;date;hour;day_ahead_price;intraday_price;price_diff;DE_solar_generation_forecast;DE_solar_generation_actual;DE_solar_generation_error;DE_wind_generation_forecast;DE_wind_generation_actual;DE_wind_generation_error
0;01.01.2016;'00 - 01;23,86;29,34;-5,48;0;0;0;7653;8648;995
1;01.01.2016;'01 - 02;22,39;24,28;-1,89;0;0;0;7421;8579;1158
2;01.01.2016;'02 - 03;20,59;25,26;-4,67;0;0;0;7266;8542;1276
3;01.01.2016;'03 - 04;16,81;20,24;-3,43;0;0;0;7180;8443;1263
4;01.01.2016;'04 - 05;17,41;21,94;-4,53;0;0;0;7016;8295;1279
5;01.01.2016;'05 - 06;17,02;23,5;-6,48;0;0;0;6787;7319;532
6;01.01.2016;'06 - 07;15,86;21,87;-6,01;0;0;0;6492;6574;82
7;01.01.2016;'07 - 08;18,16;25,13;-6,97;0;0;0;6058;5624;-434
8;01.01.2016;'08 - 09;17,73;24,52;-6,79;137;137;0;5510;4644;-866
9;01.01.2016;'09 - 10;19,77;23,67;-3,9;1010;964;-46;4924;3733;-1191
10;01.01.2016;'10 - 11;23,75;25,64;-1,89;2451;2522;71;4172;2776;-1396
11;01.01.2016;'11 - 12;26,03;27,8;-1,77;3815;3768;-47;3423;1830;-1593
12;01.01.2016;'12 - 13;27,06;29,75;-2,69;4382;4121;-261;2787;1287;-1500
13;01.01.2016;'13 - 14;26,59;28,45;-1,86;3986;3717;-269;2328;790;-1538
14;01.01.2016;'14 - 15;25;26,42;-1,42;2658;2442;-216;1937;496;-1441
15;01.01.2016;'15 - 16;24,43;28,25;-3,82;979;841;-138;1609;405;-1204
16;01.01.2016;'16 - 17;28,87;32,49;-3,62;51;51;0;1568;665;-903
17;01.01.2016;'17 - 18;37,44;40,98;-3,54;0;0;0;1673;1298;-375
18;01.01.2016;'18 - 19;37,41;39,48;-2,07;0;0;0;1798;2146;348
19;01.01.2016;'19 - 20;35,34;34,34;1;0;0;0;2070;3371;1301
20;01.01.2016;'20 - 21;33,07;31,09;1,98;0;0;0;2725;4383;1658
21;01.01.2016;'21 - 22;29,52;27,17;2,35;0;0;0;3182;5409;2227
22;01.01.2016;'22 - 23;30,1;27,59;2,51;0;0;0;3567;6180;2613
23;01.01.2016;'23 - 24;24,57;21,6;2,97;0;0;0;3885;6958;3073
24;02.01.2016;'00 - 01;22,2;14,36;7,84;0;0;0;6397;7462;1065
25;02.01.2016;'01 - 02;16,57;13,48;3,09;0;0;0;7411;8763;1352
26;02.01.2016;'02 - 03;15,35;10,16;5,19;0;0;0;8610;10716;2106
27;02.01.2016;'03 - 04;12,77;7,77;5;0;0;0;9904;11949;2045
28;02.01.2016;'04 - 05;11,27;6,45;4,82;0;0;0;11359;13451;2092
29;02.01.2016;'05 - 06;11,91;6,38;5,53;0;0;0;12607;14640;2033
30;02.01.2016;'06 - 07;12,62;3,01;9,61;0;0;0;13859;15480;1621
31;02.01.2016;'07 - 08;13,83;6,98;6,85;1;0;-1;15165;16062;897
32;02.01.2016;'08 - 09;16,12;9,37;6,75;153;106;-47;16305;16588;283
33;02.01.2016;'09 - 10;18,12;11,83;6,29;940;593;-347;17458;17324;-134
34;02.01.2016;'10 - 11;19,59;18,85;0,74;2047;1341;-706;18304;17888;-416
35;02.01.2016;'11 - 12;21,07;27,29;-6,22;2911;1866;-1045;18733;18265;-468
36;02.01.2016;'12 - 13;22,54;29,36;-6,82;3094;2043;-1051;19105;18329;-776
37;02.01.2016;'13 - 14;19,79;28,6;-8,81;2601;1869;-732;19475;18394;-1081
38;02.01.2016;'14 - 15;16,9;30,22;-13,32;1628;1178;-450;20000;18540;-1460
39;02.01.2016;'15 - 16;16,97;27,73;-10,76;563;382;-181;20642;18754;-1888
40;02.01.2016;'16 - 17;19,25;28,75;-9,5;34;28;-6;21140;19192;-1948
41;02.01.2016;'17 - 18;28,01;38,96;-10,95;0;0;0;21661;19913;-1748
42;02.01.2016;'18 - 19;28,36;41,66;-13,3;0;0;0;22029;20215;-1814
43;02.01.2016;'19 - 20;26,56;38,3;-11,74;0;0;0;22119;20108;-2011
44;02.01.2016;'20 - 21;17,38;31,65;-14,27;0;0;0;21881;19693;-2188
45;02.01.2016;'21 - 22;15,83;29,08;-13,25;0;0;0;21525;19202;-2323
46;02.01.2016;'22 - 23;16,97;32,61;-15,64;0;0;0;21297;18460;-2837
47;02.01.2016;'23 - 24;15,31;25,18;-9,87;0;0;0;20946;18772;-2174
48;03.01.2016;'00 - 01;6,99;20,44;-13,45;0;0;0;20522;18924;-1598
49;03.01.2016;'01 - 02;-0,01;15,81;-15,82;0;0;0;20481;18596;-1885
50;03.01.2016;'02 - 03;0,23;17,87;-17,64;0;0;0;20434;18600;-1834
51;03.01.2016;'03 - 04;4,51;15,08;-10,57;0;0;0;20265;18440;-1825
52;03.01.2016;'04 - 05;4,12;11,55;-7,43;0;0;0;20091;18281;-1810
53;03.01.2016;'05 - 06;6,76;14,16;-7,4;0;0;0;19910;18302;-1608
54;03.01.2016;'06 - 07;0,75;14,69;-13,94;0;0;0;19785;18422;-1363
55;03.01.2016;'07 - 08;4,27;14,02;-9,75;1;0;-1;19670;18190;-1480
56;03.01.2016;'08 - 09;9,11;20,93;-11,82;131;66;-65;19571;17751;-1820
57;03.01.2016;'09 - 10;15,92;25;-9,08;943;638;-305;19505;17202;-2303
58;03.01.2016;'10 - 11;17,06;27,33;-10,27;2097;1648;-449;19248;16685;-2563
59;03.01.2016;'11 - 12;19,28;29,2;-9,92;3095;2621;-474;18646;15632;-3014
60;03.01.2016;'12 - 13;20,25;26,54;-6,29;3553;3051;-502;17990;14568;-3422
61;03.01.2016;'13 - 14;17,66;25,77;-8,11;3313;2909;-404;17589;14358;-3231
62;03.01.2016;'14 - 15;18,49;24,03;-5,54;2332;1880;-452;17373;14313;-3060
63;03.01.2016;'15 - 16;16,51;22,31;-5,8;943;658;-285;17320;14881;-2439
64;03.01.2016;'16 - 17;18,76;26,72;-7,96;76;48;-28;17567;15377;-2190
65;03.01.2016;'17 - 18;22,21;38,84;-16,63;3;0;-3;17978;16306;-1672
66;03.01.2016;'18 - 19;26,76;41,61;-14,85;0;0;0;18445;17294;-1151
67;03.01.2016;'19 - 20;27,08;38,94;-11,86;0;0;0;18751;17648;-1103
68;03.01.2016;'20 - 21;25,33;38,03;-12,7;0;0;0;18773;17745;-1028
69;03.01.2016;'21 - 22;22,11;32,32;-10,21;0;0;0;18734;17589;-1145
70;03.01.2016;'22 - 23;20,91;33,33;-12,42;0;0;0;18795;16955;-1840
71;03.01.2016;'23 - 24;14,43;30,73;-16,3;0;0;0;18768;16746;-2022
72;04.01.2016;'00 - 01;13,78;23,63;-9,85;0;0;0;20345;16415;-3930
73;04.01.2016;'01 - 02;12,77;24,03;-11,26;0;0;0;20175;15686;-4489
74;04.01.2016;'02 - 03;10,56;22,8;-12,24;0;0;0;19888;15040;-4848
75;04.01.2016;'03 - 04;3,87;19,33;-15,46;0;0;0;19409;14410;-4999
76;04.01.2016;'04 - 05;3,2;16,23;-13,03;0;0;0;18962;13623;-5339
77;04.01.2016;'05 - 06;8,67;24,19;-15,52;0;0;0;18591;13175;-5416
78;04.01.2016;'06 - 07;18,01;37,74;-19,73;0;0;0;18237;13284;-4953
79;04.01.2016;'07 - 08;28,52;45,73;-17,21;1;0;-1;17904;13091;-4813
80;04.01.2016;'08 - 09;34,74;48,78;-14,04;99;71;-28;17578;12873;-4705
81;04.01.2016;'09 - 10;33,46;47,22;-13,76;709;533;-176;17147;12206;-4941
82;04.01.2016;'10 - 11;33,24;47,98;-14,74;1573;1350;-223;16345;11458;-4887
83;04.01.2016;'11 - 12;35,09;48,73;-13,64;2235;1998;-237;15262;10580;-4682
84;04.01.2016;'12 - 13;35;48,48;-13,48;2497;2231;-266;14273;10173;-4100
85;04.01.2016;'13 - 14;35;49,27;-14,27;2298;2005;-293;13401;9772;-3629
86;04.01.2016;'14 - 15;34,94;50,87;-15,93;1571;1298;-273;12785;9753;-3032
87;04.01.2016;'15 - 16;34,92;50,8;-15,88;635;536;-99;12244;10014;-2230
88;04.01.2016;'16 - 17;38;51,52;-13,52;55;58;3;11901;10292;-1609
89;04.01.2016;'17 - 18;41,21;58,2;-16,99;0;0;0;11867;10920;-947
90;04.01.2016;'18 - 19;42,95;56,2;-13,25;0;0;0;11926;11096;-830
91;04.01.2016;'19 - 20;41,96;53,17;-11,21;0;0;0;11918;10861;-1057
92;04.01.2016;'20 - 21;34,94;44,74;-9,8;0;0;0;11779;10690;-1089
93;04.01.2016;'21 - 22;30,66;39,72;-9,06;0;0;0;11568;10284;-1284
94;04.01.2016;'22 - 23;30;38,23;-8,23;0;0;0;11344;9974;-1370
95;04.01.2016;'23 - 24;23,9;31,15;-7,25;0;0;0;11096;9676;-1420
96;05.01.2016;'00 - 01;25,03;26,98;-1,95;0;0;0;11547;9529;-2018
97;05.01.2016;'01 - 02;24,42;27,03;-2,61;0;0;0;11515;9304;-2211
98;05.01.2016;'02 - 03;22,34;25,34;-3;0;0;0;11626;9205;-2421
99;05.01.2016;'03 - 04;21,5;21,79;-0,29;0;0;0;11630;9191;-2439
100;05.01.2016;'04 - 05;20;24,64;-4,64;0;0;0;11611;9260;-2351
101;05.01.2016;'05 - 06;23,53;28,13;-4,6;0;0;0;11628;9387;-2241
102;05.01.2016;'06 - 07;28,96;35,45;-6,49;0;0;0;11726;9378;-2348
103;05.01.2016;'07 - 08;38,32;44,65;-6,33;2;0;-2;11817;9323;-2494
104;05.01.2016;'08 - 09;41,45;44,25;-2,8;131;75;-56;11868;9250;-2618
105;05.01.2016;'09 - 10;40,72;44,67;-3,95;856;603;-253;11782;9086;-2696
106;05.01.2016;'10 - 11;40,66;45,37;-4,71;1875;1670;-205;11583;8797;-2786
107;05.01.2016;'11 - 12;40,33;44,41;-4,08;2700;2497;-203;11379;8369;-3010
108;05.01.2016;'12 - 13;38,25;42,57;-4,32;2968;2936;-32;11231;8088;-3143
109;05.01.2016;'13 - 14;36,98;39,63;-2,65;2646;2423;-223;11158;7892;-3266
110;05.01.2016;'14 - 15;34,91;38,64;-3,73;1813;1610;-203;11233;7972;-3261
111;05.01.2016;'15 - 16;33,5;41,92;-8,42;741;673;-68;11433;8052;-3381
112;05.01.2016;'16 - 17;35,1;50,09;-14,99;68;62;-6;11507;8112;-3395
113;05.01.2016;'17 - 18;42,44;58,72;-16,28;2;0;-2;11530;8368;-3162
114;05.01.2016;'18 - 19;42,94;58,14;-15,2;0;0;0;11492;8622;-2870
115;05.01.2016;'19 - 20;41,74;54,55;-12,81;0;0;0;11468;8527;-2941
116;05.01.2016;'20 - 21;36,47;46,6;-10,13;0;0;0;11493;8410;-3083
117;05.01.2016;'21 - 22;33,01;40,38;-7,37;0;0;0;11499;8185;-3314
118;05.01.2016;'22 - 23;31,75;37,22;-5,47;0;0;0;11404;7999;-3405
119;05.01.2016;'23 - 24;26,99;35,91;-8,92;0;0;0;11204;7968;-3236
120;06.01.2016;'00 - 01;26,62;29,21;-2,59;0;0;0;9587;7723;-1864
121;06.01.2016;'01 - 02;25,58;28,77;-3,19;0;0;0;9330;7566;-1764
122;06.01.2016;'02 - 03;24,59;27,85;-3,26;0;0;0;9098;7264;-1834
123;06.01.2016;'03 - 04;22,5;24,37;-1,87;0;0;0;8900;7212;-1688
124;06.01.2016;'04 - 05;23,16;25,65;-2,49;0;0;0;8828;7163;-1665
125;06.01.2016;'05 - 06;24,99;29,5;-4,51;0;0;0;8815;7366;-1449
126;06.01.2016;'06 - 07;26,62;31,85;-5,23;0;0;0;8877;7206;-1671
127;06.01.2016;'07 - 08;28,03;34,36;-6,33;2;0;-2;8859;7265;-1594
128;06.01.2016;'08 - 09;29,34;32,95;-3,61;151;127;-24;8777;7169;-1608
129;06.01.2016;'09 - 10;32,94;37,14;-4,2;974;770;-204;8656;6806;-1850
130;06.01.2016;'10 - 11;37,71;41,12;-3,41;2129;1818;-311;8410;6636;-1774
131;06.01.2016;'11 - 12;40,08;43,43;-3,35;3128;2721;-407;8082;6272;-1810
132;06.01.2016;'12 - 13;40,73;44,42;-3,69;3436;2820;-616;7613;5672;-1941
133;06.01.2016;'13 - 14;38,26;44,28;-6,02;3040;2326;-714;7188;5346;-1842
134;06.01.2016;'14 - 15;35,44;42,68;-7,24;2033;1463;-570;6949;5177;-1772
135;06.01.2016;'15 - 16;36,92;45,32;-8,4;809;510;-299;6920;5347;-1573
136;06.01.2016;'16 - 17;41,28;46,84;-5,56;73;40;-33;7007;5586;-1421
137;06.01.2016;'17 - 18;44,95;50,51;-5,56;2;0;-2;7098;6018;-1080
138;06.01.2016;'18 - 19;46,9;53,42;-6,52;0;0;0;7186;6242;-944
139;06.01.2016;'19 - 20;43,95;48,17;-4,22;0;0;0;7194;6465;-729
140;06.01.2016;'20 - 21;39,94;41,03;-1,09;0;0;0;7143;6603;-540
141;06.01.2016;'21 - 22;32,4;35,65;-3,25;0;0;0;7111;6434;-677
142;06.01.2016;'22 - 23;33,51;36,94;-3,43;0;0;0;7267;6437;-830
143;06.01.2016;'23 - 24;30,11;33,11;-3;0;0;0;7524;6372;-1152
144;07.01.2016;'00 - 01;26,41;24,69;1,72;0;0;0;7849;6420;-1429
145;07.01.2016;'01 - 02;26,05;24,47;1,58;0;0;0;8036;6509;-1527
146;07.01.2016;'02 - 03;24,93;25,31;-0,38;0;0;0;8486;6713;-1773
147;07.01.2016;'03 - 04;22,39;21,5;0,89;0;0;0;8978;6943;-2035
148;07.01.2016;'04 - 05;22,32;22,26;0,06;0;0;0;9486;7062;-2424
149;07.01.2016;'05 - 06;24,2;24,18;0,02;0;0;0;10102;7098;-3004
150;07.01.2016;'06 - 07;31;29,87;1,13;0;0;0;10803;7575;-3228
151;07.01.2016;'07 - 08;42,47;39,51;2,96;2;0;-2;11481;8400;-3081
152;07.01.2016;'08 - 09;42,97;41,1;1,87;168;150;-18;12432;9167;-3265
153;07.01.2016;'09 - 10;41,93;35,86;6,07;1031;1205;174;13396;10482;-2914
154;07.01.2016;'10 - 11;41,62;31,72;9,9;2033;2839;806;14229;11005;-3224
155;07.01.2016;'11 - 12;41,5;31,65;9,85;2687;3898;1211;14959;10906;-4053
156;07.01.2016;'12 - 13;40,66;31,54;9,12;2630;3342;712;15707;10983;-4724
157;07.01.2016;'13 - 14;40,33;33,17;7,16;2057;1982;-75;16548;11398;-5150
158;07.01.2016;'14 - 15;36,51;36,45;0,06;1241;914;-327;17534;12438;-5096
159;07.01.2016;'15 - 16;33,49;35,56;-2,07;480;282;-198;18413;13858;-4555
160;07.01.2016;'16 - 17;34,19;34,5;-0,31;39;26;-13;18852;15102;-3750
161;07.01.2016;'17 - 18;40,66;35,69;4,97;0;0;0;18830;16114;-2716
162;07.01.2016;'18 - 19;40,8;38,01;2,79;0;0;0;19081;17594;-1487
163;07.01.2016;'19 - 20;37,19;35,47;1,72;0;0;0;18928;18522;-406
164;07.01.2016;'20 - 21;31,94;31,06;0,88;0;0;0;18391;19609;1218
165;07.01.2016;'21 - 22;27,01;26,68;0,33;0;0;0;18346;20734;2388
166;07.01.2016;'22 - 23;27,52;24,14;3,38;0;0;0;18499;21372;2873
167;07.01.2016;'23 - 24;23,4;18,59;4,81;0;0;0;18665;21563;2898
168;08.01.2016;'00 - 01;12,12;26,13;-14,01;0;0;0;22592;22456;-136
169;08.01.2016;'01 - 02;17,23;23,63;-6,4;0;0;0;23248;22810;-438
170;08.01.2016;'02 - 03;13,9;20,41;-6,51;0;0;0;23343;22868;-475
171;08.01.2016;'03 - 04;12,11;20,57;-8,46;0;0;0;24123;23458;-665
172;08.01.2016;'04 - 05;12,99;15,22;-2,23;0;0;0;24963;23700;-1263
173;08.01.2016;'05 - 06;16,98;11,67;5,31;0;0;0;25376;24682;-694
174;08.01.2016;'06 - 07;22,02;20,22;1,8;0;0;0;25487;25880;393
175;08.01.2016;'07 - 08;28,4;25,32;3,08;4;0;-4;25309;26073;764
176;08.01.2016;'08 - 09;29,31;27,81;1,5;352;339;-13;24975;26408;1433
177;08.01.2016;'09 - 10;26,6;26,82;-0,22;2624;2815;191;24599;26070;1471
178;08.01.2016;'10 - 11;25,55;22,08;3,47;5446;6242;796;24073;25515;1442
179;08.01.2016;'11 - 12;25,76;21,25;4,51;7704;8735;1031;22965;25106;2141
180;08.01.2016;'12 - 13;25,13;16,92;8,21;8423;9116;693;21369;23671;2302
181;08.01.2016;'13 - 14;25,58;19,95;5,63;7515;7362;-153;19785;21322;1537
182;08.01.2016;'14 - 15;27,6;25,96;1,64;5208;4492;-716;18190;18643;453
183;08.01.2016;'15 - 16;32,08;31,97;0,11;2086;1750;-336;16772;16149;-623
184;08.01.2016;'16 - 17;37,16;42,61;-5,45;116;118;2;15764;15412;-352
185;08.01.2016;'17 - 18;45;48,1;-3,1;0;0;0;15302;14731;-571
186;08.01.2016;'18 - 19;46,97;48,32;-1,35;0;0;0;14870;13577;-1293
187;08.01.2016;'19 - 20;40,09;42,89;-2,8;0;0;0;14476;12775;-1701
188;08.01.2016;'20 - 21;34,61;38,08;-3,47;0;0;0;13587;11888;-1699
189;08.01.2016;'21 - 22;31,52;32,84;-1,32;0;0;0;12433;11230;-1203
190;08.01.2016;'22 - 23;32,5;32,07;0,43;0;0;0;11183;10311;-872
191;08.01.2016;'23 - 24;26,01;31,45;-5,44;0;0;0;9976;9782;-194
192;09.01.2016;'00 - 01;26,1;27,17;-1,07;0;0;0;7203;8815;1612
193;09.01.2016;'01 - 02;25,1;25,45;-0,35;0;0;0;6367;8121;1754
194;09.01.2016;'02 - 03;24,3;26,08;-1,78;0;0;0;5681;7671;1990
195;09.01.2016;'03 - 04;23,23;23,93;-0,7;0;0;0;5192;7198;2006
196;09.01.2016;'04 - 05;21,96;23,12;-1,16;0;0;0;5058;7355;2297
197;09.01.2016;'05 - 06;22,45;22,48;-0,03;0;0;0;5105;7094;1989
198;09.01.2016;'06 - 07;23,07;24,06;-0,99;0;0;0;5296;7464;2168
199;09.01.2016;'07 - 08;25;24,67;0,33;2;0;-2;5614;7537;1923
200;09.01.2016;'08 - 09;32,11;27,98;4,13;113;196;83;5944;7807;1863
201;09.01.2016;'09 - 10;37,12;28,57;8,55;816;1554;738;6104;7990;1886
202;09.01.2016;'10 - 11;36,13;28,12;8,01;2240;3446;1206;5984;7728;1744
203;09.01.2016;'11 - 12;35,76;25,53;10,23;3656;5002;1346;5572;6464;892
204;09.01.2016;'12 - 13;34,06;26,81;7,25;4087;5171;1084;5206;5640;434
205;09.01.2016;'13 - 14;31,54;28,12;3,42;3640;4453;813;5234;5292;58
206;09.01.2016;'14 - 15;27,92;27,26;0,66;2461;2900;439;5657;5173;-484
207;09.01.2016;'15 - 16;27;29,17;-2,17;990;1078;88;6322;6124;-198
208;09.01.2016;'16 - 17;30,5;32,26;-1,76;65;91;26;7202;7979;777
209;09.01.2016;'17 - 18;36,99;36,33;0,66;0;0;0;8085;9648;1563
210;09.01.2016;'18 - 19;36,8;33,83;2,97;0;0;0;8823;10718;1895
211;09.01.2016;'19 - 20;35;29,3;5,7;0;0;0;9277;11450;2173
212;09.01.2016;'20 - 21;29;27,98;1,02;0;0;0;9569;11629;2060
213;09.01.2016;'21 - 22;25,01;26,09;-1,08;0;0;0;9980;11666;1686
214;09.01.2016;'22 - 23;25,1;25,55;-0,45;0;0;0;10436;12193;1757
215;09.01.2016;'23 - 24;22,28;24,09;-1,81;0;0;0;10860;12602;1742
216;10.01.2016;'00 - 01;15,58;17,03;-1,45;0;0;0;11711;13086;1375
217;10.01.2016;'01 - 02;19,05;15,65;3,4;0;0;0;12260;13590;1330
218;10.01.2016;'02 - 03;16,87;11,05;5,82;0;0;0;12807;14377;1570
219;10.01.2016;'03 - 04;12,75;9,83;2,92;0;0;0;13318;15121;1803
220;10.01.2016;'04 - 05;10,81;9,25;1,56;0;0;0;13770;15188;1418
221;10.01.2016;'05 - 06;10,85;8,9;1,95;0;0;0;14421;15749;1328
222;10.01.2016;'06 - 07;9,85;8,4;1,45;0;0;0;14889;16646;1757
223;10.01.2016;'07 - 08;11,92;9,52;2,4;3;0;-3;15332;17234;1902
224;10.01.2016;'08 - 09;15,44;12,5;2,94;165;178;13;15903;17175;1272
225;10.01.2016;'09 - 10;18,99;18,72;0,27;1160;1196;36;16020;16838;818
226;10.01.2016;'10 - 11;19,66;24,59;-4,93;2698;2311;-387;15944;16607;663
227;10.01.2016;'11 - 12;21,59;25,55;-3,96;4058;3154;-904;15332;16256;924
228;10.01.2016;'12 - 13;21,83;26,89;-5,06;4500;3805;-695;14519;15297;778
229;10.01.2016;'13 - 14;20,82;24,38;-3,56;4172;3940;-232;13475;14348;873
230;10.01.2016;'14 - 15;20,06;21,91;-1,85;3052;3009;-43;12144;13428;1284
231;10.01.2016;'15 - 16;21,45;22,51;-1,06;1312;1226;-86;11175;12548;1373
232;10.01.2016;'16 - 17;23,92;25,23;-1,31;107;81;-26;10559;12871;2312
233;10.01.2016;'17 - 18;27,93;29,3;-1,37;0;0;0;10357;13438;3081
234;10.01.2016;'18 - 19;35;33,15;1,85;0;0;0;10385;13767;3382
235;10.01.2016;'19 - 20;33;30,23;2,77;0;0;0;10442;14325;3883
236;10.01.2016;'20 - 21;30,03;21,52;8,51;0;0;0;10488;13727;3239
237;10.01.2016;'21 - 22;26,06;15,76;10,3;0;0;0;10415;12371;1956
238;10.01.2016;'22 - 23;26,93;22,11;4,82;0;0;0;10359;11575;1216
239;10.01.2016;'23 - 24;23,12;23,09;0,03;0;0;0;9972;11273;1301
240;11.01.2016;'00 - 01;21,95;20,21;1,74;0;0;0;9992;10728;736
241;11.01.2016;'01 - 02;20,04;17,1;2,94;0;0;0;9365;10013;648
242;11.01.2016;'02 - 03;19,78;13,49;6,29;0;0;0;8830;9387;557
243;11.01.2016;'03 - 04;19,36;14,12;5,24;0;0;0;8231;8030;-201
244;11.01.2016;'04 - 05;19,56;14,73;4,83;0;0;0;7503;7316;-187
245;11.01.2016;'05 - 06;21,67;17,47;4,2;0;0;0;6780;6474;-306
246;11.01.2016;'06 - 07;28,5;24,77;3,73;0;0;0;6207;6188;-19
247;11.01.2016;'07 - 08;41,61;32,35;9,26;2;0;-2;5956;6382;426
248;11.01.2016;'08 - 09;45,93;39,84;6,09;142;90;-52;5895;6817;922
249;11.01.2016;'09 - 10;44;35,26;8,74;900;544;-356;5751;7204;1453
250;11.01.2016;'10 - 11;41,94;31,6;10,34;1919;1343;-576;5649;7137;1488
251;11.01.2016;'11 - 12;41,96;32,03;9,93;2666;1989;-677;5451;6793;1342
252;11.01.2016;'12 - 13;42,33;32,7;9,63;2815;2238;-577;5300;6240;940
253;11.01.2016;'13 - 14;42,1;30,57;11,53;2412;1994;-418;5409;6038;629
254;11.01.2016;'14 - 15;39,88;31,71;8,17;1717;1296;-421;5800;6398;598
255;11.01.2016;'15 - 16;37,5;32,82;4,68;801;595;-206;6281;7476;1195
256;11.01.2016;'16 - 17;37,95;31,11;6,84;78;88;10;6890;8467;1577
257;11.01.2016;'17 - 18;44,69;32,82;11,87;0;1;1;7657;9729;2072
258;11.01.2016;'18 - 19;42,88;33,12;9,76;0;0;0;8491;10479;1988
259;11.01.2016;'19 - 20;40;29,2;10,8;0;0;0;8953;10726;1773
260;11.01.2016;'20 - 21;33,09;25,99;7,1;0;0;0;8913;10824;1911
261;11.01.2016;'21 - 22;27,93;22,54;5,39;0;0;0;8833;10748;1915
262;11.01.2016;'22 - 23;28;24,24;3,76;0;0;0;8602;10604;2002
263;11.01.2016;'23 - 24;24,14;16,89;7,25;0;0;0;8375;10300;1925
264;12.01.2016;'00 - 01;21,51;16,19;5,32;0;0;0;9183;10106;923
265;12.01.2016;'01 - 02;19,81;14,43;5,38;0;0;0;9041;9849;808
266;12.01.2016;'02 - 03;19,1;13,1;6;0;0;0;8910;9681;771
267;12.01.2016;'03 - 04;15,74;10,96;4,78;0;0;0;8789;9863;1074
268;12.01.2016;'04 - 05;15,54;11,53;4,01;0;0;0;8598;10305;1707
269;12.01.2016;'05 - 06;20,19;13,52;6,67;0;0;0;8643;10822;2179
270;12.01.2016;'06 - 07;24,38;20,03;4,35;0;0;0;8973;11436;2463
271;12.01.2016;'07 - 08;35,92;31,89;4,03;3;1;-2;9240;11621;2381
272;12.01.2016;'08 - 09;40,5;33,86;6,64;156;131;-25;9335;11797;2462
273;12.01.2016;'09 - 10;41;35,25;5,75;902;791;-111;9470;12120;2650
274;12.01.2016;'10 - 11;38,66;31,37;7,29;1868;1756;-112;9664;12748;3084
275;12.01.2016;'11 - 12;36,46;30,1;6,36;2657;2538;-119;9898;12975;3077
276;12.01.2016;'12 - 13;35;31,06;3,94;2921;3142;221;10150;13248;3098
277;12.01.2016;'13 - 14;33,3;29,13;4,17;2754;3137;383;10134;13553;3419
278;12.01.2016;'14 - 15;32,21;28,93;3,28;2070;2428;358;9851;13435;3584
279;12.01.2016;'15 - 16;33;27,99;5,01;973;1092;119;9535;12850;3315
280;12.01.2016;'16 - 17;36,08;31,12;4,96;111;116;5;9628;13023;3395
281;12.01.2016;'17 - 18;41,94;37,08;4,86;0;2;2;10253;13584;3331
282;12.01.2016;'18 - 19;40,33;39,04;1,29;0;0;0;10805;13919;3114
283;12.01.2016;'19 - 20;29,69;32,73;-3,04;0;0;0;11107;14524;3417
284;12.01.2016;'20 - 21;26,05;26,3;-0,25;0;0;0;11596;15350;3754
285;12.01.2016;'21 - 22;24,76;27,3;-2,54;0;0;0;11932;15537;3605
286;12.01.2016;'22 - 23;24,03;29,03;-5;0;0;0;12229;15507;3278
287;12.01.2016;'23 - 24;21,51;24,68;-3,17;0;0;0;12508;15597;3089
288;13.01.2016;'00 - 01;21;26,41;-5,41;0;0;0;14174;15809;1635
289;13.01.2016;'01 - 02;19,66;22,51;-2,85;0;0;0;14015;16090;2075
290;13.01.2016;'02 - 03;18,13;19,18;-1,05;0;0;0;14082;16516;2434
291;13.01.2016;'03 - 04;15,3;14,59;0,71;0;0;0;14110;17244;3134
292;13.01.2016;'04 - 05;18,05;16,91;1,14;0;0;0;14317;17520;3203
293;13.01.2016;'05 - 06;20,83;18,84;1,99;0;0;0;14769;18230;3461
294;13.01.2016;'06 - 07;24,1;28,93;-4,83;0;0;0;15140;19194;4054
295;13.01.2016;'07 - 08;27,87;26,04;1,83;2;0;-2;15148;19309;4161
296;13.01.2016;'08 - 09;29,98;32,03;-2,05;109;118;9;14830;18275;3445
297;13.01.2016;'09 - 10;30,73;33,49;-2,76;622;642;20;14393;17223;2830
298;13.01.2016;'10 - 11;31,45;32,34;-0,89;1437;1551;114;13869;16594;2725
299;13.01.2016;'11 - 12;33,56;32,15;1,41;2176;2258;82;13598;15837;2239
300;13.01.2016;'12 - 13;33,99;32,16;1,83;2545;2580;35;13226;15398;2172
301;13.01.2016;'13 - 14;34,09;33,48;0,61;2448;2376;-72;12600;14673;2073
302;13.01.2016;'14 - 15;34,02;34,14;-0,12;1800;1778;-22;11802;13976;2174
303;13.01.2016;'15 - 16;37,44;34,41;3,03;819;774;-45;10957;13336;2379
304;13.01.2016;'16 - 17;39,58;37,03;2,55;103;86;-17;10088;13012;2924
305;13.01.2016;'17 - 18;43;42,26;0,74;0;2;2;9339;12136;2797
306;13.01.2016;'18 - 19;42,22;39,79;2,43;0;0;0;8671;10898;2227
307;13.01.2016;'19 - 20;38,86;42,28;-3,42;0;0;0;8021;9909;1888
308;13.01.2016;'20 - 21;29,62;33,11;-3,49;0;0;0;7720;9212;1492
309;13.01.2016;'21 - 22;26,97;28,37;-1,4;0;0;0;7525;8514;989
310;13.01.2016;'22 - 23;25,88;26,49;-0,61;0;0;0;7310;8676;1366
311;13.01.2016;'23 - 24;23,52;24,19;-0,67;0;0;0;7121;9194;2073
312;14.01.2016;'00 - 01;24,29;28,14;-3,85;0;0;0;9043;9833;790
313;14.01.2016;'01 - 02;23,06;24,44;-1,38;0;0;0;9084;9532;448
314;14.01.2016;'02 - 03;22,22;22,26;-0,04;0;0;0;8786;9152;366
315;14.01.2016;'03 - 04;22,03;22,7;-0,67;0;0;0;8331;8990;659
316;14.01.2016;'04 - 05;22,53;22,19;0,34;0;0;0;8086;8285;199
317;14.01.2016;'05 - 06;23,9;27,8;-3,9;0;0;0;8010;8370;360
318;14.01.2016;'06 - 07;29,99;30,67;-0,68;0;0;0;8202;9000;798
319;14.01.2016;'07 - 08;44,07;38,38;5,69;7;0;-7;8539;9734;1195
320;14.01.2016;'08 - 09;44,99;44,73;0,26;442;472;30;8862;10273;1411
321;14.01.2016;'09 - 10;41,39;39,93;1,46;2652;2984;332;9300;10525;1225
322;14.01.2016;'10 - 11;34,95;30,5;4,45;5317;6185;868;9641;10369;728
323;14.01.2016;'11 - 12;33,18;29,11;4,07;7208;8841;1633;9789;10483;694
324;14.01.2016;'12 - 13;31,17;26,36;4,81;7488;9829;2341;9797;10506;709
325;14.01.2016;'13 - 14;33,52;27,2;6,32;6275;8555;2280;9427;10268;841
326;14.01.2016;'14 - 15;39,97;31,62;8,35;4053;5652;1599;9154;9868;714
327;14.01.2016;'15 - 16;42,99;37,69;5,3;1731;1911;180;9051;9567;516
328;14.01.2016;'16 - 17;42,34;41,79;0,55;181;119;-62;9249;9721;472
329;14.01.2016;'17 - 18;45,5;43;2,5;0;2;2;9610;10369;759
330;14.01.2016;'18 - 19;41,06;40,12;0,94;0;0;0;9797;11076;1279
331;14.01.2016;'19 - 20;40,02;39,4;0,62;0;0;0;9762;10633;871
332;14.01.2016;'20 - 21;38,34;34,16;4,18;0;0;0;9471;10494;1023
333;14.01.2016;'21 - 22;30,86;31,2;-0,34;0;0;0;9010;10391;1381
334;14.01.2016;'22 - 23;28,16;27,24;0,92;0;0;0;8568;9926;1358
335;14.01.2016;'23 - 24;25,73;25,95;-0,22;0;0;0;8264;9744;1480
336;15.01.2016;'00 - 01;24,58;23,34;1,24;0;0;0;8588;9660;1072
337;15.01.2016;'01 - 02;25,03;24,3;0,73;0;0;0;8348;9733;1385
338;15.01.2016;'02 - 03;24,36;23,52;0,84;0;0;0;8228;9642;1414
339;15.01.2016;'03 - 04;23,5;22,46;1,04;0;0;0;8180;9479;1299
340;15.01.2016;'04 - 05;22,94;24,06;-1,12;0;0;0;7949;9575;1626
341;15.01.2016;'05 - 06;23,17;21,42;1,75;0;0;0;7740;9534;1794
342;15.01.2016;'06 - 07;26,35;21,92;4,43;0;0;0;7680;9762;2082
343;15.01.2016;'07 - 08;40,9;38,14;2,76;3;0;-3;7724;9618;1894
344;15.01.2016;'08 - 09;45,21;38,9;6,31;155;130;-25;7648;9335;1687
345;15.01.2016;'09 - 10;45,46;43,23;2,23;855;668;-187;7726;8549;823
346;15.01.2016;'10 - 11;45,99;45,58;0,41;1784;1221;-563;7768;7845;77
347;15.01.2016;'11 - 12;46,95;45,2;1,75;2513;1679;-834;7737;6973;-764
348;15.01.2016;'12 - 13;44;45,43;-1,43;2756;1800;-956;7656;6298;-1358
349;15.01.2016;'13 - 14;42,05;45,96;-3,91;2479;1637;-842;7503;5759;-1744
350;15.01.2016;'14 - 15;39,99;44,83;-4,84;1724;1053;-671;7244;5160;-2084
351;15.01.2016;'15 - 16;37,65;45,62;-7,97;784;448;-336;6782;4644;-2138
352;15.01.2016;'16 - 17;38;47,56;-9,56;101;52;-49;6345;4236;-2109
353;15.01.2016;'17 - 18;45,26;49,42;-4,16;2;2;0;5942;3936;-2006
354;15.01.2016;'18 - 19;48,04;49,44;-1,4;0;0;0;5559;3818;-1741
355;15.01.2016;'19 - 20;44,36;44,67;-0,31;0;0;0;5079;3529;-1550
356;15.01.2016;'20 - 21;34,38;35,5;-1,12;0;0;0;4595;3075;-1520
357;15.01.2016;'21 - 22;29,34;35,83;-6,49;0;0;0;4032;2934;-1098
358;15.01.2016;'22 - 23;27,17;33,6;-6,43;0;0;0;3519;2625;-894
359;15.01.2016;'23 - 24;25,02;29,34;-4,32;0;0;0;3101;2326;-775
360;16.01.2016;'00 - 01;27,13;28,48;-1,35;0;0;0;2145;2187;42
361;16.01.2016;'01 - 02;26,37;28,2;-1,83;0;0;0;1925;2093;168
362;16.01.2016;'02 - 03;25,58;28,32;-2,74;0;0;0;2036;2006;-30
363;16.01.2016;'03 - 04;24,73;25,33;-0,6;0;0;0;2301;2180;-121
364;16.01.2016;'04 - 05;24,08;25,92;-1,84;0;0;0;2559;2436;-123
365;16.01.2016;'05 - 06;25,32;25,24;0,08;0;0;0;2669;2602;-67
366;16.01.2016;'06 - 07;24,77;26,66;-1,89;0;0;0;2924;2766;-158
367;16.01.2016;'07 - 08;25,03;25,88;-0,85;4;0;-4;3283;3258;-25
368;16.01.2016;'08 - 09;27,55;29,72;-2,17;256;96;-160;3811;4115;304
369;16.01.2016;'09 - 10;32,4;29,27;3,13;1352;541;-811;4305;4726;421
370;16.01.2016;'10 - 11;34,21;33,79;0,42;2758;1106;-1652;4381;5118;737
371;16.01.2016;'11 - 12;33,23;38,46;-5,23;3885;1594;-2291;4326;5931;1605
372;16.01.2016;'12 - 13;29,16;34,4;-5,24;4275;1786;-2489;4531;6466;1935
373;16.01.2016;'13 - 14;26,31;29,51;-3,2;3942;1674;-2268;4920;7099;2179
374;16.01.2016;'14 - 15;25,47;29,41;-3,94;2892;1263;-1629;5496;7727;2231
375;16.01.2016;'15 - 16;25,6;28,93;-3,33;1400;617;-783;6033;7948;1915
376;16.01.2016;'16 - 17;30,15;29,24;0,91;208;95;-113;6267;7788;1521
377;16.01.2016;'17 - 18;39,77;39,03;0,74;12;2;-10;6420;7948;1528
378;16.01.2016;'18 - 19;40,03;38,75;1,28;0;0;0;6623;8048;1425
379;16.01.2016;'19 - 20;30,99;30,39;0,6;0;0;0;6899;8223;1324
380;16.01.2016;'20 - 21;26,19;23,78;2,41;0;0;0;7140;8343;1203
381;16.01.2016;'21 - 22;25,9;24,26;1,64;0;0;0;7403;8475;1072
382;16.01.2016;'22 - 23;25,53;25,62;-0,09;0;0;0;7411;8733;1322
383;16.01.2016;'23 - 24;24,12;22,58;1,54;0;0;0;7346;8873;1527
384;17.01.2016;'00 - 01;20,86;26,65;-5,79;0;0;0;7930;8831;901
385;17.01.2016;'01 - 02;20,25;25,05;-4,8;0;0;0;7923;8726;803
386;17.01.2016;'02 - 03;20,76;23,94;-3,18;0;0;0;7957;8456;499
387;17.01.2016;'03 - 04;20,97;22,57;-1,6;0;0;0;7743;8266;523
388;17.01.2016;'04 - 05;20,89;22,78;-1,89;0;0;0;7237;7966;729
389;17.01.2016;'05 - 06;20,94;21,39;-0,45;0;0;0;6706;7637;931
390;17.01.2016;'06 - 07;19,64;22,23;-2,59;0;0;0;6071;7495;1424
391;17.01.2016;'07 - 08;22,35;21,1;1,25;0;0;0;5398;6884;1486
392;17.01.2016;'08 - 09;23,52;22,42;1,1;143;96;-47;4555;5737;1182
393;17.01.2016;'09 - 10;26,54;28,46;-1,92;1087;486;-601;3900;4770;870
394;17.01.2016;'10 - 11;30,11;31,97;-1,86;2571;977;-1594;3268;4060;792
395;17.01.2016;'11 - 12;36,29;33,92;2,37;3955;1516;-2439;2720;3350;630
396;17.01.2016;'12 - 13;32,44;35,12;-2,68;4701;1933;-2768;2211;2878;667
397;17.01.2016;'13 - 14;26,93;29,59;-2,66;4465;1777;-2688;1820;2724;904
398;17.01.2016;'14 - 15;26,19;29,12;-2,93;3406;1259;-2147;1598;2530;932
399;17.01.2016;'15 - 16;27,07;28,61;-1,54;1713;595;-1118;1444;2310;866
400;17.01.2016;'16 - 17;31,94;28,45;3,49;223;94;-129;1429;2319;890
401;17.01.2016;'17 - 18;39,49;38,13;1,36;3;1;-2;1447;2079;632
402;17.01.2016;'18 - 19;42,8;37,9;4,9;0;0;0;1437;1968;531
403;17.01.2016;'19 - 20;39,23;36,02;3,21;0;0;0;1490;1862;372
404;17.01.2016;'20 - 21;33,3;34;-0,7;0;0;0;1529;1741;212
405;17.01.2016;'21 - 22;27,04;28,4;-1,36;0;0;0;1628;1996;368
406;17.01.2016;'22 - 23;27,05;29,13;-2,08;0;0;0;1783;2354;571
407;17.01.2016;'23 - 24;24,99;27,63;-2,64;0;0;0;1972;2563;591
408;18.01.2016;'00 - 01;23,96;23,77;0,19;0;0;0;3285;2678;-607
409;18.01.2016;'01 - 02;23,47;25,13;-1,66;0;0;0;3416;2789;-627
410;18.01.2016;'02 - 03;23,56;25,23;-1,67;0;0;0;3540;2592;-948
411;18.01.2016;'03 - 04;23,48;22,47;1,01;0;0;0;3548;2734;-814
412;18.01.2016;'04 - 05;23,51;22,4;1,11;0;0;0;3466;2519;-947
413;18.01.2016;'05 - 06;24,25;23,06;1,19;0;0;0;3338;2244;-1094
414;18.01.2016;'06 - 07;27,61;27,67;-0,06;0;0;0;3180;2195;-985
415;18.01.2016;'07 - 08;46,01;49,35;-3,34;0;0;0;3144;2498;-646
416;18.01.2016;'08 - 09;49,98;51,78;-1,8;191;128;-63;3374;2836;-538
417;18.01.2016;'09 - 10;50,54;53,92;-3,38;1541;864;-677;3662;3110;-552
418;18.01.2016;'10 - 11;49,91;50,77;-0,86;3643;1970;-1673;3762;3117;-645
419;18.01.2016;'11 - 12;48,44;50,13;-1,69;5613;3101;-2512;3530;2724;-806
420;18.01.2016;'12 - 13;46,93;52,45;-5,52;6458;3938;-2520;3190;2912;-278
421;18.01.2016;'13 - 14;46,32;50,73;-4,41;6081;4136;-1945;2990;3300;310
422;18.01.2016;'14 - 15;45,76;47,63;-1,87;4620;3360;-1260;2806;3480;674
423;18.01.2016;'15 - 16;49,53;48,95;0,58;2486;1706;-780;2826;3502;676
424;18.01.2016;'16 - 17;49,66;49,23;0,43;355;216;-139;3007;3658;651
425;18.01.2016;'17 - 18;62,55;61,36;1,19;3;2;-1;3284;4168;884
426;18.01.2016;'18 - 19;56,07;52,71;3,36;0;0;0;3588;4628;1040
427;18.01.2016;'19 - 20;47,18;46,76;0,42;0;0;0;3781;5206;1425
428;18.01.2016;'20 - 21;35,09;34,74;0,35;0;0;0;3938;5464;1526
429;18.01.2016;'21 - 22;26,95;28,28;-1,33;0;0;0;4011;5678;1667
430;18.01.2016;'22 - 23;26,94;29,18;-2,24;0;0;0;4028;5890;1862
431;18.01.2016;'23 - 24;25,09;25,96;-0,87;0;0;0;4050;6150;2100
432;19.01.2016;'00 - 01;31,95;31,08;0,87;0;0;0;5852;6575;723
433;19.01.2016;'01 - 02;32,16;30,89;1,27;0;0;0;5896;6670;774
434;19.01.2016;'02 - 03;28,97;27,26;1,71;0;0;0;6051;6634;583
435;19.01.2016;'03 - 04;30,01;28,88;1,13;0;0;0;6293;6747;454
436;19.01.2016;'04 - 05;30,45;29,63;0,82;0;0;0;6507;6940;433
437;19.01.2016;'05 - 06;27,01;29,07;-2,06;0;0;0;6627;7392;765
438;19.01.2016;'06 - 07;31,9;30,1;1,8;0;0;0;6857;7908;1051
439;19.01.2016;'07 - 08;54,1;53,08;1,02;1;0;-1;7071;8304;1233
440;19.01.2016;'08 - 09;64,9;63,61;1,29;182;202;20;7084;8551;1467
441;19.01.2016;'09 - 10;65,35;61,78;3,57;1220;1297;77;6916;7806;890
442;19.01.2016;'10 - 11;61,31;49,53;11,78;2807;2702;-105;6392;7267;875
443;19.01.2016;'11 - 12;61,43;48,31;13,12;4358;3871;-487;5697;6382;685
444;19.01.2016;'12 - 13;58,98;49,63;9,35;5120;4413;-707;5131;5768;637
445;19.01.2016;'13 - 14;58,53;47,41;11,12;4845;3926;-919;4910;5718;808
446;19.01.2016;'14 - 15;55,81;46,16;9,65;3624;2860;-764;4937;6049;1112
447;19.01.2016;'15 - 16;55,5;48,01;7,49;1940;1335;-605;4998;5881;883
448;19.01.2016;'16 - 17;56,21;50,71;5,5;277;174;-103;5228;6365;1137
449;19.01.2016;'17 - 18;70,07;63,21;6,86;2;2;0;5512;6878;1366
450;19.01.2016;'18 - 19;74,97;59,95;15,02;0;0;0;5744;7558;1814
451;19.01.2016;'19 - 20;57,56;47,96;9,6;0;0;0;5819;7957;2138
452;19.01.2016;'20 - 21;48,24;33,76;14,48;0;0;0;5613;7758;2145
453;19.01.2016;'21 - 22;37,98;28,32;9,66;0;0;0;5271;7618;2347
454;19.01.2016;'22 - 23;33,67;24,63;9,04;0;0;0;4982;7434;2452
455;19.01.2016;'23 - 24;29,79;22,33;7,46;0;0;0;4850;7168;2318
456;20.01.2016;'00 - 01;26,05;31,3;-5,25;0;0;0;8321;6819;-1502
457;20.01.2016;'01 - 02;26,17;33,23;-7,06;0;0;0;8205;6799;-1406
458;20.01.2016;'02 - 03;26,42;34,09;-7,67;0;0;0;8092;6452;-1640
459;20.01.2016;'03 - 04;25,36;32,49;-7,13;0;0;0;7940;6552;-1388
460;20.01.2016;'04 - 05;25,76;30,98;-5,22;0;0;0;7746;6640;-1106
461;20.01.2016;'05 - 06;26,54;29,21;-2,67;0;0;0;7489;6230;-1259
462;20.01.2016;'06 - 07;32,7;36,41;-3,71;0;0;0;7197;6298;-899
463;20.01.2016;'07 - 08;55,08;58,39;-3,31;1;0;-1;6841;6159;-682
464;20.01.2016;'08 - 09;61,08;65,17;-4,09;176;136;-40;6356;6024;-332
465;20.01.2016;'09 - 10;58,43;62,18;-3,75;1024;663;-361;5889;5824;-65
466;20.01.2016;'10 - 11;58,97;64,51;-5,54;2027;1439;-588;5406;5073;-333
467;20.01.2016;'11 - 12;56,14;60,21;-4,07;3140;2196;-944;4906;4800;-106
468;20.01.2016;'12 - 13;58,6;58,95;-0,35;3688;2690;-998;4449;4485;36
469;20.01.2016;'13 - 14;57,58;55,47;2,11;3561;2998;-563;4109;4362;253
470;20.01.2016;'14 - 15;54,95;52,79;2,16;2728;2477;-251;3872;4196;324
471;20.01.2016;'15 - 16;52,42;53,21;-0,79;1452;1370;-82;3698;4066;368
472;20.01.2016;'16 - 17;72,01;60,06;11,95;252;268;16;3636;4088;452
473;20.01.2016;'17 - 18;92,75;75,92;16,83;4;2;-2;3764;4120;356
474;20.01.2016;'18 - 19;79,09;64,44;14,65;0;0;0;3913;4018;105
475;20.01.2016;'19 - 20;70,03;59,49;10,54;0;0;0;3882;4006;124
476;20.01.2016;'20 - 21;50,1;55,3;-5,2;0;0;0;3661;3661;0
477;20.01.2016;'21 - 22;40,06;44,72;-4,66;0;0;0;3357;3216;-141
478;20.01.2016;'22 - 23;33,52;39,5;-5,98;0;0;0;3090;2770;-320
479;20.01.2016;'23 - 24;29,63;29,67;-0,04;0;0;0;2823;2511;-312
480;21.01.2016;'00 - 01;29,65;30,07;-0,42;0;0;0;2538;2342;-196
481;21.01.2016;'01 - 02;27,82;28,69;-0,87;0;0;0;2397;2035;-362
482;21.01.2016;'02 - 03;26,65;26,99;-0,34;0;0;0;2269;1797;-472
483;21.01.2016;'03 - 04;26,96;27,47;-0,51;0;0;0;2128;1628;-500
484;21.01.2016;'04 - 05;27,47;29,38;-1,91;0;0;0;1970;1432;-538
485;21.01.2016;'05 - 06;29,09;34,38;-5,29;0;0;0;1874;1410;-464
486;21.01.2016;'06 - 07;40,78;49,64;-8,86;0;0;0;1800;1444;-356
487;21.01.2016;'07 - 08;70,01;87,23;-17,22;1;0;-1;1700;1562;-138
488;21.01.2016;'08 - 09;85,05;94,16;-9,11;158;117;-41;1625;1621;-4
489;21.01.2016;'09 - 10;83,54;89,69;-6,15;1100;720;-380;1557;1652;95
490;21.01.2016;'10 - 11;74,94;80,85;-5,91;2297;1702;-595;1545;1605;60
491;21.01.2016;'11 - 12;70,12;74,37;-4,25;3671;2923;-748;1632;1699;67
492;21.01.2016;'12 - 13;59,91;60,53;-0,62;4523;3954;-569;1641;1587;-54
493;21.01.2016;'13 - 14;57,69;54,37;3,32;4574;4241;-333;1649;1680;31
494;21.01.2016;'14 - 15;57,99;54,47;3,52;3667;3396;-271;1686;1551;-135
495;21.01.2016;'15 - 16;61,05;67,13;-6,08;2066;1909;-157;1694;1394;-300
496;21.01.2016;'16 - 17;57,43;69,44;-12,01;351;370;19;1840;1430;-410
497;21.01.2016;'17 - 18;77,13;114,7;-37,57;9;3;-6;2113;1681;-432
498;21.01.2016;'18 - 19;86,01;110,61;-24,6;0;0;0;2442;2142;-300
499;21.01.2016;'19 - 20;60,13;84,01;-23,88;0;0;0;2762;2507;-255
500;21.01.2016;'20 - 21;50,09;59,58;-9,49;0;0;0;3075;2841;-234
501;21.01.2016;'21 - 22;35,47;40,49;-5,02;0;0;0;3321;2952;-369
502;21.01.2016;'22 - 23;30,36;37,31;-6,95;0;0;0;3525;3004;-521
503;21.01.2016;'23 - 24;26,97;32,13;-5,16;0;0;0;3707;3224;-483
504;22.01.2016;'00 - 01;28,05;31,95;-3,9;0;0;0;3498;3354;-144
505;22.01.2016;'01 - 02;27,92;33,47;-5,55;0;0;0;3651;3441;-210
506;22.01.2016;'02 - 03;26,78;31,5;-4,72;0;0;0;3887;3424;-463
507;22.01.2016;'03 - 04;26,57;32,29;-5,72;0;0;0;4228;3532;-696
508;22.01.2016;'04 - 05;27,02;32,28;-5,26;0;0;0;4631;3730;-901
509;22.01.2016;'05 - 06;28,07;34,68;-6,61;0;0;0;5110;4004;-1106
510;22.01.2016;'06 - 07;30,82;42,48;-11,66;0;0;0;5719;4308;-1411
511;22.01.2016;'07 - 08;48,46;53,73;-5,27;2;0;-2;6514;4954;-1560
512;22.01.2016;'08 - 09;52,5;58,22;-5,72;308;335;27;7390;5882;-1508
513;22.01.2016;'09 - 10;48,66;54,04;-5,38;1953;2097;144;8109;6469;-1640
514;22.01.2016;'10 - 11;45,11;49,71;-4,6;3802;4390;588;8338;6489;-1849
515;22.01.2016;'11 - 12;44,96;44,38;0,58;5646;6234;588;8024;6114;-1910
516;22.01.2016;'12 - 13;42,06;38,24;3,82;6348;6960;612;7655;5821;-1834
517;22.01.2016;'13 - 14;37,02;36,71;0,31;5907;6725;818;7824;5964;-1860
518;22.01.2016;'14 - 15;32,27;35,99;-3,72;4405;5293;888;8514;6442;-2072
519;22.01.2016;'15 - 16;32,65;38,03;-5,38;2266;2707;441;9727;7692;-2035
520;22.01.2016;'16 - 17;32,84;41,11;-8,27;359;450;91;11266;9992;-1274
521;22.01.2016;'17 - 18;34,83;45,17;-10,34;5;6;1;12984;12934;-50
522;22.01.2016;'18 - 19;28,3;36,75;-8,45;0;0;0;14706;15214;508
523;22.01.2016;'19 - 20;26,88;29,89;-3,01;0;0;0;15725;15944;219
524;22.01.2016;'20 - 21;25,46;28,56;-3,1;0;0;0;16070;16267;197
525;22.01.2016;'21 - 22;24,88;27,88;-3;0;0;0;15928;15776;-152
526;22.01.2016;'22 - 23;24,28;27,8;-3,52;0;0;0;15749;15034;-715
527;22.01.2016;'23 - 24;22,63;26,74;-4,11;0;0;0;15548;14262;-1286
528;23.01.2016;'00 - 01;24,44;26,01;-1,57;0;0;0;13248;13088;-160
529;23.01.2016;'01 - 02;24,02;28,1;-4,08;0;0;0;12364;11936;-428
530;23.01.2016;'02 - 03;23,03;27,88;-4,85;0;0;0;11768;10903;-865
531;23.01.2016;'03 - 04;22,99;29,21;-6,22;0;0;0;11361;10683;-678
532;23.01.2016;'04 - 05;22,68;26,57;-3,89;0;0;0;10974;10570;-404
533;23.01.2016;'05 - 06;22,44;23,49;-1,05;0;0;0;10939;11178;239
534;23.01.2016;'06 - 07;21,46;23,55;-2,09;0;0;0;10941;11944;1003
535;23.01.2016;'07 - 08;23,35;24,83;-1,48;1;0;-1;11074;12382;1308
536;23.01.2016;'08 - 09;24,68;24,57;0,11;55;50;-5;11438;12812;1374
537;23.01.2016;'09 - 10;28,9;24,88;4,02;367;399;32;11619;13353;1734
538;23.01.2016;'10 - 11;31,32;26,48;4,84;901;972;71;11471;12898;1427
539;23.01.2016;'11 - 12;34,75;28,56;6,19;1497;1720;223;11001;11954;953
540;23.01.2016;'12 - 13;34,39;31,02;3,37;1808;2250;442;10535;12182;1647
541;23.01.2016;'13 - 14;30,45;25,99;4,46;1782;2244;462;10253;12240;1987
542;23.01.2016;'14 - 15;28,04;24,08;3,96;1386;1810;424;9903;12079;2176
543;23.01.2016;'15 - 16;29,1;23,58;5,52;734;980;246;9561;11705;2144
544;23.01.2016;'16 - 17;29,7;26,84;2,86;142;206;64;9323;12347;3024
545;23.01.2016;'17 - 18;36,97;33,91;3,06;0;3;3;9298;12193;2895
546;23.01.2016;'18 - 19;42,6;31,05;11,55;0;0;0;9319;11267;1948
547;23.01.2016;'19 - 20;35,83;26,13;9,7;0;0;0;9369;11248;1879
548;23.01.2016;'20 - 21;28,84;22,45;6,39;0;0;0;9296;11502;2206
549;23.01.2016;'21 - 22;25,4;21,45;3,95;0;0;0;9092;10594;1502
550;23.01.2016;'22 - 23;26,27;23,56;2,71;0;0;0;8860;10684;1824
551;23.01.2016;'23 - 24;27,06;24,02;3,04;0;0;0;8665;10650;1985
552;24.01.2016;'00 - 01;24,08;22,39;1,69;0;0;0;9820;10535;715
553;24.01.2016;'01 - 02;23,99;23,33;0,66;0;0;0;9458;10120;662
554;24.01.2016;'02 - 03;24,83;21,93;2,9;0;0;0;9237;9829;592
555;24.01.2016;'03 - 04;23,24;20,26;2,98;0;0;0;8986;9755;769
556;24.01.2016;'04 - 05;22,54;19,13;3,41;0;0;0;8795;9922;1127
557;24.01.2016;'05 - 06;23,41;17,86;5,55;0;0;0;8724;9343;619
558;24.01.2016;'06 - 07;21,41;19,32;2,09;0;0;0;8675;9229;554
559;24.01.2016;'07 - 08;21,4;21,14;0,26;2;0;-2;8649;9028;379
560;24.01.2016;'08 - 09;22,12;21,33;0,79;135;179;44;8673;8927;254
561;24.01.2016;'09 - 10;24,63;21,98;2,65;673;912;239;8625;8941;316
562;24.01.2016;'10 - 11;27,05;22,92;4,13;1372;1952;580;8535;9137;602
563;24.01.2016;'11 - 12;32,66;23,8;8,86;1953;2903;950;8386;9184;798
564;24.01.2016;'12 - 13;28,94;21,16;7,78;2237;3501;1264;8222;8602;380
565;24.01.2016;'13 - 14;26,04;20,53;5,51;2118;3580;1462;7988;8702;714
566;24.01.2016;'14 - 15;24,84;20,99;3,85;1562;2676;1114;7760;8447;687
567;24.01.2016;'15 - 16;23,99;21,84;2,15;789;1418;629;7625;8656;1031
568;24.01.2016;'16 - 17;25,04;24,09;0,95;153;285;132;7643;9800;2157
569;24.01.2016;'17 - 18;32,88;30,77;2,11;0;4;4;8059;11357;3298
570;24.01.2016;'18 - 19;36,09;32,83;3,26;0;0;0;8620;12349;3729
571;24.01.2016;'19 - 20;35,87;29,06;6,81;0;0;0;9084;13103;4019
572;24.01.2016;'20 - 21;31,7;25,4;6,3;0;0;0;9297;14080;4783
573;24.01.2016;'21 - 22;26;20,19;5,81;0;0;0;9429;14663;5234
574;24.01.2016;'22 - 23;27,09;18,59;8,5;0;0;0;9384;14628;5244
575;24.01.2016;'23 - 24;22,44;15,16;7,28;0;0;0;9408;14571;5163
576;25.01.2016;'00 - 01;20,07;18,82;1,25;0;0;0;12805;14322;1517
577;25.01.2016;'01 - 02;19,65;17,12;2,53;0;0;0;12649;14318;1669
578;25.01.2016;'02 - 03;19,68;17,05;2,63;0;0;0;12458;13945;1487
579;25.01.2016;'03 - 04;19,98;15,89;4,09;0;0;0;12275;13843;1568
580;25.01.2016;'04 - 05;20,33;17,41;2,92;0;0;0;12028;13358;1330
581;25.01.2016;'05 - 06;21,32;21,44;-0,12;0;0;0;11729;13026;1297
582;25.01.2016;'06 - 07;25,01;25,58;-0,57;0;0;0;11364;12509;1145
583;25.01.2016;'07 - 08;34,94;36,8;-1,86;2;0;-2;11048;11962;914
584;25.01.2016;'08 - 09;35;39,28;-4,28;194;178;-16;10753;11340;587
585;25.01.2016;'09 - 10;36,04;38,39;-2,35;1052;1126;74;10524;10903;379
586;25.01.2016;'10 - 11;36,62;36,64;-0,02;2399;2782;383;10206;10400;194
587;25.01.2016;'11 - 12;35,6;34,59;1,01;3857;5160;1303;9641;9988;347
588;25.01.2016;'12 - 13;34,75;30,84;3,91;4910;6942;2032;8957;9490;533
589;25.01.2016;'13 - 14;32,26;27,45;4,81;5283;7364;2081;8437;9015;578
590;25.01.2016;'14 - 15;30,61;28,32;2,29;4517;6011;1494;8188;8838;650
591;25.01.2016;'15 - 16;29,73;29,67;0,06;2681;3418;737;8103;9042;939
592;25.01.2016;'16 - 17;31,17;31,81;-0,64;572;793;221;8464;9933;1469
593;25.01.2016;'17 - 18;34,96;35,69;-0,73;1;8;7;9247;12158;2911
594;25.01.2016;'18 - 19;36,33;31,27;5,06;0;0;0;10165;13805;3640
595;25.01.2016;'19 - 20;31,96;30,69;1,27;0;0;0;11187;14240;3053
596;25.01.2016;'20 - 21;26,8;28,31;-1,51;0;0;0;12137;15004;2867
597;25.01.2016;'21 - 22;25,32;27,93;-2,61;0;0;0;13176;16136;2960
598;25.01.2016;'22 - 23;23,93;28,65;-4,72;0;0;0;14300;16781;2481
599;25.01.2016;'23 - 24;18,11;21,29;-3,18;0;0;0;15526;17747;2221
600;26.01.2016;'00 - 01;20,23;22;-1,77;0;0;0;17245;18747;1502
601;26.01.2016;'01 - 02;18,02;14,82;3,2;0;0;0;18030;19518;1488
602;26.01.2016;'02 - 03;15,9;7,17;8,73;0;0;0;18645;19580;935
603;26.01.2016;'03 - 04;15,91;12,42;3,49;0;0;0;19041;19225;184
604;26.01.2016;'04 - 05;17,1;16,74;0,36;0;0;0;19106;18846;-260
605;26.01.2016;'05 - 06;21,8;25,38;-3,58;0;0;0;18865;17893;-972
606;26.01.2016;'06 - 07;27,09;32,01;-4,92;0;0;0;18362;17494;-868
607;26.01.2016;'07 - 08;34,13;39;-4,87;7;0;-7;17409;16872;-537
608;26.01.2016;'08 - 09;38,11;39,72;-1,61;410;388;-22;16261;16324;63
609;26.01.2016;'09 - 10;32,31;30,05;2,26;1955;2040;85;15168;15472;304
610;26.01.2016;'10 - 11;29,99;27,49;2,5;3995;4673;678;14302;14800;498
611;26.01.2016;'11 - 12;29,55;26,05;3,5;5820;7296;1476;13783;14228;445
612;26.01.2016;'12 - 13;28,52;21,69;6,83;6766;8774;2008;13546;14373;827
613;26.01.2016;'13 - 14;29,33;22,03;7,3;6565;8202;1637;13449;14705;1256
614;26.01.2016;'14 - 15;27,97;22,21;5,76;5142;6159;1017;13342;15111;1769
615;26.01.2016;'15 - 16;30,09;24,51;5,58;2852;3420;568;13497;16500;3003
616;26.01.2016;'16 - 17;30,62;24,34;6,28;601;726;125;14456;18790;4334
617;26.01.2016;'17 - 18;32,87;25,21;7,66;2;8;6;16261;21511;5250
618;26.01.2016;'18 - 19;29,27;25,12;4,15;0;0;0;18511;24311;5800
619;26.01.2016;'19 - 20;24,94;23,34;1,6;0;0;0;20695;26444;5749
620;26.01.2016;'20 - 21;23,17;20,67;2,5;0;0;0;22440;27858;5418
621;26.01.2016;'21 - 22;21,66;18,7;2,96;0;0;0;23810;28508;4698
622;26.01.2016;'22 - 23;20,24;14,58;5,66;0;0;0;25122;28830;3708
623;26.01.2016;'23 - 24;13,43;10,15;3,28;0;0;0;26239;28931;2692
624;27.01.2016;'00 - 01;10,97;10,37;0,6;0;0;0;29034;28542;-492
625;27.01.2016;'01 - 02;3,18;6,55;-3,37;0;0;0;29355;27815;-1540
626;27.01.2016;'02 - 03;0,05;11,69;-11,64;0;0;0;29439;27534;-1905
627;27.01.2016;'03 - 04;0,13;12,24;-12,11;0;0;0;29307;27406;-1901
628;27.01.2016;'04 - 05;8,82;16,3;-7,48;0;0;0;29022;27292;-1730
629;27.01.2016;'05 - 06;13,3;23,3;-10;0;0;0;28746;26777;-1969
630;27.01.2016;'06 - 07;17,33;27,09;-9,76;0;0;0;28340;26992;-1348
631;27.01.2016;'07 - 08;22,97;35,9;-12,93;6;2;-4;28020;26978;-1042
632;27.01.2016;'08 - 09;23,93;32,73;-8,8;335;322;-13;27861;26584;-1277
633;27.01.2016;'09 - 10;28,95;32,03;-3,08;1374;1510;136;27733;26108;-1625
634;27.01.2016;'10 - 11;29,94;32,75;-2,81;2702;3226;524;27633;26273;-1360
635;27.01.2016;'11 - 12;25,55;31,13;-5,58;3788;5157;1369;27518;26995;-523
636;27.01.2016;'12 - 13;24,12;23,92;0,2;4173;5511;1338;27347;27513;166
637;27.01.2016;'13 - 14;22,95;20,81;2,14;3888;4300;412;27311;27523;212
638;27.01.2016;'14 - 15;20,95;20,18;0,77;2987;2789;-198;27252;27370;118
639;27.01.2016;'15 - 16;23,91;23,53;0,38;1667;1398;-269;27116;27322;206
640;27.01.2016;'16 - 17;23,97;24,86;-0,89;425;292;-133;27090;27532;442
641;27.01.2016;'17 - 18;28,93;28,16;0,77;2;7;5;27109;27679;570
642;27.01.2016;'18 - 19;30,98;31,5;-0,52;0;0;0;27212;27916;704
643;27.01.2016;'19 - 20;29,07;28,92;0,15;0;0;0;27585;28453;868
644;27.01.2016;'20 - 21;21,5;21,19;0,31;0;0;0;27745;28925;1180
645;27.01.2016;'21 - 22;19,06;14,02;5,04;0;0;0;27559;28776;1217
646;27.01.2016;'22 - 23;16,34;15,33;1,01;0;0;0;26863;28438;1575
647;27.01.2016;'23 - 24;13,96;16,4;-2,44;0;0;0;25780;28116;2336
648;28.01.2016;'00 - 01;14,5;12,37;2,13;0;0;0;27076;27246;170
649;28.01.2016;'01 - 02;12,83;11,44;1,39;0;0;0;26091;26090;-1
650;28.01.2016;'02 - 03;12,88;11,82;1,06;0;0;0;24845;25343;498
651;28.01.2016;'03 - 04;12,14;14,57;-2,43;0;0;0;23676;25443;1767
652;28.01.2016;'04 - 05;13,2;12,97;0,23;0;0;0;22777;26041;3264
653;28.01.2016;'05 - 06;17,39;9,48;7,91;0;0;0;22234;26284;4050
654;28.01.2016;'06 - 07;23,41;15,51;7,9;0;0;0;21773;26359;4586
655;28.01.2016;'07 - 08;28,49;24,5;3,99;8;1;-7;21131;25506;4375
656;28.01.2016;'08 - 09;30,96;29,67;1,29;360;398;38;20334;23400;3066
657;28.01.2016;'09 - 10;29,97;30,55;-0,58;1695;1697;2;19469;20935;1466
658;28.01.2016;'10 - 11;29,07;32,95;-3,88;3505;3970;465;18685;20029;1344
659;28.01.2016;'11 - 12;25,21;29,66;-4,45;5161;6327;1166;17925;19400;1475
660;28.01.2016;'12 - 13;24,01;25,73;-1,72;6035;7593;1558;16952;19448;2496
661;28.01.2016;'13 - 14;25,56;24,79;0,77;5989;7267;1278;15773;17982;2209
662;28.01.2016;'14 - 15;26,73;27,79;-1,06;4847;5746;899;14226;16382;2156
663;28.01.2016;'15 - 16;31,02;33,82;-2,8;2680;3018;338;12778;13862;1084
664;28.01.2016;'16 - 17;33,58;38,36;-4,78;512;586;74;12085;12070;-15
665;28.01.2016;'17 - 18;39,05;45,37;-6,32;1;12;11;12370;11582;-788
666;28.01.2016;'18 - 19;46,02;52,58;-6,56;0;0;0;13221;12935;-286
667;28.01.2016;'19 - 20;36,56;41,89;-5,33;0;0;0;14333;14030;-303
668;28.01.2016;'20 - 21;32,12;36,96;-4,84;0;0;0;15169;15163;-6
669;28.01.2016;'21 - 22;27,45;27,27;0,18;0;0;0;15734;16139;405
670;28.01.2016;'22 - 23;26,31;26,27;0,04;0;0;0;16058;16162;104
671;28.01.2016;'23 - 24;20,79;25,55;-4,76;0;0;0;16324;16338;14
672;29.01.2016;'00 - 01;21,1;24,7;-3,6;0;0;0;16908;16844;-64
673;29.01.2016;'01 - 02;19,53;25,43;-5,9;0;0;0;17604;17479;-125
674;29.01.2016;'02 - 03;19,06;22,24;-3,18;0;0;0;18700;18572;-128
675;29.01.2016;'03 - 04;18,08;14,97;3,11;0;0;0;19934;19934;0
676;29.01.2016;'04 - 05;15,96;10,76;5,2;0;0;0;21110;21325;215
677;29.01.2016;'05 - 06;18,01;10,09;7,92;0;0;0;22194;22625;431
678;29.01.2016;'06 - 07;26;20,72;5,28;0;0;0;23222;24499;1277
679;29.01.2016;'07 - 08;34,89;27,55;7,34;16;2;-14;24345;25848;1503
680;29.01.2016;'08 - 09;36,06;28,82;7,24;552;558;6;25548;26616;1068
681;29.01.2016;'09 - 10;34,94;23,75;11,19;2482;3346;864;26685;26763;78
682;29.01.2016;'10 - 11;29,91;18,48;11,43;4821;6770;1949;27555;27827;272
683;29.01.2016;'11 - 12;25,43;7,42;18,01;6736;8836;2100;28321;28690;369
684;29.01.2016;'12 - 13;21,83;5,01;16,82;7529;9364;1835;28898;29495;597
685;29.01.2016;'13 - 14;20,03;4,19;15,84;7183;8776;1593;29458;29640;182
686;29.01.2016;'14 - 15;19,1;4,37;14,73;5672;7008;1336;29986;29767;-219
687;29.01.2016;'15 - 16;19,39;5,72;13,67;3256;3906;650;30490;30245;-245
688;29.01.2016;'16 - 17;22,54;7,12;15,42;822;941;119;30628;30768;140
689;29.01.2016;'17 - 18;27,43;14,74;12,69;5;12;7;30513;30664;151
690;29.01.2016;'18 - 19;25,99;16,78;9,21;0;0;0;30294;30760;466
691;29.01.2016;'19 - 20;25,18;18,38;6,8;0;0;0;29996;30601;605
692;29.01.2016;'20 - 21;21,11;11,6;9,51;0;0;0;29788;30456;668
693;29.01.2016;'21 - 22;17,08;6,01;11,07;0;0;0;29759;30378;619
694;29.01.2016;'22 - 23;14,6;6,69;7,91;0;0;0;29788;29262;-526
695;29.01.2016;'23 - 24;10,29;3,83;6,46;0;0;0;29913;29223;-690
696;30.01.2016;'00 - 01;14,08;9,39;4,69;0;0;0;30190;28908;-1282
697;30.01.2016;'01 - 02;8,4;2,59;5,81;0;0;0;30695;29125;-1570
698;30.01.2016;'02 - 03;0,79;1,3;-0,51;0;0;0;31085;29182;-1903
699;30.01.2016;'03 - 04;0;-2,5;2,5;0;0;0;31313;29380;-1933
700;30.01.2016;'04 - 05;-0,02;-2,57;2,55;0;0;0;31419;30016;-1403
701;30.01.2016;'05 - 06;-0,04;-6,56;6,52;0;0;0;31332;30230;-1102
702;30.01.2016;'06 - 07;-2,97;-4,86;1,89;0;0;0;31231;31789;558
703;30.01.2016;'07 - 08;8,51;-2,99;11,5;18;4;-14;31173;32090;917
704;30.01.2016;'08 - 09;12,42;8,05;4,37;552;635;83;30928;32413;1485
705;30.01.2016;'09 - 10;13,78;8,39;5,39;2030;2671;641;30432;31782;1350
706;30.01.2016;'10 - 11;14,22;5,29;8,93;3698;4706;1008;29749;30788;1039
707;30.01.2016;'11 - 12;14,69;9,36;5,33;4874;5693;819;28826;29990;1164
708;30.01.2016;'12 - 13;14,27;10,71;3,56;5102;5320;218;27573;28881;1308
709;30.01.2016;'13 - 14;14,6;15,56;-0,96;4514;4371;-143;26500;27798;1298
710;30.01.2016;'14 - 15;14,28;19,81;-5,53;3258;2817;-441;25464;27678;2214
711;30.01.2016;'15 - 16;15,37;18,77;-3,4;1786;1384;-402;24539;26752;2213
712;30.01.2016;'16 - 17;16,03;19,65;-3,62;475;293;-182;23910;25540;1630
713;30.01.2016;'17 - 18;18,67;24,79;-6,12;4;8;4;23335;25128;1793
714;30.01.2016;'18 - 19;27,78;32;-4,22;0;0;0;23042;25553;2511
715;30.01.2016;'19 - 20;22,16;26,5;-4,34;0;0;0;22797;25352;2555
716;30.01.2016;'20 - 21;18,53;18,4;0,13;0;0;0;22557;25704;3147
717;30.01.2016;'21 - 22;16,21;14,5;1,71;0;0;0;22528;25382;2854
718;30.01.2016;'22 - 23;15,49;16,71;-1,22;0;0;0;22915;24279;1364
719;30.01.2016;'23 - 24;12;17,33;-5,33;0;0;0;23462;24644;1182
720;31.01.2016;'00 - 01;8,43;16,36;-7,93;0;0;0;27106;24338;-2768
721;31.01.2016;'01 - 02;3,04;10,19;-7,15;0;0;0;27343;24500;-2843
722;31.01.2016;'02 - 03;5,09;12,89;-7,8;0;0;0;27323;24771;-2552
723;31.01.2016;'03 - 04;0,85;9,85;-9;0;0;0;27200;24614;-2586
724;31.01.2016;'04 - 05;-0,27;8,59;-8,86;0;0;0;26999;24742;-2257
725;31.01.2016;'05 - 06;0,03;10,16;-10,13;0;0;0;26591;24956;-1635
726;31.01.2016;'06 - 07;0,08;8,99;-8,91;0;0;0;25985;25184;-801
727;31.01.2016;'07 - 08;6,04;11,6;-5,56;16;3;-13;25194;24304;-890
728;31.01.2016;'08 - 09;8,33;16,06;-7,73;464;487;23;24465;23348;-1117
729;31.01.2016;'09 - 10;10,59;18,14;-7,55;1835;1849;14;23933;22886;-1047
730;31.01.2016;'10 - 11;11,91;17,74;-5,83;3260;3194;-66;23874;22920;-954
731;31.01.2016;'11 - 12;14,68;19,35;-4,67;4133;3797;-336;24228;23001;-1227
732;31.01.2016;'12 - 13;16,18;20,17;-3,99;4115;3858;-257;24216;22836;-1380
733;31.01.2016;'13 - 14;12,5;19,25;-6,75;3376;3234;-142;23553;22051;-1502
734;31.01.2016;'14 - 15;13,96;17,9;-3,94;2276;2235;-41;22143;20347;-1796
735;31.01.2016;'15 - 16;13,89;18;-4,11;1152;1058;-94;20459;18223;-2236
736;31.01.2016;'16 - 17;16,08;19,28;-3,2;279;234;-45;18931;16996;-1935
737;31.01.2016;'17 - 18;21,44;26,14;-4,7;3;8;5;17919;16310;-1609
738;31.01.2016;'18 - 19;26,28;27,78;-1,5;0;0;0;17180;16277;-903
739;31.01.2016;'19 - 20;25,48;27,64;-2,16;0;0;0;16777;16489;-288
740;31.01.2016;'20 - 21;21,34;21,52;-0,18;0;0;0;16424;15947;-477
741;31.01.2016;'21 - 22;18,04;21,71;-3,67;0;0;0;15959;15440;-519
742;31.01.2016;'22 - 23;18,79;21,77;-2,98;0;0;0;15334;15268;-66
743;31.01.2016;'23 - 24;16,45;19,33;-2,88;0;0;0;14604;14553;-51
744;01.02.2016;'00 - 01;16,31;15,53;0,78;0;0;0;13004;14064;1060
745;01.02.2016;'01 - 02;14,42;12,24;2,18;0;0;0;12053;13730;1677
746;01.02.2016;'02 - 03;15,07;11,39;3,68;0;0;0;11216;13145;1929
747;01.02.2016;'03 - 04;13,27;10,55;2,72;0;0;0;10547;12450;1903
748;01.02.2016;'04 - 05;13,87;13,67;0,2;0;0;0;10292;11930;1638
749;01.02.2016;'05 - 06;14,26;19,88;-5,62;0;0;0;10915;12058;1143
750;01.02.2016;'06 - 07;23,93;34,42;-10,49;0;0;0;12065;12123;58
751;01.02.2016;'07 - 08;35,9;42,23;-6,33;5;2;-3;13782;12819;-963
752;01.02.2016;'08 - 09;37,99;40,89;-2,9;180;181;1;16548;15324;-1224
753;01.02.2016;'09 - 10;36,05;35,16;0,89;736;946;210;19748;17706;-2042
754;01.02.2016;'10 - 11;33,34;28,78;4,56;1459;1799;340;22911;20348;-2563
755;01.02.2016;'11 - 12;29,24;25,42;3,82;2031;2332;301;26096;22670;-3426
756;01.02.2016;'12 - 13;24,99;28,43;-3,44;2365;2660;295;28854;25496;-3358
757;01.02.2016;'13 - 14;21,96;24,35;-2,39;2393;2748;355;30888;27799;-3089
758;01.02.2016;'14 - 15;18,34;23,94;-5,6;2072;2255;183;32182;29928;-2254
759;01.02.2016;'15 - 16;17,97;23,15;-5,18;1307;1441;134;32966;31317;-1649
760;01.02.2016;'16 - 17;18,24;19,73;-1,49;372;408;36;33218;31939;-1279
761;01.02.2016;'17 - 18;23,37;27,13;-3,76;6;11;5;33159;31914;-1245
762;01.02.2016;'18 - 19;23,95;27,2;-3,25;0;0;0;33169;32235;-934
763;01.02.2016;'19 - 20;22,65;28,19;-5,54;0;0;0;33165;32928;-237
764;01.02.2016;'20 - 21;17,75;20;-2,25;0;0;0;33581;32724;-857
765;01.02.2016;'21 - 22;14,63;15,63;-1;0;0;0;33355;32541;-814
766;01.02.2016;'22 - 23;14,16;14,54;-0,38;0;0;0;33199;31794;-1405
767;01.02.2016;'23 - 24;8,44;8,3;0,14;0;0;0;33074;31636;-1438
768;02.02.2016;'00 - 01;4,06;4,48;-0,42;0;0;0;33053;31215;-1838
769;02.02.2016;'01 - 02;0,3;0,55;-0,25;0;0;0;33043;30705;-2338
770;02.02.2016;'02 - 03;-2,66;0,21;-2,87;0;0;0;33005;30330;-2675
771;02.02.2016;'03 - 04;-1,92;-0,52;-1,4;0;0;0;32839;30124;-2715
772;02.02.2016;'04 - 05;0,09;-0,15;0,24;0;0;0;32620;29534;-3086
773;02.02.2016;'05 - 06;9,52;5,64;3,88;0;0;0;32345;29690;-2655
774;02.02.2016;'06 - 07;15,68;19,87;-4,19;0;0;0;32036;30366;-1670
775;02.02.2016;'07 - 08;22,92;35,79;-12,87;16;4;-12;31853;29804;-2049
776;02.02.2016;'08 - 09;22,99;31,16;-8,17;444;440;-4;31807;29322;-2485
777;02.02.2016;'09 - 10;22,15;30,02;-7,87;1577;1739;162;31850;29118;-2732
778;02.02.2016;'10 - 11;22,16;28,79;-6,63;2940;3165;225;31821;29054;-2767
779;02.02.2016;'11 - 12;22,53;27,12;-4,59;4019;4488;469;31706;29110;-2596
780;02.02.2016;'12 - 13;22,08;24,15;-2,07;4419;4979;560;31539;28598;-2941
781;02.02.2016;'13 - 14;22,09;24,99;-2,9;4421;4387;-34;31548;28287;-3261
782;02.02.2016;'14 - 15;22,19;25,69;-3,5;3559;3490;-69;31506;27882;-3624
783;02.02.2016;'15 - 16;23,35;25,67;-2,32;2059;2108;49;31209;27441;-3768
784;02.02.2016;'16 - 17;23,31;27;-3,69;599;571;-28;30762;27414;-3348
785;02.02.2016;'17 - 18;28,42;34,77;-6,35;12;16;4;30452;28224;-2228
786;02.02.2016;'18 - 19;29,99;34,04;-4,05;0;0;0;30384;28388;-1996
787;02.02.2016;'19 - 20;24,61;30,33;-5,72;0;0;0;30642;29349;-1293
788;02.02.2016;'20 - 21;22,51;26,77;-4,26;0;0;0;30537;29300;-1237
789;02.02.2016;'21 - 22;17,59;23,4;-5,81;0;0;0;30375;29058;-1317
790;02.02.2016;'22 - 23;14,18;20,82;-6,64;0;0;0;30155;28504;-1651
791;02.02.2016;'23 - 24;9,53;15,38;-5,85;0;0;0;29943;28434;-1509
792;03.02.2016;'00 - 01;13,75;18,09;-4,34;0;0;0;29688;27785;-1903
793;03.02.2016;'01 - 02;11,58;16,42;-4,84;0;0;0;29344;27733;-1611
794;03.02.2016;'02 - 03;8,09;14,67;-6,58;0;0;0;28803;26864;-1939
795;03.02.2016;'03 - 04;6,93;15,34;-8,41;0;0;0;28290;26042;-2248
796;03.02.2016;'04 - 05;9,04;16,33;-7,29;0;0;0;27769;24558;-3211
797;03.02.2016;'05 - 06;13,74;22,37;-8,63;0;0;0;27096;23470;-3626
798;03.02.2016;'06 - 07;21,41;34,27;-12,86;0;0;0;26355;22626;-3729
799;03.02.2016;'07 - 08;33,25;41,73;-8,48;24;6;-18;25625;21860;-3765
800;03.02.2016;'08 - 09;35;43,73;-8,73;662;512;-150;25073;20982;-4091
801;03.02.2016;'09 - 10;33,96;40,65;-6,69;2556;1971;-585;24948;20464;-4484
802;03.02.2016;'10 - 11;25,44;36,92;-11,48;4537;3691;-846;25377;20989;-4388
803;03.02.2016;'11 - 12;22,93;35,12;-12,19;6086;5246;-840;26002;21847;-4155
804;03.02.2016;'12 - 13;21,46;28,82;-7,36;6682;5783;-899;26429;23191;-3238
805;03.02.2016;'13 - 14;20,95;25,81;-4,86;6268;5410;-858;26237;23083;-3154
806;03.02.2016;'14 - 15;22,93;27,06;-4,13;4970;4523;-447;25342;22030;-3312
807;03.02.2016;'15 - 16;23,02;29,45;-6,43;3020;2871;-149;24021;20933;-3088
808;03.02.2016;'16 - 17;26,4;29,48;-3,08;890;814;-76;22662;20032;-2630
809;03.02.2016;'17 - 18;32,62;35,41;-2,79;24;32;8;21871;19782;-2089
810;03.02.2016;'18 - 19;36,69;37,42;-0,73;0;0;0;21449;20728;-721
811;03.02.2016;'19 - 20;36,19;35,86;0,33;0;0;0;21221;21476;255
812;03.02.2016;'20 - 21;30,13;27,7;2,43;0;0;0;21220;22002;782
813;03.02.2016;'21 - 22;23,75;26,27;-2,52;0;0;0;21321;21936;615
814;03.02.2016;'22 - 23;22,41;26,6;-4,19;0;0;0;21370;21385;15
815;03.02.2016;'23 - 24;17,13;22,48;-5,35;0;0;0;21255;20732;-523
816;04.02.2016;'00 - 01;18,04;24,19;-6,15;0;0;0;19503;20226;723
817;04.02.2016;'01 - 02;16,38;22,06;-5,68;0;0;0;19464;19654;190
818;04.02.2016;'02 - 03;15,99;17,55;-1,56;0;0;0;19427;19360;-67
819;04.02.2016;'03 - 04;15,29;15,43;-0,14;0;0;0;19461;19754;293
820;04.02.2016;'04 - 05;13,93;12,94;0,99;0;0;0;19498;19653;155
821;04.02.2016;'05 - 06;17,01;19,03;-2,02;0;0;0;19308;19693;385
822;04.02.2016;'06 - 07;22,43;25,73;-3,3;0;0;0;18986;19853;867
823;04.02.2016;'07 - 08;31,96;32,19;-0,23;24;8;-16;18445;19832;1387
824;04.02.2016;'08 - 09;30,91;29;1,91;461;305;-156;17704;19152;1448
825;04.02.2016;'09 - 10;27,93;25,74;2,19;1550;1250;-300;17053;18534;1481
826;04.02.2016;'10 - 11;29,19;26;3,19;2713;2213;-500;16729;17584;855
827;04.02.2016;'11 - 12;30,22;29,16;1,06;3552;2832;-720;16647;16815;168
828;04.02.2016;'12 - 13;27,97;30,49;-2,52;3642;3063;-579;16200;16259;59
829;04.02.2016;'13 - 14;26,87;30,74;-3,87;3088;2594;-494;15110;15398;288
830;04.02.2016;'14 - 15;25,85;31,41;-5,56;2161;1706;-455;13469;14263;794
831;04.02.2016;'15 - 16;27,94;32,98;-5,04;1165;942;-223;11858;13446;1588
832;04.02.2016;'16 - 17;27,81;33,24;-5,43;336;269;-67;10525;12863;2338
833;04.02.2016;'17 - 18;35;36,76;-1,76;14;12;-2;9539;11540;2001
834;04.02.2016;'18 - 19;42,18;41,29;0,89;0;0;0;8850;11197;2347
835;04.02.2016;'19 - 20;39,01;40,73;-1,72;0;0;0;8548;11275;2727
836;04.02.2016;'20 - 21;32,04;31,83;0,21;0;0;0;8240;11196;2956
837;04.02.2016;'21 - 22;26,96;27,77;-0,81;0;0;0;7902;10463;2561
838;04.02.2016;'22 - 23;27,83;27,68;0,15;0;0;0;7512;9538;2026
839;04.02.2016;'23 - 24;23,98;25,94;-1,96;0;0;0;7024;8908;1884
840;05.02.2016;'00 - 01;24,61;23,53;1,08;0;0;0;7239;8179;940
841;05.02.2016;'01 - 02;23;21,25;1,75;0;0;0;6787;7862;1075
842;05.02.2016;'02 - 03;22,22;21,33;0,89;0;0;0;6606;7374;768
843;05.02.2016;'03 - 04;20,1;20,6;-0,5;0;0;0;6600;6951;351
844;05.02.2016;'04 - 05;21,18;21,62;-0,44;0;0;0;6810;6767;-43
845;05.02.2016;'05 - 06;21,18;21,89;-0,71;0;0;0;7221;7232;11
846;05.02.2016;'06 - 07;25,97;24,56;1,41;0;0;0;7746;8272;526
847;05.02.2016;'07 - 08;33,92;29,87;4,05;22;12;-10;8370;9302;932
848;05.02.2016;'08 - 09;37,48;29,92;7,56;420;492;72;9002;10422;1420
849;05.02.2016;'09 - 10;35,25;26,45;8,8;1286;1666;380;9559;11042;1483
850;05.02.2016;'10 - 11;36,5;26,21;10,29;2286;2665;379;10024;11222;1198
851;05.02.2016;'11 - 12;35,94;28,42;7,52;2962;3675;713;10453;12252;1799
852;05.02.2016;'12 - 13;34,36;25,85;8,51;3014;4322;1308;10878;13045;2167
853;05.02.2016;'13 - 14;31,95;24,17;7,78;2662;4336;1674;11196;13329;2133
854;05.02.2016;'14 - 15;27,74;21,56;6,18;2029;3156;1127;11404;12984;1580
855;05.02.2016;'15 - 16;25,33;23,39;1,94;1240;1774;534;11619;12616;997
856;05.02.2016;'16 - 17;24,78;24,69;0,09;442;549;107;12000;12451;451
857;05.02.2016;'17 - 18;29,96;26,7;3,26;24;14;-10;12445;12845;400
858;05.02.2016;'18 - 19;33,09;30,2;2,89;0;0;0;12839;13391;552
859;05.02.2016;'19 - 20;28,01;28,05;-0,04;0;0;0;13129;13561;432
860;05.02.2016;'20 - 21;25,7;27,59;-1,89;0;0;0;13159;13872;713
861;05.02.2016;'21 - 22;23,12;26,67;-3,55;0;0;0;13237;13364;127
862;05.02.2016;'22 - 23;24,55;30,14;-5,59;0;0;0;13335;13223;-112
863;05.02.2016;'23 - 24;22,71;30,34;-7,63;0;0;0;13426;13151;-275
864;06.02.2016;'00 - 01;18,18;26,41;-8,23;0;0;0;13796;13477;-319
865;06.02.2016;'01 - 02;15,55;19,36;-3,81;0;0;0;14049;13499;-550
866;06.02.2016;'02 - 03;16,01;19,5;-3,49;0;0;0;14684;13761;-923
867;06.02.2016;'03 - 04;14,33;13,86;0,47;0;0;0;15375;14254;-1121
868;06.02.2016;'04 - 05;13,78;14;-0,22;0;0;0;15900;14770;-1130
869;06.02.2016;'05 - 06;13,98;14,14;-0,16;0;0;0;16352;15485;-867
870;06.02.2016;'06 - 07;15,05;13,94;1,11;0;0;0;16612;15883;-729
871;06.02.2016;'07 - 08;16,08;18,69;-2,61;64;38;-26;16879;16409;-470
872;06.02.2016;'08 - 09;18,02;27,09;-9,07;1374;1435;61;17270;17033;-237
873;06.02.2016;'09 - 10;19,34;24,82;-5,48;4486;4259;-227;17456;16979;-477
874;06.02.2016;'10 - 11;17,1;24,65;-7,55;7896;7286;-610;17460;16278;-1182
875;06.02.2016;'11 - 12;16,5;22,21;-5,71;10570;9476;-1094;17140;16069;-1071
876;06.02.2016;'12 - 13;16,09;17,3;-1,21;11807;10496;-1311;16570;16216;-354
877;06.02.2016;'13 - 14;15,11;15,04;0,07;11583;10621;-962;16215;15993;-222
878;06.02.2016;'14 - 15;13,99;10;3,99;9624;9100;-524;16254;16076;-178
879;06.02.2016;'15 - 16;15,29;12,9;2,39;6175;5734;-441;16480;15751;-729
880;06.02.2016;'16 - 17;17,01;16,3;0,71;2140;1720;-420;16844;15499;-1345
881;06.02.2016;'17 - 18;19,97;28,35;-8,38;91;60;-31;17595;16906;-689
882;06.02.2016;'18 - 19;23,15;26,67;-3,52;0;0;0;18518;18713;195
883;06.02.2016;'19 - 20;21,02;23,04;-2,02;0;0;0;19454;19909;455
884;06.02.2016;'20 - 21;16,07;13,78;2,29;0;0;0;20221;20982;761
885;06.02.2016;'21 - 22;12,71;6,35;6,36;0;0;0;20750;21360;610
886;06.02.2016;'22 - 23;15,04;16,21;-1,17;0;0;0;21035;21124;89
887;06.02.2016;'23 - 24;11,74;14,55;-2,81;0;0;0;21148;21370;222
888;07.02.2016;'00 - 01;5,01;5,97;-0,96;0;0;0;21588;21808;220
889;07.02.2016;'01 - 02;5,98;4,43;1,55;0;0;0;21794;21905;111
890;07.02.2016;'02 - 03;5,62;5,44;0,18;0;0;0;21909;21959;50
891;07.02.2016;'03 - 04;3,05;3,12;-0,07;0;0;0;22049;22072;23
892;07.02.2016;'04 - 05;0,93;4,14;-3,21;0;0;0;22229;22223;-6
893;07.02.2016;'05 - 06;0,08;2,46;-2,38;0;0;0;22272;22516;244
894;07.02.2016;'06 - 07;-0,92;1,59;-2,51;0;0;0;22229;22919;690
895;07.02.2016;'07 - 08;1,13;2,77;-1,64;70;35;-35;22159;23406;1247
896;07.02.2016;'08 - 09;5,74;-2,15;7,89;1263;1232;-31;21744;22946;1202
897;07.02.2016;'09 - 10;8,01;-2,71;10,72;3558;3475;-83;20896;21465;569
898;07.02.2016;'10 - 11;12,92;4,48;8,44;5769;5508;-261;19842;19390;-452
899;07.02.2016;'11 - 12;13,79;6,94;6,85;7374;6566;-808;18860;18259;-601
900;07.02.2016;'12 - 13;13,84;14,94;-1,1;7828;6976;-852;18190;17959;-231
901;07.02.2016;'13 - 14;12,19;8,71;3,48;7121;6331;-790;18013;18453;440
902;07.02.2016;'14 - 15;11,76;6,88;4,88;5499;4471;-1028;18214;19231;1017
903;07.02.2016;'15 - 16;10,01;5,1;4,91;3335;2567;-768;18487;19668;1181
904;07.02.2016;'16 - 17;13,32;2,85;10,47;1123;860;-263;18829;19890;1061
905;07.02.2016;'17 - 18;16,64;10,87;5,77;75;53;-22;19285;20242;957
906;07.02.2016;'18 - 19;22,17;12,47;9,7;0;0;0;20123;21006;883
907;07.02.2016;'19 - 20;17,28;11,62;5,66;0;0;0;21201;22314;1113
908;07.02.2016;'20 - 21;17,88;9,77;8,11;0;0;0;22309;22808;499
909;07.02.2016;'21 - 22;13,79;8,68;5,11;0;0;0;23373;23425;52
910;07.02.2016;'22 - 23;15,04;10,42;4,62;0;0;0;24359;23082;-1277
911;07.02.2016;'23 - 24;9,29;7,2;2,09;0;0;0;25198;23779;-1419
912;08.02.2016;'00 - 01;10,02;6,51;3,51;0;0;0;24830;25050;220
913;08.02.2016;'01 - 02;7,99;-1,16;9,15;0;0;0;25889;26199;310
914;08.02.2016;'02 - 03;5,24;-15,24;20,48;0;0;0;27085;27201;116
915;08.02.2016;'03 - 04;1,16;-26,51;27,67;0;0;0;28240;28770;530
916;08.02.2016;'04 - 05;1,4;-24,12;25,52;0;0;0;29351;29938;587
917;08.02.2016;'05 - 06;7,32;-21,61;28,93;0;0;0;30314;30778;464
918;08.02.2016;'06 - 07;12,32;-2,78;15,1;0;0;0;31264;32157;893
919;08.02.2016;'07 - 08;16,17;4,43;11,74;62;32;-30;32258;32838;580
920;08.02.2016;'08 - 09;16,55;3,17;13,38;987;1098;111;32635;32551;-84
921;08.02.2016;'09 - 10;16,41;8,17;8,24;2606;2620;14;32799;31979;-820
922;08.02.2016;'10 - 11;16,56;10,81;5,75;4106;3783;-323;32649;31654;-995
923;08.02.2016;'11 - 12;16,61;11,35;5,26;5265;5109;-156;32458;31185;-1273
924;08.02.2016;'12 - 13;16,35;8,89;7,46;5752;6139;387;32488;31443;-1045
925;08.02.2016;'13 - 14;16,1;7,39;8,71;5407;5999;592;32518;31182;-1336
926;08.02.2016;'14 - 15;16,15;6,75;9,4;4196;4418;222;32289;31595;-694
927;08.02.2016;'15 - 16;16,35;9,39;6,96;2537;2297;-240;31998;30876;-1122
928;08.02.2016;'16 - 17;15,94;10,41;5,53;980;739;-241;31766;30703;-1063
929;08.02.2016;'17 - 18;20,88;14,06;6,82;81;46;-35;31826;31031;-795
930;08.02.2016;'18 - 19;27,26;16,62;10,64;0;0;0;32054;31456;-598
931;08.02.2016;'19 - 20;21,02;11,77;9,25;0;0;0;32412;32301;-111
932;08.02.2016;'20 - 21;15,24;4,35;10,89;0;0;0;32917;32560;-357
933;08.02.2016;'21 - 22;12,52;3,77;8,75;0;0;0;33372;33626;254
934;08.02.2016;'22 - 23;12,11;1,84;10,27;0;0;0;33619;33461;-158
935;08.02.2016;'23 - 24;9,72;-10,45;20,17;0;0;0;33635;33258;-377
936;09.02.2016;'00 - 01;-19,94;-13,66;-6,28;0;0;0;33954;32914;-1040
937;09.02.2016;'01 - 02;-12,34;-8,58;-3,76;0;0;0;33794;33110;-684
938;09.02.2016;'02 - 03;-19,95;-9,78;-10,17;0;0;0;33468;32852;-616
939;09.02.2016;'03 - 04;-19,3;-9,78;-9,52;0;0;0;32972;32503;-469
940;09.02.2016;'04 - 05;-5,52;-6,11;0,59;0;0;0;32326;31980;-346
941;09.02.2016;'05 - 06;2,79;1,31;1,48;0;0;0;31504;31616;112
942;09.02.2016;'06 - 07;16,98;21,62;-4,64;0;0;0;30545;31238;693
943;09.02.2016;'07 - 08;19,75;26,8;-7,05;62;40;-22;29131;29166;35
944;09.02.2016;'08 - 09;23,43;31,26;-7,83;1017;1013;-4;27520;26749;-771
945;09.02.2016;'09 - 10;20,99;31,72;-10,73;2799;2827;28;26139;24804;-1335
946;09.02.2016;'10 - 11;23,9;30,24;-6,34;4223;4476;253;24948;23088;-1860
947;09.02.2016;'11 - 12;24,93;29,49;-4,56;4917;4520;-397;23817;21694;-2123
948;09.02.2016;'12 - 13;27,03;34,24;-7,21;4535;3896;-639;22470;19287;-3183
949;09.02.2016;'13 - 14;28,69;37,46;-8,77;3705;3051;-654;20315;17667;-2648
950;09.02.2016;'14 - 15;27,44;35,65;-8,21;2719;1811;-908;17939;17512;-427
951;09.02.2016;'15 - 16;26,97;33,33;-6,36;1587;974;-613;16457;18343;1886
952;09.02.2016;'16 - 17;27,24;26,34;0,9;551;339;-212;16207;19866;3659
953;09.02.2016;'17 - 18;31,01;25,56;5,45;52;24;-28;16757;21646;4889
954;09.02.2016;'18 - 19;39,98;29,89;10,09;0;0;0;17512;23182;5670
955;09.02.2016;'19 - 20;34,06;26,6;7,46;0;0;0;18276;25269;6993
956;09.02.2016;'20 - 21;28,77;19,88;8,89;0;0;0;18879;27403;8524
957;09.02.2016;'21 - 22;23,97;14,63;9,34;0;0;0;19779;27126;7347
958;09.02.2016;'22 - 23;20,78;11,01;9,77;0;0;0;20394;26534;6140
959;09.02.2016;'23 - 24;15,99;7,15;8,84;0;0;0;20586;26272;5686
960;10.02.2016;'00 - 01;13,08;3,61;9,47;0;0;0;21159;25460;4301
961;10.02.2016;'01 - 02;13,68;8,83;4,85;0;0;0;20655;24426;3771
962;10.02.2016;'02 - 03;13,06;10,84;2,22;0;0;0;19598;22916;3318
963;10.02.2016;'03 - 04;13,41;13,4;0,01;0;0;0;18314;21844;3530
964;10.02.2016;'04 - 05;14,3;10,45;3,85;0;0;0;17135;19613;2478
965;10.02.2016;'05 - 06;16,2;13,83;2,37;0;0;0;16169;18176;2007
966;10.02.2016;'06 - 07;22,8;19,81;2,99;0;0;0;15416;17942;2526
967;10.02.2016;'07 - 08;30,59;29,72;0,87;62;33;-29;14997;17458;2461
968;10.02.2016;'08 - 09;32,05;29,79;2,26;1034;759;-275;14781;16715;1934
969;10.02.2016;'09 - 10;32,42;29,03;3,39;2857;2196;-661;14789;16135;1346
970;10.02.2016;'10 - 11;30,94;29,8;1,14;4685;4215;-470;14764;15844;1080
971;10.02.2016;'11 - 12;29,98;30,05;-0,07;5966;5438;-528;14585;16206;1621
972;10.02.2016;'12 - 13;25,97;27,37;-1,4;6287;5352;-935;14172;15931;1759
973;10.02.2016;'13 - 14;27,74;29,12;-1,38;5759;4529;-1230;13546;15596;2050
974;10.02.2016;'14 - 15;27,44;29,49;-2,05;4558;3327;-1231;12574;15193;2619
975;10.02.2016;'15 - 16;27,77;27,45;0,32;2841;2012;-829;11716;14222;2506
976;10.02.2016;'16 - 17;28,68;27,49;1,19;1002;724;-278;11253;13315;2062
977;10.02.2016;'17 - 18;32,1;33,15;-1,05;86;56;-30;11240;13246;2006
978;10.02.2016;'18 - 19;36,59;39,91;-3,32;0;0;0;11521;13896;2375
979;10.02.2016;'19 - 20;29,44;34,9;-5,46;0;0;0;12051;14630;2579
980;10.02.2016;'20 - 21;23,18;26,09;-2,91;0;0;0;12787;15377;2590
981;10.02.2016;'21 - 22;21,66;25,08;-3,42;0;0;0;13393;15338;1945
982;10.02.2016;'22 - 23;21,94;25,94;-4;0;0;0;13937;15853;1916
983;10.02.2016;'23 - 24;18,88;21,93;-3,05;0;0;0;14522;16401;1879
984;11.02.2016;'00 - 01;17,72;20,14;-2,42;0;0;0;14308;16586;2278
985;11.02.2016;'01 - 02;17,46;16,55;0,91;0;0;0;14974;16893;1919
986;11.02.2016;'02 - 03;16,91;17,09;-0,18;0;0;0;15464;17480;2016
987;11.02.2016;'03 - 04;16,97;15,01;1,96;0;0;0;15864;17638;1774
988;11.02.2016;'04 - 05;17,66;14,93;2,73;0;0;0;16217;17766;1549
989;11.02.2016;'05 - 06;18,55;17,46;1,09;0;0;0;16209;17167;958
990;11.02.2016;'06 - 07;20,84;23,7;-2,86;0;0;0;15989;17270;1281
991;11.02.2016;'07 - 08;30,82;33,44;-2,62;75;32;-43;15756;16751;995
992;11.02.2016;'08 - 09;25,34;31,88;-6,54;1189;899;-290;15852;15368;-484
993;11.02.2016;'09 - 10;22,84;31,34;-8,5;3434;3072;-362;16158;14823;-1335
994;11.02.2016;'10 - 11;21,12;31,12;-10;5762;5480;-282;16269;15138;-1131
995;11.02.2016;'11 - 12;24,74;30,72;-5,98;7647;7117;-530;16202;15534;-668
996;11.02.2016;'12 - 13;23,72;29,02;-5,3;8547;7675;-872;15936;16317;381
997;11.02.2016;'13 - 14;23,01;26,1;-3,09;8307;7497;-810;15465;15929;464
998;11.02.2016;'14 - 15;21,03;24,16;-3,13;6909;6380;-529;14402;14798;396
999;11.02.2016;'15 - 16;30;22,51;7,49;4689;4250;-439;12937;13115;178
1000;11.02.2016;'16 - 17;31,58;24,66;6,92;1906;1562;-344;11498;10306;-1192
1001;11.02.2016;'17 - 18;36;27,56;8,44;162;82;-80;10508;9109;-1399
1002;11.02.2016;'18 - 19;41,02;40,57;0,45;0;0;0;9920;9056;-864
1003;11.02.2016;'19 - 20;41,34;38,09;3,25;0;0;0;9453;8845;-608
1004;11.02.2016;'20 - 21;32,98;32,21;0,77;0;0;0;9324;8740;-584
1005;11.02.2016;'21 - 22;29,96;25,74;4,22;0;0;0;9179;8842;-337
1006;11.02.2016;'22 - 23;29,46;25,51;3,95;0;0;0;8868;8605;-263
1007;11.02.2016;'23 - 24;26,1;24,53;1,57;0;0;0;8443;8298;-145
1008;12.02.2016;'00 - 01;22,81;22,26;0,55;0;0;0;6952;7431;479
1009;12.02.2016;'01 - 02;21,59;20,14;1,45;0;0;0;6396;6888;492
1010;12.02.2016;'02 - 03;21,3;18,91;2,39;0;0;0;5904;6255;351
1011;12.02.2016;'03 - 04;19,86;17,84;2,02;0;0;0;5424;5748;324
1012;12.02.2016;'04 - 05;20,69;18,42;2,27;0;0;0;4999;5298;299
1013;12.02.2016;'05 - 06;21,64;19,68;1,96;0;0;0;4686;4880;194
1014;12.02.2016;'06 - 07;27,18;24,54;2,64;0;0;0;4401;4760;359
1015;12.02.2016;'07 - 08;36,43;37,18;-0,75;108;51;-57;4098;4396;298
1016;12.02.2016;'08 - 09;37,3;35,57;1,73;1593;1446;-147;3744;3874;130
1017;12.02.2016;'09 - 10;34,97;33,02;1,95;4619;4415;-204;3330;3055;-275
1018;12.02.2016;'10 - 11;34,7;31,79;2,91;8077;8364;287;2889;2416;-473
1019;12.02.2016;'11 - 12;33,48;26,31;7,17;10867;11454;587;2417;1860;-557
1020;12.02.2016;'12 - 13;30;24,77;5,23;11939;12608;669;2065;1732;-333
1021;12.02.2016;'13 - 14;26,93;22,84;4,09;11394;11638;244;1701;1647;-54
1022;12.02.2016;'14 - 15;25,62;22,01;3,61;9359;9091;-268;1494;1548;54
1023;12.02.2016;'15 - 16;25;23,51;1,49;6225;5523;-702;1338;1676;338
1024;12.02.2016;'16 - 17;27,18;23,52;3,66;2538;1728;-810;1285;1886;601
1025;12.02.2016;'17 - 18;34,56;28,36;6,2;216;87;-129;1477;2374;897
1026;12.02.2016;'18 - 19;40,36;37,91;2,45;0;0;0;1822;3194;1372
1027;12.02.2016;'19 - 20;35,56;29,4;6,16;0;0;0;2131;3706;1575
1028;12.02.2016;'20 - 21;29,96;25,11;4,85;0;0;0;2309;3894;1585
1029;12.02.2016;'21 - 22;26,45;22,53;3,92;0;0;0;2369;3676;1307
1030;12.02.2016;'22 - 23;27,18;22,77;4,41;0;0;0;2384;3562;1178
1031;12.02.2016;'23 - 24;25,45;22,46;2,99;0;0;0;2384;3297;913
1032;13.02.2016;'00 - 01;22,23;24,2;-1,97;0;0;0;2262;2871;609
1033;13.02.2016;'01 - 02;21,1;23,36;-2,26;0;0;0;2235;2517;282
1034;13.02.2016;'02 - 03;20,21;22,52;-2,31;0;0;0;2333;2331;-2
1035;13.02.2016;'03 - 04;19,94;20,69;-0,75;0;0;0;2534;2247;-287
1036;13.02.2016;'04 - 05;19,9;19,99;-0,09;0;0;0;2768;2308;-460
1037;13.02.2016;'05 - 06;19,98;20,05;-0,07;0;0;0;3116;2501;-615
1038;13.02.2016;'06 - 07;19,9;22,53;-2,63;0;0;0;3550;2717;-833
1039;13.02.2016;'07 - 08;21,48;22,32;-0,84;96;53;-43;3909;2974;-935
1040;13.02.2016;'08 - 09;28,38;23,63;4,75;1273;1202;-71;4176;3136;-1040
1041;13.02.2016;'09 - 10;30,36;26,88;3,48;3728;4049;321;4323;3123;-1200
1042;13.02.2016;'10 - 11;30,09;28,48;1,61;6234;6894;660;4453;2958;-1495
1043;13.02.2016;'11 - 12;29,84;26,62;3,22;8027;8801;774;4643;3124;-1519
1044;13.02.2016;'12 - 13;26,75;25,57;1,18;8577;9555;978;4990;3679;-1311
1045;13.02.2016;'13 - 14;23,93;20,73;3,2;8048;8408;360;5501;4471;-1030
1046;13.02.2016;'14 - 15;21,37;20,39;0,98;6430;5959;-471;6234;5683;-551
1047;13.02.2016;'15 - 16;21,15;22,86;-1,71;4056;3289;-767;7141;7198;57
1048;13.02.2016;'16 - 17;20,96;21,43;-0,47;1584;1089;-495;8251;9292;1041
1049;13.02.2016;'17 - 18;24,69;21,23;3,46;146;74;-72;9633;11491;1858
1050;13.02.2016;'18 - 19;29,65;24,49;5,16;0;0;0;11142;13254;2112
1051;13.02.2016;'19 - 20;24,61;18,58;6,03;0;0;0;12153;14291;2138
1052;13.02.2016;'20 - 21;19,91;14,5;5,41;0;0;0;12267;14349;2082
1053;13.02.2016;'21 - 22;18,7;14,15;4,55;0;0;0;11877;14296;2419
1054;13.02.2016;'22 - 23;18,47;13,1;5,37;0;0;0;11484;13990;2506
1055;13.02.2016;'23 - 24;16,88;11,91;4,97;0;0;0;11159;13884;2725
1056;14.02.2016;'00 - 01;13,06;16,63;-3,57;0;0;0;14283;14110;-173
1057;14.02.2016;'01 - 02;10,28;16,24;-5,96;0;0;0;14863;14386;-477
1058;14.02.2016;'02 - 03;8,48;14,84;-6,36;0;0;0;15612;14254;-1358
1059;14.02.2016;'03 - 04;5,09;13,3;-8,21;0;0;0;16359;14747;-1612
1060;14.02.2016;'04 - 05;4,21;12,64;-8,43;0;0;0;16746;14977;-1769
1061;14.02.2016;'05 - 06;4,75;11,05;-6,3;0;0;0;16922;14934;-1988
1062;14.02.2016;'06 - 07;5,3;11,81;-6,51;0;0;0;17001;14827;-2174
1063;14.02.2016;'07 - 08;8,76;15,85;-7,09;100;90;-10;16917;13984;-2933
1064;14.02.2016;'08 - 09;11,81;17,71;-5,9;1067;1226;159;16769;13118;-3651
1065;14.02.2016;'09 - 10;15,03;19,28;-4,25;2530;3208;678;16549;12349;-4200
1066;14.02.2016;'10 - 11;17,46;21,11;-3,65;3914;4480;566;16240;11776;-4464
1067;14.02.2016;'11 - 12;18,01;22,99;-4,98;4849;4874;25;15742;11310;-4432
1068;14.02.2016;'12 - 13;17,69;23,32;-5,63;5028;4297;-731;15082;10976;-4106
1069;14.02.2016;'13 - 14;17,34;23,87;-6,53;4594;3948;-646;14145;10631;-3514
1070;14.02.2016;'14 - 15;16,27;21,49;-5,22;3659;2694;-965;13082;10516;-2566
1071;14.02.2016;'15 - 16;15,13;20,5;-5,37;2371;1492;-879;12126;10222;-1904
1072;14.02.2016;'16 - 17;16,96;20,87;-3,91;957;552;-405;11405;9871;-1534
1073;14.02.2016;'17 - 18;21,21;24,21;-3;110;49;-61;11023;9660;-1363
1074;14.02.2016;'18 - 19;29,94;31,94;-2;0;0;0;10818;9632;-1186
1075;14.02.2016;'19 - 20;30,38;32,03;-1,65;0;0;0;10618;9926;-692
1076;14.02.2016;'20 - 21;23,57;25,6;-2,03;0;0;0;10396;9906;-490
1077;14.02.2016;'21 - 22;20,21;21,65;-1,44;0;0;0;10218;9735;-483
1078;14.02.2016;'22 - 23;20,33;26,17;-5,84;0;0;0;10032;9485;-547
1079;14.02.2016;'23 - 24;17,52;22,74;-5,22;0;0;0;9800;9568;-232
1080;15.02.2016;'00 - 01;16,57;16,18;0,39;0;0;0;9659;9614;-45
1081;15.02.2016;'01 - 02;16;16,81;-0,81;0;0;0;9689;9519;-170
1082;15.02.2016;'02 - 03;14,36;13,6;0,76;0;0;0;9795;9483;-312
1083;15.02.2016;'03 - 04;13,14;11,47;1,67;0;0;0;9845;9649;-196
1084;15.02.2016;'04 - 05;12,68;11,29;1,39;0;0;0;9897;9720;-177
1085;15.02.2016;'05 - 06;14,65;13,56;1,09;0;0;0;9861;9722;-139
1086;15.02.2016;'06 - 07;21,12;21,93;-0,81;0;0;0;9899;9963;64
1087;15.02.2016;'07 - 08;32,18;31,18;1;92;50;-42;10002;9906;-96
1088;15.02.2016;'08 - 09;30,11;32,06;-1,95;952;706;-246;10151;9512;-639
1089;15.02.2016;'09 - 10;31,72;32,67;-0,95;2361;1872;-489;10385;9360;-1025
1090;15.02.2016;'10 - 11;30,91;32,95;-2,04;3821;3196;-625;10582;9180;-1402
1091;15.02.2016;'11 - 12;29,93;32,88;-2,95;4930;3902;-1028;10573;9113;-1460
1092;15.02.2016;'12 - 13;27,22;32,34;-5,12;5407;4170;-1237;10420;8848;-1572
1093;15.02.2016;'13 - 14;25,39;32,11;-6,72;5262;3874;-1388;10388;9096;-1292
1094;15.02.2016;'14 - 15;24,81;30,74;-5,93;4409;3088;-1321;10285;9608;-677
1095;15.02.2016;'15 - 16;24,4;30,1;-5,7;2983;1877;-1106;10217;9935;-282
1096;15.02.2016;'16 - 17;24,93;30,74;-5,81;1295;680;-615;10064;9792;-272
1097;15.02.2016;'17 - 18;28,45;33,32;-4,87;144;58;-86;9901;9675;-226
1098;15.02.2016;'18 - 19;35,19;38,02;-2,83;0;0;0;9786;9461;-325
1099;15.02.2016;'19 - 20;32,19;34,26;-2,07;0;0;0;9590;8660;-930
1100;15.02.2016;'20 - 21;30,05;33,18;-3,13;0;0;0;9070;7837;-1233
1101;15.02.2016;'21 - 22;24,39;27,48;-3,09;0;0;0;8382;7053;-1329
1102;15.02.2016;'22 - 23;25,87;27,81;-1,94;0;0;0;7662;6395;-1267
1103;15.02.2016;'23 - 24;22,39;25,44;-3,05;0;0;0;6967;6090;-877
1104;16.02.2016;'00 - 01;22,37;21,42;0,95;0;0;0;6004;6043;39
1105;16.02.2016;'01 - 02;22,32;21,59;0,73;0;0;0;5444;5520;76
1106;16.02.2016;'02 - 03;22,31;21,29;1,02;0;0;0;4982;4913;-69
1107;16.02.2016;'03 - 04;22,04;21,05;0,99;0;0;0;4486;4292;-194
1108;16.02.2016;'04 - 05;21,83;21,89;-0,06;0;0;0;4037;3640;-397
1109;16.02.2016;'05 - 06;22,74;23,73;-0,99;0;0;0;3639;2754;-885
1110;16.02.2016;'06 - 07;29,39;32,68;-3,29;0;0;0;3216;2190;-1026
1111;16.02.2016;'07 - 08;40,43;46,34;-5,91;133;76;-57;2787;1756;-1031
1112;16.02.2016;'08 - 09;42,46;50,56;-8,1;1695;1113;-582;2398;1369;-1029
1113;16.02.2016;'09 - 10;42,42;49,33;-6,91;4469;3438;-1031;2071;1174;-897
1114;16.02.2016;'10 - 11;37,91;42,98;-5,07;7235;5806;-1429;1816;1055;-761
1115;16.02.2016;'11 - 12;35,72;38,12;-2,4;9232;7553;-1679;1589;1058;-531
1116;16.02.2016;'12 - 13;33,07;34,87;-1,8;10002;8108;-1894;1456;1057;-399
1117;16.02.2016;'13 - 14;32,77;32,38;0,39;9664;7890;-1774;1405;986;-419
1118;16.02.2016;'14 - 15;31,7;31,21;0,49;8009;6671;-1338;1437;966;-471
1119;16.02.2016;'15 - 16;32,09;32,11;-0,02;5302;4657;-645;1518;1113;-405
1120;16.02.2016;'16 - 17;34,88;31,2;3,68;2232;1983;-249;1715;1352;-363
1121;16.02.2016;'17 - 18;39,81;33,2;6,61;244;178;-66;2071;1875;-196
1122;16.02.2016;'18 - 19;53,46;41;12,46;0;0;0;2551;2780;229
1123;16.02.2016;'19 - 20;49,71;32,72;16,99;0;0;0;3223;4374;1151
1124;16.02.2016;'20 - 21;33,96;26,29;7,67;0;0;0;4036;5609;1573
1125;16.02.2016;'21 - 22;27;24,98;2,02;0;0;0;4770;6366;1596
1126;16.02.2016;'22 - 23;24,98;22,71;2,27;0;0;0;5537;6980;1443
1127;16.02.2016;'23 - 24;21,48;18,3;3,18;0;0;0;6273;6924;651
1128;17.02.2016;'00 - 01;18,97;16,2;2,77;0;0;0;7413;7561;148
1129;17.02.2016;'01 - 02;18,86;16,57;2,29;0;0;0;8133;8616;483
1130;17.02.2016;'02 - 03;18,7;16,24;2,46;0;0;0;8665;9687;1022
1131;17.02.2016;'03 - 04;18,74;12,38;6,36;0;0;0;9128;10694;1566
1132;17.02.2016;'04 - 05;19,58;11,84;7,74;0;0;0;9436;11697;2261
1133;17.02.2016;'05 - 06;19;14,99;4,01;0;0;0;9676;12309;2633
1134;17.02.2016;'06 - 07;22,75;19,72;3,03;0;0;0;9703;12200;2497
1135;17.02.2016;'07 - 08;30,97;24,03;6,94;157;101;-56;9531;12072;2541
1136;17.02.2016;'08 - 09;31,71;24,81;6,9;1839;1542;-297;9152;11272;2120
1137;17.02.2016;'09 - 10;29,95;24,01;5,94;4593;4233;-360;8747;10051;1304
1138;17.02.2016;'10 - 11;23,53;24,05;-0,52;7070;6986;-84;8550;9612;1062
1139;17.02.2016;'11 - 12;24,77;23,63;1,14;8623;8137;-486;8532;9904;1372
1140;17.02.2016;'12 - 13;23,55;22,98;0,57;8732;7903;-829;8420;9663;1243
1141;17.02.2016;'13 - 14;24,72;24,06;0,66;7752;6582;-1170;8184;8891;707
1142;17.02.2016;'14 - 15;25,91;25,13;0,78;5983;4726;-1257;7754;8369;615
1143;17.02.2016;'15 - 16;29,9;27,05;2,85;3847;2824;-1023;7340;7941;601
1144;17.02.2016;'16 - 17;30,67;27,79;2,88;1655;1080;-575;7033;7242;209
1145;17.02.2016;'17 - 18;38,06;32,14;5,92;209;108;-101;6863;6918;55
1146;17.02.2016;'18 - 19;40,87;34,31;6,56;0;0;0;6697;6592;-105
1147;17.02.2016;'19 - 20;33,96;28,85;5,11;0;0;0;6440;5460;-980
1148;17.02.2016;'20 - 21;29,94;28,5;1,44;0;0;0;5711;4442;-1269
1149;17.02.2016;'21 - 22;24,05;27,62;-3,57;0;0;0;4809;3825;-984
1150;17.02.2016;'22 - 23;24,25;24,42;-0,17;0;0;0;3944;3462;-482
1151;17.02.2016;'23 - 24;22,73;19,52;3,21;0;0;0;3226;3392;166
1152;18.02.2016;'00 - 01;20,74;20,04;0,7;0;0;0;2941;3462;521
1153;18.02.2016;'01 - 02;20,57;19,02;1,55;0;0;0;2866;3618;752
1154;18.02.2016;'02 - 03;18,87;15,87;3;0;0;0;2906;3783;877
1155;18.02.2016;'03 - 04;19,88;15,95;3,93;0;0;0;2961;3904;943
1156;18.02.2016;'04 - 05;19,89;16,54;3,35;0;0;0;3043;3886;843
1157;18.02.2016;'05 - 06;20,33;20,27;0,06;0;0;0;3133;3709;576
1158;18.02.2016;'06 - 07;23,16;21,26;1,9;0;0;0;3185;3759;574
1159;18.02.2016;'07 - 08;35,53;26,07;9,46;206;158;-48;3184;4303;1119
1160;18.02.2016;'08 - 09;39,92;30,66;9,26;1785;1367;-418;3091;4533;1442
1161;18.02.2016;'09 - 10;34,97;24,46;10,51;4733;3818;-915;3062;4166;1104
1162;18.02.2016;'10 - 11;29,92;26,14;3,78;8019;7576;-443;3078;3920;842
1163;18.02.2016;'11 - 12;25,98;25,23;0,75;10096;10971;875;3165;3693;528
1164;18.02.2016;'12 - 13;23,77;22,22;1,55;10875;12110;1235;3192;4050;858
1165;18.02.2016;'13 - 14;24,53;21,54;2,99;10275;11044;769;3141;3927;786
1166;18.02.2016;'14 - 15;25,13;23,51;1,62;8431;8618;187;2920;3325;405
1167;18.02.2016;'15 - 16;29,04;27,76;1,28;5569;5577;8;2596;2706;110
1168;18.02.2016;'16 - 17;32;29,58;2,42;2440;2151;-289;2314;2270;-44
1169;18.02.2016;'17 - 18;38,74;35,2;3,54;323;201;-122;2216;2526;310
1170;18.02.2016;'18 - 19;45,08;40,61;4,47;0;0;0;2291;3030;739
1171;18.02.2016;'19 - 20;38,06;33,54;4,52;0;0;0;2570;3258;688
1172;18.02.2016;'20 - 21;32,24;29,03;3,21;0;0;0;2941;3143;202
1173;18.02.2016;'21 - 22;25,95;24,97;0,98;0;0;0;3235;2986;-249
1174;18.02.2016;'22 - 23;23,09;24,51;-1,42;0;0;0;3338;2800;-538
1175;18.02.2016;'23 - 24;21,34;21,29;0,05;0;0;0;3276;2375;-901
1176;19.02.2016;'00 - 01;21,85;21,34;0,51;0;0;0;1883;2008;125
1177;19.02.2016;'01 - 02;21,44;20,58;0,86;0;0;0;1684;1842;158
1178;19.02.2016;'02 - 03;21,75;21,07;0,68;0;0;0;1619;1612;-7
1179;19.02.2016;'03 - 04;22,19;20,98;1,21;0;0;0;1591;1523;-68
1180;19.02.2016;'04 - 05;22,37;22,34;0,03;0;0;0;1588;1350;-238
1181;19.02.2016;'05 - 06;19,46;21,54;-2,08;0;0;0;1600;1351;-249
1182;19.02.2016;'06 - 07;27,83;25,71;2,12;0;0;0;1676;1383;-293
1183;19.02.2016;'07 - 08;34,98;32,94;2,04;181;122;-59;1881;1612;-269
1184;19.02.2016;'08 - 09;38,49;37,92;0,57;1440;1127;-313;2129;1710;-419
1185;19.02.2016;'09 - 10;34,95;34,76;0,19;3219;2745;-474;2418;1634;-784
1186;19.02.2016;'10 - 11;34,95;34,52;0,43;4993;4482;-511;2693;1590;-1103
1187;19.02.2016;'11 - 12;37,91;33,86;4,05;6237;5681;-556;2918;1808;-1110
1188;19.02.2016;'12 - 13;31,55;32,33;-0,78;6636;6200;-436;3218;2304;-914
1189;19.02.2016;'13 - 14;27,93;31,1;-3,17;6403;5743;-660;3844;3114;-730
1190;19.02.2016;'14 - 15;25,25;29,83;-4,58;5607;4704;-903;4538;4019;-519
1191;19.02.2016;'15 - 16;25,09;26,07;-0,98;4106;3097;-1009;5039;4358;-681
1192;19.02.2016;'16 - 17;24,84;27,7;-2,86;1995;1351;-644;5615;4778;-837
1193;19.02.2016;'17 - 18;30,04;32,59;-2,55;282;176;-106;6475;5392;-1083
1194;19.02.2016;'18 - 19;34,94;37,26;-2,32;0;0;0;7649;6882;-767
1195;19.02.2016;'19 - 20;27,99;31,79;-3,8;0;0;0;9042;9020;-22
1196;19.02.2016;'20 - 21;23,69;25,23;-1,54;0;0;0;10476;10774;298
1197;19.02.2016;'21 - 22;24,93;26,73;-1,8;0;0;0;11801;12215;414
1198;19.02.2016;'22 - 23;23,38;25,31;-1,93;0;0;0;13134;13338;204
1199;19.02.2016;'23 - 24;18,9;22,62;-3,72;0;0;0;14415;14693;278
1200;20.02.2016;'00 - 01;18,3;19,74;-1,44;0;0;0;14784;16088;1304
1201;20.02.2016;'01 - 02;16,82;19,66;-2,84;0;0;0;16319;17708;1389
1202;20.02.2016;'02 - 03;11,54;12,79;-1,25;0;0;0;18127;19224;1097
1203;20.02.2016;'03 - 04;9,69;12,48;-2,79;0;0;0;20123;20806;683
1204;20.02.2016;'04 - 05;9,52;14,51;-4,99;0;0;0;22022;22932;910
1205;20.02.2016;'05 - 06;5,01;8,61;-3,6;0;0;0;23622;25182;1560
1206;20.02.2016;'06 - 07;5,06;6,1;-1,04;0;0;0;24928;27281;2353
1207;20.02.2016;'07 - 08;9,09;-9,02;18,11;208;246;38;25708;28225;2517
1208;20.02.2016;'08 - 09;8,69;-0,4;9,09;1325;1486;161;25880;28359;2479
1209;20.02.2016;'09 - 10;13,43;3,33;10,1;2414;2290;-124;25737;28347;2610
1210;20.02.2016;'10 - 11;16,36;13,47;2,89;2959;2800;-159;25439;28486;3047
1211;20.02.2016;'11 - 12;17;16,15;0,85;3042;2862;-180;25183;28458;3275
1212;20.02.2016;'12 - 13;16,96;13,28;3,68;2915;2646;-269;24913;28080;3167
1213;20.02.2016;'13 - 14;15,94;13,69;2,25;2532;2123;-409;24481;27206;2725
1214;20.02.2016;'14 - 15;15,77;14,23;1,54;1977;1635;-342;23888;26410;2522
1215;20.02.2016;'15 - 16;16,05;12,26;3,79;1281;993;-288;23277;25921;2644
1216;20.02.2016;'16 - 17;16,15;12,64;3,51;537;394;-143;22752;25836;3084
1217;20.02.2016;'17 - 18;18,99;15,37;3,62;87;42;-45;22434;25771;3337
1218;20.02.2016;'18 - 19;24,22;16,7;7,52;0;1;1;22066;24812;2746
1219;20.02.2016;'19 - 20;23,49;14,03;9,46;0;0;0;22011;24102;2091
1220;20.02.2016;'20 - 21;18,96;13,47;5,49;0;0;0;22379;23914;1535
1221;20.02.2016;'21 - 22;13,92;10,75;3,17;0;0;0;22928;23791;863
1222;20.02.2016;'22 - 23;11,79;14,23;-2,44;0;0;0;23457;24019;562
1223;20.02.2016;'23 - 24;7,81;7,63;0,18;0;0;0;24174;25306;1132
1224;21.02.2016;'00 - 01;9,37;-1,25;10,62;0;0;0;22438;26906;4468
1225;21.02.2016;'01 - 02;6,52;-6,06;12,58;0;0;0;22822;28060;5238
1226;21.02.2016;'02 - 03;5,09;-10,86;15,95;0;0;0;23307;28387;5080
1227;21.02.2016;'03 - 04;3,14;-11,23;14,37;0;0;0;23807;28498;4691
1228;21.02.2016;'04 - 05;0,46;-8,55;9,01;0;0;0;24133;28598;4465
1229;21.02.2016;'05 - 06;0,13;-4,38;4,51;0;0;0;24243;27872;3629
1230;21.02.2016;'06 - 07;-0,05;-4,44;4,39;0;0;0;24435;26430;1995
1231;21.02.2016;'07 - 08;0,13;2,88;-2,75;58;56;-2;24475;24803;328
1232;21.02.2016;'08 - 09;5,62;11,64;-6,02;406;544;138;24304;23006;-1298
1233;21.02.2016;'09 - 10;10,81;15,65;-4,84;1001;1504;503;24143;22402;-1741
1234;21.02.2016;'10 - 11;13,07;16,92;-3,85;1608;2328;720;23945;22348;-1597
1235;21.02.2016;'11 - 12;14,94;15;-0,06;2031;3174;1143;23625;21962;-1663
1236;21.02.2016;'12 - 13;14,95;13,45;1,5;2186;3858;1672;23393;21056;-2337
1237;21.02.2016;'13 - 14;10,6;8,52;2,08;2084;3772;1688;23029;20696;-2333
1238;21.02.2016;'14 - 15;7,71;6,07;1,64;1734;3430;1696;22481;21300;-1181
1239;21.02.2016;'15 - 16;4,95;1,83;3,12;1172;2470;1298;22208;22521;313
1240;21.02.2016;'16 - 17;7,69;-1,19;8,88;567;1198;631;22165;23954;1789
1241;21.02.2016;'17 - 18;14,34;2,22;12,12;106;188;82;22595;26399;3804
1242;21.02.2016;'18 - 19;18,61;2,35;16,26;0;1;1;23150;29106;5956
1243;21.02.2016;'19 - 20;18,2;0,73;17,47;0;0;0;23744;30990;7246
1244;21.02.2016;'20 - 21;12;-3,65;15,65;0;0;0;24101;32413;8312
1245;21.02.2016;'21 - 22;12,64;-10,03;22,67;0;0;0;24245;32974;8729
1246;21.02.2016;'22 - 23;13,94;-6,11;20,05;0;0;0;24344;32643;8299
1247;21.02.2016;'23 - 24;9,31;-9,49;18,8;0;0;0;24502;31420;6918
1248;22.02.2016;'00 - 01;-4,93;-13,09;8,16;0;0;0;29403;32416;3013
1249;22.02.2016;'01 - 02;-4,98;-17,52;12,54;0;0;0;29109;31824;2715
1250;22.02.2016;'02 - 03;-5,08;-18,83;13,75;0;0;0;28637;31631;2994
1251;22.02.2016;'03 - 04;-1,02;-14,78;13,76;0;0;0;27972;31336;3364
1252;22.02.2016;'04 - 05;-0,97;-11,44;10,47;0;0;0;27179;30528;3349
1253;22.02.2016;'05 - 06;7,63;-1,67;9,3;0;0;0;26201;29676;3475
1254;22.02.2016;'06 - 07;18,05;12,33;5,72;0;0;0;25188;30282;5094
1255;22.02.2016;'07 - 08;26,38;19,33;7,05;186;216;30;24232;28923;4691
1256;22.02.2016;'08 - 09;27,92;17,77;10,15;1236;1805;569;23246;26606;3360
1257;22.02.2016;'09 - 10;23,97;16,62;7,35;2834;4507;1673;22280;25559;3279
1258;22.02.2016;'10 - 11;23,11;14,48;8,63;4475;6625;2150;21438;24586;3148
1259;22.02.2016;'11 - 12;23,93;14,82;9,11;5596;8060;2464;20767;22746;1979
1260;22.02.2016;'12 - 13;24;16,85;7,15;6130;8911;2781;20025;21065;1040
1261;22.02.2016;'13 - 14;24,52;18,31;6,21;6029;8402;2373;19269;19842;573
1262;22.02.2016;'14 - 15;23,98;18,48;5,5;5142;6653;1511;18369;19288;919
1263;22.02.2016;'15 - 16;23,91;20,22;3,69;3559;3374;-185;17333;18203;870
1264;22.02.2016;'16 - 17;23,92;21,29;2,63;1683;1400;-283;16144;17392;1248
1265;22.02.2016;'17 - 18;27,93;23,52;4,41;278;163;-115;15122;16948;1826
1266;22.02.2016;'18 - 19;40,13;30,82;9,31;0;1;1;14412;16238;1826
1267;22.02.2016;'19 - 20;39,45;30,67;8,78;0;0;0;13803;16515;2712
1268;22.02.2016;'20 - 21;29,37;24,72;4,65;0;0;0;13480;16558;3078
1269;22.02.2016;'21 - 22;24,69;21,11;3,58;0;0;0;13221;16226;3005
1270;22.02.2016;'22 - 23;25,08;21,73;3,35;0;0;0;12821;16234;3413
1271;22.02.2016;'23 - 24;19,56;14,83;4,73;0;0;0;12371;15243;2872
1272;23.02.2016;'00 - 01;17,81;20,91;-3,1;0;0;0;14206;14627;421
1273;23.02.2016;'01 - 02;14,28;19,82;-5,54;0;0;0;13529;13850;321
1274;23.02.2016;'02 - 03;17,23;20,89;-3,66;0;0;0;12945;12746;-199
1275;23.02.2016;'03 - 04;17,47;18,67;-1,2;0;0;0;12403;11983;-420
1276;23.02.2016;'04 - 05;17,83;18,88;-1,05;0;0;0;11872;11431;-441
1277;23.02.2016;'05 - 06;19,15;24,6;-5,45;0;0;0;11418;10759;-659
1278;23.02.2016;'06 - 07;27,32;28,05;-0,73;0;0;0;11183;10554;-629
1279;23.02.2016;'07 - 08;30,62;32,12;-1,5;189;168;-21;11044;10344;-700
1280;23.02.2016;'08 - 09;31,9;33,37;-1,47;1305;1170;-135;11022;9761;-1261
1281;23.02.2016;'09 - 10;31,09;33,97;-2,88;2922;2754;-168;11094;9220;-1874
1282;23.02.2016;'10 - 11;29,19;35,02;-5,83;4607;4338;-269;11324;9388;-1936
1283;23.02.2016;'11 - 12;30,68;35,46;-4,78;5868;5757;-111;11620;10157;-1463
1284;23.02.2016;'12 - 13;25,92;29;-3,08;6399;6514;115;11854;10784;-1070
1285;23.02.2016;'13 - 14;24,96;27,47;-2,51;6200;6195;-5;12010;11098;-912
1286;23.02.2016;'14 - 15;23,9;26,3;-2,4;5305;5136;-169;11900;11354;-546
1287;23.02.2016;'15 - 16;24,13;25,43;-1,3;3765;3594;-171;11683;11179;-504
1288;23.02.2016;'16 - 17;24,36;23,25;1,11;1817;1808;-9;11514;11434;-80
1289;23.02.2016;'17 - 18;30,08;24,94;5,14;309;288;-21;11526;11744;218
1290;23.02.2016;'18 - 19;36,75;35,8;0,95;0;2;2;11773;13424;1651
1291;23.02.2016;'19 - 20;29,94;30,26;-0,32;0;0;0;12384;14758;2374
1292;23.02.2016;'20 - 21;22,96;22,4;0,56;0;0;0;12754;15241;2487
1293;23.02.2016;'21 - 22;23,23;21,14;2,09;0;0;0;13018;16154;3136
1294;23.02.2016;'22 - 23;19,76;21;-1,24;0;0;0;13154;16008;2854
1295;23.02.2016;'23 - 24;17,9;15,97;1,93;0;0;0;13202;15446;2244
1296;24.02.2016;'00 - 01;18,04;20,7;-2,66;0;0;0;13795;15174;1379
1297;24.02.2016;'01 - 02;16,59;20,25;-3,66;0;0;0;13721;14902;1181
1298;24.02.2016;'02 - 03;13,61;18,68;-5,07;0;0;0;13591;15014;1423
1299;24.02.2016;'03 - 04;13,66;15,13;-1,47;0;0;0;13367;14647;1280
1300;24.02.2016;'04 - 05;17,43;18;-0,57;0;0;0;13078;14472;1394
1301;24.02.2016;'05 - 06;18,92;22,38;-3,46;0;0;0;12836;13844;1008
1302;24.02.2016;'06 - 07;23,15;29,41;-6,26;3;0;-3;12576;13990;1414
1303;24.02.2016;'07 - 08;33,69;35,85;-2,16;439;342;-97;12295;13089;794
1304;24.02.2016;'08 - 09;30,99;35,65;-4,66;3011;2150;-861;12166;11461;-705
1305;24.02.2016;'09 - 10;25,04;35,46;-10,42;6447;5657;-790;12015;10698;-1317
1306;24.02.2016;'10 - 11;23,41;32,72;-9,31;10078;9072;-1006;11765;11371;-394
1307;24.02.2016;'11 - 12;22,56;29,64;-7,08;12857;11082;-1775;11622;12442;820
1308;24.02.2016;'12 - 13;22,03;28,76;-6,73;14045;11542;-2503;11459;12889;1430
1309;24.02.2016;'13 - 14;22,05;25,91;-3,86;13641;11518;-2123;11268;12683;1415
1310;24.02.2016;'14 - 15;22,56;25,48;-2,92;11547;10518;-1029;10780;11415;635
1311;24.02.2016;'15 - 16;24;24,72;-0,72;8049;7958;-91;10108;9832;-276
1312;24.02.2016;'16 - 17;25,05;24,61;0,44;3942;3842;-100;9201;8085;-1116
1313;24.02.2016;'17 - 18;31,96;31,02;0,94;669;493;-176;8141;6497;-1644
1314;24.02.2016;'18 - 19;35,68;38,15;-2,47;0;3;3;7519;6058;-1461
1315;24.02.2016;'19 - 20;36,41;34,85;1,56;0;0;0;7332;6538;-794
1316;24.02.2016;'20 - 21;30,51;30,13;0,38;0;0;0;7423;6544;-879
1317;24.02.2016;'21 - 22;23,97;28,6;-4,63;0;0;0;7462;6464;-998
1318;24.02.2016;'22 - 23;22,96;26,34;-3,38;0;0;0;7357;6583;-774
1319;24.02.2016;'23 - 24;20,56;24,02;-3,46;0;0;0;7181;6372;-809
1320;25.02.2016;'00 - 01;24,04;22,98;1,06;0;0;0;5236;5854;618
1321;25.02.2016;'01 - 02;22,58;21,17;1,41;0;0;0;5047;5508;461
1322;25.02.2016;'02 - 03;21,26;21,54;-0,28;0;0;0;4858;5314;456
1323;25.02.2016;'03 - 04;20,09;20,81;-0,72;0;0;0;4723;5149;426
1324;25.02.2016;'04 - 05;19,94;20,54;-0,6;0;0;0;4636;5068;432
1325;25.02.2016;'05 - 06;21,7;22,22;-0,52;0;0;0;4653;5086;433
1326;25.02.2016;'06 - 07;27,19;28,91;-1,72;3;0;-3;4712;5003;291
1327;25.02.2016;'07 - 08;36,04;35,72;0,32;395;277;-118;4786;5179;393
1328;25.02.2016;'08 - 09;38,29;33,36;4,93;2463;2172;-291;4836;4990;154
1329;25.02.2016;'09 - 10;34,44;29,06;5,38;5356;5504;148;4975;4730;-245
1330;25.02.2016;'10 - 11;32,12;26,16;5,96;8308;8730;422;5238;4972;-266
1331;25.02.2016;'11 - 12;30,44;25,27;5,17;10416;10326;-90;5637;6368;731
1332;25.02.2016;'12 - 13;26,55;22,31;4,24;11305;9987;-1318;6158;7964;1806
1333;25.02.2016;'13 - 14;26,01;22,27;3,74;10997;8560;-2437;6617;8974;2357
1334;25.02.2016;'14 - 15;25;23,02;1,98;9374;6974;-2400;6698;9357;2659
1335;25.02.2016;'15 - 16;24,78;23,5;1,28;6571;5130;-1441;6432;9108;2676
1336;25.02.2016;'16 - 17;25,39;22,36;3,03;3269;2500;-769;6003;8006;2003
1337;25.02.2016;'17 - 18;31,16;25,42;5,74;623;434;-189;5686;7083;1397
1338;25.02.2016;'18 - 19;39,91;32,94;6,97;0;3;3;5793;7036;1243
1339;25.02.2016;'19 - 20;36,51;30,28;6,23;0;0;0;6309;7366;1057
1340;25.02.2016;'20 - 21;31,54;26,4;5,14;0;0;0;6801;8192;1391
1341;25.02.2016;'21 - 22;25,2;21,25;3,95;0;0;0;7051;8686;1635
1342;25.02.2016;'22 - 23;25,1;22,16;2,94;0;0;0;7140;8722;1582
1343;25.02.2016;'23 - 24;23,84;21,83;2,01;0;0;0;7138;8888;1750
1344;26.02.2016;'00 - 01;21,66;21,62;0,04;0;0;0;8198;8540;342
1345;26.02.2016;'01 - 02;21,69;21;0,69;0;0;0;7944;8258;314
1346;26.02.2016;'02 - 03;21,11;21,58;-0,47;0;0;0;7652;7788;136
1347;26.02.2016;'03 - 04;20;21,07;-1,07;0;0;0;7261;7579;318
1348;26.02.2016;'04 - 05;21,02;20,33;0,69;0;0;0;6804;7205;401
1349;26.02.2016;'05 - 06;22,07;20,79;1,28;0;0;0;6248;6146;-102
1350;26.02.2016;'06 - 07;27,35;26,97;0,38;5;0;-5;5641;5799;158
1351;26.02.2016;'07 - 08;32,93;31,37;1,56;652;542;-110;5046;5177;131
1352;26.02.2016;'08 - 09;36,08;33,7;2,38;3836;3488;-348;4489;4430;-59
1353;26.02.2016;'09 - 10;33,48;33,07;0,41;7805;7392;-413;3989;3706;-283
1354;26.02.2016;'10 - 11;31,68;31,38;0,3;11408;10974;-434;3531;3383;-148
1355;26.02.2016;'11 - 12;29,5;28,65;0,85;13794;12492;-1302;3072;2930;-142
1356;26.02.2016;'12 - 13;27,47;27,41;0,06;14759;12066;-2693;2615;2617;2
1357;26.02.2016;'13 - 14;25,06;28,41;-3,35;14118;10965;-3153;2221;2158;-63
1358;26.02.2016;'14 - 15;24;26,47;-2,47;11903;9286;-2617;1861;1844;-17
1359;26.02.2016;'15 - 16;25,11;25,16;-0,05;8393;6764;-1629;1531;1430;-101
1360;26.02.2016;'16 - 17;26,94;24,72;2,22;4195;3329;-866;1329;1290;-39
1361;26.02.2016;'17 - 18;33,98;28,56;5,42;777;557;-220;1377;1172;-205
1362;26.02.2016;'18 - 19;39,94;36,05;3,89;0;4;4;1539;1360;-179
1363;26.02.2016;'19 - 20;37,55;33,09;4,46;0;0;0;1725;1689;-36
1364;26.02.2016;'20 - 21;31,18;28,18;3;0;0;0;1885;2040;155
1365;26.02.2016;'21 - 22;26,35;24,04;2,31;0;0;0;2010;2308;298
1366;26.02.2016;'22 - 23;26,86;23,51;3,35;0;0;0;2166;2493;327
1367;26.02.2016;'23 - 24;25;23,13;1,87;0;0;0;2367;2604;237
1368;27.02.2016;'00 - 01;26,94;23,56;3,38;0;0;0;2417;2748;331
1369;27.02.2016;'01 - 02;23,02;20,7;2,32;0;0;0;2530;2924;394
1370;27.02.2016;'02 - 03;21,77;19,37;2,4;0;0;0;2705;3038;333
1371;27.02.2016;'03 - 04;19,76;19,05;0,71;0;0;0;2887;3131;244
1372;27.02.2016;'04 - 05;19,83;19,02;0,81;0;0;0;3150;3450;300
1373;27.02.2016;'05 - 06;20,16;18,66;1,5;0;0;0;3396;3806;410
1374;27.02.2016;'06 - 07;21,18;19,77;1,41;8;0;-8;3656;4286;630
1375;27.02.2016;'07 - 08;22,76;21;1,76;790;660;-130;3719;4762;1043
1376;27.02.2016;'08 - 09;25,71;20,16;5,55;4608;4233;-375;3505;4587;1082
1377;27.02.2016;'09 - 10;26,79;21,5;5,29;9338;9587;249;3118;3348;230
1378;27.02.2016;'10 - 11;23,24;21,26;1,98;13588;13795;207;2965;2584;-381
1379;27.02.2016;'11 - 12;21,17;19,44;1,73;16257;16523;266;3195;2901;-294
1380;27.02.2016;'12 - 13;19,92;20,28;-0,36;17254;17650;396;3615;3780;165
1381;27.02.2016;'13 - 14;19,49;18,08;1,41;16530;16978;448;4071;4322;251
1382;27.02.2016;'14 - 15;19,68;16,09;3,59;13973;14562;589;4472;4642;170
1383;27.02.2016;'15 - 16;19,93;16,99;2,94;9922;10206;284;4787;5054;267
1384;27.02.2016;'16 - 17;20,21;16,99;3,22;5096;5000;-96;5094;5198;104
1385;27.02.2016;'17 - 18;24,97;21,73;3,24;1015;826;-189;5622;5369;-253
1386;27.02.2016;'18 - 19;32,04;26,94;5,1;1;5;4;6337;6715;378
1387;27.02.2016;'19 - 20;31,91;25,24;6,67;0;0;0;6866;7802;936
1388;27.02.2016;'20 - 21;25,72;21,51;4,21;0;0;0;6806;7814;1008
1389;27.02.2016;'21 - 22;21,74;20,36;1,38;0;0;0;6458;7298;840
1390;27.02.2016;'22 - 23;23,1;20,72;2,38;0;0;0;6063;6541;478
1391;27.02.2016;'23 - 24;20,98;19,39;1,59;0;0;0;5676;5993;317
1392;28.02.2016;'00 - 01;19,9;18,87;1,03;0;0;0;4488;5646;1158
1393;28.02.2016;'01 - 02;18,39;17,64;0,75;0;0;0;4281;5713;1432
1394;28.02.2016;'02 - 03;18,01;14,36;3,65;0;0;0;4123;5813;1690
1395;28.02.2016;'03 - 04;17,62;13,21;4,41;0;0;0;4071;5897;1826
1396;28.02.2016;'04 - 05;17,31;14,3;3,01;0;0;0;4126;6263;2137
1397;28.02.2016;'05 - 06;17,46;15,65;1,81;0;0;0;4151;6581;2430
1398;28.02.2016;'06 - 07;17,51;14,78;2,73;9;1;-8;4088;6870;2782
1399;28.02.2016;'07 - 08;17,58;14,79;2,79;681;564;-117;4034;7087;3053
1400;28.02.2016;'08 - 09;17,9;18,35;-0,45;3692;3294;-398;3868;6670;2802
1401;28.02.2016;'09 - 10;19,02;19,53;-0,51;7393;6832;-561;3653;5667;2014
1402;28.02.2016;'10 - 11;19,01;20,91;-1,9;10900;9960;-940;3658;5168;1510
1403;28.02.2016;'11 - 12;19,02;21,31;-2,29;13227;11690;-1537;3939;5552;1613
1404;28.02.2016;'12 - 13;16,6;20,84;-4,24;14090;11781;-2309;4412;6096;1684
1405;28.02.2016;'13 - 14;14,06;19,75;-5,69;13465;10275;-3190;5135;6748;1613
1406;28.02.2016;'14 - 15;12,45;18,28;-5,83;11269;8178;-3091;5968;7740;1772
1407;28.02.2016;'15 - 16;12,21;16,02;-3,81;7800;5566;-2234;6720;8568;1848
1408;28.02.2016;'16 - 17;13,26;15,42;-2,16;3893;2586;-1307;7392;8618;1226
1409;28.02.2016;'17 - 18;19,11;21,33;-2,22;776;471;-305;8007;8782;775
1410;28.02.2016;'18 - 19;24,6;27,41;-2,81;0;4;4;8737;10222;1485
1411;28.02.2016;'19 - 20;26,98;27,09;-0,11;0;0;0;9348;10937;1589
1412;28.02.2016;'20 - 21;21,81;22,78;-0,97;0;0;0;9531;10918;1387
1413;28.02.2016;'21 - 22;19,9;20,62;-0,72;0;0;0;9401;10790;1389
1414;28.02.2016;'22 - 23;20,44;23,62;-3,18;0;0;0;9231;10604;1373
1415;28.02.2016;'23 - 24;19,93;21,17;-1,24;0;0;0;9087;10255;1168
1416;29.02.2016;'00 - 01;19,12;17,85;1,27;0;0;0;8560;10086;1526
1417;29.02.2016;'01 - 02;17,77;16,63;1,14;0;0;0;8563;9836;1273
1418;29.02.2016;'02 - 03;17,6;17;0,6;0;0;0;8817;9699;882
1419;29.02.2016;'03 - 04;16,77;17,62;-0,85;0;0;0;9165;9846;681
1420;29.02.2016;'04 - 05;17,01;17,61;-0,6;0;0;0;9608;10274;666
1421;29.02.2016;'05 - 06;18,49;21,03;-2,54;0;0;0;9999;10637;638
1422;29.02.2016;'06 - 07;28,23;30,41;-2,18;5;0;-5;10371;11103;732
1423;29.02.2016;'07 - 08;34,72;36;-1,28;402;334;-68;10656;11394;738
1424;29.02.2016;'08 - 09;32,96;36,22;-3,26;2162;1700;-462;10697;11124;427
1425;29.02.2016;'09 - 10;27,99;32,01;-4,02;4274;3700;-574;10463;10318;-145
1426;29.02.2016;'10 - 11;24,92;32,08;-7,16;6262;5550;-712;10503;10420;-83
1427;29.02.2016;'11 - 12;23,48;29,83;-6,35;7515;6600;-915;11062;11010;-52
1428;29.02.2016;'12 - 13;22,77;28,13;-5,36;7985;6930;-1055;11766;11711;-55
1429;29.02.2016;'13 - 14;22,2;26,58;-4,38;7568;6580;-988;12325;11947;-378
1430;29.02.2016;'14 - 15;22;26,51;-4,51;6328;5599;-729;12560;12314;-246
1431;29.02.2016;'15 - 16;22,24;27,37;-5,13;4507;3973;-534;12588;12208;-380
1432;29.02.2016;'16 - 17;22,57;27,27;-4,7;2354;2007;-347;12268;11470;-798
1433;29.02.2016;'17 - 18;26,58;28,77;-2,19;523;436;-87;11764;10410;-1354
1434;29.02.2016;'18 - 19;34,03;40,12;-6,09;0;7;7;11369;9927;-1442
1435;29.02.2016;'19 - 20;31,21;39,28;-8,07;0;0;0;11157;10045;-1112
1436;29.02.2016;'20 - 21;27,14;34,09;-6,95;0;0;0;10512;9626;-886
1437;29.02.2016;'21 - 22;23,04;30,47;-7,43;0;0;0;9643;9158;-485
1438;29.02.2016;'22 - 23;22,55;28,68;-6,13;0;0;0;8707;8317;-390
1439;29.02.2016;'23 - 24;19,29;25,23;-5,94;0;0;0;7648;7367;-281
1440;01.03.2016;'00 - 01;22,48;20,89;1,59;0;0;0;5168;5789;621
1441;01.03.2016;'01 - 02;22,08;20,47;1,61;0;0;0;4436;4600;164
1442;01.03.2016;'02 - 03;19,87;20,79;-0,92;0;0;0;4016;3722;-294
1443;01.03.2016;'03 - 04;19,13;20,04;-0,91;0;0;0;3841;3718;-123
1444;01.03.2016;'04 - 05;19,33;18,75;0,58;0;0;0;3654;4514;860
1445;01.03.2016;'05 - 06;20,18;18,47;1,71;0;0;0;3530;5153;1623
1446;01.03.2016;'06 - 07;25,59;22,92;2,67;7;1;-6;3484;5097;1613
1447;01.03.2016;'07 - 08;32,93;29,08;3,85;376;322;-54;3468;5032;1564
1448;01.03.2016;'08 - 09;37,86;29,37;8,49;2065;1721;-344;3555;4692;1137
1449;01.03.2016;'09 - 10;34,95;28,16;6,79;4125;3983;-142;3732;4718;986
1450;01.03.2016;'10 - 11;31,9;24,59;7,31;6265;5838;-427;4017;5297;1280
1451;01.03.2016;'11 - 12;30,06;24,39;5,67;7735;7148;-587;4531;6372;1841
1452;01.03.2016;'12 - 13;28,8;24,38;4,42;8297;8000;-297;5336;7568;2232
1453;01.03.2016;'13 - 14;27,96;23,63;4,33;7891;7830;-61;6235;8428;2193
1454;01.03.2016;'14 - 15;25,55;22,48;3,07;6519;6569;50;7224;9478;2254
1455;01.03.2016;'15 - 16;25,48;23,65;1,83;4417;4321;-96;8229;11019;2790
1456;01.03.2016;'16 - 17;23,97;24,47;-0,5;2180;1892;-288;9193;12418;3225
1457;01.03.2016;'17 - 18;26,95;25,29;1,66;480;302;-178;10471;13566;3095
1458;01.03.2016;'18 - 19;26;26,74;-0,74;2;6;4;12014;15443;3429
1459;01.03.2016;'19 - 20;22,63;26,49;-3,86;0;0;0;13539;17501;3962
1460;01.03.2016;'20 - 21;21,26;23,81;-2,55;0;0;0;15046;19356;4310
1461;01.03.2016;'21 - 22;19,52;20,35;-0,83;0;0;0;16233;20226;3993
1462;01.03.2016;'22 - 23;18,39;17,7;0,69;0;0;0;16830;20115;3285
1463;01.03.2016;'23 - 24;17,06;19,49;-2,43;0;0;0;16833;19938;3105
1464;02.03.2016;'00 - 01;10,58;10,26;0,32;0;0;0;16586;19394;2808
1465;02.03.2016;'01 - 02;13,56;12,22;1,34;0;0;0;16293;19205;2912
1466;02.03.2016;'02 - 03;12,69;10,35;2,34;0;0;0;16176;19230;3054
1467;02.03.2016;'03 - 04;12,62;7,83;4,79;0;0;0;16240;19073;2833
1468;02.03.2016;'04 - 05;13,27;7,76;5,51;0;0;0;16272;19747;3475
1469;02.03.2016;'05 - 06;15,85;8,98;6,87;0;0;0;16241;19489;3248
1470;02.03.2016;'06 - 07;21,45;17,01;4,44;3;1;-2;16224;19916;3692
1471;02.03.2016;'07 - 08;23,08;20,5;2,58;194;189;-5;16109;19285;3176
1472;02.03.2016;'08 - 09;25,96;22,5;3,46;861;924;63;15975;18479;2504
1473;02.03.2016;'09 - 10;24,68;24,24;0,44;1773;2233;460;15785;19156;3371
1474;02.03.2016;'10 - 11;26,7;24,56;2,14;2782;3629;847;15383;19238;3855
1475;02.03.2016;'11 - 12;28;23,55;4,45;3606;4836;1230;15096;17828;2732
1476;02.03.2016;'12 - 13;27,43;24,12;3,31;4170;5581;1411;14525;17431;2906
1477;02.03.2016;'13 - 14;26;22,54;3,46;4434;5680;1246;13508;17115;3607
1478;02.03.2016;'14 - 15;25,92;21,74;4,18;4236;5089;853;11954;15360;3406
1479;02.03.2016;'15 - 16;28,06;21,63;6,43;3384;3547;163;10253;13662;3409
1480;02.03.2016;'16 - 17;28,56;23,44;5,12;1990;1678;-312;8623;11071;2448
1481;02.03.2016;'17 - 18;31,99;26,37;5,62;508;374;-134;7614;8675;1061
1482;02.03.2016;'18 - 19;40;36,27;3,73;2;8;6;7441;8956;1515
1483;02.03.2016;'19 - 20;36,87;33,05;3,82;0;0;0;7878;9560;1682
1484;02.03.2016;'20 - 21;30,99;27,23;3,76;0;0;0;8341;10102;1761
1485;02.03.2016;'21 - 22;27,07;24,67;2,4;0;0;0;8650;10410;1760
1486;02.03.2016;'22 - 23;24,27;22,26;2,01;0;0;0;8698;9850;1152
1487;02.03.2016;'23 - 24;21,58;19,04;2,54;0;0;0;8551;8868;317
1488;03.03.2016;'00 - 01;20,02;22,27;-2,25;0;0;0;7780;8171;391
1489;03.03.2016;'01 - 02;19,29;22,32;-3,03;0;0;0;7497;8044;547
1490;03.03.2016;'02 - 03;18,64;20,93;-2,29;0;0;0;7193;8129;936
1491;03.03.2016;'03 - 04;17,93;18,44;-0,51;0;0;0;6757;8417;1660
1492;03.03.2016;'04 - 05;18,26;15,83;2,43;0;0;0;6348;8724;2376
1493;03.03.2016;'05 - 06;19,38;18,21;1,17;0;0;0;5977;8042;2065
1494;03.03.2016;'06 - 07;24,58;25,24;-0,66;12;4;-8;5558;7471;1913
1495;03.03.2016;'07 - 08;30,93;30,99;-0,06;563;490;-73;5148;7414;2266
1496;03.03.2016;'08 - 09;31,04;31,67;-0,63;2520;2203;-317;4602;6668;2066
1497;03.03.2016;'09 - 10;30,94;32,39;-1,45;4803;4566;-237;4051;5280;1229
1498;03.03.2016;'10 - 11;30,57;31,94;-1,37;6950;6722;-228;3675;3716;41
1499;03.03.2016;'11 - 12;31,94;32,25;-0,31;8291;8081;-210;3385;2816;-569
1500;03.03.2016;'12 - 13;30,07;32,31;-2,24;8460;8533;73;3077;2305;-772
1501;03.03.2016;'13 - 14;30,53;32,49;-1,96;7787;7773;-14;2773;1964;-809
1502;03.03.2016;'14 - 15;30,06;33,04;-2,98;6499;6304;-195;2483;1866;-617
1503;03.03.2016;'15 - 16;30,97;33,46;-2,49;4688;4380;-308;2264;1874;-390
1504;03.03.2016;'16 - 17;30,96;35,18;-4,22;2553;2376;-177;2020;1661;-359
1505;03.03.2016;'17 - 18;32,85;38,21;-5,36;628;562;-66;1925;1676;-249
1506;03.03.2016;'18 - 19;42,71;47;-4,29;5;12;7;2063;1700;-363
1507;03.03.2016;'19 - 20;42,92;45,26;-2,34;0;0;0;2403;1986;-417
1508;03.03.2016;'20 - 21;33,98;39,79;-5,81;0;0;0;2851;2322;-529
1509;03.03.2016;'21 - 22;28,97;30,9;-1,93;0;0;0;3218;2654;-564
1510;03.03.2016;'22 - 23;25,92;26,39;-0,47;0;0;0;3506;3139;-367
1511;03.03.2016;'23 - 24;23,11;21,47;1,64;0;0;0;3720;3544;-176
1512;04.03.2016;'00 - 01;22,15;17,79;4,36;0;0;0;1992;4077;2085
1513;04.03.2016;'01 - 02;20,03;15,86;4,17;0;0;0;2252;4545;2293
1514;04.03.2016;'02 - 03;19,75;16,53;3,22;0;0;0;2494;5063;2569
1515;04.03.2016;'03 - 04;19,19;17,03;2,16;0;0;0;2835;5497;2662
1516;04.03.2016;'04 - 05;18,99;17,57;1,42;0;0;0;3183;5647;2464
1517;04.03.2016;'05 - 06;20,18;19,63;0,55;0;0;0;3574;6042;2468
1518;04.03.2016;'06 - 07;26,92;22,34;4,58;20;10;-10;4027;6835;2808
1519;04.03.2016;'07 - 08;31,73;25,92;5,81;1031;920;-111;4456;8002;3546
1520;04.03.2016;'08 - 09;33,97;27,84;6,13;4237;4445;208;4972;8853;3881
1521;04.03.2016;'09 - 10;30,04;21,68;8,36;7820;8506;686;5498;9418;3920
1522;04.03.2016;'10 - 11;26,69;20,34;6,35;10886;11167;281;6127;10616;4489
1523;04.03.2016;'11 - 12;23,78;18,4;5,38;12524;12243;-281;7262;12658;5396
1524;04.03.2016;'12 - 13;22,48;18,8;3,68;12491;11870;-621;8696;14666;5970
1525;04.03.2016;'13 - 14;21,78;17,9;3,88;11107;10361;-746;10152;16672;6520
1526;04.03.2016;'14 - 15;21,86;17,04;4,82;8626;7646;-980;11182;18161;6979
1527;04.03.2016;'15 - 16;22,48;17,69;4,79;5610;4603;-1007;11847;18016;6169
1528;04.03.2016;'16 - 17;24,17;18,93;5,24;2707;1917;-790;12070;17770;5700
1529;04.03.2016;'17 - 18;29,2;22,51;6,69;592;345;-247;12179;17314;5135
1530;04.03.2016;'18 - 19;33,99;25,92;8,07;3;8;5;12596;17271;4675
1531;04.03.2016;'19 - 20;31,06;24,32;6,74;0;0;0;12983;16904;3921
1532;04.03.2016;'20 - 21;27,9;22,72;5,18;0;0;0;12912;15565;2653
1533;04.03.2016;'21 - 22;23,52;22,68;0,84;0;0;0;12587;14198;1611
1534;04.03.2016;'22 - 23;23,8;24,25;-0,45;0;0;0;12145;12077;-68
1535;04.03.2016;'23 - 24;21,55;22,47;-0,92;0;0;0;11474;10753;-721
1536;05.03.2016;'00 - 01;19,15;20,44;-1,29;0;0;0;9981;9839;-142
1537;05.03.2016;'01 - 02;19,17;19,69;-0,52;0;0;0;8895;8544;-351
1538;05.03.2016;'02 - 03;19,04;19,21;-0,17;0;0;0;7946;7867;-79
1539;05.03.2016;'03 - 04;18,96;18,71;0,25;0;0;0;7074;7204;130
1540;05.03.2016;'04 - 05;18,88;24,52;-5,64;0;0;0;6524;6546;22
1541;05.03.2016;'05 - 06;19,01;22,44;-3,43;0;0;0;6204;5862;-342
1542;05.03.2016;'06 - 07;19,16;21,37;-2,21;18;8;-10;5781;5231;-550
1543;05.03.2016;'07 - 08;20,75;27,66;-6,91;630;483;-147;5287;4657;-630
1544;05.03.2016;'08 - 09;24,55;30,53;-5,98;2247;2226;-21;4849;4266;-583
1545;05.03.2016;'09 - 10;26,9;28,58;-1,68;4177;4172;-5;4477;3595;-882
1546;05.03.2016;'10 - 11;24,78;27,28;-2,5;5759;5685;-74;4297;3097;-1200
1547;05.03.2016;'11 - 12;24,63;27,29;-2,66;6716;6370;-346;4319;2909;-1410
1548;05.03.2016;'12 - 13;24,25;27,64;-3,39;6831;6812;-19;4310;2671;-1639
1549;05.03.2016;'13 - 14;21,14;26,32;-5,18;6055;5888;-167;4360;2155;-2205
1550;05.03.2016;'14 - 15;20,42;27,04;-6,62;4793;4737;-56;4391;2078;-2313
1551;05.03.2016;'15 - 16;20,57;26,24;-5,67;3267;3316;49;4373;1884;-2489
1552;05.03.2016;'16 - 17;21,25;26,53;-5,28;1677;1552;-125;4430;1608;-2822
1553;05.03.2016;'17 - 18;25,92;30,84;-4,92;413;346;-67;4547;1759;-2788
1554;05.03.2016;'18 - 19;34,02;41,91;-7,89;7;11;4;4549;1981;-2568
1555;05.03.2016;'19 - 20;35;40,93;-5,93;0;0;0;4051;2053;-1998
1556;05.03.2016;'20 - 21;27,86;33,59;-5,73;0;0;0;3885;1839;-2046
1557;05.03.2016;'21 - 22;24,44;28,77;-4,33;0;0;0;3874;1615;-2259
1558;05.03.2016;'22 - 23;25,18;30,02;-4,84;0;0;0;3914;1529;-2385
1559;05.03.2016;'23 - 24;20;27,83;-7,83;0;0;0;4033;1598;-2435
1560;06.03.2016;'00 - 01;20,69;23,97;-3,28;0;0;0;2413;1603;-810
1561;06.03.2016;'01 - 02;19,94;22,99;-3,05;0;0;0;2582;1667;-915
1562;06.03.2016;'02 - 03;19,13;22,63;-3,5;0;0;0;2762;2019;-743
1563;06.03.2016;'03 - 04;18,69;22,41;-3,72;0;0;0;2922;2240;-682
1564;06.03.2016;'04 - 05;18,58;20,69;-2,11;0;0;0;3134;2346;-788
1565;06.03.2016;'05 - 06;18,83;21,21;-2,38;0;0;0;3411;2686;-725
1566;06.03.2016;'06 - 07;18,65;21,31;-2,66;15;5;-10;3826;3218;-608
1567;06.03.2016;'07 - 08;18,78;20,3;-1,52;489;389;-100;4438;3660;-778
1568;06.03.2016;'08 - 09;19,28;19,21;0,07;1969;1757;-212;5177;4266;-911
1569;06.03.2016;'09 - 10;19,99;21,67;-1,68;3879;3742;-137;5980;4587;-1393
1570;06.03.2016;'10 - 11;20,26;22,2;-1,94;5775;5757;-18;6748;5302;-1446
1571;06.03.2016;'11 - 12;20,51;21,61;-1,1;7209;7308;99;7365;5964;-1401
1572;06.03.2016;'12 - 13;20,02;20,73;-0,71;7949;7874;-75;7857;6817;-1040
1573;06.03.2016;'13 - 14;19,14;19,73;-0,59;7847;7434;-413;8130;7248;-882
1574;06.03.2016;'14 - 15;18,24;20,39;-2,15;6815;6219;-596;7925;7266;-659
1575;06.03.2016;'15 - 16;18,23;20,73;-2,5;5056;4902;-154;7419;6816;-603
1576;06.03.2016;'16 - 17;18,73;20,3;-1,57;2824;3006;182;6598;6636;38
1577;06.03.2016;'17 - 18;20,57;22,91;-2,34;749;792;43;5883;5854;-29
1578;06.03.2016;'18 - 19;28,93;33,02;-4,09;14;19;5;5514;5785;271
1579;06.03.2016;'19 - 20;31,62;33,34;-1,72;0;0;0;5704;5773;69
1580;06.03.2016;'20 - 21;29,17;32,04;-2,87;0;0;0;6333;6324;-9
1581;06.03.2016;'21 - 22;25,44;27,01;-1,57;0;0;0;6893;6496;-397
1582;06.03.2016;'22 - 23;27,44;29;-1,56;0;0;0;7117;6303;-814
1583;06.03.2016;'23 - 24;21,15;25,84;-4,69;0;0;0;7042;6008;-1034
1584;07.03.2016;'00 - 01;22,04;24,25;-2,21;0;0;0;6588;6063;-525
1585;07.03.2016;'01 - 02;22,05;23,43;-1,38;0;0;0;6301;5845;-456
1586;07.03.2016;'02 - 03;20,34;22,3;-1,96;0;0;0;5993;5499;-494
1587;07.03.2016;'03 - 04;20,02;21;-0,98;0;0;0;5679;5110;-569
1588;07.03.2016;'04 - 05;20,09;21,27;-1,18;0;0;0;5413;4719;-694
1589;07.03.2016;'05 - 06;21,87;24,98;-3,11;0;0;0;5168;4176;-992
1590;07.03.2016;'06 - 07;32,34;29,92;2,42;32;14;-18;4871;3630;-1241
1591;07.03.2016;'07 - 08;35,97;34,66;1,31;854;730;-124;4479;3108;-1371
1592;07.03.2016;'08 - 09;37,79;34,51;3,28;3117;3301;184;4076;2302;-1774
1593;07.03.2016;'09 - 10;33,07;29,6;3,47;5920;7101;1181;3786;1805;-1981
1594;07.03.2016;'10 - 11;31,98;25,83;6,15;8205;9795;1590;3653;1718;-1935
1595;07.03.2016;'11 - 12;29,96;24,7;5,26;9678;10770;1092;3554;1850;-1704
1596;07.03.2016;'12 - 13;27,98;24,37;3,61;10377;10664;287;3488;2050;-1438
1597;07.03.2016;'13 - 14;27,44;25,41;2,03;10208;9819;-389;3287;2277;-1010
1598;07.03.2016;'14 - 15;27,72;26,49;1,23;8808;8616;-192;2945;2018;-927
1599;07.03.2016;'15 - 16;27,1;25,01;2,09;6590;6684;94;2679;1615;-1064
1600;07.03.2016;'16 - 17;30,07;25,86;4,21;3726;3930;204;2381;1290;-1091
1601;07.03.2016;'17 - 18;33,97;28,1;5,87;1010;1010;0;2087;1093;-994
1602;07.03.2016;'18 - 19;48,29;45,69;2,6;22;26;4;1912;1090;-822
1603;07.03.2016;'19 - 20;46,65;46,39;0,26;0;0;0;1876;1059;-817
1604;07.03.2016;'20 - 21;30,03;28,07;1,96;0;0;0;1877;1086;-791
1605;07.03.2016;'21 - 22;27,95;25;2,95;0;0;0;1893;1192;-701
1606;07.03.2016;'22 - 23;26,96;23,79;3,17;0;0;0;1932;1294;-638
1607;07.03.2016;'23 - 24;24,47;20,17;4,3;0;0;0;1887;1305;-582
1608;08.03.2016;'00 - 01;22,39;24,54;-2,15;0;0;0;1444;1286;-158
1609;08.03.2016;'01 - 02;22,91;22,43;0,48;0;0;0;1518;1324;-194
1610;08.03.2016;'02 - 03;22,81;23,06;-0,25;0;0;0;1632;1344;-288
1611;08.03.2016;'03 - 04;22;24,08;-2,08;0;0;0;1818;1376;-442
1612;08.03.2016;'04 - 05;21,67;24,49;-2,82;0;0;0;1980;1632;-348
1613;08.03.2016;'05 - 06;22,7;27,48;-4,78;0;0;0;2119;1758;-361
1614;08.03.2016;'06 - 07;27,44;31,53;-4,09;47;28;-19;2250;2050;-200
1615;08.03.2016;'07 - 08;37,73;41;-3,27;1009;856;-153;2289;2278;-11
1616;08.03.2016;'08 - 09;39,08;43,48;-4,4;3551;3071;-480;2222;2001;-221
1617;08.03.2016;'09 - 10;34,98;38,36;-3,38;7090;7256;166;2119;1656;-463
1618;08.03.2016;'10 - 11;28,61;30,49;-1,88;10100;9899;-201;2060;1464;-596
1619;08.03.2016;'11 - 12;25,42;30,54;-5,12;11860;11736;-124;2212;1886;-326
1620;08.03.2016;'12 - 13;25,1;29,86;-4,76;12270;11752;-518;2517;2587;70
1621;08.03.2016;'13 - 14;24,64;27,22;-2,58;11402;10356;-1046;2768;3091;323
1622;08.03.2016;'14 - 15;24,81;26,76;-1,95;9569;8784;-785;2848;3562;714
1623;08.03.2016;'15 - 16;25,09;24,95;0,14;7121;6794;-327;2796;3547;751
1624;08.03.2016;'16 - 17;27,92;26,39;1,53;4131;4097;-34;2652;3164;512
1625;08.03.2016;'17 - 18;33,1;31,94;1,16;1182;1146;-36;2533;2613;80
1626;08.03.2016;'18 - 19;44,93;45,7;-0,77;34;26;-8;2612;2513;-99
1627;08.03.2016;'19 - 20;40,58;42,28;-1,7;0;0;0;3118;3146;28
1628;08.03.2016;'20 - 21;31,94;33,75;-1,81;0;0;0;4008;4425;417
1629;08.03.2016;'21 - 22;25,07;25,87;-0,8;0;0;0;4961;5790;829
1630;08.03.2016;'22 - 23;27,2;23,46;3,74;0;0;0;5820;6571;751
1631;08.03.2016;'23 - 24;22,61;21,76;0,85;0;0;0;6434;6819;385
1632;09.03.2016;'00 - 01;23,8;17,21;6,59;0;0;0;6544;7126;582
1633;09.03.2016;'01 - 02;22,03;18,02;4,01;0;0;0;6719;7365;646
1634;09.03.2016;'02 - 03;20,94;19,38;1,56;0;0;0;6867;7347;480
1635;09.03.2016;'03 - 04;20,08;16,89;3,19;0;0;0;7036;7488;452
1636;09.03.2016;'04 - 05;20,01;18,1;1,91;0;0;0;7246;7883;637
1637;09.03.2016;'05 - 06;21,14;17,6;3,54;0;0;0;7554;8280;726
1638;09.03.2016;'06 - 07;24,95;16,98;7,97;60;37;-23;7976;9163;1187
1639;09.03.2016;'07 - 08;31,92;23,39;8,53;1623;1552;-71;8308;9404;1096
1640;09.03.2016;'08 - 09;29,91;21,93;7,98;5748;5509;-239;8279;8616;337
1641;09.03.2016;'09 - 10;25,03;24,14;0,89;10905;10208;-697;7964;7937;-27
1642;09.03.2016;'10 - 11;23,43;23,74;-0,31;15346;14146;-1200;7894;8292;398
1643;09.03.2016;'11 - 12;23,85;21,8;2,05;17692;16862;-830;8295;9554;1259
1644;09.03.2016;'12 - 13;22,28;21,02;1,26;18414;18016;-398;8865;10911;2046
1645;09.03.2016;'13 - 14;21,96;19,44;2,52;17536;17452;-84;9260;12364;3104
1646;09.03.2016;'14 - 15;22,48;18,28;4,2;15212;15471;259;9402;13194;3792
1647;09.03.2016;'15 - 16;23,05;16,82;6,23;11274;11646;372;9472;13528;4056
1648;09.03.2016;'16 - 17;24,83;17,59;7,24;6293;6380;87;9372;13153;3781
1649;09.03.2016;'17 - 18;33;21,71;11,29;1757;1690;-67;9425;11632;2207
1650;09.03.2016;'18 - 19;38,77;29,33;9,44;50;37;-13;10121;11658;1537
1651;09.03.2016;'19 - 20;37,99;27,47;10,52;0;0;0;10939;12332;1393
1652;09.03.2016;'20 - 21;29,81;22,41;7,4;0;0;0;11058;12706;1648
1653;09.03.2016;'21 - 22;25,8;21,5;4,3;0;0;0;10695;11707;1012
1654;09.03.2016;'22 - 23;27,51;22,65;4,86;0;0;0;9926;10022;96
1655;09.03.2016;'23 - 24;23,41;20,49;2,92;0;0;0;8903;9072;169
1656;10.03.2016;'00 - 01;19,72;19,15;0,57;0;0;0;7851;8492;641
1657;10.03.2016;'01 - 02;20,17;19,93;0,24;0;0;0;7132;7895;763
1658;10.03.2016;'02 - 03;20,04;20,25;-0,21;0;0;0;6620;7106;486
1659;10.03.2016;'03 - 04;20,16;20,01;0,15;0;0;0;6181;6614;433
1660;10.03.2016;'04 - 05;20,94;21,34;-0,4;0;0;0;5866;6449;583
1661;10.03.2016;'05 - 06;21,6;21,24;0,36;0;0;0;5694;6449;755
1662;10.03.2016;'06 - 07;28,48;24,95;3,53;54;32;-22;5535;6418;883
1663;10.03.2016;'07 - 08;35,44;33,08;2,36;1225;1327;102;5265;5762;497
1664;10.03.2016;'08 - 09;31,99;31,85;0,14;4277;4851;574;4868;5194;326
1665;10.03.2016;'09 - 10;30,07;27,23;2,84;7709;8984;1275;4443;4510;67
1666;10.03.2016;'10 - 11;25,53;21,35;4,18;10834;12217;1383;4057;4249;192
1667;10.03.2016;'11 - 12;24,71;21,11;3,6;12705;14298;1593;3693;3785;92
1668;10.03.2016;'12 - 13;26,35;22,17;4,18;13497;14836;1339;3398;3680;282
1669;10.03.2016;'13 - 14;25;22,49;2,51;12868;13852;984;3291;3596;305
1670;10.03.2016;'14 - 15;25;22,69;2,31;10890;11836;946;3382;3404;22
1671;10.03.2016;'15 - 16;24,89;22,62;2,27;7872;8548;676;3658;3617;-41
1672;10.03.2016;'16 - 17;25,03;23,14;1,89;4392;4604;212;4064;4042;-22
1673;10.03.2016;'17 - 18;29,95;26,39;3,56;1343;1277;-66;4534;4247;-287
1674;10.03.2016;'18 - 19;35,49;36,15;-0,66;56;32;-24;5050;4762;-288
1675;10.03.2016;'19 - 20;37,79;39,39;-1,6;0;0;0;5487;5761;274
1676;10.03.2016;'20 - 21;30,02;31,97;-1,95;0;0;0;5613;6231;618
1677;10.03.2016;'21 - 22;25,31;26,95;-1,64;0;0;0;5534;6205;671
1678;10.03.2016;'22 - 23;22,72;22,26;0,46;0;0;0;5246;5856;610
1679;10.03.2016;'23 - 24;21,32;21,86;-0,54;0;0;0;4824;5345;521
1680;11.03.2016;'00 - 01;22,03;20,78;1,25;0;0;0;4091;4914;823
1681;11.03.2016;'01 - 02;20,85;17,57;3,28;0;0;0;3651;4399;748
1682;11.03.2016;'02 - 03;21,03;19,38;1,65;0;0;0;3243;4181;938
1683;11.03.2016;'03 - 04;21,06;18,03;3,03;0;0;0;2969;3859;890
1684;11.03.2016;'04 - 05;21,75;20,04;1,71;0;0;0;2854;3627;773
1685;11.03.2016;'05 - 06;22,39;19,61;2,78;0;0;0;2909;3526;617
1686;11.03.2016;'06 - 07;28,34;29,58;-1,24;43;26;-17;2974;3574;600
1687;11.03.2016;'07 - 08;34,47;33,72;0,75;810;838;28;3026;3626;600
1688;11.03.2016;'08 - 09;38,34;40,26;-1,92;2707;3120;413;3118;3395;277
1689;11.03.2016;'09 - 10;36,69;37,18;-0,49;5200;6023;823;3164;3172;8
1690;11.03.2016;'10 - 11;32,91;34,74;-1,83;7625;8832;1207;3149;3336;187
1691;11.03.2016;'11 - 12;31,98;29,63;2,35;9163;10875;1712;2976;3305;329
1692;11.03.2016;'12 - 13;29,81;27,02;2,79;9863;11152;1289;2785;3110;325
1693;11.03.2016;'13 - 14;27,03;26,1;0,93;9542;10134;592;2780;3045;265
1694;11.03.2016;'14 - 15;25,01;28,45;-3,44;8189;8062;-127;2971;3106;135
1695;11.03.2016;'15 - 16;24,92;29,27;-4,35;5998;5525;-473;3311;3457;146
1696;11.03.2016;'16 - 17;24,88;28,9;-4,02;3402;2869;-533;3665;3726;61
1697;11.03.2016;'17 - 18;27,9;33,03;-5,13;1062;742;-320;3929;3892;-37
1698;11.03.2016;'18 - 19;32,55;43,46;-10,91;51;27;-24;4128;4380;252
1699;11.03.2016;'19 - 20;35,69;46,83;-11,14;0;0;0;4237;5141;904
1700;11.03.2016;'20 - 21;30,33;36,33;-6;0;0;0;4262;5513;1251
1701;11.03.2016;'21 - 22;26,77;29,31;-2,54;0;0;0;4156;5114;958
1702;11.03.2016;'22 - 23;28,2;27,95;0,25;0;0;0;3975;4664;689
1703;11.03.2016;'23 - 24;25,21;25,54;-0,33;0;0;0;3770;4211;441
1704;12.03.2016;'00 - 01;29,01;29,53;-0,52;0;0;0;3453;3801;348
1705;12.03.2016;'01 - 02;26,1;25,24;0,86;0;0;0;3182;3614;432
1706;12.03.2016;'02 - 03;25,69;25,52;0,17;0;0;0;3032;3566;534
1707;12.03.2016;'03 - 04;24,5;24,91;-0,41;0;0;0;2988;3513;525
1708;12.03.2016;'04 - 05;23,26;24,26;-1;0;0;0;3001;3660;659
1709;12.03.2016;'05 - 06;24,5;23,91;0,59;0;0;0;3091;4010;919
1710;12.03.2016;'06 - 07;25,45;25,34;0,11;55;31;-24;3155;4232;1077
1711;12.03.2016;'07 - 08;25,51;25,6;-0,09;971;851;-120;3097;4186;1089
1712;12.03.2016;'08 - 09;28,91;26,57;2,34;3199;3243;44;2930;3430;500
1713;12.03.2016;'09 - 10;30,09;31,8;-1,71;6102;6288;186;2756;2979;223
1714;12.03.2016;'10 - 11;29,26;31,17;-1,91;8675;8644;-31;2636;2737;101
1715;12.03.2016;'11 - 12;28,44;29,99;-1,55;10284;9951;-333;2559;2559;0
1716;12.03.2016;'12 - 13;27,6;31,39;-3,79;10756;9796;-960;2546;2475;-71
1717;12.03.2016;'13 - 14;25,01;27,92;-2,91;10172;8685;-1487;2605;2526;-79
1718;12.03.2016;'14 - 15;23,38;27,16;-3,78;8656;7031;-1625;2758;2663;-95
1719;12.03.2016;'15 - 16;22,96;25,98;-3,02;6330;4901;-1429;3025;2967;-58
1720;12.03.2016;'16 - 17;23,67;27,97;-4,3;3574;2626;-948;3300;3106;-194
1721;12.03.2016;'17 - 18;27,07;31,16;-4,09;1140;738;-402;3459;3380;-79
1722;12.03.2016;'18 - 19;34,09;36,19;-2,1;62;32;-30;3684;3763;79
1723;12.03.2016;'19 - 20;36,97;37,79;-0,82;0;0;0;3986;4401;415
1724;12.03.2016;'20 - 21;35;31,7;3,3;0;0;0;4173;4924;751
1725;12.03.2016;'21 - 22;30,17;28,84;1,33;0;0;0;4237;5070;833
1726;12.03.2016;'22 - 23;30,91;31,46;-0,55;0;0;0;4217;4936;719
1727;12.03.2016;'23 - 24;30;30,04;-0,04;0;0;0;4116;4950;834
1728;13.03.2016;'00 - 01;26,51;26,15;0,36;0;0;0;4555;5059;504
1729;13.03.2016;'01 - 02;22,65;23,4;-0,75;0;0;0;4462;5292;830
1730;13.03.2016;'02 - 03;21,67;20,35;1,32;0;0;0;4337;5351;1014
1731;13.03.2016;'03 - 04;21,05;18,93;2,12;0;0;0;4233;5360;1127
1732;13.03.2016;'04 - 05;21,12;19,9;1,22;0;0;0;4148;4893;745
1733;13.03.2016;'05 - 06;21,17;19,68;1,49;0;0;0;4144;4940;796
1734;13.03.2016;'06 - 07;21,11;20,82;0,29;60;33;-27;4158;5342;1184
1735;13.03.2016;'07 - 08;21,08;19,16;1,92;968;830;-138;4293;5607;1314
1736;13.03.2016;'08 - 09;21,31;19,46;1,85;3122;2319;-803;4538;5788;1250
1737;13.03.2016;'09 - 10;21,69;20,97;0,72;5720;4362;-1358;4607;5890;1283
1738;13.03.2016;'10 - 11;21,73;21,14;0,59;8059;6162;-1897;4531;5889;1358
1739;13.03.2016;'11 - 12;21,69;21,54;0,15;9716;7716;-2000;4582;5480;898
1740;13.03.2016;'12 - 13;21,07;22,72;-1,65;10580;9172;-1408;4629;4878;249
1741;13.03.2016;'13 - 14;19,4;20,51;-1,11;10479;9732;-747;4764;4743;-21
1742;13.03.2016;'14 - 15;17,78;19,78;-2;9316;8949;-367;5002;4979;-23
1743;13.03.2016;'15 - 16;17,46;18,78;-1,32;6989;6882;-107;5419;5453;34
1744;13.03.2016;'16 - 17;18,08;19,74;-1,66;3938;3893;-45;5798;6101;303
1745;13.03.2016;'17 - 18;20,19;22,25;-2,06;1283;1246;-37;6001;6336;335
1746;13.03.2016;'18 - 19;26,08;25,59;0,49;74;58;-16;6220;6584;364
1747;13.03.2016;'19 - 20;33,55;28,24;5,31;0;0;0;6538;6771;233
1748;13.03.2016;'20 - 21;31,05;25,93;5,12;0;0;0;6522;6860;338
1749;13.03.2016;'21 - 22;27,24;24,86;2,38;0;0;0;6305;6474;169
1750;13.03.2016;'22 - 23;28,93;26,33;2,6;0;0;0;5977;6120;143
1751;13.03.2016;'23 - 24;26,63;23,56;3,07;0;0;0;5597;5768;171
1752;14.03.2016;'00 - 01;22,39;21,65;0,74;0;0;0;5297;5374;77
1753;14.03.2016;'01 - 02;20,7;22,71;-2,01;0;0;0;5027;5156;129
1754;14.03.2016;'02 - 03;20,22;21,2;-0,98;0;0;0;4820;5032;212
1755;14.03.2016;'03 - 04;19,99;19,51;0,48;0;0;0;4554;5030;476
1756;14.03.2016;'04 - 05;20,36;19,71;0,65;0;0;0;4363;4964;601
1757;14.03.2016;'05 - 06;21,92;20,64;1,28;0;0;0;4204;4959;755
1758;14.03.2016;'06 - 07;29,46;29,99;-0,53;103;85;-18;4014;4817;803
1759;14.03.2016;'07 - 08;35,43;33,86;1,57;1440;1912;472;3888;4364;476
1760;14.03.2016;'08 - 09;35,81;32,15;3,66;4593;6572;1979;3767;3554;-213
1761;14.03.2016;'09 - 10;31,75;23,87;7,88;8663;11762;3099;3582;3104;-478
1762;14.03.2016;'10 - 11;28,82;22,77;6,05;12637;15717;3080;3453;2916;-537
1763;14.03.2016;'11 - 12;24,33;21,69;2,64;15543;18578;3035;3448;2662;-786
1764;14.03.2016;'12 - 13;23,31;20,84;2,47;17016;19926;2910;3511;2647;-864
1765;14.03.2016;'13 - 14;22,84;21,18;1,66;16818;19427;2609;3682;2766;-916
1766;14.03.2016;'14 - 15;22,55;20,9;1,65;14916;16798;1882;3911;2986;-925
1767;14.03.2016;'15 - 16;23,04;21,2;1,84;11339;12392;1053;4114;3225;-889
1768;14.03.2016;'16 - 17;24,8;21,72;3,08;6656;7010;354;4178;3318;-860
1769;14.03.2016;'17 - 18;30,71;28,62;2,09;2174;2155;-19;4034;3298;-736
1770;14.03.2016;'18 - 19;39,48;35,1;4,38;121;88;-33;4043;3563;-480
1771;14.03.2016;'19 - 20;47,92;46,05;1,87;0;0;0;4118;4020;-98
1772;14.03.2016;'20 - 21;34,32;33,12;1,2;0;0;0;4139;4400;261
1773;14.03.2016;'21 - 22;29,48;26,88;2,6;0;0;0;4027;4379;352
1774;14.03.2016;'22 - 23;26,37;24,45;1,92;0;0;0;3862;4074;212
1775;14.03.2016;'23 - 24;22,91;20,55;2,36;0;0;0;3634;3778;144
1776;15.03.2016;'00 - 01;21,1;21,2;-0,1;0;0;0;3508;3628;120
1777;15.03.2016;'01 - 02;20,76;22,5;-1,74;0;0;0;3522;3578;56
1778;15.03.2016;'02 - 03;21,17;22,78;-1,61;0;0;0;3683;3562;-121
1779;15.03.2016;'03 - 04;20,74;22,43;-1,69;0;0;0;3980;3646;-334
1780;15.03.2016;'04 - 05;20,91;22,86;-1,95;0;0;0;4414;3687;-727
1781;15.03.2016;'05 - 06;22,86;28,5;-5,64;0;0;0;4995;3649;-1346
1782;15.03.2016;'06 - 07;27,1;35,2;-8,1;54;45;-9;5488;3759;-1729
1783;15.03.2016;'07 - 08;33,69;43,99;-10,3;750;739;-11;5778;4052;-1726
1784;15.03.2016;'08 - 09;38,47;58,35;-19,88;2115;2223;108;5906;4354;-1552
1785;15.03.2016;'09 - 10;35,96;47,37;-11,41;3612;3642;30;6083;4818;-1265
1786;15.03.2016;'10 - 11;36,09;41,48;-5,39;4964;4856;-108;6417;5347;-1070
1787;15.03.2016;'11 - 12;34,31;39,7;-5,39;5910;5196;-714;6917;6296;-621
1788;15.03.2016;'12 - 13;30,93;34,25;-3,32;6414;4734;-1680;7433;6931;-502
1789;15.03.2016;'13 - 14;27,44;32,97;-5,53;6407;4194;-2213;7893;7539;-354
1790;15.03.2016;'14 - 15;24,78;31,26;-6,48;5791;3706;-2085;8278;7992;-286
1791;15.03.2016;'15 - 16;23,71;30;-6,29;4458;3108;-1350;8498;8554;56
1792;15.03.2016;'16 - 17;23,3;28,36;-5,06;2746;2052;-694;8490;9103;613
1793;15.03.2016;'17 - 18;25,45;28,21;-2,76;983;701;-282;8355;9339;984
1794;15.03.2016;'18 - 19;31,91;32,72;-0,81;64;45;-19;8354;8903;549
1795;15.03.2016;'19 - 20;34,13;36,07;-1,94;0;0;0;8342;9604;1262
1796;15.03.2016;'20 - 21;29,06;28,69;0,37;0;0;0;8278;9827;1549
1797;15.03.2016;'21 - 22;24,15;23,03;1,12;0;0;0;8260;8370;110
1798;15.03.2016;'22 - 23;22,52;22,97;-0,45;0;0;0;8160;8423;263
1799;15.03.2016;'23 - 24;20,95;23,48;-2,53;0;0;0;7900;7740;-160
1800;16.03.2016;'00 - 01;21,22;19,81;1,41;0;0;0;8361;9416;1055
1801;16.03.2016;'01 - 02;20,92;19,17;1,75;0;0;0;8144;9762;1618
1802;16.03.2016;'02 - 03;20,45;16,59;3,86;0;0;0;8048;10052;2004
1803;16.03.2016;'03 - 04;20,06;16,58;3,48;0;0;0;8017;10419;2402
1804;16.03.2016;'04 - 05;20,49;16,06;4,43;0;0;0;8106;10965;2859
1805;16.03.2016;'05 - 06;21,59;15,25;6,34;0;0;0;8269;11439;3170
1806;16.03.2016;'06 - 07;26,24;19,92;6,32;148;100;-48;8577;11814;3237
1807;16.03.2016;'07 - 08;33,94;25,6;8,34;1957;1704;-253;8768;11715;2947
1808;16.03.2016;'08 - 09;32,99;23,41;9,58;5493;4996;-497;9005;11016;2011
1809;16.03.2016;'09 - 10;24,71;21,68;3,03;9517;9090;-427;9410;11622;2212
1810;16.03.2016;'10 - 11;22,48;20,65;1,83;12958;12394;-564;9772;13054;3282
1811;16.03.2016;'11 - 12;22,43;19,5;2,93;15150;13968;-1182;10229;14557;4328
1812;16.03.2016;'12 - 13;22,16;19,7;2,46;16141;15197;-944;10525;14330;3805
1813;16.03.2016;'13 - 14;21,85;19,9;1,95;15902;15689;-213;10621;13628;3007
1814;16.03.2016;'14 - 15;21,9;20,3;1,6;14211;14696;485;10531;12985;2454
1815;16.03.2016;'15 - 16;22,28;19,77;2,51;10788;11434;646;10405;12539;2134
1816;16.03.2016;'16 - 17;23,67;19,9;3,77;6232;6761;529;9949;11653;1704
1817;16.03.2016;'17 - 18;29,92;29,15;0,77;2020;2237;217;9192;10133;941
1818;16.03.2016;'18 - 19;35,6;33,91;1,69;133;100;-33;8678;9019;341
1819;16.03.2016;'19 - 20;39,2;34,67;4,53;0;0;0;8471;9344;873
1820;16.03.2016;'20 - 21;32,02;31,69;0,33;0;0;0;8126;9390;1264
1821;16.03.2016;'21 - 22;27,04;28,55;-1,51;0;0;0;7703;8846;1143
1822;16.03.2016;'22 - 23;23,7;23,29;0,41;0;0;0;7056;8013;957
1823;16.03.2016;'23 - 24;22,97;23,23;-0,26;0;0;0;6197;6994;797
1824;17.03.2016;'00 - 01;23,08;22,23;0,85;0;0;0;4899;5946;1047
1825;17.03.2016;'01 - 02;22,3;21,93;0,37;0;0;0;4127;5096;969
1826;17.03.2016;'02 - 03;22,13;22,42;-0,29;0;0;0;3559;4432;873
1827;17.03.2016;'03 - 04;22,27;24,1;-1,83;0;0;0;3138;4002;864
1828;17.03.2016;'04 - 05;22,24;23,5;-1,26;0;0;0;2882;3630;748
1829;17.03.2016;'05 - 06;23,55;26,7;-3,15;0;0;0;2699;3272;573
1830;17.03.2016;'06 - 07;33,9;33,88;0,02;242;212;-30;2572;3177;605
1831;17.03.2016;'07 - 08;38,16;39,69;-1,53;3061;3247;186;2378;2857;479
1832;17.03.2016;'08 - 09;34,97;28,3;6,67;8562;9224;662;2078;1852;-226
1833;17.03.2016;'09 - 10;25,98;21,04;4,94;14224;14940;716;1805;996;-809
1834;17.03.2016;'10 - 11;23,11;21,37;1,74;18459;19105;646;1719;931;-788
1835;17.03.2016;'11 - 12;22,96;20,96;2;20849;21804;955;1834;1252;-582
1836;17.03.2016;'12 - 13;22,38;20,41;1,97;21654;22950;1296;2076;1388;-688
1837;17.03.2016;'13 - 14;22,2;19,89;2,31;20781;22022;1241;2476;1578;-898
1838;17.03.2016;'14 - 15;22,15;19,87;2,28;18143;19109;966;2905;1798;-1107
1839;17.03.2016;'15 - 16;22,43;20,62;1,81;13691;14338;647;3325;2121;-1204
1840;17.03.2016;'16 - 17;25,85;24,02;1,83;7905;8186;281;3777;2528;-1249
1841;17.03.2016;'17 - 18;31,92;30,97;0,95;2626;2630;4;4173;2962;-1211
1842;17.03.2016;'18 - 19;38,81;39,34;-0,53;189;156;-33;4639;3689;-950
1843;17.03.2016;'19 - 20;46,69;41,98;4,71;0;0;0;5248;4644;-604
1844;17.03.2016;'20 - 21;37,76;37,84;-0,08;0;0;0;5777;5295;-482
1845;17.03.2016;'21 - 22;30,98;30,23;0,75;0;0;0;6249;5751;-498
1846;17.03.2016;'22 - 23;25,48;26,68;-1,2;0;0;0;6587;6127;-460
1847;17.03.2016;'23 - 24;21,84;22,42;-0,58;0;0;0;6746;6422;-324
1848;18.03.2016;'00 - 01;20,34;23,43;-3,09;0;0;0;6777;6865;88
1849;18.03.2016;'01 - 02;19,47;22,05;-2,58;0;0;0;6989;7364;375
1850;18.03.2016;'02 - 03;19,49;22,19;-2,7;0;0;0;7307;7937;630
1851;18.03.2016;'03 - 04;19,67;21,36;-1,69;0;0;0;7583;8352;769
1852;18.03.2016;'04 - 05;20,14;22,17;-2,03;0;0;0;7776;8384;608
1853;18.03.2016;'05 - 06;21,58;25,79;-4,21;0;0;0;7727;8414;687
1854;18.03.2016;'06 - 07;24,86;28,37;-3,51;231;208;-23;7496;8236;740
1855;18.03.2016;'07 - 08;32,69;29,87;2,82;2597;2724;127;7089;8111;1022
1856;18.03.2016;'08 - 09;29,94;29,74;0,2;6988;7390;402;6442;7576;1134
1857;18.03.2016;'09 - 10;23,88;21,88;2;11354;11486;132;5908;6576;668
1858;18.03.2016;'10 - 11;22,43;21,11;1,32;14509;14153;-356;5465;6008;543
1859;18.03.2016;'11 - 12;22,92;23,52;-0,6;16237;15443;-794;5006;5510;504
1860;18.03.2016;'12 - 13;22,59;24,6;-2,01;16777;15717;-1060;4651;5019;368
1861;18.03.2016;'13 - 14;22,53;24,08;-1,55;16117;14940;-1177;4422;4948;526
1862;18.03.2016;'14 - 15;22,56;24,77;-2,21;14083;12904;-1179;4246;5092;846
1863;18.03.2016;'15 - 16;23,46;25,83;-2,37;10603;9540;-1063;4112;4981;869
1864;18.03.2016;'16 - 17;24,42;24,93;-0,51;6106;5426;-680;3940;4590;650
1865;18.03.2016;'17 - 18;27,82;28,61;-0,79;2051;1738;-313;3763;4062;299
1866;18.03.2016;'18 - 19;33,99;32,88;1,11;159;97;-62;3588;4014;426
1867;18.03.2016;'19 - 20;39,3;40,48;-1,18;0;0;0;3439;3946;507
1868;18.03.2016;'20 - 21;33,91;35,02;-1,11;0;0;0;3251;3530;279
1869;18.03.2016;'21 - 22;27,09;28,73;-1,64;0;0;0;3116;3325;209
1870;18.03.2016;'22 - 23;26,92;29,08;-2,16;0;0;0;2954;2966;12
1871;18.03.2016;'23 - 24;23,78;25,39;-1,61;0;0;0;2681;2636;-45
1872;19.03.2016;'00 - 01;23,37;24,54;-1,17;0;0;0;2408;2424;16
1873;19.03.2016;'01 - 02;21,68;24,5;-2,82;0;0;0;2075;2219;144
1874;19.03.2016;'02 - 03;21,66;22,83;-1,17;0;0;0;1858;2018;160
1875;19.03.2016;'03 - 04;22,6;22,58;0,02;0;0;0;1701;1947;246
1876;19.03.2016;'04 - 05;22,71;21,44;1,27;0;0;0;1598;1812;214
1877;19.03.2016;'05 - 06;22,2;21,42;0,78;0;0;0;1538;1724;186
1878;19.03.2016;'06 - 07;22,4;20,97;1,43;140;137;-3;1426;1583;157
1879;19.03.2016;'07 - 08;28,93;27,55;1,38;1412;1506;94;1259;1612;353
1880;19.03.2016;'08 - 09;29,38;26,56;2,82;3763;4002;239;1178;1846;668
1881;19.03.2016;'09 - 10;28,58;26,02;2,56;6398;6800;402;1181;2114;933
1882;19.03.2016;'10 - 11;26,96;23,96;3;8623;8782;159;1320;2504;1184
1883;19.03.2016;'11 - 12;24,79;22,09;2,7;10225;10135;-90;1654;2962;1308
1884;19.03.2016;'12 - 13;23,04;21,21;1,83;11066;10888;-178;2088;3513;1425
1885;19.03.2016;'13 - 14;22,04;20,8;1,24;10963;10703;-260;2729;4208;1479
1886;19.03.2016;'14 - 15;21,12;20,52;0,6;9762;9317;-445;3574;5173;1599
1887;19.03.2016;'15 - 16;20,93;18,99;1,94;7336;6987;-349;4398;6150;1752
1888;19.03.2016;'16 - 17;21,3;18,82;2,48;4237;4030;-207;5160;7038;1878
1889;19.03.2016;'17 - 18;24;24,92;-0,92;1452;1252;-200;5762;7504;1742
1890;19.03.2016;'18 - 19;31,21;28,66;2,55;118;64;-54;6393;8347;1954
1891;19.03.2016;'19 - 20;35,42;30,21;5,21;0;0;0;7153;9360;2207
1892;19.03.2016;'20 - 21;26,18;20,92;5,26;0;0;0;8017;10254;2237
1893;19.03.2016;'21 - 22;22,78;21,23;1,55;0;0;0;8913;10697;1784
1894;19.03.2016;'22 - 23;24,69;24,15;0,54;0;0;0;9663;11094;1431
1895;19.03.2016;'23 - 24;21,21;23,03;-1,82;0;0;0;10180;11454;1274
1896;20.03.2016;'00 - 01;17,73;20,99;-3,26;0;0;0;11529;11496;-33
1897;20.03.2016;'01 - 02;17,04;19,57;-2,53;0;0;0;11586;11311;-275
1898;20.03.2016;'02 - 03;18,63;18,75;-0,12;0;0;0;11678;11321;-357
1899;20.03.2016;'03 - 04;18,59;18,69;-0,1;0;0;0;11808;11612;-196
1900;20.03.2016;'04 - 05;18,71;22,53;-3,82;0;0;0;11876;11858;-18
1901;20.03.2016;'05 - 06;18,73;20,25;-1,52;0;0;0;11928;11948;20
1902;20.03.2016;'06 - 07;18,51;19,82;-1,31;143;99;-44;11983;12316;333
1903;20.03.2016;'07 - 08;17,05;18,42;-1,37;1265;914;-351;12144;12414;270
1904;20.03.2016;'08 - 09;16,04;18,79;-2,75;3325;2163;-1162;12608;12736;128
1905;20.03.2016;'09 - 10;16,09;22,32;-6,23;5688;3734;-1954;13337;12965;-372
1906;20.03.2016;'10 - 11;14,33;23,08;-8,75;7695;5493;-2202;13888;13076;-812
1907;20.03.2016;'11 - 12;16,07;23,95;-7,88;9045;7526;-1519;13917;13470;-447
1908;20.03.2016;'12 - 13;13,19;21,96;-8,77;9801;9601;-200;13899;13335;-564
1909;20.03.2016;'13 - 14;12,44;17,61;-5,17;9859;10654;795;13717;13037;-680
1910;20.03.2016;'14 - 15;12;13,37;-1,37;8814;9882;1068;13246;12844;-402
1911;20.03.2016;'15 - 16;12,69;13,86;-1,17;6674;7470;796;12772;12731;-41
1912;20.03.2016;'16 - 17;13,59;17,06;-3,47;3891;4335;444;12251;12332;81
1913;20.03.2016;'17 - 18;19,02;20,21;-1,19;1379;1416;37;11762;11080;-682
1914;20.03.2016;'18 - 19;23,54;27,84;-4,3;140;73;-67;11395;10106;-1289
1915;20.03.2016;'19 - 20;25,86;32,8;-6,94;0;0;0;11363;9904;-1459
1916;20.03.2016;'20 - 21;22,66;33,77;-11,11;0;0;0;11547;9987;-1560
1917;20.03.2016;'21 - 22;22,32;31,77;-9,45;0;0;0;11644;10052;-1592
1918;20.03.2016;'22 - 23;24,03;30,57;-6,54;0;0;0;11677;9798;-1879
1919;20.03.2016;'23 - 24;20,33;26,62;-6,29;0;0;0;11799;9750;-2049
1920;21.03.2016;'00 - 01;20,82;25,47;-4,65;0;0;0;10451;10168;-283
1921;21.03.2016;'01 - 02;19,9;26,31;-6,41;0;0;0;10445;10536;91
1922;21.03.2016;'02 - 03;19,79;22,57;-2,78;0;0;0;10316;10696;380
1923;21.03.2016;'03 - 04;19,9;21,56;-1,66;0;0;0;10124;10914;790
1924;21.03.2016;'04 - 05;20,4;21,76;-1,36;0;0;0;9897;10701;804
1925;21.03.2016;'05 - 06;23,18;25,88;-2,7;1;0;-1;9644;10017;373
1926;21.03.2016;'06 - 07;32,01;36,13;-4,12;139;118;-21;9640;10234;594
1927;21.03.2016;'07 - 08;31,72;37,22;-5,5;1144;1143;-1;9960;10294;334
1928;21.03.2016;'08 - 09;30,94;34,52;-3,58;2862;3066;204;10775;10987;212
1929;21.03.2016;'09 - 10;30,04;36,99;-6,95;4815;5807;992;11904;12085;181
1930;21.03.2016;'10 - 11;24,9;27,34;-2,44;6506;8509;2003;12928;13411;483
1931;21.03.2016;'11 - 12;24,73;25,73;-1;7668;10166;2498;13656;14468;812
1932;21.03.2016;'12 - 13;26,03;21,85;4,18;8160;9830;1670;14280;14906;626
1933;21.03.2016;'13 - 14;24,53;22,84;1,69;7913;8390;477;14704;15495;791
1934;21.03.2016;'14 - 15;23,75;26;-2,25;6970;6658;-312;14779;15852;1073
1935;21.03.2016;'15 - 16;24,28;27,66;-3,38;5303;4806;-497;14529;16216;1687
1936;21.03.2016;'16 - 17;23,91;27,96;-4,05;3226;2712;-514;14031;15555;1524
1937;21.03.2016;'17 - 18;26,87;30,37;-3,5;1218;922;-296;13239;15173;1934
1938;21.03.2016;'18 - 19;30,1;32,63;-2,53;127;53;-74;12471;15220;2749
1939;21.03.2016;'19 - 20;33,49;34,44;-0,95;0;0;0;11907;15118;3211
1940;21.03.2016;'20 - 21;29,9;28,37;1,53;0;0;0;11590;14733;3143
1941;21.03.2016;'21 - 22;23,02;23,66;-0,64;0;0;0;11437;14711;3274
1942;21.03.2016;'22 - 23;22,11;21,35;0,76;0;0;0;11198;13925;2727
1943;21.03.2016;'23 - 24;20,9;20,66;0,24;0;0;0;10913;13259;2346
1944;22.03.2016;'00 - 01;20,28;21,82;-1,54;0;0;0;12712;12702;-10
1945;22.03.2016;'01 - 02;20,08;22,02;-1,94;0;0;0;12248;12282;34
1946;22.03.2016;'02 - 03;20,05;20,71;-0,66;0;0;0;11743;11663;-80
1947;22.03.2016;'03 - 04;20,47;23,22;-2,75;0;0;0;11182;11221;39
1948;22.03.2016;'04 - 05;21;22,67;-1,67;0;0;0;10518;10820;302
1949;22.03.2016;'05 - 06;22,01;23,18;-1,17;0;1;1;9809;10193;384
1950;22.03.2016;'06 - 07;24,07;25,65;-1,58;175;170;-5;9120;9372;252
1951;22.03.2016;'07 - 08;29,99;30,1;-0,11;1423;1630;207;8683;8894;211
1952;22.03.2016;'08 - 09;31,46;27,3;4,16;3516;4407;891;8549;8399;-150
1953;22.03.2016;'09 - 10;31,41;27,22;4,19;5822;7525;1703;8708;8153;-555
1954;22.03.2016;'10 - 11;28,9;25,46;3,44;7753;9778;2025;8660;7807;-853
1955;22.03.2016;'11 - 12;30;26,54;3,46;9046;10398;1352;8175;7858;-317
1956;22.03.2016;'12 - 13;28,94;26,95;1,99;9507;9452;-55;7710;7491;-219
1957;22.03.2016;'13 - 14;28,99;28,82;0,17;9053;9003;-50;7438;7028;-410
1958;22.03.2016;'14 - 15;29;27,15;1,85;7733;7540;-193;7223;6521;-702
1959;22.03.2016;'15 - 16;29,29;27,02;2,27;5839;5520;-319;7006;6032;-974
1960;22.03.2016;'16 - 17;30,08;29,18;0,9;3531;3191;-340;6522;5472;-1050
1961;22.03.2016;'17 - 18;34,01;30,3;3,71;1301;1215;-86;5697;4869;-828
1962;22.03.2016;'18 - 19;36,73;32,85;3,88;134;104;-30;4963;4302;-661
1963;22.03.2016;'19 - 20;40,64;39,36;1,28;0;0;0;4953;4442;-511
1964;22.03.2016;'20 - 21;38,1;34,11;3,99;0;0;0;5164;4566;-598
1965;22.03.2016;'21 - 22;33,05;28,96;4,09;0;0;0;5386;4518;-868
1966;22.03.2016;'22 - 23;29,86;27,3;2,56;0;0;0;5590;4352;-1238
1967;22.03.2016;'23 - 24;23,73;24,46;-0,73;0;0;0;5758;4456;-1302
1968;23.03.2016;'00 - 01;21,3;24,06;-2,76;0;0;0;4972;4598;-374
1969;23.03.2016;'01 - 02;20,51;22,14;-1,63;0;0;0;5064;4666;-398
1970;23.03.2016;'02 - 03;20,26;21,85;-1,59;0;0;0;5232;5260;28
1971;23.03.2016;'03 - 04;21,06;22;-0,94;0;0;0;5402;5692;290
1972;23.03.2016;'04 - 05;21,38;22,86;-1,48;0;0;0;5671;5696;25
1973;23.03.2016;'05 - 06;21,38;24,37;-2,99;0;1;1;5931;5666;-265
1974;23.03.2016;'06 - 07;25,88;27,17;-1,29;181;172;-9;6229;5381;-848
1975;23.03.2016;'07 - 08;32,9;35,42;-2,52;1297;1335;38;6612;5442;-1170
1976;23.03.2016;'08 - 09;32,46;36,06;-3,6;3204;3428;224;7133;5857;-1276
1977;23.03.2016;'09 - 10;30,03;33,28;-3,25;5582;5806;224;7743;6243;-1500
1978;23.03.2016;'10 - 11;26,53;30,59;-4,06;7536;7703;167;8206;6402;-1804
1979;23.03.2016;'11 - 12;26,73;29,17;-2,44;8901;8664;-237;8450;6753;-1697
1980;23.03.2016;'12 - 13;25,23;28,33;-3,1;9475;8765;-710;8663;7088;-1575
1981;23.03.2016;'13 - 14;25;28,8;-3,8;9270;8634;-636;9095;7666;-1429
1982;23.03.2016;'14 - 15;24,03;28,84;-4,81;8202;7622;-580;9357;8109;-1248
1983;23.03.2016;'15 - 16;24,13;25,85;-1,72;6476;5834;-642;9321;8075;-1246
1984;23.03.2016;'16 - 17;24,18;26,13;-1,95;4176;3405;-771;8943;7216;-1727
1985;23.03.2016;'17 - 18;28;29,23;-1,23;1702;1251;-451;7984;6284;-1700
1986;23.03.2016;'18 - 19;32,44;33,56;-1,12;198;115;-83;6974;5132;-1842
1987;23.03.2016;'19 - 20;37,16;36,88;0,28;0;0;0;6255;4873;-1382
1988;23.03.2016;'20 - 21;34,98;29,23;5,75;0;0;0;5622;4910;-712
1989;23.03.2016;'21 - 22;31,43;25,7;5,73;0;0;0;5128;4684;-444
1990;23.03.2016;'22 - 23;25,02;23,29;1,73;0;0;0;4651;4359;-292
1991;23.03.2016;'23 - 24;22,59;22,1;0,49;0;0;0;4015;4098;83
1992;24.03.2016;'00 - 01;22,08;20,76;1,32;0;0;0;3043;4115;1072
1993;24.03.2016;'01 - 02;21,5;19,07;2,43;0;0;0;2641;3862;1221
1994;24.03.2016;'02 - 03;21,11;18,78;2,33;0;0;0;2267;3568;1301
1995;24.03.2016;'03 - 04;21,38;19,95;1,43;0;0;0;1932;3006;1074
1996;24.03.2016;'04 - 05;21,75;21,37;0,38;0;0;0;1645;2508;863
1997;24.03.2016;'05 - 06;22,97;24,48;-1,51;1;1;0;1400;2211;811
1998;24.03.2016;'06 - 07;31,49;27,18;4,31;292;228;-64;1268;1945;677
1999;24.03.2016;'07 - 08;35;30,57;4,43;2139;1770;-369;1218;1734;516
2000;24.03.2016;'08 - 09;34,94;31,84;3,1;5195;4452;-743;1224;1446;222
2001;24.03.2016;'09 - 10;32,4;31,76;0,64;8423;7313;-1110;1286;1386;100
2002;24.03.2016;'10 - 11;31,69;32,73;-1,04;10722;9685;-1037;1505;1598;93
2003;24.03.2016;'11 - 12;31;32,06;-1,06;12082;10209;-1873;1872;2064;192
2004;24.03.2016;'12 - 13;28,62;31,53;-2,91;12372;9628;-2744;2259;2324;65
2005;24.03.2016;'13 - 14;27,27;33,32;-6,05;11388;9156;-2232;2695;2499;-196
2006;24.03.2016;'14 - 15;26,5;30,85;-4,35;9558;8252;-1306;3040;3017;-23
2007;24.03.2016;'15 - 16;25,35;28,75;-3,4;7094;6307;-787;3255;3352;97
2008;24.03.2016;'16 - 17;26,6;27,24;-0,64;4271;3747;-524;3271;3165;-106
2009;24.03.2016;'17 - 18;30;31,09;-1,09;1619;1270;-349;3260;2989;-271
2010;24.03.2016;'18 - 19;32,47;35,68;-3,21;169;80;-89;3439;3318;-121
2011;24.03.2016;'19 - 20;35,18;38,43;-3,25;0;0;0;4080;3782;-298
2012;24.03.2016;'20 - 21;33,97;35,01;-1,04;0;0;0;4846;4380;-466
2013;24.03.2016;'21 - 22;25,96;29,34;-3,38;0;0;0;5852;5371;-481
2014;24.03.2016;'22 - 23;25,06;27,75;-2,69;0;0;0;6771;6147;-624
2015;24.03.2016;'23 - 24;22,52;23,58;-1,06;0;0;0;7501;6473;-1028
2016;25.03.2016;'00 - 01;23,92;27,24;-3,32;0;0;0;7271;6760;-511
2017;25.03.2016;'01 - 02;21,07;26,87;-5,8;0;0;0;7598;7191;-407
2018;25.03.2016;'02 - 03;21;25,24;-4,24;0;0;0;7871;7576;-295
2019;25.03.2016;'03 - 04;20;23,86;-3,86;0;0;0;8168;7928;-240
2020;25.03.2016;'04 - 05;20,01;24,16;-4,15;0;0;0;8526;8205;-321
2021;25.03.2016;'05 - 06;20,3;24,2;-3,9;1;1;0;8888;8536;-352
2022;25.03.2016;'06 - 07;20,26;24,87;-4,61;184;143;-41;9276;9022;-254
2023;25.03.2016;'07 - 08;20,39;24,72;-4,33;1063;995;-68;9685;9242;-443
2024;25.03.2016;'08 - 09;21,85;27,07;-5,22;2336;2622;286;10098;9085;-1013
2025;25.03.2016;'09 - 10;23,85;28,33;-4,48;3543;4061;518;10487;9071;-1416
2026;25.03.2016;'10 - 11;27,26;28,55;-1,29;4266;4793;527;10798;9310;-1488
2027;25.03.2016;'11 - 12;28,91;28,99;-0,08;4542;4918;376;10818;8897;-1921
2028;25.03.2016;'12 - 13;27,87;29,19;-1,32;4279;4570;291;10641;8380;-2261
2029;25.03.2016;'13 - 14;27,06;29,99;-2,93;3636;4060;424;10306;7959;-2347
2030;25.03.2016;'14 - 15;26,01;28,75;-2,74;2925;3328;403;9635;8220;-1415
2031;25.03.2016;'15 - 16;24,44;28,51;-4,07;2204;2529;325;8996;8476;-520
2032;25.03.2016;'16 - 17;23,5;26,58;-3,08;1369;1556;187;8263;7924;-339
2033;25.03.2016;'17 - 18;26,1;27,73;-1,63;554;673;119;7535;6724;-811
2034;25.03.2016;'18 - 19;29,44;32,17;-2,73;72;77;5;6934;5582;-1352
2035;25.03.2016;'19 - 20;33,08;36,39;-3,31;0;0;0;6269;5264;-1005
2036;25.03.2016;'20 - 21;32,95;36,31;-3,36;0;0;0;5766;5614;-152
2037;25.03.2016;'21 - 22;31,48;31,51;-0,03;0;0;0;5372;5792;420
2038;25.03.2016;'22 - 23;30,12;28,81;1,31;0;0;0;4982;5584;602
2039;25.03.2016;'23 - 24;30;26,33;3,67;0;0;0;4734;5084;350
2040;26.03.2016;'00 - 01;28,07;21,54;6,53;0;0;0;4230;4750;520
2041;26.03.2016;'01 - 02;24,08;18,53;5,55;0;0;0;3853;4181;328
2042;26.03.2016;'02 - 03;21,11;17,85;3,26;0;0;0;3638;3718;80
2043;26.03.2016;'03 - 04;20;17,45;2,55;0;0;0;3505;4014;509
2044;26.03.2016;'04 - 05;20;17,37;2,63;0;0;0;3474;4233;759
2045;26.03.2016;'05 - 06;20,01;16,27;3,74;1;1;0;3532;4355;823
2046;26.03.2016;'06 - 07;20,01;15,44;4,57;259;289;30;3603;4456;853
2047;26.03.2016;'07 - 08;21,69;17,12;4,57;1755;2258;503;3754;4620;866
2048;26.03.2016;'08 - 09;22,49;15,69;6,8;4298;6038;1740;3962;4630;668
2049;26.03.2016;'09 - 10;24;13,76;10,24;7540;10671;3131;4241;5142;901
2050;26.03.2016;'10 - 11;21,6;11,44;10,16;10713;14736;4023;4686;6251;1565
2051;26.03.2016;'11 - 12;19,97;9,66;10,31;13228;16504;3276;5235;7200;1965
2052;26.03.2016;'12 - 13;19,06;8,91;10,15;14864;16838;1974;5886;8205;2319
2053;26.03.2016;'13 - 14;18,07;7,87;10,2;15577;16934;1357;6639;8666;2027
2054;26.03.2016;'14 - 15;16,28;6,44;9,84;14629;16323;1694;7484;9407;1923
2055;26.03.2016;'15 - 16;15,75;1,75;14;11728;13501;1773;8414;10562;2148
2056;26.03.2016;'16 - 17;15,85;4,82;11,03;7382;8516;1134;9216;11784;2568
2057;26.03.2016;'17 - 18;19,39;7,71;11,68;2900;3392;492;10308;11993;1685
2058;26.03.2016;'18 - 19;21,32;13,04;8,28;363;358;-5;11956;13292;1336
2059;26.03.2016;'19 - 20;22,12;17,34;4,78;0;0;0;13915;16552;2637
2060;26.03.2016;'20 - 21;20,75;14,6;6,15;0;0;0;15498;19180;3682
2061;26.03.2016;'21 - 22;17,99;11,14;6,85;0;0;0;16819;20902;4083
2062;26.03.2016;'22 - 23;17,91;9,69;8,22;0;0;0;17752;20958;3206
2063;26.03.2016;'23 - 24;14,66;6,53;8,13;0;0;0;18038;20875;2837
2064;27.03.2016;'00 - 01;7,33;-2,69;10,02;0;0;0;19274;20100;826
2065;27.03.2016;'01 - 02;3,04;-11,42;14,46;0;0;0;19459;20214;755
2066;27.03.2016;'02 - 03;0;0;0;0;0;0;0;0;0
2067;27.03.2016;'03 - 04;6,1;-6,32;12,42;0;0;0;19877;20679;802
2068;27.03.2016;'04 - 05;4,02;-4,01;8,03;0;0;0;19972;21346;1374
2069;27.03.2016;'05 - 06;4,02;-2,25;6,27;0;0;0;19604;21778;2174
2070;27.03.2016;'06 - 07;0,91;-6,75;7,66;8;3;-5;18899;21626;2727
2071;27.03.2016;'07 - 08;4,63;-3,33;7,96;631;676;45;17839;21001;3162
2072;27.03.2016;'08 - 09;7,5;5,89;1,61;3434;3699;265;16599;20734;4135
2073;27.03.2016;'09 - 10;8,91;6,08;2,83;7367;7236;-131;15631;20146;4515
2074;27.03.2016;'10 - 11;10,99;7,52;3,47;10479;9322;-1157;15192;19997;4805
2075;27.03.2016;'11 - 12;11,16;13,55;-2,39;11881;10688;-1193;14964;19756;4792
2076;27.03.2016;'12 - 13;11,49;12,25;-0,76;12219;11791;-428;15401;19894;4493
2077;27.03.2016;'13 - 14;9,19;7,26;1,93;11756;12359;603;15680;19627;3947
2078;27.03.2016;'14 - 15;6,49;1,82;4,67;10590;10633;43;14969;19492;4523
2079;27.03.2016;'15 - 16;6,92;2,32;4,6;8880;8760;-120;13745;18571;4826
2080;27.03.2016;'16 - 17;7,47;-2,22;9,69;6773;6758;-15;12440;16304;3864
2081;27.03.2016;'17 - 18;13,06;1,67;11,39;4375;4434;59;11095;13615;2520
2082;27.03.2016;'18 - 19;14,94;7,8;7,14;1907;1924;17;9795;11676;1881
2083;27.03.2016;'19 - 20;19,6;14,16;5,44;260;241;-19;9001;10553;1552
2084;27.03.2016;'20 - 21;22,86;15,73;7,13;0;0;0;9235;10964;1729
2085;27.03.2016;'21 - 22;20,36;12,52;7,84;0;0;0;9991;12394;2403
2086;27.03.2016;'22 - 23;19,98;13,25;6,73;0;0;0;10802;13927;3125
2087;27.03.2016;'23 - 24;18,5;10,92;7,58;0;0;0;11381;14613;3232
2088;28.03.2016;'00 - 01;12,88;3,98;8,9;0;0;0;12187;14458;2271
2089;28.03.2016;'01 - 02;8,28;1,97;6,31;0;0;0;12291;14498;2207
2090;28.03.2016;'02 - 03;7,43;1,18;6,25;0;0;0;12437;14758;2321
2091;28.03.2016;'03 - 04;6,5;1,22;5,28;0;0;0;12865;15337;2472
2092;28.03.2016;'04 - 05;5,27;1,53;3,74;0;0;0;13496;16098;2602
2093;28.03.2016;'05 - 06;6,28;1,49;4,79;0;0;0;14344;17234;2890
2094;28.03.2016;'06 - 07;5,86;-1,92;7,78;41;6;-35;15429;18870;3441
2095;28.03.2016;'07 - 08;5,96;-0,29;6,25;901;732;-169;16548;20410;3862
2096;28.03.2016;'08 - 09;3,99;-4,66;8,65;4341;4250;-91;17254;20967;3713
2097;28.03.2016;'09 - 10;3,41;-7,73;11,14;8772;8803;31;17710;20476;2766
2098;28.03.2016;'10 - 11;2,68;-13,11;15,79;12295;11635;-660;18654;22381;3727
2099;28.03.2016;'11 - 12;0,07;-14,37;14,44;14044;12813;-1231;20445;25916;5471
2100;28.03.2016;'12 - 13;-4,01;-52,46;48,45;14251;12404;-1847;22790;26255;3465
2101;28.03.2016;'13 - 14;-28,68;-86,78;58,1;13116;11171;-1945;24834;26540;1706
2102;28.03.2016;'14 - 15;-38,45;-84,31;45,86;11114;9986;-1128;26129;26848;719
2103;28.03.2016;'15 - 16;-19,92;-72,47;52,55;8741;8132;-609;26505;26728;223
2104;28.03.2016;'16 - 17;-13,82;-24,29;10,47;6401;6314;-87;26142;25608;-534
2105;28.03.2016;'17 - 18;-4,2;2,64;-6,84;4051;4681;630;25222;23787;-1435
2106;28.03.2016;'18 - 19;7,45;16,29;-8,84;1804;2120;316;24100;21076;-3024
2107;28.03.2016;'19 - 20;11,79;25,55;-13,76;272;228;-44;22817;19281;-3536
2108;28.03.2016;'20 - 21;17,02;30,48;-13,46;1;0;-1;21290;18317;-2973
2109;28.03.2016;'21 - 22;11,47;26,85;-15,38;0;0;0;20139;18182;-1957
2110;28.03.2016;'22 - 23;16,29;26,48;-10,19;0;0;0;19170;17887;-1283
2111;28.03.2016;'23 - 24;12,98;24,15;-11,17;0;0;0;18404;18139;-265
2112;29.03.2016;'00 - 01;11,51;20,27;-8,76;0;0;0;17913;18057;144
2113;29.03.2016;'01 - 02;9,14;16,69;-7,55;0;0;0;17646;17628;-18
2114;29.03.2016;'02 - 03;11,95;17,09;-5,14;0;0;0;17313;17891;578
2115;29.03.2016;'03 - 04;9,23;14,79;-5,56;0;0;0;17249;18539;1290
2116;29.03.2016;'04 - 05;8,3;13,63;-5,33;0;0;0;17342;18767;1425
2117;29.03.2016;'05 - 06;13,49;17,16;-3,67;0;0;0;17511;18894;1383
2118;29.03.2016;'06 - 07;25,35;24,66;0,69;32;6;-26;17807;20168;2361
2119;29.03.2016;'07 - 08;31,52;29,92;1,6;656;538;-118;18191;20440;2249
2120;29.03.2016;'08 - 09;31,43;31,7;-0,27;3035;3127;92;18958;20617;1659
2121;29.03.2016;'09 - 10;26,37;27,7;-1,33;6555;6980;425;20121;21470;1349
2122;29.03.2016;'10 - 11;21,76;22,28;-0,52;10418;10031;-387;21176;22934;1758
2123;29.03.2016;'11 - 12;21,06;21,05;0,01;13399;12194;-1205;21892;23295;1403
2124;29.03.2016;'12 - 13;20,43;22,54;-2,11;15172;13600;-1572;21852;22808;956
2125;29.03.2016;'13 - 14;19,99;21,21;-1,22;15649;14140;-1509;21488;22426;938
2126;29.03.2016;'14 - 15;19,08;18,14;0,94;14944;14326;-618;20943;22161;1218
2127;29.03.2016;'15 - 16;19,05;15,91;3,14;12880;12979;99;20105;21784;1679
2128;29.03.2016;'16 - 17;19,14;16,71;2,43;9847;9937;90;18939;20518;1579
2129;29.03.2016;'17 - 18;21,48;20,07;1,41;6214;6184;-30;17342;17518;176
2130;29.03.2016;'18 - 19;30,07;29,37;0,7;2625;2622;-3;14992;14027;-965
2131;29.03.2016;'19 - 20;35,79;36,74;-0,95;408;317;-91;12831;10890;-1941
2132;29.03.2016;'20 - 21;39,54;42,85;-3,31;2;0;-2;11629;9666;-1963
2133;29.03.2016;'21 - 22;32,64;33,43;-0,79;0;0;0;11387;9137;-2250
2134;29.03.2016;'22 - 23;28,56;34,16;-5,6;0;0;0;11531;9057;-2474
2135;29.03.2016;'23 - 24;22,72;28,98;-6,26;0;0;0;11700;9103;-2597
2136;30.03.2016;'00 - 01;24,9;26,57;-1,67;0;0;0;10930;9621;-1309
2137;30.03.2016;'01 - 02;22;22,93;-0,93;0;0;0;11015;10971;-44
2138;30.03.2016;'02 - 03;20,87;20,79;0,08;0;0;0;11080;12004;924
2139;30.03.2016;'03 - 04;19,92;19,47;0,45;0;0;0;11359;12499;1140
2140;30.03.2016;'04 - 05;20,18;19,53;0,65;0;0;0;11405;12431;1026
2141;30.03.2016;'05 - 06;21,65;20,54;1,11;0;0;0;11709;13270;1561
2142;30.03.2016;'06 - 07;29,6;24,75;4,85;7;4;-3;12445;13746;1301
2143;30.03.2016;'07 - 08;29,89;23,38;6,51;356;300;-56;13181;14271;1090
2144;30.03.2016;'08 - 09;27,95;24,53;3,42;1718;1332;-386;13773;14322;549
2145;30.03.2016;'09 - 10;31,93;27,08;4,85;3683;3390;-293;14495;14660;165
2146;30.03.2016;'10 - 11;29,65;28,72;0,93;5873;5734;-139;15442;15518;76
2147;30.03.2016;'11 - 12;27,16;24,48;2,68;7778;8099;321;16054;16181;127
2148;30.03.2016;'12 - 13;26,89;24,51;2,38;9189;9378;189;16211;16432;221
2149;30.03.2016;'13 - 14;22,25;23,05;-0,8;9677;9381;-296;16253;16617;364
2150;30.03.2016;'14 - 15;22,3;23,62;-1,32;9584;9227;-357;15735;16251;516
2151;30.03.2016;'15 - 16;22,23;23,36;-1,13;8766;8666;-100;14412;15396;984
2152;30.03.2016;'16 - 17;25,64;22,34;3,3;7147;7338;191;12807;14810;2003
2153;30.03.2016;'17 - 18;29,04;23,89;5,15;4781;4791;10;10928;13818;2890
2154;30.03.2016;'18 - 19;31,9;26,57;5,33;2111;1995;-116;8903;11789;2886
2155;30.03.2016;'19 - 20;37,42;28,18;9,24;325;252;-73;7165;9809;2644
2156;30.03.2016;'20 - 21;37;29;8;0;0;0;6356;9169;2813
2157;30.03.2016;'21 - 22;34,65;28,83;5,82;0;0;0;6146;8236;2090
2158;30.03.2016;'22 - 23;30,38;25,93;4,45;0;0;0;5868;7348;1480
2159;30.03.2016;'23 - 24;27,25;23,65;3,6;0;0;0;5462;6666;1204
2160;31.03.2016;'00 - 01;23,34;24,2;-0,86;0;0;0;5629;6192;563
2161;31.03.2016;'01 - 02;22,27;23,63;-1,36;0;0;0;4998;5459;461
2162;31.03.2016;'02 - 03;21,5;23,22;-1,72;0;0;0;4369;4604;235
2163;31.03.2016;'03 - 04;21,11;22,04;-0,93;0;0;0;3801;4248;447
2164;31.03.2016;'04 - 05;21,29;20,44;0,85;0;0;0;3156;3786;630
2165;31.03.2016;'05 - 06;22,86;24,37;-1,51;0;0;0;2524;3125;601
2166;31.03.2016;'06 - 07;29,08;33,45;-4,37;14;8;-6;2011;2719;708
2167;31.03.2016;'07 - 08;36,09;36,98;-0,89;650;526;-124;1661;2264;603
2168;31.03.2016;'08 - 09;40,96;34,75;6,21;2907;2622;-285;1466;1757;291
2169;31.03.2016;'09 - 10;36,46;33,1;3,36;6061;5980;-81;1323;1441;118
2170;31.03.2016;'10 - 11;34,64;31,52;3,12;9338;9288;-50;1291;1487;196
2171;31.03.2016;'11 - 12;33,95;31,01;2,94;11855;11718;-137;1442;1824;382
2172;31.03.2016;'12 - 13;30,03;30,13;-0,1;12884;13532;648;1733;2258;525
2173;31.03.2016;'13 - 14;30,03;26,69;3,34;12287;13638;1351;2018;2776;758
2174;31.03.2016;'14 - 15;27,92;24,23;3,69;10870;12471;1601;2483;3538;1055
2175;31.03.2016;'15 - 16;25,12;23,85;1,27;8841;9418;577;3221;4424;1203
2176;31.03.2016;'16 - 17;24,73;25,97;-1,24;6296;5804;-492;4028;5046;1018
2177;31.03.2016;'17 - 18;24,93;29,2;-4,27;3630;2931;-699;4872;5363;491
2178;31.03.2016;'18 - 19;27,44;33,02;-5,58;1479;1192;-287;5539;6166;627
2179;31.03.2016;'19 - 20;31,07;34,72;-3,65;238;152;-86;6121;6971;850
2180;31.03.2016;'20 - 21;31,99;32,77;-0,78;0;1;1;6633;7539;906
2181;31.03.2016;'21 - 22;25,35;29,59;-4,24;0;0;0;7027;8048;1021
2182;31.03.2016;'22 - 23;25,23;27,17;-1,94;0;0;0;7438;8486;1048
2183;31.03.2016;'23 - 24;23,22;25,01;-1,79;0;0;0;7738;9017;1279
2184;01.04.2016;'00 - 01;21,35;21,01;0,34;0;0;0;7964;9337;1373
2185;01.04.2016;'01 - 02;20,98;22,51;-1,53;0;0;0;8049;9045;996
2186;01.04.2016;'02 - 03;21,19;23,92;-2,73;0;0;0;7739;8336;597
2187;01.04.2016;'03 - 04;20,64;24,34;-3,7;0;0;0;7177;7564;387
2188;01.04.2016;'04 - 05;21,13;23,61;-2,48;0;0;0;6605;6520;-85
2189;01.04.2016;'05 - 06;21,78;24,3;-2,52;0;0;0;6082;5500;-582
2190;01.04.2016;'06 - 07;29,73;30,79;-1,06;19;7;-12;5557;4812;-745
2191;01.04.2016;'07 - 08;36,5;37,66;-1,16;674;512;-162;4906;4422;-484
2192;01.04.2016;'08 - 09;40,44;43,57;-3,13;3042;2383;-659;4001;3469;-532
2193;01.04.2016;'09 - 10;38,39;39;-0,61;6299;5325;-974;3046;2592;-454
2194;01.04.2016;'10 - 11;34,57;35,81;-1,24;9691;8722;-969;2385;2303;-82
2195;01.04.2016;'11 - 12;30,55;29,95;0,6;12292;11605;-687;2098;2070;-28
2196;01.04.2016;'12 - 13;25,79;24,24;1,55;13814;13433;-381;1958;2126;168
2197;01.04.2016;'13 - 14;23,09;24,11;-1,02;14561;14210;-351;1988;2175;187
2198;01.04.2016;'14 - 15;23,13;25,1;-1,97;14594;14310;-284;2017;1965;-52
2199;01.04.2016;'15 - 16;23;24,17;-1,17;13301;13398;97;1977;1736;-241
2200;01.04.2016;'16 - 17;22,45;22,4;0,05;10665;10814;149;2000;1518;-482
2201;01.04.2016;'17 - 18;24,28;23,64;0,64;6724;7167;443;2100;1373;-727
2202;01.04.2016;'18 - 19;31,91;28,83;3,08;2786;3104;318;2132;1327;-805
2203;01.04.2016;'19 - 20;33,9;30,49;3,41;425;442;17;2450;1443;-1007
2204;01.04.2016;'20 - 21;35,85;32,59;3,26;1;2;1;3638;2157;-1481
2205;01.04.2016;'21 - 22;31,3;31,91;-0,61;0;0;0;5073;3520;-1553
2206;01.04.2016;'22 - 23;24,33;25,28;-0,95;0;0;0;6197;5425;-772
2207;01.04.2016;'23 - 24;26,03;25,86;0,17;0;0;0;7383;7111;-272
2208;02.04.2016;'00 - 01;21,82;21,89;-0,07;0;0;0;7691;8309;618
2209;02.04.2016;'01 - 02;21,31;23,35;-2,04;0;0;0;8465;8777;312
2210;02.04.2016;'02 - 03;21,1;21,81;-0,71;0;0;0;9341;9145;-196
2211;02.04.2016;'03 - 04;19,84;22,02;-2,18;0;0;0;9895;9690;-205
2212;02.04.2016;'04 - 05;19,91;22,08;-2,17;0;0;0;10307;10372;65
2213;02.04.2016;'05 - 06;20,09;21,98;-1,89;0;0;0;10693;10614;-79
2214;02.04.2016;'06 - 07;20,19;21,2;-1,01;45;21;-24;10893;10344;-549
2215;02.04.2016;'07 - 08;22,29;23,55;-1,26;1328;1097;-231;10853;9761;-1092
2216;02.04.2016;'08 - 09;22,51;23,8;-1,29;5618;4554;-1064;9840;8520;-1320
2217;02.04.2016;'09 - 10;22,04;27,93;-5,89;11251;9060;-2191;7743;6305;-1438
2218;02.04.2016;'10 - 11;20,81;26,05;-5,24;16647;13742;-2905;6557;5492;-1065
2219;02.04.2016;'11 - 12;19,55;27,12;-7,57;20604;17358;-3246;6535;5321;-1214
2220;02.04.2016;'12 - 13;18,12;25,01;-6,89;22832;19202;-3630;6605;4983;-1622
2221;02.04.2016;'13 - 14;17,06;24,05;-6,99;23360;19707;-3653;6679;5068;-1611
2222;02.04.2016;'14 - 15;14,06;22,02;-7,96;22364;18402;-3962;6744;5416;-1328
2223;02.04.2016;'15 - 16;16,05;22,52;-6,47;19546;15636;-3910;6639;5184;-1455
2224;02.04.2016;'16 - 17;18,73;23,76;-5,03;15103;12010;-3093;6392;4968;-1424
2225;02.04.2016;'17 - 18;20,12;25,84;-5,72;9350;7333;-2017;5970;4732;-1238
2226;02.04.2016;'18 - 19;23,41;32,24;-8,83;3800;2929;-871;6020;4075;-1945
2227;02.04.2016;'19 - 20;28,2;35,08;-6,88;605;423;-182;6838;4345;-2493
2228;02.04.2016;'20 - 21;30,43;39,34;-8,91;3;2;-1;8628;6076;-2552
2229;02.04.2016;'21 - 22;30,1;35,88;-5,78;0;0;0;10516;7870;-2646
2230;02.04.2016;'22 - 23;26,79;30,51;-3,72;0;0;0;11655;9075;-2580
2231;02.04.2016;'23 - 24;21,43;23,61;-2,18;0;0;0;11765;9406;-2359
2232;03.04.2016;'00 - 01;19,59;18,93;0,66;0;0;0;8986;9420;434
2233;03.04.2016;'01 - 02;18,07;17,43;0,64;0;0;0;8793;8880;87
2234;03.04.2016;'02 - 03;17,5;14,94;2,56;0;0;0;8500;8176;-324
2235;03.04.2016;'03 - 04;15,29;13,65;1,64;0;0;0;8326;7542;-784
2236;03.04.2016;'04 - 05;15,68;13,91;1,77;0;0;0;8385;7151;-1234
2237;03.04.2016;'05 - 06;15,59;14,06;1,53;0;0;0;8482;7003;-1479
2238;03.04.2016;'06 - 07;13,32;12,01;1,31;42;21;-21;8590;6588;-2002
2239;03.04.2016;'07 - 08;14,6;13,78;0,82;1119;984;-135;8615;6624;-1991
2240;03.04.2016;'08 - 09;17,48;16,94;0,54;4411;3711;-700;8024;6134;-1890
2241;03.04.2016;'09 - 10;18,55;19,18;-0,63;8504;7481;-1023;6563;5306;-1257
2242;03.04.2016;'10 - 11;17,36;17,47;-0,11;12491;11599;-892;5421;3879;-1542
2243;03.04.2016;'11 - 12;17,67;16,27;1,4;15515;14799;-716;4763;3340;-1423
2244;03.04.2016;'12 - 13;15,48;15,01;0,47;17220;17055;-165;4407;3158;-1249
2245;03.04.2016;'13 - 14;14,8;7,5;7,3;17498;17806;308;4144;3169;-975
2246;03.04.2016;'14 - 15;12,75;6,29;6,46;16537;16825;288;3756;3260;-496
2247;03.04.2016;'15 - 16;12,18;6,58;5,6;14187;14279;92;3254;2941;-313
2248;03.04.2016;'16 - 17;13,02;7,53;5,49;10802;10636;-166;2762;2214;-548
2249;03.04.2016;'17 - 18;15,77;12,47;3,3;6715;6447;-268;2384;1734;-650
2250;03.04.2016;'18 - 19;21,19;22,78;-1,59;2831;2588;-243;2375;1393;-982
2251;03.04.2016;'19 - 20;23,15;25,63;-2,48;470;376;-94;2585;1795;-790
2252;03.04.2016;'20 - 21;25,28;27,66;-2,38;2;2;0;3047;2414;-633
2253;03.04.2016;'21 - 22;25,01;25,64;-0,63;0;0;0;3646;3172;-474
2254;03.04.2016;'22 - 23;24,32;22,7;1,62;0;0;0;4273;3634;-639
2255;03.04.2016;'23 - 24;20,9;21,43;-0,53;0;0;0;4881;4076;-805
2256;04.04.2016;'00 - 01;21;20,34;0,66;0;0;0;3724;4343;619
2257;04.04.2016;'01 - 02;19,59;19,02;0,57;0;0;0;3961;4703;742
2258;04.04.2016;'02 - 03;19,15;18,07;1,08;0;0;0;4124;5100;976
2259;04.04.2016;'03 - 04;18,75;15,65;3,1;0;0;0;4398;5286;888
2260;04.04.2016;'04 - 05;18,72;16,4;2,32;0;0;0;4714;6131;1417
2261;04.04.2016;'05 - 06;20,39;19,13;1,26;0;0;0;5071;6878;1807
2262;04.04.2016;'06 - 07;29,1;26,08;3,02;34;20;-14;5450;7641;2191
2263;04.04.2016;'07 - 08;34,19;29,25;4,94;835;746;-89;5865;8381;2516
2264;04.04.2016;'08 - 09;35,42;29,88;5,54;3360;3028;-332;6019;8099;2080
2265;04.04.2016;'09 - 10;33,5;25,88;7,62;6865;6382;-483;5814;7678;1864
2266;04.04.2016;'10 - 11;29,62;22,97;6,65;10320;10620;300;5614;7292;1678
2267;04.04.2016;'11 - 12;25,1;22,01;3,09;13115;13634;519;5576;7381;1805
2268;04.04.2016;'12 - 13;23,37;21,5;1,87;14930;15506;576;5603;7746;2143
2269;04.04.2016;'13 - 14;23,83;19,9;3,93;15335;16366;1031;5610;7931;2321
2270;04.04.2016;'14 - 15;23,93;19,25;4,68;14743;15337;594;5548;7473;1925
2271;04.04.2016;'15 - 16;23,04;19,39;3,65;13020;12967;-53;5201;7716;2515
2272;04.04.2016;'16 - 17;27,42;20,65;6,77;10190;10030;-160;4729;7099;2370
2273;04.04.2016;'17 - 18;29,25;24,44;4,81;6496;6377;-119;4167;6488;2321
2274;04.04.2016;'18 - 19;32,96;27,62;5,34;2822;2856;34;3627;5118;1491
2275;04.04.2016;'19 - 20;35,05;29,43;5,62;476;478;2;3018;3300;282
2276;04.04.2016;'20 - 21;36,1;31,52;4,58;2;5;3;2721;3092;371
2277;04.04.2016;'21 - 22;35,6;30,2;5,4;0;0;0;2627;2344;-283
2278;04.04.2016;'22 - 23;30,3;29,01;1,29;0;0;0;2628;2014;-614
2279;04.04.2016;'23 - 24;25,96;22,73;3,23;0;0;0;2644;2031;-613
2280;05.04.2016;'00 - 01;21,39;22,3;-0,91;0;0;0;2525;2600;75
2281;05.04.2016;'01 - 02;20,8;20,01;0,79;0;0;0;2793;3456;663
2282;05.04.2016;'02 - 03;20,76;17,79;2,97;0;0;0;2973;3913;940
2283;05.04.2016;'03 - 04;20,31;17,64;2,67;0;0;0;3037;4388;1351
2284;05.04.2016;'04 - 05;20,34;20,11;0,23;0;0;0;3074;4818;1744
2285;05.04.2016;'05 - 06;21,79;23,1;-1,31;0;0;0;3137;4646;1509
2286;05.04.2016;'06 - 07;27,84;36,1;-8,26;45;26;-19;3247;4356;1109
2287;05.04.2016;'07 - 08;32,76;42,42;-9,66;1043;1047;4;3374;4187;813
2288;05.04.2016;'08 - 09;35,18;43,58;-8,4;3811;3841;30;3420;3558;138
2289;05.04.2016;'09 - 10;34,92;39,32;-4,4;7226;7470;244;3253;2715;-538
2290;05.04.2016;'10 - 11;34,1;36,43;-2,33;10455;10836;381;3114;2457;-657
2291;05.04.2016;'11 - 12;32,93;32,93;0;12815;12521;-294;3230;2467;-763
2292;05.04.2016;'12 - 13;29,52;29,78;-0,26;13942;13379;-563;3604;2782;-822
2293;05.04.2016;'13 - 14;26,58;28,18;-1,6;13514;13266;-248;3977;3032;-945
2294;05.04.2016;'14 - 15;24,74;27,44;-2,7;11984;12194;210;4330;3411;-919
2295;05.04.2016;'15 - 16;24,19;26;-1,81;9919;9916;-3;4578;3864;-714
2296;05.04.2016;'16 - 17;23,96;24,09;-0,13;7321;6932;-389;4971;4672;-299
2297;05.04.2016;'17 - 18;27,05;24,55;2,5;4371;4014;-357;5412;5460;48
2298;05.04.2016;'18 - 19;29,79;26,8;2,99;1788;1636;-152;5948;6552;604
2299;05.04.2016;'19 - 20;30,66;26,49;4,17;316;266;-50;6652;7260;608
2300;05.04.2016;'20 - 21;30,04;26,58;3,46;2;4;2;7341;8149;808
2301;05.04.2016;'21 - 22;28;23,83;4,17;0;0;0;8219;9798;1579
2302;05.04.2016;'22 - 23;25,32;20,02;5,3;0;0;0;9364;12306;2942
2303;05.04.2016;'23 - 24;21,97;18,08;3,89;0;0;0;10325;13478;3153
2304;06.04.2016;'00 - 01;20;15,35;4,65;0;0;0;10369;13202;2833
2305;06.04.2016;'01 - 02;19,2;15,49;3,71;0;0;0;11304;12987;1683
2306;06.04.2016;'02 - 03;19,06;15,45;3,61;0;0;0;11845;12948;1103
2307;06.04.2016;'03 - 04;18,95;14,11;4,84;0;0;0;11977;13080;1103
2308;06.04.2016;'04 - 05;19,02;14,66;4,36;0;0;0;11981;12663;682
2309;06.04.2016;'05 - 06;20;15,89;4,11;0;0;0;11948;12534;586
2310;06.04.2016;'06 - 07;24,33;19,1;5,23;36;28;-8;11874;12256;382
2311;06.04.2016;'07 - 08;32,97;31,56;1,41;885;904;19;11927;12405;478
2312;06.04.2016;'08 - 09;34,24;35,17;-0,93;3456;3732;276;12268;12273;5
2313;06.04.2016;'09 - 10;25,98;29,6;-3,62;6797;7747;950;13006;13004;-2
2314;06.04.2016;'10 - 11;23,24;23,23;0,01;10174;11372;1198;14020;15501;1481
2315;06.04.2016;'11 - 12;21,97;19;2,97;12803;13334;531;15029;18396;3367
2316;06.04.2016;'12 - 13;21,25;17,25;4;14145;13839;-306;16003;19794;3791
2317;06.04.2016;'13 - 14;20,02;16,7;3,32;14058;14081;23;16952;20337;3385
2318;06.04.2016;'14 - 15;19,75;16,74;3,01;12951;13312;361;17690;20982;3292
2319;06.04.2016;'15 - 16;19,85;14,86;4,99;10942;12258;1316;18030;21509;3479
2320;06.04.2016;'16 - 17;20,09;14,85;5,24;8593;10102;1509;17975;21483;3508
2321;06.04.2016;'17 - 18;21,59;16,88;4,71;5624;6730;1106;17320;20376;3056
2322;06.04.2016;'18 - 19;23,1;16,68;6,42;2470;3162;692;16280;18746;2466
2323;06.04.2016;'19 - 20;26,71;20,18;6,53;419;519;100;15481;16718;1237
2324;06.04.2016;'20 - 21;28,26;22,65;5,61;4;3;-1;15302;16738;1436
2325;06.04.2016;'21 - 22;23,23;20,24;2,99;0;0;0;16117;19056;2939
2326;06.04.2016;'22 - 23;21,06;18,07;2,99;0;0;0;17429;20656;3227
2327;06.04.2016;'23 - 24;19,01;11,56;7,45;0;0;0;18535;21232;2697
2328;07.04.2016;'00 - 01;16,42;10,47;5,95;0;0;0;18932;21052;2120
2329;07.04.2016;'01 - 02;16;7,04;8,96;0;0;0;19021;20598;1577
2330;07.04.2016;'02 - 03;13,46;8,79;4,67;0;0;0;18937;19468;531
2331;07.04.2016;'03 - 04;12,57;7,72;4,85;0;0;0;18816;18646;-170
2332;07.04.2016;'04 - 05;13,49;11,32;2,17;0;0;0;18629;16999;-1630
2333;07.04.2016;'05 - 06;17,37;19,74;-2,37;0;0;0;18304;15714;-2590
2334;07.04.2016;'06 - 07;22,62;31,56;-8,94;53;38;-15;18071;14815;-3256
2335;07.04.2016;'07 - 08;28,4;35,12;-6,72;1057;1031;-26;17963;13937;-4026
2336;07.04.2016;'08 - 09;31,31;37,86;-6,55;3876;3620;-256;18448;13868;-4580
2337;07.04.2016;'09 - 10;26,33;35,29;-8,96;7193;6400;-793;19452;15409;-4043
2338;07.04.2016;'10 - 11;21,55;28,13;-6,58;10164;8919;-1245;20292;17068;-3224
2339;07.04.2016;'11 - 12;21,56;28,6;-7,04;12151;10722;-1429;20516;18131;-2385
2340;07.04.2016;'12 - 13;22,32;25,9;-3,58;13250;11392;-1858;19915;18363;-1552
2341;07.04.2016;'13 - 14;21,6;24,52;-2,92;13397;11719;-1678;19006;17818;-1188
2342;07.04.2016;'14 - 15;22,57;24,48;-1,91;12728;11688;-1040;17916;17505;-411
2343;07.04.2016;'15 - 16;21,86;23,37;-1,51;11210;10858;-352;16757;17178;421
2344;07.04.2016;'16 - 17;21,94;21,86;0,08;8928;9082;154;15415;16397;982
2345;07.04.2016;'17 - 18;22,73;22,9;-0,17;5953;6250;297;13715;14968;1253
2346;07.04.2016;'18 - 19;28,59;28,9;-0,31;2722;2962;240;11571;12939;1368
2347;07.04.2016;'19 - 20;31,11;30,02;1,09;520;560;40;9712;10330;618
2348;07.04.2016;'20 - 21;32,68;31,52;1,16;9;6;-3;8882;9924;1042
2349;07.04.2016;'21 - 22;29,41;28,51;0,9;0;0;0;8914;9688;774
2350;07.04.2016;'22 - 23;28,27;27,09;1,18;0;0;0;9251;9479;228
2351;07.04.2016;'23 - 24;23,54;23,03;0,51;0;0;0;9356;9393;37
2352;08.04.2016;'00 - 01;23,39;24,73;-1,34;0;0;0;8917;9159;242
2353;08.04.2016;'01 - 02;21,69;24,17;-2,48;0;0;0;8608;8603;-5
2354;08.04.2016;'02 - 03;21,18;22,49;-1,31;0;0;0;8065;8354;289
2355;08.04.2016;'03 - 04;20,52;22,16;-1,64;0;0;0;7409;8143;734
2356;08.04.2016;'04 - 05;21,04;21,88;-0,84;0;0;0;6830;7989;1159
2357;08.04.2016;'05 - 06;21,72;21,4;0,32;0;0;0;6224;7144;920
2358;08.04.2016;'06 - 07;29,12;27,53;1,59;60;45;-15;5625;6160;535
2359;08.04.2016;'07 - 08;35;29,47;5,53;1154;1152;-2;4972;5345;373
2360;08.04.2016;'08 - 09;38,2;34,64;3,56;4176;4406;230;4189;4318;129
2361;08.04.2016;'09 - 10;37,55;31,05;6,5;7825;8662;837;3507;3518;11
2362;08.04.2016;'10 - 11;34,22;27,16;7,06;11005;12309;1304;3162;3780;618
2363;08.04.2016;'11 - 12;32,96;25,3;7,66;13050;14936;1886;3011;4242;1231
2364;08.04.2016;'12 - 13;29,74;23,68;6,06;14020;15395;1375;2953;4041;1088
2365;08.04.2016;'13 - 14;27,9;23,88;4,02;13995;14385;390;2895;3764;869
2366;08.04.2016;'14 - 15;26,36;25,71;0,65;13054;12910;-144;2743;3510;767
2367;08.04.2016;'15 - 16;24,66;23,86;0,8;11209;10967;-242;2382;3098;716
2368;08.04.2016;'16 - 17;23,95;25,23;-1,28;8621;8534;-87;1959;2574;615
2369;08.04.2016;'17 - 18;27,03;26,46;0,57;5584;5563;-21;1530;2211;681
2370;08.04.2016;'18 - 19;29,58;28,21;1,37;2564;2770;206;1117;1744;627
2371;08.04.2016;'19 - 20;32,22;29,26;2,96;490;582;92;824;1170;346
2372;08.04.2016;'20 - 21;31,96;30,64;1,32;8;8;0;697;930;233
2373;08.04.2016;'21 - 22;30,66;29,4;1,26;0;0;0;683;942;259
2374;08.04.2016;'22 - 23;30,68;29,4;1,28;0;0;0;699;1078;379
2375;08.04.2016;'23 - 24;29;27,54;1,46;0;0;0;752;1300;548
2376;09.04.2016;'00 - 01;28,45;24,34;4,11;0;0;0;773;1383;610
2377;09.04.2016;'01 - 02;24,18;22,34;1,84;0;0;0;799;1533;734
2378;09.04.2016;'02 - 03;23,28;21,98;1,3;0;0;0;810;1467;657
2379;09.04.2016;'03 - 04;21,84;19,97;1,87;0;0;0;820;1367;547
2380;09.04.2016;'04 - 05;21,46;19,63;1,83;0;0;0;862;1194;332
2381;09.04.2016;'05 - 06;21,72;19,18;2,54;0;0;0;904;1008;104
2382;09.04.2016;'06 - 07;22,42;20,13;2,29;90;61;-29;941;1033;92
2383;09.04.2016;'07 - 08;23,42;21,66;1,76;1514;1374;-140;968;1236;268
2384;09.04.2016;'08 - 09;27,21;22,94;4,27;5295;5010;-285;938;1240;302
2385;09.04.2016;'09 - 10;25,12;22,76;2,36;9826;9427;-399;871;809;-62
2386;09.04.2016;'10 - 11;22,76;22,56;0,2;13452;13222;-230;892;805;-87
2387;09.04.2016;'11 - 12;22,58;22,82;-0,24;15655;15233;-422;1032;1174;142
2388;09.04.2016;'12 - 13;21,83;22,93;-1,1;16470;15808;-662;1239;1507;268
2389;09.04.2016;'13 - 14;20,81;21,23;-0,42;15692;14813;-879;1433;1466;33
2390;09.04.2016;'14 - 15;19,94;21,08;-1,14;13777;12956;-821;1568;1394;-174
2391;09.04.2016;'15 - 16;20,35;21,33;-0,98;11262;10663;-599;1672;1392;-280
2392;09.04.2016;'16 - 17;20,3;21,07;-0,77;8413;7968;-445;1791;1706;-85
2393;09.04.2016;'17 - 18;22,27;20,33;1,94;5290;5160;-130;2133;2471;338
2394;09.04.2016;'18 - 19;26,91;23,07;3,84;2405;2664;259;2881;3309;428
2395;09.04.2016;'19 - 20;29,62;24,82;4,8;463;577;114;3863;4153;290
2396;09.04.2016;'20 - 21;31,81;26,34;5,47;8;10;2;5139;5794;655
2397;09.04.2016;'21 - 22;29,56;26,07;3,49;0;0;0;6402;7698;1296
2398;09.04.2016;'22 - 23;27,44;24,86;2,58;0;0;0;7420;8572;1152
2399;09.04.2016;'23 - 24;24;20,61;3,39;0;0;0;7902;9009;1107
2400;10.04.2016;'00 - 01;21,13;18,8;2,33;0;0;0;8350;8874;524
2401;10.04.2016;'01 - 02;20,03;17,22;2,81;0;0;0;8008;8245;237
2402;10.04.2016;'02 - 03;19,25;16,97;2,28;0;0;0;7601;7529;-72
2403;10.04.2016;'03 - 04;18,96;17,86;1,1;0;0;0;7162;7106;-56
2404;10.04.2016;'04 - 05;19,02;17,21;1,81;0;0;0;6805;6774;-31
2405;10.04.2016;'05 - 06;18,88;17,63;1,25;0;0;0;6539;6502;-37
2406;10.04.2016;'06 - 07;19,15;16,21;2,94;58;42;-16;6260;6274;14
2407;10.04.2016;'07 - 08;19,19;18,57;0,62;964;941;-23;5896;5786;-110
2408;10.04.2016;'08 - 09;20,22;18,6;1,62;3417;3358;-59;5284;4604;-680
2409;10.04.2016;'09 - 10;20,97;19,84;1,13;6611;7122;511;4467;3429;-1038
2410;10.04.2016;'10 - 11;21;18,16;2,84;9750;11649;1899;3770;3153;-617
2411;10.04.2016;'11 - 12;20,59;15,34;5,25;12288;15514;3226;3433;3090;-343
2412;10.04.2016;'12 - 13;19,29;11,83;7,46;13857;17658;3801;3399;2866;-533
2413;10.04.2016;'13 - 14;16,89;9,58;7,31;13988;18215;4227;3398;2878;-520
2414;10.04.2016;'14 - 15;14,25;4,51;9,74;13117;16457;3340;3484;3254;-230
2415;10.04.2016;'15 - 16;13,61;3,53;10,08;11524;13902;2378;3722;3980;258
2416;10.04.2016;'16 - 17;12,06;4,29;7,77;9420;11042;1622;4128;4796;668
2417;10.04.2016;'17 - 18;16,67;9,46;7,21;6484;7536;1052;4775;5512;737
2418;10.04.2016;'18 - 19;20,78;17,5;3,28;3112;3774;662;5745;6499;754
2419;10.04.2016;'19 - 20;22,47;18,55;3,92;627;850;223;6765;7210;445
2420;10.04.2016;'20 - 21;24,55;19,22;5,33;12;15;3;7969;8759;790
2421;10.04.2016;'21 - 22;23;16,28;6,72;0;0;0;8892;11014;2122
2422;10.04.2016;'22 - 23;21,84;16,57;5,27;0;0;0;9482;11780;2298
2423;10.04.2016;'23 - 24;19,57;15,48;4,09;0;0;0;9645;11639;1994
2424;11.04.2016;'00 - 01;16,35;10,55;5,8;0;0;0;9866;10998;1132
2425;11.04.2016;'01 - 02;13,7;9,37;4,33;0;0;0;9498;10560;1062
2426;11.04.2016;'02 - 03;12,81;9,41;3,4;0;0;0;9172;10521;1349
2427;11.04.2016;'03 - 04;10,66;8,4;2,26;0;0;0;8977;10193;1216
2428;11.04.2016;'04 - 05;13,09;8,99;4,1;0;0;0;8880;9807;927
2429;11.04.2016;'05 - 06;18,55;14,62;3,93;0;0;0;8858;9436;578
2430;11.04.2016;'06 - 07;25,49;21,85;3,64;132;90;-42;8807;9781;974
2431;11.04.2016;'07 - 08;32;32,29;-0,29;1973;1808;-165;8575;9392;817
2432;11.04.2016;'08 - 09;34,61;32,29;2,32;6590;5992;-598;8093;8002;-91
2433;11.04.2016;'09 - 10;28,98;31,05;-2,07;12079;10960;-1119;7638;7766;128
2434;11.04.2016;'10 - 11;25,63;27,88;-2,25;16819;15427;-1392;7452;8166;714
2435;11.04.2016;'11 - 12;23,1;23,56;-0,46;19892;18822;-1070;7606;8196;590
2436;11.04.2016;'12 - 13;22,59;23,47;-0,88;21411;20776;-635;8071;8233;162
2437;11.04.2016;'13 - 14;22,51;24,1;-1,59;21494;21217;-277;8614;8694;80
2438;11.04.2016;'14 - 15;22,12;22,25;-0,13;20305;20016;-289;9201;9275;74
2439;11.04.2016;'15 - 16;21,83;22,36;-0,53;17633;17632;-1;9710;10097;387
2440;11.04.2016;'16 - 17;22,11;23,05;-0,94;13653;13644;-9;10241;10692;451
2441;11.04.2016;'17 - 18;23,68;23,72;-0,04;8582;8567;-15;10645;11082;437
2442;11.04.2016;'18 - 19;28,47;29,62;-1,15;3767;3809;42;10842;11174;332
2443;11.04.2016;'19 - 20;31,27;31,74;-0,47;760;776;16;10957;10622;-335
2444;11.04.2016;'20 - 21;32,56;34,15;-1,59;19;16;-3;11143;10764;-379
2445;11.04.2016;'21 - 22;31,49;32,59;-1,1;0;0;0;11227;10579;-648
2446;11.04.2016;'22 - 23;27,86;32,44;-4,58;0;0;0;11219;9924;-1295
2447;11.04.2016;'23 - 24;24,8;27,79;-2,99;0;0;0;10952;9169;-1783
2448;12.04.2016;'00 - 01;22,8;24,77;-1,97;0;0;0;9185;8688;-497
2449;12.04.2016;'01 - 02;22,2;23,73;-1,53;0;0;0;8658;8011;-647
2450;12.04.2016;'02 - 03;21,69;23,73;-2,04;0;0;0;8157;7384;-773
2451;12.04.2016;'03 - 04;21,05;23,32;-2,27;0;0;0;7783;7235;-548
2452;12.04.2016;'04 - 05;21,32;22,43;-1,11;0;0;0;7493;7165;-328
2453;12.04.2016;'05 - 06;22,15;23;-0,85;0;0;0;7192;7209;17
2454;12.04.2016;'06 - 07;28,98;30,21;-1,23;100;85;-15;6819;6922;103
2455;12.04.2016;'07 - 08;36;33,78;2,22;1318;1170;-148;6357;6378;21
2456;12.04.2016;'08 - 09;38,94;40,93;-1,99;4158;3484;-674;5528;5158;-370
2457;12.04.2016;'09 - 10;37,6;40,02;-2,42;7643;6534;-1109;4631;4059;-572
2458;12.04.2016;'10 - 11;34;35,75;-1,75;11170;10263;-907;4055;3349;-706
2459;12.04.2016;'11 - 12;31,02;31,14;-0,12;14063;13527;-536;3840;2832;-1008
2460;12.04.2016;'12 - 13;27,97;26,97;1;15926;16028;102;3610;2371;-1239
2461;12.04.2016;'13 - 14;26,41;25,39;1,02;16623;17562;939;3405;2266;-1139
2462;12.04.2016;'14 - 15;24,59;24,47;0,12;16243;17528;1285;3222;2300;-922
2463;12.04.2016;'15 - 16;24,18;23,35;0,83;14467;15428;961;3038;2604;-434
2464;12.04.2016;'16 - 17;25,13;23,08;2,05;11454;11970;516;2938;2608;-330
2465;12.04.2016;'17 - 18;27,26;26,86;0,4;7450;7848;398;2963;2678;-285
2466;12.04.2016;'18 - 19;31,32;30,5;0,82;3364;3414;50;3134;2683;-451
2467;12.04.2016;'19 - 20;34,62;32,37;2,25;702;662;-40;3457;2474;-983
2468;12.04.2016;'20 - 21;34,95;32,86;2,09;19;16;-3;3933;3138;-795
2469;12.04.2016;'21 - 22;32,24;29,82;2,42;0;0;0;4411;3274;-1137
2470;12.04.2016;'22 - 23;30;26,49;3,51;0;0;0;4656;3189;-1467
2471;12.04.2016;'23 - 24;24,1;25,04;-0,94;0;0;0;4719;3150;-1569
2472;13.04.2016;'00 - 01;22,93;24,62;-1,69;0;0;0;3689;3096;-593
2473;13.04.2016;'01 - 02;21,68;22,81;-1,13;0;0;0;3473;2822;-651
2474;13.04.2016;'02 - 03;21,68;24,01;-2,33;0;0;0;3263;2774;-489
2475;13.04.2016;'03 - 04;21,41;22,84;-1,43;0;0;0;3133;1969;-1164
2476;13.04.2016;'04 - 05;21,71;21,69;0,02;0;0;0;2936;1808;-1128
2477;13.04.2016;'05 - 06;22,77;23,64;-0,87;0;0;0;2763;2100;-663
2478;13.04.2016;'06 - 07;31,35;34,29;-2,94;119;110;-9;2694;2369;-325
2479;13.04.2016;'07 - 08;34,99;35,67;-0,68;1422;1527;105;2569;2254;-315
2480;13.04.2016;'08 - 09;39,41;39,97;-0,56;4344;4732;388;2350;1778;-572
2481;13.04.2016;'09 - 10;35,06;33,19;1,87;7824;8892;1068;2135;1032;-1103
2482;13.04.2016;'10 - 11;33,23;29,87;3,36;10874;12812;1938;1950;904;-1046
2483;13.04.2016;'11 - 12;31,94;28,19;3,75;12792;15197;2405;1903;1020;-883
2484;13.04.2016;'12 - 13;28,9;26,81;2,09;13599;15193;1594;2019;1119;-900
2485;13.04.2016;'13 - 14;27,01;28,76;-1,75;13394;13220;-174;2193;1341;-852
2486;13.04.2016;'14 - 15;25,96;30,17;-4,21;12365;11180;-1185;2519;1418;-1101
2487;13.04.2016;'15 - 16;26;30,38;-4,38;10452;8936;-1516;2902;1580;-1322
2488;13.04.2016;'16 - 17;26,33;31,24;-4,91;7888;6287;-1601;3314;1927;-1387
2489;13.04.2016;'17 - 18;29;32,07;-3,07;5086;4149;-937;3643;2007;-1636
2490;13.04.2016;'18 - 19;32,37;36,51;-4,14;2436;2288;-148;3785;2256;-1529
2491;13.04.2016;'19 - 20;33,86;35,94;-2,08;556;567;11;3878;2360;-1518
2492;13.04.2016;'20 - 21;34,42;36,83;-2,41;19;16;-3;4080;2686;-1394
2493;13.04.2016;'21 - 22;31,31;31,39;-0,08;0;0;0;4244;2816;-1428
2494;13.04.2016;'22 - 23;28;28,12;-0,12;0;0;0;4375;2856;-1519
2495;13.04.2016;'23 - 24;23,59;24,66;-1,07;0;0;0;4451;2612;-1839
2496;14.04.2016;'00 - 01;23,35;19,62;3,73;0;0;0;2052;2541;489
2497;14.04.2016;'01 - 02;21,93;17,65;4,28;0;0;0;1985;2565;580
2498;14.04.2016;'02 - 03;21,18;16,94;4,24;0;0;0;1998;2573;575
2499;14.04.2016;'03 - 04;20,94;16,95;3,99;0;0;0;2104;2844;740
2500;14.04.2016;'04 - 05;21,06;16,85;4,21;0;0;0;2217;2991;774
2501;14.04.2016;'05 - 06;21,74;18,41;3,33;0;0;0;2220;3042;822
2502;14.04.2016;'06 - 07;27;24,05;2,95;118;89;-29;2143;2952;809
2503;14.04.2016;'07 - 08;32,03;27,3;4,73;1400;1328;-72;2052;2646;594
2504;14.04.2016;'08 - 09;37,28;33,2;4,08;4366;4244;-122;1916;2224;308
2505;14.04.2016;'09 - 10;34,59;31,95;2,64;8073;8140;67;1796;1936;140
2506;14.04.2016;'10 - 11;30,91;26,15;4,76;11730;11562;-168;1765;1729;-36
2507;14.04.2016;'11 - 12;28,08;26,55;1,53;14696;14512;-184;1812;1740;-72
2508;14.04.2016;'12 - 13;26,4;24,74;1,66;16713;15829;-884;1906;1908;2
2509;14.04.2016;'13 - 14;25,05;23,96;1,09;17317;15970;-1347;1995;2195;200
2510;14.04.2016;'14 - 15;23,83;23,23;0,6;16668;15214;-1454;2136;2370;234
2511;14.04.2016;'15 - 16;23,44;23,35;0,09;14808;13844;-964;2260;2720;460
2512;14.04.2016;'16 - 17;23,22;23,91;-0,69;11827;11494;-333;2258;2777;519
2513;14.04.2016;'17 - 18;24,2;24,82;-0,62;7932;8006;74;2021;2359;338
2514;14.04.2016;'18 - 19;27,25;27,27;-0,02;3742;4190;448;1576;1702;126
2515;14.04.2016;'19 - 20;32,51;29,5;3,01;841;1022;181;1207;1047;-160
2516;14.04.2016;'20 - 21;31,98;31,73;0,25;29;29;0;1171;894;-277
2517;14.04.2016;'21 - 22;31,53;31;0,53;0;0;0;1526;1080;-446
2518;14.04.2016;'22 - 23;28,33;27,89;0,44;0;0;0;2131;1759;-372
2519;14.04.2016;'23 - 24;23,9;26,54;-2,64;0;0;0;2889;2897;8
2520;15.04.2016;'00 - 01;22,1;21,82;0,28;0;0;0;3652;3902;250
2521;15.04.2016;'01 - 02;21,31;20,93;0,38;0;0;0;4625;4786;161
2522;15.04.2016;'02 - 03;20,45;20,9;-0,45;0;0;0;5359;5840;481
2523;15.04.2016;'03 - 04;20,14;21,2;-1,06;0;0;0;5704;6156;452
2524;15.04.2016;'04 - 05;20,34;21,52;-1,18;0;0;0;5968;6859;891
2525;15.04.2016;'05 - 06;21,08;21,81;-0,73;0;0;0;6364;7400;1036
2526;15.04.2016;'06 - 07;25;24,66;0,34;128;115;-13;6897;7809;912
2527;15.04.2016;'07 - 08;31,69;30,55;1,14;1131;1166;35;7336;8326;990
2528;15.04.2016;'08 - 09;34,7;32,17;2,53;2894;2472;-422;7278;8350;1072
2529;15.04.2016;'09 - 10;33,02;33,09;-0,07;4731;4175;-556;7107;7575;468
2530;15.04.2016;'10 - 11;30,98;33,6;-2,62;6385;5790;-595;7450;8081;631
2531;15.04.2016;'11 - 12;29,94;31,55;-1,61;7770;7260;-510;8028;9369;1341
2532;15.04.2016;'12 - 13;28;29,88;-1,88;8893;8324;-569;8903;10960;2057
2533;15.04.2016;'13 - 14;23,82;25,53;-1,71;9606;8695;-911;9873;11984;2111
2534;15.04.2016;'14 - 15;22,81;23,04;-0,23;9758;9652;-106;10283;12452;2169
2535;15.04.2016;'15 - 16;21,36;21,41;-0,05;9084;10053;969;10428;13170;2742
2536;15.04.2016;'16 - 17;21,32;19,74;1,58;7612;8799;1187;10623;13069;2446
2537;15.04.2016;'17 - 18;22,51;20,4;2,11;5412;6387;975;10151;12595;2444
2538;15.04.2016;'18 - 19;23,94;21,73;2,21;2795;3517;722;8831;10518;1687
2539;15.04.2016;'19 - 20;26,34;24,05;2,29;681;868;187;7495;8132;637
2540;15.04.2016;'20 - 21;28,08;25,56;2,52;27;28;1;7285;7010;-275
2541;15.04.2016;'21 - 22;27,08;24,75;2,33;0;0;0;7622;6864;-758
2542;15.04.2016;'22 - 23;25;23,36;1,64;0;0;0;8036;7356;-680
2543;15.04.2016;'23 - 24;24,69;22,62;2,07;0;0;0;8461;8070;-391
2544;16.04.2016;'00 - 01;21,3;22,73;-1,43;0;0;0;9616;8993;-623
2545;16.04.2016;'01 - 02;19,7;18,61;1,09;0;0;0;10115;9532;-583
2546;16.04.2016;'02 - 03;19,24;17,36;1,88;0;0;0;10452;10307;-145
2547;16.04.2016;'03 - 04;18,28;16,89;1,39;0;0;0;10859;10914;55
2548;16.04.2016;'04 - 05;17,19;16,68;0,51;0;0;0;11388;11369;-19
2549;16.04.2016;'05 - 06;18,76;17,99;0,77;0;0;0;11949;12050;101
2550;16.04.2016;'06 - 07;19,46;19,39;0,07;149;137;-12;12440;12361;-79
2551;16.04.2016;'07 - 08;19,54;20,05;-0,51;1374;1490;116;12830;13022;192
2552;16.04.2016;'08 - 09;21,14;18,35;2,79;3609;3837;228;13473;13250;-223
2553;16.04.2016;'09 - 10;21,64;20,14;1,5;6030;6050;20;14774;13778;-996
2554;16.04.2016;'10 - 11;19,8;19,4;0,4;8118;7349;-769;16457;15563;-894
2555;16.04.2016;'11 - 12;19,06;19,44;-0,38;9695;8418;-1277;17833;17645;-188
2556;16.04.2016;'12 - 13;18,05;17,83;0,22;10768;9613;-1155;18613;18536;-77
2557;16.04.2016;'13 - 14;14,06;15,9;-1,84;11370;10990;-380;19160;19050;-110
2558;16.04.2016;'14 - 15;13,77;13,29;0,48;11370;12542;1172;19317;18902;-415
2559;16.04.2016;'15 - 16;13,19;6,05;7,14;10479;12438;1959;18343;19016;673
2560;16.04.2016;'16 - 17;12,69;0,23;12,46;8598;10148;1550;16923;18462;1539
2561;16.04.2016;'17 - 18;14,08;8,84;5,24;5993;6972;979;15295;17369;2074
2562;16.04.2016;'18 - 19;17,69;16,72;0,97;3026;3380;354;13367;15100;1733
2563;16.04.2016;'19 - 20;22,05;21,31;0,74;755;734;-21;11490;12470;980
2564;16.04.2016;'20 - 21;23,7;25,88;-2,18;32;24;-8;10284;11001;717
2565;16.04.2016;'21 - 22;24,31;24,12;0,19;0;0;0;9703;9689;-14
2566;16.04.2016;'22 - 23;23,94;25,15;-1,21;0;0;0;9217;8936;-281
2567;16.04.2016;'23 - 24;20,83;21,71;-0,88;0;0;0;8839;8597;-242
2568;17.04.2016;'00 - 01;19,33;16,63;2,7;0;0;0;7530;7414;-116
2569;17.04.2016;'01 - 02;17,74;15,04;2,7;0;0;0;7071;6939;-132
2570;17.04.2016;'02 - 03;15,85;12,48;3,37;0;0;0;6709;7022;313
2571;17.04.2016;'03 - 04;15,13;8,16;6,97;0;0;0;6458;7547;1089
2572;17.04.2016;'04 - 05;15,15;10,17;4,98;0;0;0;6242;7488;1246
2573;17.04.2016;'05 - 06;14,57;9,17;5,4;0;0;0;6122;7066;944
2574;17.04.2016;'06 - 07;14,82;10,73;4,09;132;109;-23;6166;6898;732
2575;17.04.2016;'07 - 08;14,57;10,93;3,64;1116;999;-117;6359;6265;-94
2576;17.04.2016;'08 - 09;16,48;14,49;1,99;3177;2805;-372;6734;6260;-474
2577;17.04.2016;'09 - 10;18,69;14,8;3,89;5669;5182;-487;7376;6843;-533
2578;17.04.2016;'10 - 11;18,69;12,57;6,12;8046;7712;-334;8074;7410;-664
2579;17.04.2016;'11 - 12;18,94;14,33;4,61;9976;9659;-317;8738;7873;-865
2580;17.04.2016;'12 - 13;18,16;15,49;2,67;11328;10904;-424;9413;8695;-718
2581;17.04.2016;'13 - 14;16,16;9,27;6,89;11773;11440;-333;10041;9646;-395
2582;17.04.2016;'14 - 15;13,82;7,59;6,23;11447;11184;-263;10521;10118;-403
2583;17.04.2016;'15 - 16;12,52;8,87;3,65;10330;10309;-21;10921;10352;-569
2584;17.04.2016;'16 - 17;13,52;12,52;1;8451;8109;-342;11140;10134;-1006
2585;17.04.2016;'17 - 18;16,16;18,94;-2,78;5867;5383;-484;10918;9997;-921
2586;17.04.2016;'18 - 19;19,35;24,39;-5,04;2989;2669;-320;10218;9236;-982
2587;17.04.2016;'19 - 20;21,19;26,22;-5,03;797;808;11;9359;7928;-1431
2588;17.04.2016;'20 - 21;26,4;27,63;-1,23;40;44;4;8712;7062;-1650
2589;17.04.2016;'21 - 22;29,65;28,52;1,13;0;0;0;8701;6975;-1726
2590;17.04.2016;'22 - 23;30,16;28,96;1,2;0;0;0;8930;7285;-1645
2591;17.04.2016;'23 - 24;27,25;23,8;3,45;0;0;0;9119;7547;-1572
2592;18.04.2016;'00 - 01;20,92;19,73;1,19;0;0;0;7639;7570;-69
2593;18.04.2016;'01 - 02;20,9;18,8;2,1;0;0;0;7755;7349;-406
2594;18.04.2016;'02 - 03;19,7;19,35;0,35;0;0;0;7854;7270;-584
2595;18.04.2016;'03 - 04;18,9;19,58;-0,68;0;0;0;8006;7263;-743
2596;18.04.2016;'04 - 05;19;20,14;-1,14;0;0;0;8154;7608;-546
2597;18.04.2016;'05 - 06;20,6;20,93;-0,33;0;0;0;8253;7885;-368
2598;18.04.2016;'06 - 07;30;34,35;-4,35;293;219;-74;8367;8223;-144
2599;18.04.2016;'07 - 08;37,06;45,72;-8,66;2540;2118;-422;8379;7867;-512
2600;18.04.2016;'08 - 09;38,79;47,95;-9,16;7004;5834;-1170;8622;7034;-1588
2601;18.04.2016;'09 - 10;29,27;37,69;-8,42;11907;10307;-1600;9464;7734;-1730
2602;18.04.2016;'10 - 11;24,09;30,22;-6,13;15358;13908;-1450;10633;9294;-1339
2603;18.04.2016;'11 - 12;23,28;28,83;-5,55;17097;15286;-1811;11831;10165;-1666
2604;18.04.2016;'12 - 13;21,14;25,48;-4,34;17622;15442;-2180;13040;10846;-2194
2605;18.04.2016;'13 - 14;20,7;23,34;-2,64;17021;14662;-2359;14252;11732;-2520
2606;18.04.2016;'14 - 15;20,65;24,63;-3,98;15466;12970;-2496;15336;12682;-2654
2607;18.04.2016;'15 - 16;20,49;23,23;-2,74;13088;10731;-2357;16026;13560;-2466
2608;18.04.2016;'16 - 17;20,31;22,44;-2,13;10298;8604;-1694;16534;14176;-2358
2609;18.04.2016;'17 - 18;20,94;24,34;-3,4;7015;5826;-1189;16454;13998;-2456
2610;18.04.2016;'18 - 19;23,19;27,82;-4,63;3530;2940;-590;15704;13532;-2172
2611;18.04.2016;'19 - 20;25,62;30,56;-4,94;928;810;-118;14823;12485;-2338
2612;18.04.2016;'20 - 21;27,92;30,98;-3,06;44;34;-10;14241;11688;-2553
2613;18.04.2016;'21 - 22;29,03;30,34;-1,31;0;0;0;13973;11602;-2371
2614;18.04.2016;'22 - 23;22,55;27,7;-5,15;0;0;0;14031;11608;-2423
2615;18.04.2016;'23 - 24;19,31;25,3;-5,99;0;0;0;14234;11959;-2275
2616;19.04.2016;'00 - 01;19,32;22,62;-3,3;0;0;0;13205;12257;-948
2617;19.04.2016;'01 - 02;18,69;23,65;-4,96;0;0;0;13496;12291;-1205
2618;19.04.2016;'02 - 03;18,04;22,59;-4,55;0;0;0;13627;12658;-969
2619;19.04.2016;'03 - 04;17,49;20,43;-2,94;0;0;0;13747;12779;-968
2620;19.04.2016;'04 - 05;18,44;19,55;-1,11;0;0;0;13862;12776;-1086
2621;19.04.2016;'05 - 06;19,8;25,14;-5,34;0;0;0;13899;12980;-919
2622;19.04.2016;'06 - 07;26,93;32,96;-6,03;294;277;-17;13899;13278;-621
2623;19.04.2016;'07 - 08;29,99;35,8;-5,81;2470;2368;-102;13928;13286;-642
2624;19.04.2016;'08 - 09;29,68;35,45;-5,77;6554;6116;-438;14471;14017;-454
2625;19.04.2016;'09 - 10;21,96;29,06;-7,1;11181;10970;-211;15916;15535;-381
2626;19.04.2016;'10 - 11;20,94;25,25;-4,31;14886;15291;405;17345;17316;-29
2627;19.04.2016;'11 - 12;20,42;23,18;-2,76;17073;16087;-986;18554;18830;276
2628;19.04.2016;'12 - 13;17,79;21,02;-3,23;17918;15199;-2719;19483;19577;94
2629;19.04.2016;'13 - 14;15,62;23,02;-7,4;17701;14345;-3356;20281;20182;-99
2630;19.04.2016;'14 - 15;13,6;22,04;-8,44;16511;13287;-3224;21017;20267;-750
2631;19.04.2016;'15 - 16;13,68;19,8;-6,12;14454;11872;-2582;21471;21291;-180
2632;19.04.2016;'16 - 17;15,02;21,09;-6,07;11768;9998;-1770;21699;21624;-75
2633;19.04.2016;'17 - 18;19,24;21,99;-2,75;8155;6907;-1248;21434;21404;-30
2634;19.04.2016;'18 - 19;20,76;25,05;-4,29;4143;3703;-440;20409;20635;226
2635;19.04.2016;'19 - 20;23,99;27,21;-3,22;1123;1086;-37;18876;19258;382
2636;19.04.2016;'20 - 21;25,95;27,65;-1,7;60;56;-4;17460;17322;-138
2637;19.04.2016;'21 - 22;24,87;28,14;-3,27;0;0;0;16460;16079;-381
2638;19.04.2016;'22 - 23;21,42;26,99;-5,57;0;0;0;15673;14856;-817
2639;19.04.2016;'23 - 24;19,33;21,65;-2,32;0;0;0;14972;14013;-959
2640;20.04.2016;'00 - 01;19,14;24,75;-5,61;0;0;0;14360;13134;-1226
2641;20.04.2016;'01 - 02;18,85;24,65;-5,8;0;0;0;13684;12668;-1016
2642;20.04.2016;'02 - 03;16,5;21,23;-4,73;0;0;0;13027;12138;-889
2643;20.04.2016;'03 - 04;17,49;19,72;-2,23;0;0;0;12468;11529;-939
2644;20.04.2016;'04 - 05;18,63;20,61;-1,98;0;0;0;11985;10868;-1117
2645;20.04.2016;'05 - 06;20;22,74;-2,74;1;1;0;11528;10233;-1295
2646;20.04.2016;'06 - 07;25,76;32,56;-6,8;344;361;17;11056;9613;-1443
2647;20.04.2016;'07 - 08;30,55;35,76;-5,21;2977;2904;-73;10518;9178;-1340
2648;20.04.2016;'08 - 09;31,91;32,7;-0,79;8005;7572;-433;9986;9219;-767
2649;20.04.2016;'09 - 10;26,44;27,63;-1,19;13798;12920;-878;9638;9791;153
2650;20.04.2016;'10 - 11;23,02;20,23;2,79;18816;17164;-1652;9151;8954;-197
2651;20.04.2016;'11 - 12;22,43;22,64;-0,21;22154;20281;-1873;8455;7786;-669
2652;20.04.2016;'12 - 13;21,51;21,74;-0,23;23794;22810;-984;7762;7000;-762
2653;20.04.2016;'13 - 14;20,49;20,12;0,37;24298;24216;-82;7208;6477;-731
2654;20.04.2016;'14 - 15;20,89;19,88;1,01;23598;24054;456;6875;5911;-964
2655;20.04.2016;'15 - 16;21,57;18,64;2,93;21189;21897;708;6577;5777;-800
2656;20.04.2016;'16 - 17;21,59;18,55;3,04;17041;17750;709;6320;5433;-887
2657;20.04.2016;'17 - 18;22,89;20,17;2,72;11405;11995;590;6058;5574;-484
2658;20.04.2016;'18 - 19;27,24;26,66;0,58;5368;5854;486;5725;5780;55
2659;20.04.2016;'19 - 20;31,09;29,16;1,93;1465;1653;188;5394;5522;128
2660;20.04.2016;'20 - 21;32,16;30,44;1,72;84;94;10;5361;5449;88
2661;20.04.2016;'21 - 22;30,66;29,02;1,64;0;0;0;5508;5986;478
2662;20.04.2016;'22 - 23;28,52;27,1;1,42;0;0;0;5634;6393;759
2663;20.04.2016;'23 - 24;24,5;22,11;2,39;0;0;0;5546;6110;564
2664;21.04.2016;'00 - 01;22,51;18;4,51;0;0;0;5041;5567;526
2665;21.04.2016;'01 - 02;20,5;20,5;0;0;0;0;4796;5129;333
2666;21.04.2016;'02 - 03;19,93;19,86;0,07;0;0;0;4509;4563;54
2667;21.04.2016;'03 - 04;19,58;18,97;0,61;0;0;0;4287;3924;-363
2668;21.04.2016;'04 - 05;19,84;21,38;-1,54;0;0;0;4072;3649;-423
2669;21.04.2016;'05 - 06;21,11;25,46;-4,35;4;1;-3;3884;3493;-391
2670;21.04.2016;'06 - 07;29,1;33,71;-4,61;488;476;-12;3748;3301;-447
2671;21.04.2016;'07 - 08;34,58;38,49;-3,91;3584;3665;81;3524;2963;-561
2672;21.04.2016;'08 - 09;35,38;38,41;-3,03;9385;9471;86;3201;2086;-1115
2673;21.04.2016;'09 - 10;32,92;28,34;4,58;15700;15526;-174;3196;1786;-1410
2674;21.04.2016;'10 - 11;28,91;25,19;3,72;20783;20629;-154;3462;2004;-1458
2675;21.04.2016;'11 - 12;26,12;24,13;1,99;23919;24038;119;3641;2492;-1149
2676;21.04.2016;'12 - 13;23,59;21,67;1,92;25317;25594;277;3692;2855;-837
2677;21.04.2016;'13 - 14;23,43;22;1,43;25381;25764;383;3730;2964;-766
2678;21.04.2016;'14 - 15;23,47;22,32;1,15;24042;24594;552;3842;3029;-813
2679;21.04.2016;'15 - 16;23,93;22,8;1,13;21232;21918;686;4064;3353;-711
2680;21.04.2016;'16 - 17;23,95;21,64;2,31;16796;17638;842;4352;3552;-800
2681;21.04.2016;'17 - 18;27,61;25,75;1,86;11004;11892;888;4688;3616;-1072
2682;21.04.2016;'18 - 19;30,74;30,11;0,63;5117;5750;633;5083;3930;-1153
2683;21.04.2016;'19 - 20;32,33;33,58;-1,25;1393;1599;206;5516;4098;-1418
2684;21.04.2016;'20 - 21;32,34;37,36;-5,02;89;92;3;6110;5082;-1028
2685;21.04.2016;'21 - 22;32,02;32,22;-0,2;0;0;0;6910;6045;-865
2686;21.04.2016;'22 - 23;29,19;29,33;-0,14;0;0;0;7807;7056;-751
2687;21.04.2016;'23 - 24;25;23,78;1,22;0;0;0;8548;8078;-470
2688;22.04.2016;'00 - 01;21,95;24,75;-2,8;0;0;0;8620;8686;66
2689;22.04.2016;'01 - 02;20,7;24,42;-3,72;0;0;0;8899;9274;375
2690;22.04.2016;'02 - 03;19,59;23,35;-3,76;0;0;0;9124;9432;308
2691;22.04.2016;'03 - 04;19,32;23,54;-4,22;0;0;0;9211;9636;425
2692;22.04.2016;'04 - 05;19,85;22,52;-2,67;0;0;0;9123;9566;443
2693;22.04.2016;'05 - 06;22,94;29,48;-6,54;4;2;-2;8940;9498;558
2694;22.04.2016;'06 - 07;28;33,5;-5,5;445;466;21;8541;9027;486
2695;22.04.2016;'07 - 08;33,14;35,11;-1,97;3097;3282;185;7752;7612;-140
2696;22.04.2016;'08 - 09;34,61;34,72;-0,11;7773;7822;49;6738;6526;-212
2697;22.04.2016;'09 - 10;31,59;31,08;0,51;12821;12559;-262;5982;6392;410
2698;22.04.2016;'10 - 11;28,69;25,98;2,71;16918;16783;-135;5537;5214;-323
2699;22.04.2016;'11 - 12;25,22;24,54;0,68;19575;19844;269;5300;4582;-718
2700;22.04.2016;'12 - 13;23,98;24,05;-0,07;20844;21411;567;5231;4260;-971
2701;22.04.2016;'13 - 14;22,95;22,52;0,43;20703;21565;862;5232;4251;-981
2702;22.04.2016;'14 - 15;22,24;22,99;-0,75;19270;20372;1102;5449;4379;-1070
2703;22.04.2016;'15 - 16;22,32;21,31;1,01;16606;17921;1315;5867;4419;-1448
2704;22.04.2016;'16 - 17;22,89;22,18;0,71;12870;14146;1276;6252;4805;-1447
2705;22.04.2016;'17 - 18;24,75;25,14;-0,39;8416;9306;890;6450;5080;-1370
2706;22.04.2016;'18 - 19;28,99;28,05;0,94;4091;4650;559;6550;5273;-1277
2707;22.04.2016;'19 - 20;30,93;28,57;2,36;1165;1303;138;6635;5270;-1365
2708;22.04.2016;'20 - 21;30,94;29,49;1,45;80;68;-12;6677;5535;-1142
2709;22.04.2016;'21 - 22;29,33;28,04;1,29;0;0;0;6621;5614;-1007
2710;22.04.2016;'22 - 23;27,94;28,33;-0,39;0;0;0;6612;5687;-925
2711;22.04.2016;'23 - 24;25,04;25,43;-0,39;0;0;0;6587;5788;-799
2712;23.04.2016;'00 - 01;27,72;24,59;3,13;0;0;0;6352;5810;-542
2713;23.04.2016;'01 - 02;22,45;20,96;1,49;0;0;0;6433;5859;-574
2714;23.04.2016;'02 - 03;21,47;19,42;2,05;0;0;0;6595;5764;-831
2715;23.04.2016;'03 - 04;20,99;19,38;1,61;0;0;0;6720;5869;-851
2716;23.04.2016;'04 - 05;20,99;20,24;0,75;0;0;0;6791;6150;-641
2717;23.04.2016;'05 - 06;20,9;19,56;1,34;4;2;-2;6832;6388;-444
2718;23.04.2016;'06 - 07;21,05;20,02;1,03;302;280;-22;6698;6230;-468
2719;23.04.2016;'07 - 08;21,48;21,67;-0,19;1862;1792;-70;6308;5664;-644
2720;23.04.2016;'08 - 09;23,62;23,81;-0,19;4354;4197;-157;6232;5168;-1064
2721;23.04.2016;'09 - 10;27,29;24,49;2,8;7023;6884;-139;6903;5927;-976
2722;23.04.2016;'10 - 11;26,91;23,79;3,12;9432;9034;-398;7542;6340;-1202
2723;23.04.2016;'11 - 12;25,76;22,67;3,09;11228;10591;-637;7812;6727;-1085
2724;23.04.2016;'12 - 13;23,4;23,09;0,31;12268;11327;-941;8070;7250;-820
2725;23.04.2016;'13 - 14;21,36;21,25;0,11;12162;11007;-1155;8685;8037;-648
2726;23.04.2016;'14 - 15;20,42;20,14;0,28;11182;9934;-1248;9566;9117;-449
2727;23.04.2016;'15 - 16;18,29;18,37;-0,08;9727;8648;-1079;10559;10192;-367
2728;23.04.2016;'16 - 17;16,27;16,63;-0,36;7834;7118;-716;11553;11380;-173
2729;23.04.2016;'17 - 18;19,13;17,58;1,55;5488;5015;-473;12100;12826;726
2730;23.04.2016;'18 - 19;21,07;19,37;1,7;2958;2804;-154;11927;13298;1371
2731;23.04.2016;'19 - 20;22,46;19,26;3,2;942;976;34;11374;11684;310
2732;23.04.2016;'20 - 21;25;22,04;2,96;75;85;10;10523;9784;-739
2733;23.04.2016;'21 - 22;27,19;22,9;4,29;0;0;0;9673;8751;-922
2734;23.04.2016;'22 - 23;25,05;22,29;2,76;0;0;0;9149;8136;-1013
2735;23.04.2016;'23 - 24;22,1;21,74;0,36;0;0;0;9193;8220;-973
2736;24.04.2016;'00 - 01;18,21;20,5;-2,29;0;0;0;9981;8896;-1085
2737;24.04.2016;'01 - 02;15,07;15,16;-0,09;0;0;0;10039;9484;-555
2738;24.04.2016;'02 - 03;14,31;8,54;5,77;0;0;0;9792;9604;-188
2739;24.04.2016;'03 - 04;12,59;7,95;4,64;0;0;0;9349;9466;117
2740;24.04.2016;'04 - 05;12,79;8,95;3,84;0;0;0;8757;8816;59
2741;24.04.2016;'05 - 06;13,62;10,23;3,39;8;3;-5;8298;8376;78
2742;24.04.2016;'06 - 07;12,76;11,19;1,57;489;478;-11;7918;7519;-399
2743;24.04.2016;'07 - 08;12,2;11,96;0,24;3202;2946;-256;7546;6601;-945
2744;24.04.2016;'08 - 09;13,75;14,07;-0,32;7776;6718;-1058;7232;6486;-746
2745;24.04.2016;'09 - 10;12,57;15;-2,43;12573;10662;-1911;7200;6827;-373
2746;24.04.2016;'10 - 11;12,54;13,59;-1,05;16196;12925;-3271;7077;7741;664
2747;24.04.2016;'11 - 12;13,79;15,8;-2,01;18390;13870;-4520;6848;7998;1150
2748;24.04.2016;'12 - 13;14,19;18,4;-4,21;19255;15009;-4246;6745;8003;1258
2749;24.04.2016;'13 - 14;11,88;15,54;-3,66;19028;16520;-2508;6707;7696;989
2750;24.04.2016;'14 - 15;9,44;14,41;-4,97;17713;16380;-1333;7155;8040;885
2751;24.04.2016;'15 - 16;9,5;8,5;1;15406;14887;-519;7856;8342;486
2752;24.04.2016;'16 - 17;8,47;4,18;4,29;12285;12034;-251;8418;8199;-219
2753;24.04.2016;'17 - 18;13,04;10,76;2,28;8331;8156;-175;8592;8318;-274
2754;24.04.2016;'18 - 19;20,28;19,79;0,49;4271;4510;239;8077;7337;-740
2755;24.04.2016;'19 - 20;21,96;23,9;-1,94;1323;1440;117;7299;6422;-877
2756;24.04.2016;'20 - 21;23,94;27,87;-3,93;103;104;1;6833;5845;-988
2757;24.04.2016;'21 - 22;24,37;25,36;-0,99;0;0;0;6674;5177;-1497
2758;24.04.2016;'22 - 23;27,87;28,58;-0,71;0;0;0;6654;4888;-1766
2759;24.04.2016;'23 - 24;24,04;27,41;-3,37;0;0;0;6652;5380;-1272
2760;25.04.2016;'00 - 01;22,56;24,19;-1,63;0;0;0;6713;5458;-1255
2761;25.04.2016;'01 - 02;21,46;22,5;-1,04;0;0;0;6754;5686;-1068
2762;25.04.2016;'02 - 03;20,82;21,77;-0,95;0;0;0;6853;5725;-1128
2763;25.04.2016;'03 - 04;20,23;21,85;-1,62;0;0;0;7052;5986;-1066
2764;25.04.2016;'04 - 05;20,26;20,98;-0,72;0;0;0;7232;6261;-971
2765;25.04.2016;'05 - 06;21,1;24,68;-3,58;9;5;-4;7327;6439;-888
2766;25.04.2016;'06 - 07;29,02;32,4;-3,38;498;434;-64;7364;7282;-82
2767;25.04.2016;'07 - 08;32,97;32,29;0,68;2994;2546;-448;7327;7169;-158
2768;25.04.2016;'08 - 09;34,48;32,74;1,74;7063;5680;-1383;7407;7142;-265
2769;25.04.2016;'09 - 10;30,03;28,27;1,76;11368;9199;-2169;7899;8423;524
2770;25.04.2016;'10 - 11;28,95;27,51;1,44;14775;12130;-2645;8660;10037;1377
2771;25.04.2016;'11 - 12;27,94;27,15;0,79;16805;13896;-2909;9534;11203;1669
2772;25.04.2016;'12 - 13;28,31;27,72;0,59;17367;14741;-2626;10422;11910;1488
2773;25.04.2016;'13 - 14;27,37;25,93;1,44;16856;14774;-2082;11361;11895;534
2774;25.04.2016;'14 - 15;24,39;24,43;-0,04;15501;14224;-1277;12222;12523;301
2775;25.04.2016;'15 - 16;23,75;22,29;1,46;13311;12134;-1177;12720;12987;267
2776;25.04.2016;'16 - 17;23,78;21,17;2,61;10432;9592;-840;13046;12934;-112
2777;25.04.2016;'17 - 18;25,95;23,47;2,48;6912;6368;-544;12794;12770;-24
2778;25.04.2016;'18 - 19;28,41;26,15;2,26;3453;3092;-361;12114;12497;383
2779;25.04.2016;'19 - 20;31,19;26,82;4,37;1061;874;-187;11628;11984;356
2780;25.04.2016;'20 - 21;31,46;27,94;3,52;83;47;-36;11574;12020;446
2781;25.04.2016;'21 - 22;30,15;27,4;2,75;0;0;0;11911;12952;1041
2782;25.04.2016;'22 - 23;28,14;25,9;2,24;0;0;0;12278;14142;1864
2783;25.04.2016;'23 - 24;22,97;21,01;1,96;0;0;0;12703;14843;2140
2784;26.04.2016;'00 - 01;21,81;22,96;-1,15;0;0;0;13418;14770;1352
2785;26.04.2016;'01 - 02;20,9;21,62;-0,72;0;0;0;13125;14154;1029
2786;26.04.2016;'02 - 03;20,96;21,8;-0,84;0;0;0;12533;13019;486
2787;26.04.2016;'03 - 04;20,62;22,13;-1,51;0;0;0;11671;12086;415
2788;26.04.2016;'04 - 05;21,07;22,32;-1,25;0;0;0;10827;10368;-459
2789;26.04.2016;'05 - 06;22,73;25,21;-2,48;7;3;-4;10213;9594;-619
2790;26.04.2016;'06 - 07;29,91;35,19;-5,28;313;283;-30;10142;9160;-982
2791;26.04.2016;'07 - 08;34,07;39,55;-5,48;1867;1645;-222;10354;8825;-1529
2792;26.04.2016;'08 - 09;35,14;48,42;-13,28;4346;3595;-751;10543;9065;-1478
2793;26.04.2016;'09 - 10;32,7;44,48;-11,78;7155;5988;-1167;10624;9401;-1223
2794;26.04.2016;'10 - 11;30,36;38,24;-7,88;9953;8323;-1630;10821;9846;-975
2795;26.04.2016;'11 - 12;29,78;35,68;-5,9;12370;10162;-2208;11270;10145;-1125
2796;26.04.2016;'12 - 13;26,95;33,55;-6,6;14019;11156;-2863;11950;10546;-1404
2797;26.04.2016;'13 - 14;25,65;33,17;-7,52;14564;11930;-2634;12644;11035;-1609
2798;26.04.2016;'14 - 15;25,29;32,97;-7,68;14244;11786;-2458;13127;10992;-2135
2799;26.04.2016;'15 - 16;25,23;30,59;-5,36;12962;11381;-1581;13364;11062;-2302
2800;26.04.2016;'16 - 17;24,73;28,03;-3,3;10608;9392;-1216;13409;11703;-1706
2801;26.04.2016;'17 - 18;25,29;27,25;-1,96;7339;6460;-879;13085;12286;-799
2802;26.04.2016;'18 - 19;28,92;30,5;-1,58;3865;3334;-531;12440;11888;-552
2803;26.04.2016;'19 - 20;31,11;31,27;-0,16;1248;1052;-196;11694;11542;-152
2804;26.04.2016;'20 - 21;31,61;30,79;0,82;109;80;-29;11318;11178;-140
2805;26.04.2016;'21 - 22;31,07;30,19;0,88;0;0;0;11603;11176;-427
2806;26.04.2016;'22 - 23;27,98;29,39;-1,41;0;0;0;12058;12690;632
2807;26.04.2016;'23 - 24;23,99;26,27;-2,28;0;0;0;12306;13356;1050
2808;27.04.2016;'00 - 01;23,01;17,9;5,11;0;0;0;11882;14496;2614
2809;27.04.2016;'01 - 02;22,42;18,51;3,91;0;0;0;12126;15162;3036
2810;27.04.2016;'02 - 03;22,53;18,2;4,33;0;0;0;12250;15440;3190
2811;27.04.2016;'03 - 04;22,04;18,33;3,71;0;0;0;12261;15592;3331
2812;27.04.2016;'04 - 05;22,17;18,73;3,44;0;0;0;12319;15520;3201
2813;27.04.2016;'05 - 06;23,77;19,33;4,44;8;6;-2;12414;15642;3228
2814;27.04.2016;'06 - 07;28,6;20,92;7,68;469;406;-63;12483;16436;3953
2815;27.04.2016;'07 - 08;31,47;22,44;9,03;2621;2134;-487;12670;16572;3902
2816;27.04.2016;'08 - 09;30,27;23,12;7,15;5848;4061;-1787;13221;16848;3627
2817;27.04.2016;'09 - 10;28,85;24,23;4,62;9277;6380;-2897;14085;16934;2849
2818;27.04.2016;'10 - 11;25,65;25,15;0,5;12075;8467;-3608;14767;17029;2262
2819;27.04.2016;'11 - 12;24,91;26,86;-1,95;14039;10700;-3339;15059;18071;3012
2820;27.04.2016;'12 - 13;24,21;25,13;-0,92;15036;12493;-2543;15071;18969;3898
2821;27.04.2016;'13 - 14;24,14;23,7;0,44;15136;12960;-2176;14917;19161;4244
2822;27.04.2016;'14 - 15;23,56;23,3;0,26;14558;13178;-1380;14864;19916;5052
2823;27.04.2016;'15 - 16;23,42;20,71;2,71;13051;12136;-915;14976;20111;5135
2824;27.04.2016;'16 - 17;23,53;20,61;2,92;10599;10125;-474;14932;19226;4294
2825;27.04.2016;'17 - 18;24,03;22,02;2,01;7452;7406;-46;14283;19128;4845
2826;27.04.2016;'18 - 19;28,95;22,07;6,88;4036;4124;88;13044;17602;4558
2827;27.04.2016;'19 - 20;30,27;24,87;5,4;1326;1390;64;11865;15265;3400
2828;27.04.2016;'20 - 21;33;26,92;6,08;116;108;-8;11093;13911;2818
2829;27.04.2016;'21 - 22;31,95;26,67;5,28;0;0;0;10840;13130;2290
2830;27.04.2016;'22 - 23;27,93;23,81;4,12;0;0;0;10815;12957;2142
2831;27.04.2016;'23 - 24;25,51;22,13;3,38;0;0;0;10739;12874;2135
2832;28.04.2016;'00 - 01;23;27,94;-4,94;0;0;0;12163;12663;500
2833;28.04.2016;'01 - 02;23,46;27,47;-4,01;0;0;0;11731;11806;75
2834;28.04.2016;'02 - 03;24,55;28,29;-3,74;0;0;0;11257;11327;70
2835;28.04.2016;'03 - 04;23,28;26,84;-3,56;0;0;0;10745;10891;146
2836;28.04.2016;'04 - 05;23,73;26,65;-2,92;0;0;0;10266;10574;308
2837;28.04.2016;'05 - 06;25,59;28,02;-2,43;8;7;-1;9777;9960;183
2838;28.04.2016;'06 - 07;31,12;33,7;-2,58;584;614;30;9266;9234;-32
2839;28.04.2016;'07 - 08;37,99;39,11;-1,12;3182;3124;-58;8707;8314;-393
2840;28.04.2016;'08 - 09;37,99;38,94;-0,95;7132;6748;-384;8283;8048;-235
2841;28.04.2016;'09 - 10;34,1;35,17;-1,07;11447;10577;-870;8177;8152;-25
2842;28.04.2016;'10 - 11;29,93;29,33;0,6;15234;13889;-1345;8172;8185;13
2843;28.04.2016;'11 - 12;29,39;31,66;-2,27;17795;15988;-1807;8125;8489;364
2844;28.04.2016;'12 - 13;26,16;28,73;-2,57;19176;16584;-2592;8030;8812;782
2845;28.04.2016;'13 - 14;24,98;26,65;-1,67;19375;16964;-2411;7860;8937;1077
2846;28.04.2016;'14 - 15;27,39;28,69;-1,3;18534;17124;-1410;7766;8510;744
2847;28.04.2016;'15 - 16;26,96;27,34;-0,38;16494;15743;-751;7641;8522;881
2848;28.04.2016;'16 - 17;26,5;26,92;-0,42;13241;13084;-157;7332;8122;790
2849;28.04.2016;'17 - 18;30;29,26;0,74;9039;9376;337;6529;6877;348
2850;28.04.2016;'18 - 19;34,79;33,27;1,52;4701;5100;399;5264;5660;396
2851;28.04.2016;'19 - 20;38,43;35,27;3,16;1531;1772;241;4018;4506;488
2852;28.04.2016;'20 - 21;35,75;35,34;0,41;149;172;23;3296;3430;134
2853;28.04.2016;'21 - 22;37,19;35,33;1,86;0;0;0;3165;3549;384
2854;28.04.2016;'22 - 23;34,92;33,71;1,21;0;0;0;3308;4184;876
2855;28.04.2016;'23 - 24;30,3;29,73;0,57;0;0;0;3617;5386;1769
2856;29.04.2016;'00 - 01;26,41;27,98;-1,57;0;0;0;5873;6466;593
2857;29.04.2016;'01 - 02;25,01;27,36;-2,35;0;0;0;7196;7913;717
2858;29.04.2016;'02 - 03;23,99;25,9;-1,91;0;0;0;8312;9048;736
2859;29.04.2016;'03 - 04;22,46;24,7;-2,24;0;0;0;9298;10546;1248
2860;29.04.2016;'04 - 05;22,35;26,47;-4,12;0;0;0;10224;11732;1508
2861;29.04.2016;'05 - 06;23,47;27,36;-3,89;15;12;-3;11123;12835;1712
2862;29.04.2016;'06 - 07;26,8;33,51;-6,71;794;804;10;11986;13999;2013
2863;29.04.2016;'07 - 08;30,68;34,95;-4,27;4096;4147;51;12494;14182;1688
2864;29.04.2016;'08 - 09;28,51;30,98;-2,47;9376;9430;54;12688;12953;265
2865;29.04.2016;'09 - 10;22,39;24,69;-2,3;14698;14942;244;13339;12995;-344
2866;29.04.2016;'10 - 11;20,69;23,1;-2,41;18359;18865;506;14564;15457;893
2867;29.04.2016;'11 - 12;20,05;20,51;-0,46;19952;19604;-348;15713;18394;2681
2868;29.04.2016;'12 - 13;19,09;17,99;1,1;19974;17905;-2069;16148;18542;2394
2869;29.04.2016;'13 - 14;20,14;21,29;-1,15;18934;16380;-2554;16127;17452;1325
2870;29.04.2016;'14 - 15;20,86;22,86;-2;16914;15713;-1201;15700;15255;-445
2871;29.04.2016;'15 - 16;22,01;23,68;-1,67;14267;14690;423;14780;15522;742
2872;29.04.2016;'16 - 17;22,59;23,67;-1,08;11509;12552;1043;13442;14939;1497
2873;29.04.2016;'17 - 18;26,01;24,72;1,29;8049;9154;1105;11840;13698;1858
2874;29.04.2016;'18 - 19;30,82;28,2;2,62;4235;5065;830;10107;11404;1297
2875;29.04.2016;'19 - 20;34,83;33;1,83;1409;1643;234;8712;8910;198
2876;29.04.2016;'20 - 21;35,18;35,21;-0,03;149;125;-24;8532;7793;-739
2877;29.04.2016;'21 - 22;33,08;34,01;-0,93;0;0;0;9128;8566;-562
2878;29.04.2016;'22 - 23;30,93;32,83;-1,9;0;0;0;9690;9312;-378
2879;29.04.2016;'23 - 24;27,35;27,35;0;0;0;0;9835;9935;100
2880;30.04.2016;'00 - 01;24,17;30,8;-6,63;0;0;0;10317;10280;-37
2881;30.04.2016;'01 - 02;24,25;29,81;-5,56;0;0;0;9951;10194;243
2882;30.04.2016;'02 - 03;24,54;28,87;-4,33;0;0;0;9345;9654;309
2883;30.04.2016;'03 - 04;25,04;26,19;-1,15;0;0;0;8548;8984;436
2884;30.04.2016;'04 - 05;24;25,66;-1,66;0;0;0;7672;8258;586
2885;30.04.2016;'05 - 06;24;24,24;-0,24;15;12;-3;6848;7407;559
2886;30.04.2016;'06 - 07;24,22;26,57;-2,35;689;741;52;6037;6990;953
2887;30.04.2016;'07 - 08;25,45;26,33;-0,88;3363;3509;146;5080;6264;1184
2888;30.04.2016;'08 - 09;26,81;26,72;0,09;7376;7681;305;3930;4742;812
2889;30.04.2016;'09 - 10;28,69;26,42;2,27;11629;12009;380;2931;3876;945
2890;30.04.2016;'10 - 11;25,7;24,59;1,11;15190;16164;974;2313;3432;1119
2891;30.04.2016;'11 - 12;24,05;20,44;3,61;17510;19068;1558;2065;2951;886
2892;30.04.2016;'12 - 13;22,44;19,64;2,8;18514;20235;1721;2088;2826;738
2893;30.04.2016;'13 - 14;22,01;19,04;2,97;18196;19682;1486;2109;2564;455
2894;30.04.2016;'14 - 15;21,48;18,79;2,69;16823;17740;917;2115;2331;216
2895;30.04.2016;'15 - 16;21,17;19,43;1,74;14480;14856;376;2122;2335;213
2896;30.04.2016;'16 - 17;21,54;19,49;2,05;11223;11312;89;2185;2594;409
2897;30.04.2016;'17 - 18;22,34;20,82;1,52;7386;7727;341;2599;3760;1161
2898;30.04.2016;'18 - 19;25,02;22,54;2,48;3780;4191;411;3641;5280;1639
2899;30.04.2016;'19 - 20;25,51;22,91;2,6;1257;1326;69;5123;6532;1409
2900;30.04.2016;'20 - 21;25,61;22,17;3,44;134;121;-13;6731;8054;1323
2901;30.04.2016;'21 - 22;28,53;23,63;4,9;0;0;0;7896;9568;1672
2902;30.04.2016;'22 - 23;27,92;24,02;3,9;0;0;0;8729;10158;1429
2903;30.04.2016;'23 - 24;24,03;22,75;1,28;0;0;0;9036;10194;1158
2904;01.05.2016;'00 - 01;20,1;17,88;2,22;0;0;0;9317;10691;1374
2905;01.05.2016;'01 - 02;19,81;16,86;2,95;0;0;0;9214;10789;1575
2906;01.05.2016;'02 - 03;18,72;14,82;3,9;0;0;0;9012;10807;1795
2907;01.05.2016;'03 - 04;17,03;12,47;4,56;0;0;0;8999;10786;1787
2908;01.05.2016;'04 - 05;17,17;12,77;4,4;0;0;0;9018;10154;1136
2909;01.05.2016;'05 - 06;17,92;13,04;4,88;18;14;-4;8871;9804;933
2910;01.05.2016;'06 - 07;17,64;13,71;3,93;659;642;-17;8490;9514;1024
2911;01.05.2016;'07 - 08;17,04;11,9;5,14;3053;2880;-173;7951;8297;346
2912;01.05.2016;'08 - 09;16,82;12,93;3,89;6544;6136;-408;7304;6898;-406
2913;01.05.2016;'09 - 10;17,42;13,71;3,71;10303;9933;-370;6783;6528;-255
2914;01.05.2016;'10 - 11;16,77;11,91;4,86;13293;14222;929;6486;6573;87
2915;01.05.2016;'11 - 12;16,97;8,2;8,77;15403;17110;1707;6295;6710;415
2916;01.05.2016;'12 - 13;15,16;6,41;8,75;16532;18690;2158;6233;7034;801
2917;01.05.2016;'13 - 14;13,73;3,8;9,93;16309;18449;2140;6226;7437;1211
2918;01.05.2016;'14 - 15;14,29;3,92;10,37;15036;17159;2123;6330;7719;1389
2919;01.05.2016;'15 - 16;13,54;6,66;6,88;13073;15189;2116;6279;7688;1409
2920;01.05.2016;'16 - 17;14,25;8,12;6,13;10645;12244;1599;6162;7645;1483
2921;01.05.2016;'17 - 18;16,21;11,07;5,14;7464;8569;1105;6005;7577;1572
2922;01.05.2016;'18 - 19;21,35;20,13;1,22;4106;4732;626;5801;7312;1511
2923;01.05.2016;'19 - 20;23,57;21,86;1,71;1468;1738;270;5577;6508;931
2924;01.05.2016;'20 - 21;25,08;20,96;4,12;171;224;53;5539;5893;354
2925;01.05.2016;'21 - 22;25,74;23,11;2,63;0;0;0;5568;6287;719
2926;01.05.2016;'22 - 23;26,35;23,21;3,14;0;0;0;5521;6318;797
2927;01.05.2016;'23 - 24;24,48;20,84;3,64;0;0;0;5211;5944;733
2928;02.05.2016;'00 - 01;21,45;19,14;2,31;0;0;0;5013;5533;520
2929;02.05.2016;'01 - 02;20,23;17,04;3,19;0;0;0;4487;4904;417
2930;02.05.2016;'02 - 03;20,03;16,7;3,33;0;0;0;3960;4338;378
2931;02.05.2016;'03 - 04;19,94;16,35;3,59;0;0;0;3595;3930;335
2932;02.05.2016;'04 - 05;20,08;17,48;2,6;0;0;0;3343;3799;456
2933;02.05.2016;'05 - 06;23,47;20,33;3,14;30;21;-9;3154;3556;402
2934;02.05.2016;'06 - 07;31,12;29,46;1,66;923;897;-26;2966;3241;275
2935;02.05.2016;'07 - 08;35,53;33,73;1,8;4263;4260;-3;2679;2603;-76
2936;02.05.2016;'08 - 09;34,96;34,97;-0,01;9545;9767;222;2356;1696;-660
2937;02.05.2016;'09 - 10;31,35;30,51;0,84;15072;15511;439;2231;1472;-759
2938;02.05.2016;'10 - 11;28,29;25,08;3,21;19487;19786;299;2235;1764;-471
2939;02.05.2016;'11 - 12;26,91;23,3;3,61;22111;22729;618;2400;2082;-318
2940;02.05.2016;'12 - 13;25,29;22,84;2,45;23088;23836;748;2649;2362;-287
2941;02.05.2016;'13 - 14;25,07;22,51;2,56;22600;23746;1146;2868;2771;-97
2942;02.05.2016;'14 - 15;25,02;22,18;2,84;20758;22294;1536;3075;3014;-61
2943;02.05.2016;'15 - 16;25,53;22,18;3,35;17830;19530;1700;3127;3095;-32
2944;02.05.2016;'16 - 17;26,94;23,34;3,6;14274;15740;1466;3118;2952;-166
2945;02.05.2016;'17 - 18;29,06;26,61;2,45;9847;10889;1042;3090;2828;-262
2946;02.05.2016;'18 - 19;33;30,8;2,2;5249;5893;644;3061;2776;-285
2947;02.05.2016;'19 - 20;35,79;32,71;3,08;1785;2056;271;3133;2914;-219
2948;02.05.2016;'20 - 21;35,76;32,87;2,89;225;228;3;3524;3208;-316
2949;02.05.2016;'21 - 22;34,08;32,01;2,07;0;0;0;4320;4210;-110
2950;02.05.2016;'22 - 23;31,93;30,83;1,1;0;0;0;5182;5112;-70
2951;02.05.2016;'23 - 24;27,05;27,02;0,03;0;0;0;5744;5664;-80
2952;03.05.2016;'00 - 01;23,91;24,11;-0,2;0;0;0;6730;6107;-623
2953;03.05.2016;'01 - 02;22,32;20,45;1,87;0;0;0;6632;6374;-258
2954;03.05.2016;'02 - 03;21,84;20,34;1,5;0;0;0;6165;6059;-106
2955;03.05.2016;'03 - 04;21,37;19,29;2,08;0;0;0;5642;5507;-135
2956;03.05.2016;'04 - 05;21,85;19,01;2,84;0;0;0;5222;4994;-228
2957;03.05.2016;'05 - 06;23,26;21,52;1,74;26;22;-4;4904;4794;-110
2958;03.05.2016;'06 - 07;30,39;30,32;0,07;713;833;120;4767;4875;108
2959;03.05.2016;'07 - 08;33,9;31,29;2,61;3113;3495;382;4475;5248;773
2960;03.05.2016;'08 - 09;36,48;29,72;6,76;6470;7397;927;4088;5331;1243
2961;03.05.2016;'09 - 10;35,95;27,48;8,47;9998;11426;1428;4195;5132;937
2962;03.05.2016;'10 - 11;35,58;25,54;10,04;12784;14718;1934;4623;5923;1300
2963;03.05.2016;'11 - 12;34,9;24,32;10,58;14447;16806;2359;5241;6722;1481
2964;03.05.2016;'12 - 13;31,55;22,18;9,37;15251;16990;1739;6223;7659;1436
2965;03.05.2016;'13 - 14;26,59;21,37;5,22;15020;15931;911;7388;8848;1460
2966;03.05.2016;'14 - 15;24,9;21,89;3,01;14176;14392;216;8746;11369;2623
2967;03.05.2016;'15 - 16;24,1;20,68;3,42;12507;12723;216;10343;13346;3003
2968;03.05.2016;'16 - 17;23,91;20,43;3,48;10061;10537;476;11829;15186;3357
2969;03.05.2016;'17 - 18;25,17;22,04;3,13;7202;7474;272;12544;13922;1378
2970;03.05.2016;'18 - 19;28,51;24,99;3,52;4179;4468;289;12342;15389;3047
2971;03.05.2016;'19 - 20;31,69;27,69;4;1564;1700;136;11689;13860;2171
2972;03.05.2016;'20 - 21;32,1;29,27;2,83;197;239;42;10865;11620;755
2973;03.05.2016;'21 - 22;32,8;29,26;3,54;0;0;0;10163;9697;-466
2974;03.05.2016;'22 - 23;30,92;29,13;1,79;0;0;0;9586;8904;-682
2975;03.05.2016;'23 - 24;24,59;29,03;-4,44;0;0;0;9165;8528;-637
2976;04.05.2016;'00 - 01;22,94;26,29;-3,35;0;0;0;8577;8121;-456
2977;04.05.2016;'01 - 02;21,98;23,77;-1,79;0;0;0;8226;7644;-582
2978;04.05.2016;'02 - 03;21,95;22,79;-0,84;0;0;0;7764;7357;-407
2979;04.05.2016;'03 - 04;21,69;22,52;-0,83;0;0;0;7211;6914;-297
2980;04.05.2016;'04 - 05;22,14;23,33;-1,19;0;0;0;6666;6276;-390
2981;04.05.2016;'05 - 06;23,59;25,22;-1,63;30;25;-5;6170;5490;-680
2982;04.05.2016;'06 - 07;31,47;34,5;-3,03;919;845;-74;5668;4649;-1019
2983;04.05.2016;'07 - 08;35,05;38,27;-3,22;4051;3627;-424;5102;3672;-1430
2984;04.05.2016;'08 - 09;35,97;37,23;-1,26;8862;8136;-726;4476;2998;-1478
2985;04.05.2016;'09 - 10;32,46;34,02;-1,56;14042;12848;-1194;3867;2924;-943
2986;04.05.2016;'10 - 11;28,51;28,67;-0,16;18515;16616;-1899;3340;2682;-658
2987;04.05.2016;'11 - 12;27,14;30,42;-3,28;21612;19104;-2508;3119;2493;-626
2988;04.05.2016;'12 - 13;25,43;27,95;-2,52;23142;20480;-2662;3005;2312;-693
2989;04.05.2016;'13 - 14;24,37;26,58;-2,21;23356;20947;-2409;2908;2170;-738
2990;04.05.2016;'14 - 15;24,01;26,31;-2,3;22334;20138;-2196;2884;2064;-820
2991;04.05.2016;'15 - 16;23,64;25;-1,36;19796;17865;-1931;2785;2014;-771
2992;04.05.2016;'16 - 17;23,88;24,15;-0,27;15927;14541;-1386;2625;2011;-614
2993;04.05.2016;'17 - 18;25,1;26,03;-0,93;11039;10367;-672;2363;1963;-400
2994;04.05.2016;'18 - 19;28,96;27,84;1,12;5882;6000;118;2079;1822;-257
2995;04.05.2016;'19 - 20;31,73;30,4;1,33;2061;2311;250;1920;1758;-162
2996;04.05.2016;'20 - 21;32;30,76;1,24;300;335;35;2108;1878;-230
2997;04.05.2016;'21 - 22;32,9;31,13;1,77;1;0;-1;2679;2601;-78
2998;04.05.2016;'22 - 23;31,93;29,04;2,89;0;0;0;3289;3794;505
2999;04.05.2016;'23 - 24;27,8;26,54;1,26;0;0;0;3755;4662;907
3000;05.05.2016;'00 - 01;23,69;21,74;1,95;0;0;0;4083;5148;1065
3001;05.05.2016;'01 - 02;21,86;20,47;1,39;0;0;0;4295;5309;1014
3002;05.05.2016;'02 - 03;21,26;17,72;3,54;0;0;0;4459;5293;834
3003;05.05.2016;'03 - 04;20,26;17,18;3,08;0;0;0;4552;5449;897
3004;05.05.2016;'04 - 05;19,79;16,97;2,82;0;0;0;4557;5171;614
3005;05.05.2016;'05 - 06;19,79;16,99;2,8;45;36;-9;4457;4924;467
3006;05.05.2016;'06 - 07;19,95;17,14;2,81;1129;1023;-106;4306;4772;466
3007;05.05.2016;'07 - 08;20,07;17,15;2,92;4780;4384;-396;4059;4132;73
3008;05.05.2016;'08 - 09;20;18,69;1,31;10444;9916;-528;3467;2642;-825
3009;05.05.2016;'09 - 10;19,57;19,4;0,17;16241;15801;-440;2985;2678;-307
3010;05.05.2016;'10 - 11;19,01;18,25;0,76;20784;20324;-460;2982;3688;706
3011;05.05.2016;'11 - 12;17,76;16,69;1,07;23700;23462;-238;3207;4178;971
3012;05.05.2016;'12 - 13;16,97;13,19;3,78;25086;25208;122;3498;4357;859
3013;05.05.2016;'13 - 14;13,42;7,47;5,95;25067;25369;302;3784;4458;674
3014;05.05.2016;'14 - 15;10,85;3,05;7,8;23552;24282;730;4146;4502;356
3015;05.05.2016;'15 - 16;10,49;4,94;5,55;20625;22133;1508;4483;4702;219
3016;05.05.2016;'16 - 17;13,06;4,51;8,55;16727;18272;1545;4887;5089;202
3017;05.05.2016;'17 - 18;17,77;12,68;5,09;11689;12900;1211;5298;5711;413
3018;05.05.2016;'18 - 19;20,67;18,01;2,66;6190;6845;655;5699;6184;485
3019;05.05.2016;'19 - 20;24,2;20,52;3,68;2138;2404;266;6095;6264;169
3020;05.05.2016;'20 - 21;24,08;23,8;0,28;328;354;26;7081;6741;-340
3021;05.05.2016;'21 - 22;24,87;24,75;0,12;2;0;-2;8776;9375;599
3022;05.05.2016;'22 - 23;25,79;25,41;0,38;0;0;0;10457;11510;1053
3023;05.05.2016;'23 - 24;21,62;21,29;0,33;0;0;0;11376;12926;1550
3024;06.05.2016;'00 - 01;20,73;17,21;3,52;0;0;0;10675;13264;2589
3025;06.05.2016;'01 - 02;19,08;17,2;1,88;0;0;0;10607;12614;2007
3026;06.05.2016;'02 - 03;18,46;15,95;2,51;0;0;0;10231;11906;1675
3027;06.05.2016;'03 - 04;17,87;14,84;3,03;0;0;0;9829;11283;1454
3028;06.05.2016;'04 - 05;19,11;15,98;3,13;0;0;0;9491;10567;1076
3029;06.05.2016;'05 - 06;20;17,93;2,07;56;46;-10;9192;9642;450
3030;06.05.2016;'06 - 07;24,44;24,25;0,19;1207;1176;-31;8848;9057;209
3031;06.05.2016;'07 - 08;30,33;29,53;0,8;4989;4828;-161;8095;7499;-596
3032;06.05.2016;'08 - 09;30,99;29,07;1,92;10859;10509;-350;6978;5130;-1848
3033;06.05.2016;'09 - 10;29,98;25,38;4,6;16857;16204;-653;6456;4241;-2215
3034;06.05.2016;'10 - 11;24,28;22,59;1,69;21773;21093;-680;6699;4884;-1815
3035;06.05.2016;'11 - 12;22,58;21,78;0,8;25067;24311;-756;7435;6509;-926
3036;06.05.2016;'12 - 13;19,66;18,04;1,62;26734;25930;-804;8515;8446;-69
3037;06.05.2016;'13 - 14;14,24;12,72;1,52;26894;26055;-839;9630;10401;771
3038;06.05.2016;'14 - 15;11,92;12,74;-0,82;25587;24841;-746;10484;11911;1427
3039;06.05.2016;'15 - 16;14,96;11,37;3,59;22719;22245;-474;10901;12435;1534
3040;06.05.2016;'16 - 17;17,93;11,14;6,79;18448;18179;-269;11102;12392;1290
3041;06.05.2016;'17 - 18;21,85;16,9;4,95;12774;12692;-82;11074;11875;801
3042;06.05.2016;'18 - 19;27,99;22,32;5,67;6607;6757;150;10786;11282;496
3043;06.05.2016;'19 - 20;30,94;25,43;5,51;2260;2351;91;10831;10120;-711
3044;06.05.2016;'20 - 21;28,8;24,82;3,98;367;352;-15;11659;10581;-1078
3045;06.05.2016;'21 - 22;27,86;25,98;1,88;2;0;-2;12864;13113;249
3046;06.05.2016;'22 - 23;25,43;25,87;-0,44;0;0;0;13838;15002;1164
3047;06.05.2016;'23 - 24;21,42;23,57;-2,15;0;0;0;14129;15777;1648
3048;07.05.2016;'00 - 01;19,73;18,31;1,42;0;0;0;13823;16106;2283
3049;07.05.2016;'01 - 02;16,9;11,11;5,79;0;0;0;13276;15415;2139
3050;07.05.2016;'02 - 03;14,95;10,03;4,92;0;0;0;12858;14215;1357
3051;07.05.2016;'03 - 04;14,64;9,09;5,55;0;0;0;12486;13447;961
3052;07.05.2016;'04 - 05;14,96;9,64;5,32;0;0;0;11990;12861;871
3053;07.05.2016;'05 - 06;15,2;9,96;5,24;64;56;-8;11629;12234;605
3054;07.05.2016;'06 - 07;16,27;12,79;3,48;1300;1207;-93;11125;11436;311
3055;07.05.2016;'07 - 08;19,32;15,48;3,84;5321;4954;-367;9792;9328;-464
3056;07.05.2016;'08 - 09;19,94;15,57;4,37;11316;10669;-647;8435;6049;-2386
3057;07.05.2016;'09 - 10;19,41;19,15;0,26;17340;16378;-962;7965;4842;-3123
3058;07.05.2016;'10 - 11;13,1;16,74;-3,64;22158;21070;-1088;8331;5761;-2570
3059;07.05.2016;'11 - 12;10,54;12,09;-1,55;25313;24168;-1145;9137;8742;-395
3060;07.05.2016;'12 - 13;6,12;7,83;-1,71;26860;25687;-1173;10537;12444;1907
3061;07.05.2016;'13 - 14;5,32;4,95;0,37;26976;25750;-1226;11862;13686;1824
3062;07.05.2016;'14 - 15;3,05;-1,22;4,27;25699;24542;-1157;12295;13629;1334
3063;07.05.2016;'15 - 16;3,84;2,47;1,37;22857;21800;-1057;12570;13807;1237
3064;07.05.2016;'16 - 17;8,67;9,96;-1,29;18569;17779;-790;12749;14364;1615
3065;07.05.2016;'17 - 18;13,49;10,59;2,9;12908;12392;-516;12814;14674;1860
3066;07.05.2016;'18 - 19;19,92;13,55;6,37;6728;6680;-48;12798;14286;1488
3067;07.05.2016;'19 - 20;21,43;14,19;7,24;2308;2439;131;12889;13528;639
3068;07.05.2016;'20 - 21;19,93;15,77;4,16;401;392;-9;13462;13983;521
3069;07.05.2016;'21 - 22;19,81;19,19;0,62;2;0;-2;14786;17134;2348
3070;07.05.2016;'22 - 23;19,72;14,53;5,19;0;0;0;15514;18906;3392
3071;07.05.2016;'23 - 24;18,22;11,45;6,77;0;0;0;15555;19034;3479
3072;08.05.2016;'00 - 01;14,2;5,44;8,76;0;0;0;16051;18878;2827
3073;08.05.2016;'01 - 02;10,01;1,8;8,21;0;0;0;15340;18094;2754
3074;08.05.2016;'02 - 03;7,98;-1,78;9,76;0;0;0;14695;17076;2381
3075;08.05.2016;'03 - 04;5,07;-7,15;12,22;0;0;0;14084;16112;2028
3076;08.05.2016;'04 - 05;4;-1,09;5,09;0;0;0;13626;15361;1735
3077;08.05.2016;'05 - 06;3;-1,08;4,08;74;65;-9;13148;14688;1540
3078;08.05.2016;'06 - 07;2,91;0,26;2,65;1314;1239;-75;12450;14404;1954
3079;08.05.2016;'07 - 08;2,79;0,36;2,43;5282;4972;-310;11373;12278;905
3080;08.05.2016;'08 - 09;4;5,47;-1,47;11369;10836;-533;10418;9397;-1021
3081;08.05.2016;'09 - 10;2,35;8,66;-6,31;17429;16688;-741;10844;9978;-866
3082;08.05.2016;'10 - 11;-1,63;5,59;-7,22;22223;21373;-850;12707;14762;2055
3083;08.05.2016;'11 - 12;-7,09;-5,09;-2;25314;24409;-905;14874;18936;4062
3084;08.05.2016;'12 - 13;-76,09;-78,53;2,44;26798;25961;-837;16669;16753;84
3085;08.05.2016;'13 - 14;-100,06;-123,46;23,4;26777;25966;-811;17830;15308;-2522
3086;08.05.2016;'14 - 15;-130,09;-155,52;25,43;25308;24593;-715;18316;13816;-4500
3087;08.05.2016;'15 - 16;-82,06;-99,46;17,4;22343;21888;-455;18203;16282;-1921
3088;08.05.2016;'16 - 17;-76;-65,39;-10,61;18145;17762;-383;17727;19728;2001
3089;08.05.2016;'17 - 18;-0,6;-15,1;14,5;12614;12477;-137;17322;21186;3864
3090;08.05.2016;'18 - 19;10,4;11,43;-1,03;6616;6746;130;16793;21083;4290
3091;08.05.2016;'19 - 20;19,35;16,3;3,05;2311;2422;111;15929;18785;2856
3092;08.05.2016;'20 - 21;19,4;23,32;-3,92;423;422;-1;15695;16447;752
3093;08.05.2016;'21 - 22;20,02;29,7;-9,68;4;0;-4;16009;17140;1131
3094;08.05.2016;'22 - 23;20,12;27,96;-7,84;0;0;0;16361;17958;1597
3095;08.05.2016;'23 - 24;18,66;23,48;-4,82;0;0;0;16142;18184;2042
3096;09.05.2016;'00 - 01;14,28;18,12;-3,84;0;0;0;16221;17763;1542
3097;09.05.2016;'01 - 02;12,68;15,54;-2,86;0;0;0;15483;17132;1649
3098;09.05.2016;'02 - 03;12,09;14,38;-2,29;0;0;0;14807;16074;1267
3099;09.05.2016;'03 - 04;9,57;15,26;-5,69;0;0;0;14333;15128;795
3100;09.05.2016;'04 - 05;11;18,21;-7,21;0;0;0;13959;14736;777
3101;09.05.2016;'05 - 06;14,18;21,92;-7,74;83;71;-12;13499;14448;949
3102;09.05.2016;'06 - 07;28,57;28,63;-0,06;1375;1265;-110;12842;13391;549
3103;09.05.2016;'07 - 08;32,95;35,26;-2,31;5280;4974;-306;11807;10842;-965
3104;09.05.2016;'08 - 09;34,69;49,19;-14,5;11103;10652;-451;10786;8654;-2132
3105;09.05.2016;'09 - 10;31,24;39,7;-8,46;16895;16335;-560;11142;10232;-910
3106;09.05.2016;'10 - 11;24,23;27,19;-2,96;21429;20798;-631;12526;14034;1508
3107;09.05.2016;'11 - 12;22,15;22,61;-0,46;24325;23642;-683;14047;17504;3457
3108;09.05.2016;'12 - 13;17,08;16,54;0,54;25610;24940;-670;15383;18018;2635
3109;09.05.2016;'13 - 14;12,01;12,58;-0,57;25313;24600;-713;16369;18851;2482
3110;09.05.2016;'14 - 15;10,85;13,46;-2,61;23657;23011;-646;16681;18812;2131
3111;09.05.2016;'15 - 16;18,63;22,46;-3,83;20622;20375;-247;16433;18548;2115
3112;09.05.2016;'16 - 17;21;23,68;-2,68;16481;16387;-94;15961;18159;2198
3113;09.05.2016;'17 - 18;23,71;30,81;-7,1;11315;11318;3;15366;17084;1718
3114;09.05.2016;'18 - 19;27,12;38,3;-11,18;6022;6303;281;14441;15859;1418
3115;09.05.2016;'19 - 20;31,46;41,58;-10,12;2211;2388;177;13306;13750;444
3116;09.05.2016;'20 - 21;31,28;40,65;-9,37;386;367;-19;13267;12900;-367
3117;09.05.2016;'21 - 22;30;40,27;-10,27;3;1;-2;13846;14435;589
3118;09.05.2016;'22 - 23;24,92;34,95;-10,03;0;0;0;14203;15157;954
3119;09.05.2016;'23 - 24;21,83;28,46;-6,63;0;0;0;14207;15198;991
3120;10.05.2016;'00 - 01;22,55;23,4;-0,85;0;0;0;13842;14838;996
3121;10.05.2016;'01 - 02;21,09;23,74;-2,65;0;0;0;13285;13769;484
3122;10.05.2016;'02 - 03;19,61;23,71;-4,1;0;0;0;12773;12863;90
3123;10.05.2016;'03 - 04;19,33;22,76;-3,43;0;0;0;12169;12478;309
3124;10.05.2016;'04 - 05;19,87;20,49;-0,62;0;0;0;11768;12450;682
3125;10.05.2016;'05 - 06;21,56;22,2;-0,64;88;80;-8;11387;12054;667
3126;10.05.2016;'06 - 07;28,5;30,35;-1,85;1208;1260;52;10887;11111;224
3127;10.05.2016;'07 - 08;31,87;40,54;-8,67;4470;4459;-11;10072;9099;-973
3128;10.05.2016;'08 - 09;36,66;50,18;-13,52;8952;8986;34;9263;6928;-2335
3129;10.05.2016;'09 - 10;34,61;39,88;-5,27;13217;13104;-113;9264;7541;-1723
3130;10.05.2016;'10 - 11;29,96;29,76;0,2;16415;16361;-54;10247;9914;-333
3131;10.05.2016;'11 - 12;25,54;27,38;-1,84;18278;18494;216;11084;11362;278
3132;10.05.2016;'12 - 13;23,46;24,36;-0,9;18961;19140;179;11506;11173;-333
3133;10.05.2016;'13 - 14;23,34;25,29;-1,95;18470;18148;-322;11473;9943;-1530
3134;10.05.2016;'14 - 15;23,41;27,22;-3,81;17084;16436;-648;11142;10509;-633
3135;10.05.2016;'15 - 16;27,6;27,58;0,02;14856;14242;-614;10710;10665;-45
3136;10.05.2016;'16 - 17;28,21;30,45;-2,24;11959;11565;-394;10334;10525;191
3137;10.05.2016;'17 - 18;30,69;32,31;-1,62;8427;8259;-168;10065;10839;774
3138;10.05.2016;'18 - 19;31,93;31,37;0,56;4716;4890;174;9888;10536;648
3139;10.05.2016;'19 - 20;32,5;32,68;-0,18;1819;1988;169;9808;9756;-52
3140;10.05.2016;'20 - 21;32,25;33,06;-0,81;331;297;-34;10291;10001;-290
3141;10.05.2016;'21 - 22;31,99;31,58;0,41;3;1;-2;10838;11303;465
3142;10.05.2016;'22 - 23;29,96;30,36;-0,4;0;0;0;11202;12273;1071
3143;10.05.2016;'23 - 24;22,34;23,67;-1,33;0;0;0;11154;12397;1243
3144;11.05.2016;'00 - 01;22,4;25,96;-3,56;0;0;0;11572;11744;172
3145;11.05.2016;'01 - 02;20,54;23,17;-2,63;0;0;0;11045;11199;154
3146;11.05.2016;'02 - 03;19,92;21,34;-1,42;0;0;0;10571;10475;-96
3147;11.05.2016;'03 - 04;19,11;18,85;0,26;0;0;0;10128;9756;-372
3148;11.05.2016;'04 - 05;19,87;19,76;0,11;0;0;0;9764;9281;-483
3149;11.05.2016;'05 - 06;21,84;24,63;-2,79;95;90;-5;9388;8966;-422
3150;11.05.2016;'06 - 07;28,96;31,41;-2,45;1384;1350;-34;8864;8733;-131
3151;11.05.2016;'07 - 08;35,27;36,8;-1,53;5063;4842;-221;8100;7434;-666
3152;11.05.2016;'08 - 09;39,6;38,75;0,85;10357;9430;-927;7450;5784;-1666
3153;11.05.2016;'09 - 10;34,94;31,81;3,13;15630;14038;-1592;7670;5748;-1922
3154;11.05.2016;'10 - 11;29,41;28,49;0,92;19800;18186;-1614;8396;7751;-645
3155;11.05.2016;'11 - 12;24,58;27,56;-2,98;22503;21068;-1435;9628;11646;2018
3156;11.05.2016;'12 - 13;22,19;23,21;-1,02;23700;21365;-2335;11162;14520;3358
3157;11.05.2016;'13 - 14;20,87;20,72;0,15;23229;21411;-1818;12236;14683;2447
3158;11.05.2016;'14 - 15;20,74;21,4;-0,66;21393;20523;-870;12890;14643;1753
3159;11.05.2016;'15 - 16;21,73;23,13;-1,4;18370;17548;-822;13216;15322;2106
3160;11.05.2016;'16 - 17;22,54;24,69;-2,15;14558;13540;-1018;13629;15848;2219
3161;11.05.2016;'17 - 18;23,36;25,63;-2,27;10029;9400;-629;14184;16092;1908
3162;11.05.2016;'18 - 19;25,87;30;-4,13;5436;5282;-154;14483;15716;1233
3163;11.05.2016;'19 - 20;31,32;33,8;-2,48;2083;2162;79;14625;14989;364
3164;11.05.2016;'20 - 21;29,94;32,6;-2,66;384;402;18;15348;14629;-719
3165;11.05.2016;'21 - 22;25,09;30,18;-5,09;3;2;-1;16142;16033;-109
3166;11.05.2016;'22 - 23;22,23;28,58;-6,35;0;0;0;16693;16322;-371
3167;11.05.2016;'23 - 24;19,44;25,62;-6,18;0;0;0;16905;16790;-115
3168;12.05.2016;'00 - 01;19,5;19,1;0,4;0;0;0;16359;16891;532
3169;12.05.2016;'01 - 02;17,81;15,92;1,89;0;0;0;16171;16384;213
3170;12.05.2016;'02 - 03;14,67;14,87;-0,2;0;0;0;15969;15981;12
3171;12.05.2016;'03 - 04;14;13,51;0,49;0;0;0;15700;15514;-186
3172;12.05.2016;'04 - 05;13,02;13,83;-0,81;0;0;0;15409;14922;-487
3173;12.05.2016;'05 - 06;18,08;18,39;-0,31;100;88;-12;14965;14263;-702
3174;12.05.2016;'06 - 07;24,08;21,44;2,64;1196;1158;-38;14291;13454;-837
3175;12.05.2016;'07 - 08;30,93;29,49;1,44;4171;3988;-183;13517;11688;-1829
3176;12.05.2016;'08 - 09;34,05;36,67;-2,62;8054;7718;-336;13067;9604;-3463
3177;12.05.2016;'09 - 10;30,96;33,74;-2,78;11612;11377;-235;13415;9286;-4129
3178;12.05.2016;'10 - 11;28,93;28,9;0,03;14016;13937;-79;14063;10868;-3195
3179;12.05.2016;'11 - 12;26,95;27,26;-0,31;15235;15167;-68;14857;13609;-1248
3180;12.05.2016;'12 - 13;25,24;28,5;-3,26;15607;15161;-446;15557;16172;615
3181;12.05.2016;'13 - 14;24,15;28,69;-4,54;15243;14363;-880;15937;16948;1011
3182;12.05.2016;'14 - 15;24,75;29,61;-4,86;14033;13039;-994;15905;16860;955
3183;12.05.2016;'15 - 16;25,07;28,35;-3,28;12176;11490;-686;15392;16036;644
3184;12.05.2016;'16 - 17;25,14;28,56;-3,42;9790;9496;-294;14813;15523;710
3185;12.05.2016;'17 - 18;27,47;31,4;-3,93;6862;6844;-18;14229;15443;1214
3186;12.05.2016;'18 - 19;29,79;35,27;-5,48;3933;3988;55;13552;15044;1492
3187;12.05.2016;'19 - 20;32,91;34,26;-1,35;1621;1694;73;12714;13968;1254
3188;12.05.2016;'20 - 21;32,85;30,79;2,06;311;348;37;12373;13248;875
3189;12.05.2016;'21 - 22;31,84;28,02;3,82;4;5;1;11967;12530;563
3190;12.05.2016;'22 - 23;29,98;26,83;3,15;0;0;0;11270;11091;-179
3191;12.05.2016;'23 - 24;25,14;25,16;-0,02;0;0;0;10488;10063;-425
3192;13.05.2016;'00 - 01;23,07;20,76;2,31;0;0;0;9313;9211;-102
3193;13.05.2016;'01 - 02;21,41;20,42;0,99;0;0;0;8561;8352;-209
3194;13.05.2016;'02 - 03;21,04;18,88;2,16;0;0;0;7843;7803;-40
3195;13.05.2016;'03 - 04;20,55;17,72;2,83;0;0;0;7221;7344;123
3196;13.05.2016;'04 - 05;21,13;16,51;4,62;0;0;0;6682;6894;212
3197;13.05.2016;'05 - 06;23;19,53;3,47;86;70;-16;6130;6212;82
3198;13.05.2016;'06 - 07;28,07;22,42;5,65;1011;910;-101;5466;5519;53
3199;13.05.2016;'07 - 08;36,14;35,31;0,83;3365;3030;-335;4721;4224;-497
3200;13.05.2016;'08 - 09;40,21;37,87;2,34;6537;6004;-533;4299;3106;-1193
3201;13.05.2016;'09 - 10;38,23;37,28;0,95;9862;9322;-540;4428;3132;-1296
3202;13.05.2016;'10 - 11;35,37;33,45;1,92;12696;12438;-258;4792;3973;-819
3203;13.05.2016;'11 - 12;35,45;33,33;2,12;14729;14604;-125;5521;5517;-4
3204;13.05.2016;'12 - 13;30,94;28,5;2,44;15868;15844;-24;6597;7008;411
3205;13.05.2016;'13 - 14;27,99;26,39;1,6;16112;16024;-88;7785;8187;402
3206;13.05.2016;'14 - 15;25,28;25,15;0,13;15572;15777;205;8920;10286;1366
3207;13.05.2016;'15 - 16;23,8;22,66;1,14;14076;14391;315;10015;12474;2459
3208;13.05.2016;'16 - 17;23,53;21,43;2,1;11678;11864;186;11050;13573;2523
3209;13.05.2016;'17 - 18;24,01;22,66;1,35;8469;8477;8;11854;14119;2265
3210;13.05.2016;'18 - 19;26,37;27,17;-0,8;4958;4809;-149;12108;14160;2052
3211;13.05.2016;'19 - 20;29;29,97;-0,97;2009;1946;-63;12083;13260;1177
3212;13.05.2016;'20 - 21;27,1;28,61;-1,51;382;410;28;12091;11993;-98
3213;13.05.2016;'21 - 22;25,03;27;-1,97;5;6;1;12399;11146;-1253
3214;13.05.2016;'22 - 23;26,96;27,77;-0,81;0;0;0;12769;11236;-1533
3215;13.05.2016;'23 - 24;23,02;27,29;-4,27;0;0;0;13196;11588;-1608
3216;14.05.2016;'00 - 01;13,76;20,74;-6,98;0;0;0;12970;11893;-1077
3217;14.05.2016;'01 - 02;13,1;18,71;-5,61;0;0;0;13351;12289;-1062
3218;14.05.2016;'02 - 03;11,51;14,75;-3,24;0;0;0;13753;12804;-949
3219;14.05.2016;'03 - 04;9,71;13,97;-4,26;0;0;0;14174;13432;-742
3220;14.05.2016;'04 - 05;10,37;12,19;-1,82;0;0;0;14570;13916;-654
3221;14.05.2016;'05 - 06;10,21;11,17;-0,96;111;90;-21;14896;14014;-882
3222;14.05.2016;'06 - 07;9,91;13,32;-3,41;1281;1144;-137;15171;14179;-992
3223;14.05.2016;'07 - 08;11,24;15,6;-4,36;4334;3686;-648;15539;14277;-1262
3224;14.05.2016;'08 - 09;15,57;22,11;-6,54;8377;6797;-1580;15818;15666;-152
3225;14.05.2016;'09 - 10;14,86;18,1;-3,24;12412;9970;-2442;15902;16230;328
3226;14.05.2016;'10 - 11;11,99;15,26;-3,27;15793;12641;-3152;16053;16441;388
3227;14.05.2016;'11 - 12;11,37;17,5;-6,13;18180;14918;-3262;16296;17141;845
3228;14.05.2016;'12 - 13;10,27;17,55;-7,28;19450;15741;-3709;16668;17333;665
3229;14.05.2016;'13 - 14;8,14;15,34;-7,2;19398;15765;-3633;17196;17918;722
3230;14.05.2016;'14 - 15;7,01;13,45;-6,44;18179;14938;-3241;17923;18643;720
3231;14.05.2016;'15 - 16;4,95;12,99;-8,04;15992;12562;-3430;18819;19022;203
3232;14.05.2016;'16 - 17;4,92;11,9;-6,98;13065;9995;-3070;19454;19456;2
3233;14.05.2016;'17 - 18;9,91;17,71;-7,8;9371;7156;-2215;19572;19536;-36
3234;14.05.2016;'18 - 19;15,01;22,21;-7,2;5467;4270;-1197;18937;18697;-240
3235;14.05.2016;'19 - 20;20,71;24,31;-3,6;2281;1945;-336;17938;17697;-241
3236;14.05.2016;'20 - 21;20,46;26,31;-5,85;435;385;-50;16877;16282;-595
3237;14.05.2016;'21 - 22;19,3;27,41;-8,11;7;6;-1;16023;14788;-1235
3238;14.05.2016;'22 - 23;23,6;31,7;-8,1;0;0;0;15461;14547;-914
3239;14.05.2016;'23 - 24;20,52;28,12;-7,6;0;0;0;15406;14907;-499
3240;15.05.2016;'00 - 01;20;18,75;1,25;0;0;0;15763;14820;-943
3241;15.05.2016;'01 - 02;12,98;11,24;1,74;0;0;0;16126;15437;-689
3242;15.05.2016;'02 - 03;11,94;9,02;2,92;0;0;0;16292;15472;-820
3243;15.05.2016;'03 - 04;9,13;5,13;4;0;0;0;16372;15313;-1059
3244;15.05.2016;'04 - 05;9,19;5,18;4,01;0;0;0;16462;15226;-1236
3245;15.05.2016;'05 - 06;9,56;5;4,56;108;87;-21;16484;15435;-1049
3246;15.05.2016;'06 - 07;7,1;4,77;2,33;1318;1191;-127;16440;15479;-961
3247;15.05.2016;'07 - 08;5,63;2,53;3,1;4388;3687;-701;16522;15218;-1304
3248;15.05.2016;'08 - 09;5,5;5,14;0,36;8375;6764;-1611;16866;15487;-1379
3249;15.05.2016;'09 - 10;4,57;7,97;-3,4;12349;10232;-2117;17197;16738;-459
3250;15.05.2016;'10 - 11;3,5;10,95;-7,45;15420;12226;-3194;17367;18018;651
3251;15.05.2016;'11 - 12;3,63;13,5;-9,87;17467;13224;-4243;17711;19134;1423
3252;15.05.2016;'12 - 13;0,73;15,48;-14,75;18253;13899;-4354;18379;19429;1050
3253;15.05.2016;'13 - 14;-9,25;13,46;-22,71;17749;14752;-2997;19118;19951;833
3254;15.05.2016;'14 - 15;-35,02;1,41;-36,43;16396;14710;-1686;19294;20029;735
3255;15.05.2016;'15 - 16;-8,24;3,62;-11,86;14375;13401;-974;19530;20349;819
3256;15.05.2016;'16 - 17;-2,97;4,37;-7,34;11877;11146;-731;19630;19710;80
3257;15.05.2016;'17 - 18;2,49;11,12;-8,63;8739;8130;-609;18955;18978;23
3258;15.05.2016;'18 - 19;14,45;18,93;-4,48;5273;4902;-371;17320;18200;880
3259;15.05.2016;'19 - 20;21,41;25,64;-4,23;2307;2192;-115;15542;16077;535
3260;15.05.2016;'20 - 21;21,69;25,1;-3,41;429;385;-44;14047;14058;11
3261;15.05.2016;'21 - 22;22,95;25,33;-2,38;7;7;0;13113;13065;-48
3262;15.05.2016;'22 - 23;24,28;27,47;-3,19;0;0;0;12511;12621;110
3263;15.05.2016;'23 - 24;22,36;23,28;-0,92;0;0;0;12217;13078;861
3264;16.05.2016;'00 - 01;17,85;15,81;2,04;0;0;0;12046;12562;516
3265;16.05.2016;'01 - 02;16,86;15,44;1,42;0;0;0;12024;12060;36
3266;16.05.2016;'02 - 03;16,06;15,15;0,91;0;0;0;11957;11727;-230
3267;16.05.2016;'03 - 04;15,04;16,35;-1,31;0;0;0;11719;11276;-443
3268;16.05.2016;'04 - 05;14,06;16,71;-2,65;1;0;-1;11418;11226;-192
3269;16.05.2016;'05 - 06;15,93;17,61;-1,68;121;94;-27;11155;11154;-1
3270;16.05.2016;'06 - 07;16,42;17,35;-0,93;1212;1082;-130;10900;10104;-796
3271;16.05.2016;'07 - 08;19,43;19,58;-0,15;3801;3220;-581;10713;9615;-1098
3272;16.05.2016;'08 - 09;22,54;22,58;-0,04;6996;5721;-1275;10631;9984;-647
3273;16.05.2016;'09 - 10;22,91;25,39;-2,48;10166;8235;-1931;10573;10930;357
3274;16.05.2016;'10 - 11;23,11;24,96;-1,85;12825;10332;-2493;10518;10890;372
3275;16.05.2016;'11 - 12;23,35;25,35;-2;14706;12057;-2649;10584;10598;14
3276;16.05.2016;'12 - 13;22,9;25,67;-2,77;15624;13066;-2558;10830;10998;168
3277;16.05.2016;'13 - 14;18,23;23,27;-5,04;15643;13260;-2383;11191;11119;-72
3278;16.05.2016;'14 - 15;16,09;20,81;-4,72;15025;12949;-2076;11767;11952;185
3279;16.05.2016;'15 - 16;16,26;21,09;-4,83;13617;11918;-1699;12490;12460;-30
3280;16.05.2016;'16 - 17;17,15;20,08;-2,93;11313;9698;-1615;13061;12927;-134
3281;16.05.2016;'17 - 18;18,27;21;-2,73;8289;7124;-1165;13124;13032;-92
3282;16.05.2016;'18 - 19;24;27,8;-3,8;5037;4420;-617;12527;12983;456
3283;16.05.2016;'19 - 20;27,16;27,64;-0,48;2192;2063;-129;11684;11876;192
3284;16.05.2016;'20 - 21;28,37;26,8;1,57;439;415;-24;10579;10498;-81
3285;16.05.2016;'21 - 22;31,93;27,36;4,57;9;6;-3;10060;9537;-523
3286;16.05.2016;'22 - 23;29,99;27,03;2,96;0;0;0;9945;9300;-645
3287;16.05.2016;'23 - 24;24,99;22,45;2,54;0;0;0;10052;9952;-100
3288;17.05.2016;'00 - 01;30;24,39;5,61;0;0;0;9385;9973;588
3289;17.05.2016;'01 - 02;24;18,47;5,53;0;0;0;9641;10170;529
3290;17.05.2016;'02 - 03;22,82;17,82;5;0;0;0;9900;10425;525
3291;17.05.2016;'03 - 04;21,6;18,02;3,58;0;0;0;10126;10266;140
3292;17.05.2016;'04 - 05;21,73;17,28;4,45;1;0;-1;10318;10485;167
3293;17.05.2016;'05 - 06;22,91;17,32;5,59;117;90;-27;10458;10313;-145
3294;17.05.2016;'06 - 07;29,95;24,71;5,24;1359;1103;-256;10435;9693;-742
3295;17.05.2016;'07 - 08;36,36;34,55;1,81;4158;3119;-1039;10527;9349;-1178
3296;17.05.2016;'08 - 09;38;39,32;-1,32;7533;5598;-1935;10929;9732;-1197
3297;17.05.2016;'09 - 10;30,93;39,58;-8,65;10763;8505;-2258;11605;10808;-797
3298;17.05.2016;'10 - 11;28,99;36,9;-7,91;12790;11106;-1684;12161;10833;-1328
3299;17.05.2016;'11 - 12;32,22;35,93;-3,71;13785;12340;-1445;12536;10447;-2089
3300;17.05.2016;'12 - 13;31,61;34,13;-2,52;14235;12769;-1466;12691;10377;-2314
3301;17.05.2016;'13 - 14;30,08;34,62;-4,54;14365;12281;-2084;12660;10494;-2166
3302;17.05.2016;'14 - 15;29,93;34,49;-4,56;13829;11563;-2266;12400;10256;-2144
3303;17.05.2016;'15 - 16;30;34,46;-4,46;12496;10681;-1815;12140;9769;-2371
3304;17.05.2016;'16 - 17;30,02;33,33;-3,31;10498;9202;-1296;11602;9015;-2587
3305;17.05.2016;'17 - 18;30,14;35,68;-5,54;7905;7183;-722;10450;7706;-2744
3306;17.05.2016;'18 - 19;34,64;36,73;-2,09;4937;4821;-116;8712;6461;-2251
3307;17.05.2016;'19 - 20;34,92;36,55;-1,63;2222;2307;85;6910;4870;-2040
3308;17.05.2016;'20 - 21;36,76;36,17;0,59;435;481;46;5584;3622;-1962
3309;17.05.2016;'21 - 22;37,44;36,39;1,05;8;7;-1;4982;3209;-1773
3310;17.05.2016;'22 - 23;33,22;35,86;-2,64;0;0;0;4691;3418;-1273
3311;17.05.2016;'23 - 24;29;30,64;-1,64;0;0;0;4692;3794;-898
3312;18.05.2016;'00 - 01;24,91;22,69;2,22;0;0;0;3862;4002;140
3313;18.05.2016;'01 - 02;24,29;21,49;2,8;0;0;0;4216;4036;-180
3314;18.05.2016;'02 - 03;23,89;21,59;2,3;0;0;0;4545;4084;-461
3315;18.05.2016;'03 - 04;22,92;23,3;-0,38;0;0;0;4837;4282;-555
3316;18.05.2016;'04 - 05;23,31;22,35;0,96;1;0;-1;5082;4679;-403
3317;18.05.2016;'05 - 06;24,57;22,71;1,86;140;116;-24;5186;4896;-290
3318;18.05.2016;'06 - 07;31,12;27,96;3,16;1215;1196;-19;5070;4823;-247
3319;18.05.2016;'07 - 08;37,06;35,93;1,13;4261;3878;-383;4752;4204;-548
3320;18.05.2016;'08 - 09;39,48;38,83;0,65;8868;7684;-1184;4220;3062;-1158
3321;18.05.2016;'09 - 10;35,31;36,03;-0,72;13878;12316;-1562;4046;3056;-990
3322;18.05.2016;'10 - 11;32,58;29,85;2,73;17421;16294;-1127;4333;3682;-651
3323;18.05.2016;'11 - 12;30,98;28,91;2,07;18818;18574;-244;4721;3867;-854
3324;18.05.2016;'12 - 13;31,12;28,86;2,26;19034;18796;-238;4913;4276;-637
3325;18.05.2016;'13 - 14;30,9;26,67;4,23;18467;17342;-1125;4954;4230;-724
3326;18.05.2016;'14 - 15;30,87;26,88;3,99;17102;15485;-1617;4727;3738;-989
3327;18.05.2016;'15 - 16;30,85;28,72;2,13;14953;13396;-1557;4172;3441;-731
3328;18.05.2016;'16 - 17;31,32;31,51;-0,19;12251;11048;-1203;3409;2918;-491
3329;18.05.2016;'17 - 18;31,69;31,56;0,13;8864;8255;-609;2641;2364;-277
3330;18.05.2016;'18 - 19;33,08;34,67;-1,59;5291;4885;-406;2201;1925;-276
3331;18.05.2016;'19 - 20;34,94;37,49;-2,55;2326;2064;-262;1966;1971;5
3332;18.05.2016;'20 - 21;34,64;36,79;-2,15;463;372;-91;2243;2334;91
3333;18.05.2016;'21 - 22;34,95;38,03;-3,08;9;6;-3;3235;3034;-201
3334;18.05.2016;'22 - 23;33,09;36,12;-3,03;0;0;0;4389;3820;-569
3335;18.05.2016;'23 - 24;27,2;28,61;-1,41;0;0;0;5112;4464;-648
3336;19.05.2016;'00 - 01;24,88;25,86;-0,98;0;0;0;5544;4852;-692
3337;19.05.2016;'01 - 02;22,91;26,02;-3,11;0;0;0;5533;4947;-586
3338;19.05.2016;'02 - 03;22,23;25,67;-3,44;0;0;0;5203;4709;-494
3339;19.05.2016;'03 - 04;21,85;23,34;-1,49;0;0;0;4600;4196;-404
3340;19.05.2016;'04 - 05;22,29;22,57;-0,28;0;0;0;4013;3658;-355
3341;19.05.2016;'05 - 06;23,9;26,13;-2,23;124;112;-12;3376;3134;-242
3342;19.05.2016;'06 - 07;31,58;26,83;4,75;1080;1031;-49;2729;2514;-215
3343;19.05.2016;'07 - 08;39,4;40;-0,6;3100;2997;-103;2082;1914;-168
3344;19.05.2016;'08 - 09;46;51,32;-5,32;5535;5394;-141;1533;1394;-139
3345;19.05.2016;'09 - 10;44,13;43,19;0,94;8113;8205;92;1216;1071;-145
3346;19.05.2016;'10 - 11;45;40,81;4,19;10330;10769;439;1052;1000;-52
3347;19.05.2016;'11 - 12;44,91;38,28;6,63;12008;12775;767;966;1008;42
3348;19.05.2016;'12 - 13;40,07;34,4;5,67;13020;13764;744;952;971;19
3349;19.05.2016;'13 - 14;38,96;34,49;4,47;13178;13687;509;923;926;3
3350;19.05.2016;'14 - 15;35;32,8;2,2;12684;13126;442;906;974;68
3351;19.05.2016;'15 - 16;33,06;31;2,06;11563;11959;396;983;988;5
3352;19.05.2016;'16 - 17;31,91;29,79;2,12;9764;10176;412;1112;1159;47
3353;19.05.2016;'17 - 18;32,35;29,24;3,11;7367;7927;560;1246;1374;128
3354;19.05.2016;'18 - 19;34;30,8;3,2;4656;5018;362;1334;1704;370
3355;19.05.2016;'19 - 20;36,08;31,49;4,59;2171;2319;148;1448;1932;484
3356;19.05.2016;'20 - 21;34,96;31,55;3,41;480;526;46;1685;2229;544
3357;19.05.2016;'21 - 22;33,85;31,6;2,25;10;10;0;2325;3051;726
3358;19.05.2016;'22 - 23;32,08;29,24;2,84;0;0;0;3101;3982;881
3359;19.05.2016;'23 - 24;29,14;27,67;1,47;0;0;0;3829;4757;928
3360;20.05.2016;'00 - 01;24,73;22,86;1,87;0;0;0;4304;5240;936
3361;20.05.2016;'01 - 02;23,42;21,06;2,36;0;0;0;4801;6193;1392
3362;20.05.2016;'02 - 03;21,5;20,02;1,48;0;0;0;5385;7204;1819
3363;20.05.2016;'03 - 04;21,34;18,57;2,77;0;0;0;5951;8125;2174
3364;20.05.2016;'04 - 05;21,52;18,93;2,59;1;0;-1;6448;9031;2583
3365;20.05.2016;'05 - 06;23,23;21,43;1,8;163;147;-16;6628;9261;2633
3366;20.05.2016;'06 - 07;27,71;24,52;3,19;1558;1425;-133;6630;9438;2808
3367;20.05.2016;'07 - 08;33,07;28,97;4,1;4753;4344;-409;6539;8481;1942
3368;20.05.2016;'08 - 09;34,97;32,84;2,13;8900;8338;-562;6672;7958;1286
3369;20.05.2016;'09 - 10;31,91;26,49;5,42;12884;12398;-486;7283;8678;1395
3370;20.05.2016;'10 - 11;27,5;23,47;4,03;15586;15528;-58;7994;9630;1636
3371;20.05.2016;'11 - 12;26,27;22,24;4,03;16870;16424;-446;8622;10126;1504
3372;20.05.2016;'12 - 13;24,99;24,79;0,2;17135;16219;-916;9038;10243;1205
3373;20.05.2016;'13 - 14;24,3;25,1;-0,8;16516;15343;-1173;9301;10406;1105
3374;20.05.2016;'14 - 15;24,22;25,2;-0,98;15076;14412;-664;9225;9778;553
3375;20.05.2016;'15 - 16;24,2;24,68;-0,48;12998;13129;131;8853;9422;569
3376;20.05.2016;'16 - 17;24,57;25,38;-0,81;10640;11042;402;8152;8522;370
3377;20.05.2016;'17 - 18;28,9;27,55;1,35;7859;8158;299;7132;7527;395
3378;20.05.2016;'18 - 19;32,69;30,64;2,05;4825;4902;77;6009;6652;643
3379;20.05.2016;'19 - 20;33,92;31,48;2,44;2213;2156;-57;4862;5708;846
3380;20.05.2016;'20 - 21;34,06;31,95;2,11;473;424;-49;3982;4519;537
3381;20.05.2016;'21 - 22;33,21;32,39;0,82;10;8;-2;3626;3711;85
3382;20.05.2016;'22 - 23;33,66;31,87;1,79;0;0;0;3475;3768;293
3383;20.05.2016;'23 - 24;27,98;26,45;1,53;0;0;0;3414;3778;364
3384;21.05.2016;'00 - 01;24,36;23,82;0,54;0;0;0;3692;3620;-72
3385;21.05.2016;'01 - 02;23,49;23,25;0,24;0;0;0;3656;3614;-42
3386;21.05.2016;'02 - 03;22,6;24,74;-2,14;0;0;0;3663;3625;-38
3387;21.05.2016;'03 - 04;21,75;22,41;-0,66;0;0;0;3723;3887;164
3388;21.05.2016;'04 - 05;21,26;21,59;-0,33;1;0;-1;3799;4183;384
3389;21.05.2016;'05 - 06;20,5;21,06;-0,56;148;159;11;3776;4459;683
3390;21.05.2016;'06 - 07;20,66;20,79;-0,13;1502;1636;134;3679;4800;1121
3391;21.05.2016;'07 - 08;22,88;24,35;-1,47;4636;4710;74;3529;4496;967
3392;21.05.2016;'08 - 09;23,06;24,3;-1,24;9052;9204;152;3494;3912;418
3393;21.05.2016;'09 - 10;22,55;26;-3,45;13881;13978;97;3731;4192;461
3394;21.05.2016;'10 - 11;20,32;23,28;-2,96;17825;18154;329;4099;4998;899
3395;21.05.2016;'11 - 12;18,95;21,03;-2,08;20431;20429;-2;4460;6044;1584
3396;21.05.2016;'12 - 13;16,19;19,39;-3,2;21644;21354;-290;4742;6184;1442
3397;21.05.2016;'13 - 14;15,24;19,24;-4;21576;21482;-94;4898;6525;1627
3398;21.05.2016;'14 - 15;15,09;16,92;-1,83;20432;20300;-132;4879;6950;2071
3399;21.05.2016;'15 - 16;13,29;12,44;0,85;18261;18326;65;4752;6924;2172
3400;21.05.2016;'16 - 17;17,42;8,9;8,52;15248;15410;162;4473;6450;1977
3401;21.05.2016;'17 - 18;19,06;12,68;6,38;11172;11234;62;4046;5884;1838
3402;21.05.2016;'18 - 19;23,9;25,11;-1,21;6518;6702;184;3511;4959;1448
3403;21.05.2016;'19 - 20;26,28;30;-3,72;2718;2996;278;3060;3814;754
3404;21.05.2016;'20 - 21;30,94;29,94;1;655;752;97;3077;3522;445
3405;21.05.2016;'21 - 22;31,49;34,78;-3,29;17;13;-4;4151;4810;659
3406;21.05.2016;'22 - 23;28,94;37,48;-8,54;0;0;0;5793;6402;609
3407;21.05.2016;'23 - 24;23,42;30,31;-6,89;0;0;0;7434;7851;417
3408;22.05.2016;'00 - 01;17,79;19,84;-2,05;0;0;0;10033;8897;-1136
3409;22.05.2016;'01 - 02;10,38;9,27;1,11;0;0;0;11186;9749;-1437
3410;22.05.2016;'02 - 03;7,62;5,99;1,63;0;0;0;11905;9805;-2100
3411;22.05.2016;'03 - 04;4,6;8,5;-3,9;0;0;0;12376;9651;-2725
3412;22.05.2016;'04 - 05;2,81;9,26;-6,45;1;0;-1;12784;10078;-2706
3413;22.05.2016;'05 - 06;0,13;7,93;-7,8;213;216;3;12958;10734;-2224
3414;22.05.2016;'06 - 07;-1;7,49;-8,49;1776;1791;15;12723;11087;-1636
3415;22.05.2016;'07 - 08;0,5;6,39;-5,89;5616;5370;-246;11915;9515;-2400
3416;22.05.2016;'08 - 09;2,59;8,55;-5,96;11002;10534;-468;10784;6964;-3820
3417;22.05.2016;'09 - 10;-0,94;10,58;-11,52;16289;15565;-724;10301;6338;-3963
3418;22.05.2016;'10 - 11;-1,11;12,76;-13,87;20437;19134;-1303;10405;7912;-2493
3419;22.05.2016;'11 - 12;-0,9;10,76;-11,66;22988;21636;-1352;10681;10179;-502
3420;22.05.2016;'12 - 13;-5,68;5,23;-10,91;24142;22562;-1580;11047;12024;977
3421;22.05.2016;'13 - 14;-25,72;-2,96;-22,76;23872;22248;-1624;11219;12103;884
3422;22.05.2016;'14 - 15;-10,97;2,91;-13,88;22291;20436;-1855;10891;11204;313
3423;22.05.2016;'15 - 16;-7,82;4,38;-12,2;19437;17308;-2129;10033;10000;-33
3424;22.05.2016;'16 - 17;-5,19;7,75;-12,94;15452;13070;-2382;8988;9065;77
3425;22.05.2016;'17 - 18;2,02;16,68;-14,66;10653;8608;-2045;7935;8107;172
3426;22.05.2016;'18 - 19;21,33;27,2;-5,87;5765;4558;-1207;6994;7534;540
3427;22.05.2016;'19 - 20;23,65;29,08;-5,43;2333;1956;-377;6456;7395;939
3428;22.05.2016;'20 - 21;25,32;25,99;-0,67;559;443;-116;6478;7515;1037
3429;22.05.2016;'21 - 22;26,11;24,38;1,73;13;9;-4;6851;7804;953
3430;22.05.2016;'22 - 23;27,22;26,57;0,65;0;0;0;7130;8493;1363
3431;22.05.2016;'23 - 24;22,9;24,83;-1,93;0;0;0;6966;8887;1921
3432;23.05.2016;'00 - 01;22,61;23,22;-0,61;0;0;0;7506;8370;864
3433;23.05.2016;'01 - 02;20,89;20,73;0,16;0;0;0;7196;7004;-192
3434;23.05.2016;'02 - 03;19,51;21,3;-1,79;0;0;0;6980;5146;-1834
3435;23.05.2016;'03 - 04;18,91;21,92;-3,01;0;0;0;6829;4639;-2190
3436;23.05.2016;'04 - 05;19,46;22,44;-2,98;1;0;-1;6761;4228;-2533
3437;23.05.2016;'05 - 06;20,69;24,61;-3,92;165;155;-10;6626;4338;-2288
3438;23.05.2016;'06 - 07;28,05;35,32;-7,27;1215;1137;-78;6202;4486;-1716
3439;23.05.2016;'07 - 08;34,51;40,97;-6,46;3312;2937;-375;5735;4388;-1347
3440;23.05.2016;'08 - 09;35,93;40,26;-4,33;5636;4932;-704;5407;4248;-1159
3441;23.05.2016;'09 - 10;33,99;39,06;-5,07;7750;7004;-746;5307;4473;-834
3442;23.05.2016;'10 - 11;36;38,89;-2,89;9242;8343;-899;5362;4442;-920
3443;23.05.2016;'11 - 12;35,94;39,36;-3,42;10147;9303;-844;5578;4337;-1241
3444;23.05.2016;'12 - 13;33,91;38,35;-4,44;10434;9447;-987;5920;4434;-1486
3445;23.05.2016;'13 - 14;33,54;37,83;-4,29;9924;9456;-468;6324;5104;-1220
3446;23.05.2016;'14 - 15;32,5;37,74;-5,24;8932;8831;-101;6662;5711;-951
3447;23.05.2016;'15 - 16;32,78;35,39;-2,61;7530;7577;47;7134;6389;-745
3448;23.05.2016;'16 - 17;31,96;33,07;-1,11;5931;6236;305;7706;7144;-562
3449;23.05.2016;'17 - 18;31,68;32,38;-0,7;4264;4526;262;8294;8077;-217
3450;23.05.2016;'18 - 19;32,49;31,07;1,42;2639;2628;-11;8865;9172;307
3451;23.05.2016;'19 - 20;33,09;31,56;1,53;1243;1128;-115;9541;10316;775
3452;23.05.2016;'20 - 21;33,97;30,02;3,95;300;239;-61;10385;12008;1623
3453;23.05.2016;'21 - 22;31,97;28,57;3,4;10;7;-3;10978;13753;2775
3454;23.05.2016;'22 - 23;24,47;24,18;0,29;0;0;0;11399;14202;2803
3455;23.05.2016;'23 - 24;22,71;20,5;2,21;0;0;0;11703;13496;1793
3456;24.05.2016;'00 - 01;21,99;20,26;1,73;0;0;0;10315;12737;2422
3457;24.05.2016;'01 - 02;21,75;19,06;2,69;0;0;0;10203;11829;1626
3458;24.05.2016;'02 - 03;20,48;18,51;1,97;0;0;0;9977;12419;2442
3459;24.05.2016;'03 - 04;20;19,82;0,18;0;0;0;9879;11799;1920
3460;24.05.2016;'04 - 05;20,72;19,11;1,61;1;0;-1;9962;11425;1463
3461;24.05.2016;'05 - 06;22,61;21,46;1,15;118;100;-18;9880;11420;1540
3462;24.05.2016;'06 - 07;26,13;24,47;1,66;715;612;-103;9570;11140;1570
3463;24.05.2016;'07 - 08;34,38;30,89;3,49;1862;1528;-334;9145;10298;1153
3464;24.05.2016;'08 - 09;37,09;35,2;1,89;3238;2591;-647;8731;9751;1020
3465;24.05.2016;'09 - 10;36,19;33,47;2,72;4654;3741;-913;8243;9360;1117
3466;24.05.2016;'10 - 11;36,94;32,59;4,35;6003;4984;-1019;7767;9090;1323
3467;24.05.2016;'11 - 12;36,06;33,48;2,58;7102;5936;-1166;7272;8690;1418
3468;24.05.2016;'12 - 13;33,09;33,03;0,06;7827;6573;-1254;6730;8044;1314
3469;24.05.2016;'13 - 14;33;32,93;0,07;7875;6953;-922;6212;7432;1220
3470;24.05.2016;'14 - 15;32,69;31,71;0,98;7508;6882;-626;5811;6802;991
3471;24.05.2016;'15 - 16;30,92;30,77;0,15;6773;6200;-573;5563;6669;1106
3472;24.05.2016;'16 - 17;29,12;31,24;-2,12;5607;4950;-657;5479;6370;891
3473;24.05.2016;'17 - 18;29,8;33,4;-3,6;4223;3448;-775;5431;5879;448
3474;24.05.2016;'18 - 19;31,25;32,03;-0,78;2761;2055;-706;5352;5485;133
3475;24.05.2016;'19 - 20;32,2;31,76;0,44;1384;910;-474;5158;5116;-42
3476;24.05.2016;'20 - 21;31,64;31,8;-0,16;339;201;-138;4847;4911;64
3477;24.05.2016;'21 - 22;32,38;30,93;1,45;12;8;-4;4588;4473;-115
3478;24.05.2016;'22 - 23;30,43;28,7;1,73;0;0;0;4330;4099;-231
3479;24.05.2016;'23 - 24;24,98;22,51;2,47;0;0;0;4058;3465;-593
3480;25.05.2016;'00 - 01;22,97;23,85;-0,88;0;0;0;3884;3077;-807
3481;25.05.2016;'01 - 02;22,57;22,87;-0,3;0;0;0;3582;2694;-888
3482;25.05.2016;'02 - 03;21,57;22,91;-1,34;0;0;0;3329;2427;-902
3483;25.05.2016;'03 - 04;21;19,66;1,34;0;0;0;3139;2270;-869
3484;25.05.2016;'04 - 05;21,63;22,95;-1,32;1;0;-1;2941;2170;-771
3485;25.05.2016;'05 - 06;22,99;23,82;-0,83;150;117;-33;2712;1960;-752
3486;25.05.2016;'06 - 07;30,92;31,79;-0,87;1266;963;-303;2482;1772;-710
3487;25.05.2016;'07 - 08;35,8;34,55;1,25;3699;2538;-1161;2256;1628;-628
3488;25.05.2016;'08 - 09;39,2;37,58;1,62;6772;4081;-2691;1992;1401;-591
3489;25.05.2016;'09 - 10;34,99;37,91;-2,92;9998;5905;-4093;1733;1244;-489
3490;25.05.2016;'10 - 11;34,16;38,95;-4,79;12678;7827;-4851;1513;1056;-457
3491;25.05.2016;'11 - 12;33,07;38,88;-5,81;14574;9550;-5024;1318;881;-437
3492;25.05.2016;'12 - 13;31,02;36,43;-5,41;15651;10850;-4801;1182;801;-381
3493;25.05.2016;'13 - 14;28,95;33,64;-4,69;15944;11762;-4182;1089;764;-325
3494;25.05.2016;'14 - 15;30,13;32,66;-2,53;15461;11894;-3567;1038;670;-368
3495;25.05.2016;'15 - 16;30,12;32,42;-2,3;14162;11460;-2702;1057;608;-449
3496;25.05.2016;'16 - 17;30,9;31,98;-1,08;12031;9634;-2397;1058;596;-462
3497;25.05.2016;'17 - 18;32,92;34,18;-1,26;9076;6965;-2111;1031;625;-406
3498;25.05.2016;'18 - 19;35,8;35,15;0,65;5602;4409;-1193;1037;682;-355
3499;25.05.2016;'19 - 20;36,61;31,84;4,77;2566;2134;-432;1076;652;-424
3500;25.05.2016;'20 - 21;36,76;31,79;4,97;628;554;-74;1167;561;-606
3501;25.05.2016;'21 - 22;35,49;32,82;2,67;18;18;0;1346;638;-708
3502;25.05.2016;'22 - 23;34,92;33,23;1,69;0;0;0;1568;832;-736
3503;25.05.2016;'23 - 24;28,06;29,88;-1,82;0;0;0;1681;938;-743
3504;26.05.2016;'00 - 01;25,74;26,53;-0,79;0;0;0;1264;956;-308
3505;26.05.2016;'01 - 02;24,16;24,33;-0,17;0;0;0;1250;936;-314
3506;26.05.2016;'02 - 03;23,42;22,86;0,56;0;0;0;1225;894;-331
3507;26.05.2016;'03 - 04;23,27;23,42;-0,15;0;0;0;1226;800;-426
3508;26.05.2016;'04 - 05;23,33;20,76;2,57;1;0;-1;1228;693;-535
3509;26.05.2016;'05 - 06;23,79;22,04;1,75;145;149;4;1158;771;-387
3510;26.05.2016;'06 - 07;26,15;26,35;-0,2;1313;1312;-1;997;706;-291
3511;26.05.2016;'07 - 08;30,96;32,6;-1,64;4184;3922;-262;786;533;-253
3512;26.05.2016;'08 - 09;30,97;29,49;1,48;8339;7952;-387;677;420;-257
3513;26.05.2016;'09 - 10;27,94;24,97;2,97;12704;12727;23;646;421;-225
3514;26.05.2016;'10 - 11;25,57;22,74;2,83;16275;16612;337;631;452;-179
3515;26.05.2016;'11 - 12;24,79;21,26;3,53;18586;18514;-72;651;476;-175
3516;26.05.2016;'12 - 13;25,46;22,61;2,85;19673;19143;-530;709;580;-129
3517;26.05.2016;'13 - 14;24,71;22,66;2,05;19587;18831;-756;804;674;-130
3518;26.05.2016;'14 - 15;24,69;24,64;0,05;18439;18224;-215;926;684;-242
3519;26.05.2016;'15 - 16;25,16;23,59;1,57;16370;16804;434;1091;617;-474
3520;26.05.2016;'16 - 17;25,76;22,76;3;13492;14283;791;1209;600;-609
3521;26.05.2016;'17 - 18;28,07;26,33;1,74;9888;10622;734;1253;565;-688
3522;26.05.2016;'18 - 19;34;32,48;1,52;5941;6397;456;1219;612;-607
3523;26.05.2016;'19 - 20;35,27;35,95;-0,68;2664;2848;184;1186;710;-476
3524;26.05.2016;'20 - 21;34,95;37,61;-2,66;680;731;51;1245;940;-305
3525;26.05.2016;'21 - 22;32,94;35,26;-2,32;26;27;1;1450;1307;-143
3526;26.05.2016;'22 - 23;33,1;30,29;2,81;0;0;0;1663;1750;87
3527;26.05.2016;'23 - 24;26,94;25,48;1,46;0;0;0;1740;2147;407
3528;27.05.2016;'00 - 01;24,43;23,52;0,91;0;0;0;1809;2232;423
3529;27.05.2016;'01 - 02;23,42;23,03;0,39;0;0;0;1815;2116;301
3530;27.05.2016;'02 - 03;21,95;23,01;-1,06;0;0;0;1802;1899;97
3531;27.05.2016;'03 - 04;20,61;23,6;-2,99;0;0;0;1794;1884;90
3532;27.05.2016;'04 - 05;21,69;22,46;-0,77;1;0;-1;1803;1741;-62
3533;27.05.2016;'05 - 06;23,45;24,79;-1,34;179;184;5;1775;1632;-143
3534;27.05.2016;'06 - 07;27,88;32,35;-4,47;1396;1384;-12;1670;1442;-228
3535;27.05.2016;'07 - 08;32,99;33,96;-0,97;3773;3523;-250;1493;1261;-232
3536;27.05.2016;'08 - 09;35,48;35,04;0,44;6565;5980;-585;1249;1094;-155
3537;27.05.2016;'09 - 10;34,26;35,75;-1,49;9625;8822;-803;1010;843;-167
3538;27.05.2016;'10 - 11;32,95;34,65;-1,7;12498;12160;-338;834;642;-192
3539;27.05.2016;'11 - 12;32,91;33,09;-0,18;14763;15428;665;723;494;-229
3540;27.05.2016;'12 - 13;30,37;29,17;1,2;16108;17498;1390;698;471;-227
3541;27.05.2016;'13 - 14;27,2;24,95;2,25;16173;17994;1821;701;526;-175
3542;27.05.2016;'14 - 15;26,64;24,09;2,55;15280;16799;1519;742;645;-97
3543;27.05.2016;'15 - 16;26,86;24,44;2,42;13710;14445;735;860;814;-46
3544;27.05.2016;'16 - 17;27,68;24,26;3,42;11418;11724;306;1021;1096;75
3545;27.05.2016;'17 - 18;30,96;25,96;5;8508;8659;151;1269;1508;239
3546;27.05.2016;'18 - 19;32,91;27,9;5,01;5278;5476;198;1635;1727;92
3547;27.05.2016;'19 - 20;33,2;29,33;3,87;2476;2664;188;2017;1767;-250
3548;27.05.2016;'20 - 21;32,19;29,15;3,04;617;632;15;2319;1942;-377
3549;27.05.2016;'21 - 22;31,85;29,4;2,45;25;25;0;2758;2404;-354
3550;27.05.2016;'22 - 23;30,23;31,01;-0,78;0;0;0;3198;2714;-484
3551;27.05.2016;'23 - 24;25,99;30,08;-4,09;0;0;0;3421;2842;-579
3552;28.05.2016;'00 - 01;28,92;26,67;2,25;0;0;0;4003;2894;-1109
3553;28.05.2016;'01 - 02;24,38;26,53;-2,15;0;0;0;3992;2989;-1003
3554;28.05.2016;'02 - 03;22,79;22,92;-0,13;0;0;0;4042;2940;-1102
3555;28.05.2016;'03 - 04;22,14;21;1,14;0;0;0;4041;2807;-1234
3556;28.05.2016;'04 - 05;21,69;20,45;1,24;1;1;0;3960;2474;-1486
3557;28.05.2016;'05 - 06;21,91;20,88;1,03;220;241;21;3845;2330;-1515
3558;28.05.2016;'06 - 07;22,56;23,73;-1,17;1560;1565;5;3446;2147;-1299
3559;28.05.2016;'07 - 08;24,02;28,29;-4,27;4286;3870;-416;2767;1752;-1015
3560;28.05.2016;'08 - 09;26,57;28,84;-2,27;7779;7047;-732;2493;1316;-1177
3561;28.05.2016;'09 - 10;26,95;26,42;0,53;11440;11538;98;2510;1024;-1486
3562;28.05.2016;'10 - 11;24,46;23,05;1,41;14449;15880;1431;2649;1006;-1643
3563;28.05.2016;'11 - 12;23,49;23,38;0,11;16655;18700;2045;2900;1186;-1714
3564;28.05.2016;'12 - 13;22,87;21,38;1,49;17902;19773;1871;3212;1318;-1894
3565;28.05.2016;'13 - 14;22,06;20,74;1,32;18054;19102;1048;3511;1487;-2024
3566;28.05.2016;'14 - 15;21,47;21,22;0,25;17371;17575;204;3817;1780;-2037
3567;28.05.2016;'15 - 16;20,42;19,25;1,17;15565;15013;-552;4178;2322;-1856
3568;28.05.2016;'16 - 17;20;19,07;0,93;12780;12108;-672;4581;3006;-1575
3569;28.05.2016;'17 - 18;22,01;25,05;-3,04;9292;9032;-260;5049;3712;-1337
3570;28.05.2016;'18 - 19;25,57;27,01;-1,44;5601;5704;103;5583;4270;-1313
3571;28.05.2016;'19 - 20;26,42;27,24;-0,82;2574;2692;118;6274;4393;-1881
3572;28.05.2016;'20 - 21;27,1;29,03;-1,93;688;724;36;7276;4969;-2307
3573;28.05.2016;'21 - 22;25,69;28,69;-3;29;28;-1;7949;6622;-1327
3574;28.05.2016;'22 - 23;23,37;27,54;-4,17;0;0;0;8383;8090;-293
3575;28.05.2016;'23 - 24;22,31;21,13;1,18;0;0;0;8455;8500;45
3576;29.05.2016;'00 - 01;18,03;13,99;4,04;0;0;0;8483;8257;-226
3577;29.05.2016;'01 - 02;13,15;10,88;2,27;0;0;0;8219;7760;-459
3578;29.05.2016;'02 - 03;12,97;9,37;3,6;0;0;0;7985;6962;-1023
3579;29.05.2016;'03 - 04;13,17;12,1;1,07;0;0;0;7761;5831;-1930
3580;29.05.2016;'04 - 05;8,9;11,3;-2,4;2;1;-1;7538;5300;-2238
3581;29.05.2016;'05 - 06;6,16;10,92;-4,76;218;190;-28;7210;5209;-2001
3582;29.05.2016;'06 - 07;10,58;11,85;-1,27;1481;1388;-93;6805;4847;-1958
3583;29.05.2016;'07 - 08;13,87;14,51;-0,64;3800;3648;-152;6397;4381;-2016
3584;29.05.2016;'08 - 09;14,67;15,96;-1,29;6521;6687;166;6153;4066;-2087
3585;29.05.2016;'09 - 10;15,23;16,21;-0,98;9256;9564;308;6291;4062;-2229
3586;29.05.2016;'10 - 11;12,87;16,99;-4,12;11485;12429;944;6646;4111;-2535
3587;29.05.2016;'11 - 12;14,03;17,55;-3,52;13177;14874;1697;7171;4447;-2724
3588;29.05.2016;'12 - 13;10,46;17,38;-6,92;14011;15355;1344;8038;5064;-2974
3589;29.05.2016;'13 - 14;8,57;17,89;-9,32;13917;14450;533;8900;5311;-3589
3590;29.05.2016;'14 - 15;4,6;17,53;-12,93;12904;13282;378;9515;5551;-3964
3591;29.05.2016;'15 - 16;3,78;15,78;-12;11279;11906;627;10040;5870;-4170
3592;29.05.2016;'16 - 17;5,32;15,09;-9,77;9022;9417;395;10322;6390;-3932
3593;29.05.2016;'17 - 18;8,42;20,24;-11,82;6467;6198;-269;10536;7482;-3054
3594;29.05.2016;'18 - 19;18,08;25,23;-7,15;4025;3531;-494;10791;8197;-2594
3595;29.05.2016;'19 - 20;21,88;29,07;-7,19;1940;1594;-346;11070;9076;-1994
3596;29.05.2016;'20 - 21;22,77;28,81;-6,04;504;395;-109;11443;9423;-2020
3597;29.05.2016;'21 - 22;23,04;29,69;-6,65;23;20;-3;12015;9830;-2185
3598;29.05.2016;'22 - 23;23,1;30,35;-7,25;0;0;0;12644;10196;-2448
3599;29.05.2016;'23 - 24;19,73;25,61;-5,88;0;0;0;12986;10082;-2904
3600;30.05.2016;'00 - 01;18,07;14,08;3,99;0;0;0;11082;10460;-622
3601;30.05.2016;'01 - 02;13,87;10,19;3,68;0;0;0;11005;10955;-50
3602;30.05.2016;'02 - 03;12,27;6,31;5,96;0;0;0;11090;11037;-53
3603;30.05.2016;'03 - 04;11,28;4,21;7,07;0;0;0;11333;10737;-596
3604;30.05.2016;'04 - 05;11,86;4,17;7,69;2;1;-1;11609;11376;-233
3605;30.05.2016;'05 - 06;18,01;8,59;9,42;201;213;12;11857;11175;-682
3606;30.05.2016;'06 - 07;26,16;21,9;4,26;1062;1244;182;11926;10410;-1516
3607;30.05.2016;'07 - 08;34,94;30,15;4,79;2751;2996;245;11835;9582;-2253
3608;30.05.2016;'08 - 09;35,25;35,45;-0,2;4846;5310;464;11800;8552;-3248
3609;30.05.2016;'09 - 10;35,43;35,2;0,23;7081;8051;970;12319;8235;-4084
3610;30.05.2016;'10 - 11;34,79;32,91;1,88;9099;10646;1547;12835;8269;-4566
3611;30.05.2016;'11 - 12;34,25;33,26;0,99;10670;12256;1586;13194;9307;-3887
3612;30.05.2016;'12 - 13;29;32,41;-3,41;11715;13067;1352;13648;10367;-3281
3613;30.05.2016;'13 - 14;26,33;30,05;-3,72;12133;14124;1991;14028;11174;-2854
3614;30.05.2016;'14 - 15;25,08;29,47;-4,39;11909;13731;1822;14341;11303;-3038
3615;30.05.2016;'15 - 16;24,67;29,36;-4,69;10969;12690;1721;14279;11537;-2742
3616;30.05.2016;'16 - 17;25,06;30,09;-5,03;9293;11058;1765;13800;11168;-2632
3617;30.05.2016;'17 - 18;25,47;29,24;-3,77;7075;8089;1014;13098;11254;-1844
3618;30.05.2016;'18 - 19;28,74;32,43;-3,69;4565;4835;270;12301;10798;-1503
3619;30.05.2016;'19 - 20;28,99;34,43;-5,44;2269;2229;-40;11790;10525;-1265
3620;30.05.2016;'20 - 21;25,48;33,71;-8,23;640;572;-68;11646;10031;-1615
3621;30.05.2016;'21 - 22;24,68;31,88;-7,2;33;25;-8;11763;10225;-1538
3622;30.05.2016;'22 - 23;23,9;32,05;-8,15;0;0;0;11836;10122;-1714
3623;30.05.2016;'23 - 24;21,94;28,85;-6,91;0;0;0;11562;10289;-1273
3624;31.05.2016;'00 - 01;21,17;22,72;-1,55;0;0;0;9766;9488;-278
3625;31.05.2016;'01 - 02;19,25;20,02;-0,77;0;0;0;9133;9058;-75
3626;31.05.2016;'02 - 03;16,44;16,52;-0,08;0;0;0;8507;8139;-368
3627;31.05.2016;'03 - 04;16,09;17,19;-1,1;0;0;0;7916;7410;-506
3628;31.05.2016;'04 - 05;17,31;16,64;0,67;4;1;-3;7308;6867;-441
3629;31.05.2016;'05 - 06;20,98;22,04;-1,06;267;242;-25;6832;6286;-546
3630;31.05.2016;'06 - 07;24,52;34,26;-9,74;1735;1552;-183;6141;5496;-645
3631;31.05.2016;'07 - 08;32,93;41,57;-8,64;4611;4310;-301;5294;4574;-720
3632;31.05.2016;'08 - 09;35,81;46,86;-11,05;8305;8156;-149;4713;3570;-1143
3633;31.05.2016;'09 - 10;35,47;43,37;-7,9;11882;11729;-153;4511;3306;-1205
3634;31.05.2016;'10 - 11;34,94;41,01;-6,07;14494;14163;-331;4313;3268;-1045
3635;31.05.2016;'11 - 12;35,8;39,23;-3,43;15984;15052;-932;4092;3140;-952
3636;31.05.2016;'12 - 13;32,78;38,16;-5,38;16386;15302;-1084;3923;2764;-1159
3637;31.05.2016;'13 - 14;30,94;37,64;-6,7;16463;15273;-1190;3753;2631;-1122
3638;31.05.2016;'14 - 15;30,57;37,05;-6,48;15824;14863;-961;3551;2557;-994
3639;31.05.2016;'15 - 16;28,82;37,19;-8,37;14307;13350;-957;3396;2865;-531
3640;31.05.2016;'16 - 17;29,26;35,51;-6,25;11858;11023;-835;3262;3159;-103
3641;31.05.2016;'17 - 18;32,37;35,46;-3,09;8839;8200;-639;3177;3800;623
3642;31.05.2016;'18 - 19;34,94;37,14;-2,2;5527;4983;-544;3199;4077;878
3643;31.05.2016;'19 - 20;35,92;36,91;-0,99;2690;2468;-222;3226;4241;1015
3644;31.05.2016;'20 - 21;32,95;35,65;-2,7;751;696;-55;3357;4064;707
3645;31.05.2016;'21 - 22;31,98;32,63;-0,65;39;43;4;3743;4278;535
3646;31.05.2016;'22 - 23;30,78;36,29;-5,51;0;0;0;4118;4413;295
3647;31.05.2016;'23 - 24;26,15;29,59;-3,44;0;0;0;4354;4760;406
3648;01.06.2016;'00 - 01;24;24,67;-0,67;0;0;0;5663;4972;-691
3649;01.06.2016;'01 - 02;22,23;22,19;0,04;0;0;0;5859;5542;-317
3650;01.06.2016;'02 - 03;21,07;21,99;-0,92;0;0;0;6034;5412;-622
3651;01.06.2016;'03 - 04;20,08;20,11;-0,03;0;0;0;6112;5319;-793
3652;01.06.2016;'04 - 05;20,18;18,2;1,98;1;1;0;6133;5506;-627
3653;01.06.2016;'05 - 06;23,1;20,88;2,22;152;144;-8;6181;5466;-715
3654;01.06.2016;'06 - 07;29,9;24,2;5,7;1047;1024;-23;6207;4840;-1367
3655;01.06.2016;'07 - 08;37,49;35,27;2,22;2848;2714;-134;6200;4349;-1851
3656;01.06.2016;'08 - 09;40,87;38,83;2,04;5023;4796;-227;6216;4223;-1993
3657;01.06.2016;'09 - 10;41;40,28;0,72;7159;6928;-231;6375;4548;-1827
3658;01.06.2016;'10 - 11;40,44;39,29;1,15;8934;8741;-193;6662;5391;-1271
3659;01.06.2016;'11 - 12;40,51;40,62;-0,11;10264;9984;-280;7147;6141;-1006
3660;01.06.2016;'12 - 13;36,64;37,09;-0,45;11185;10712;-473;7908;7010;-898
3661;01.06.2016;'13 - 14;32,11;31,95;0,16;11438;10961;-477;8698;8250;-448
3662;01.06.2016;'14 - 15;30,9;31,27;-0,37;11017;10588;-429;9339;9155;-184
3663;01.06.2016;'15 - 16;28,96;27,18;1,78;10009;10356;347;9846;10272;426
3664;01.06.2016;'16 - 17;28,12;25,07;3,05;8548;8953;405;10106;10764;658
3665;01.06.2016;'17 - 18;30,11;28,56;1,55;6571;6658;87;10227;10290;63
3666;01.06.2016;'18 - 19;32,66;31,48;1,18;4253;4126;-127;10120;9812;-308
3667;01.06.2016;'19 - 20;32,92;33,6;-0,68;2150;1904;-246;9978;9470;-508
3668;01.06.2016;'20 - 21;30,95;34;-3,05;599;487;-112;9973;8960;-1013
3669;01.06.2016;'21 - 22;29,57;33,9;-4,33;32;37;5;9822;8926;-896
3670;01.06.2016;'22 - 23;30,9;34,04;-3,14;0;0;0;9624;8627;-997
3671;01.06.2016;'23 - 24;26,64;29,65;-3,01;0;0;0;9379;7972;-1407
3672;02.06.2016;'00 - 01;21,96;21,15;0,81;0;0;0;7852;7429;-423
3673;02.06.2016;'01 - 02;20,75;19,16;1,59;0;0;0;7286;6608;-678
3674;02.06.2016;'02 - 03;20,06;19,6;0,46;0;0;0;6718;5591;-1127
3675;02.06.2016;'03 - 04;20;17,59;2,41;0;0;0;6197;5079;-1118
3676;02.06.2016;'04 - 05;20;16,71;3,29;5;2;-3;5693;4817;-876
3677;02.06.2016;'05 - 06;22,37;18,82;3,55;237;200;-37;5162;4539;-623
3678;02.06.2016;'06 - 07;29,03;29,26;-0,23;1433;1173;-260;4552;4486;-66
3679;02.06.2016;'07 - 08;37,97;43,33;-5,36;3744;2832;-912;4011;4074;63
3680;02.06.2016;'08 - 09;39,54;48,33;-8,79;6564;4896;-1668;3643;3594;-49
3681;02.06.2016;'09 - 10;37,98;53,8;-15,82;9567;7375;-2192;3446;3737;291
3682;02.06.2016;'10 - 11;37,09;50,35;-13,26;12225;9850;-2375;3404;3806;402
3683;02.06.2016;'11 - 12;36,37;43,9;-7,53;14149;12123;-2026;3547;3804;257
3684;02.06.2016;'12 - 13;32,08;40,07;-7,99;15310;13778;-1532;3846;4250;404
3685;02.06.2016;'13 - 14;28,67;36,18;-7,51;15697;14200;-1497;4174;4698;524
3686;02.06.2016;'14 - 15;26,68;32,14;-5,46;15147;13461;-1686;4444;5143;699
3687;02.06.2016;'15 - 16;25,95;32,28;-6,33;13607;12171;-1436;4767;5738;971
3688;02.06.2016;'16 - 17;25,92;31,24;-5,32;11265;11200;-65;5079;5825;746
3689;02.06.2016;'17 - 18;28,22;33,49;-5,27;8341;8704;363;5259;5332;73
3690;02.06.2016;'18 - 19;31,84;37,24;-5,4;5272;5468;196;5280;4950;-330
3691;02.06.2016;'19 - 20;32,96;39,07;-6,11;2623;2675;52;5084;4446;-638
3692;02.06.2016;'20 - 21;31,96;37,86;-5,9;764;734;-30;4826;4100;-726
3693;02.06.2016;'21 - 22;29,46;34,59;-5,13;41;53;12;5024;4205;-819
3694;02.06.2016;'22 - 23;29,16;35,3;-6,14;0;0;0;5402;4207;-1195
3695;02.06.2016;'23 - 24;24,59;28,57;-3,98;0;0;0;5676;4099;-1577
3696;03.06.2016;'00 - 01;24,1;27,27;-3,17;0;0;0;5777;3924;-1853
3697;03.06.2016;'01 - 02;21,68;25,14;-3,46;0;0;0;5662;3919;-1743
3698;03.06.2016;'02 - 03;21,22;25,1;-3,88;0;0;0;5429;4064;-1365
3699;03.06.2016;'03 - 04;20,64;21,46;-0,82;0;0;0;5127;4114;-1013
3700;03.06.2016;'04 - 05;20,9;19,67;1,23;5;2;-3;4814;3937;-877
3701;03.06.2016;'05 - 06;22,5;24,2;-1,7;250;228;-22;4489;3663;-826
3702;03.06.2016;'06 - 07;27,46;30,19;-2,73;1601;1444;-157;4018;3176;-842
3703;03.06.2016;'07 - 08;35,45;39,09;-3,64;4194;3838;-356;3511;2344;-1167
3704;03.06.2016;'08 - 09;40,08;49,69;-9,61;7263;6819;-444;3256;1706;-1550
3705;03.06.2016;'09 - 10;39,93;47,48;-7,55;10362;10228;-134;3317;1928;-1389
3706;03.06.2016;'10 - 11;36,44;41,54;-5,1;12985;13003;18;3570;3028;-542
3707;03.06.2016;'11 - 12;35,64;36,42;-0,78;14779;15014;235;4008;4149;141
3708;03.06.2016;'12 - 13;30,92;30,26;0,66;15747;16386;639;4527;4907;380
3709;03.06.2016;'13 - 14;27,77;26,97;0,8;15844;16437;593;4985;5236;251
3710;03.06.2016;'14 - 15;25,28;26,21;-0,93;15035;15611;576;5234;5702;468
3711;03.06.2016;'15 - 16;25,26;26,49;-1,23;13545;14251;706;5435;6460;1025
3712;03.06.2016;'16 - 17;25,49;27,1;-1,61;11347;11861;514;5709;6318;609
3713;03.06.2016;'17 - 18;28;28,49;-0,49;8395;9016;621;5695;6382;687
3714;03.06.2016;'18 - 19;31,82;30,39;1,43;5163;5549;386;5266;5913;647
3715;03.06.2016;'19 - 20;33,61;30,58;3,03;2487;2718;231;4819;4959;140
3716;03.06.2016;'20 - 21;31,98;29,81;2,17;738;762;24;4521;4129;-392
3717;03.06.2016;'21 - 22;30,66;29,19;1,47;48;46;-2;4738;4443;-295
3718;03.06.2016;'22 - 23;32,16;30,19;1,97;0;0;0;5050;4396;-654
3719;03.06.2016;'23 - 24;28,94;27,41;1,53;0;0;0;5187;4234;-953
3720;04.06.2016;'00 - 01;23,72;25,55;-1,83;0;0;0;5081;3752;-1329
3721;04.06.2016;'01 - 02;23,21;24,16;-0,95;0;0;0;4748;3386;-1362
3722;04.06.2016;'02 - 03;21,63;22,78;-1,15;0;0;0;4436;3175;-1261
3723;04.06.2016;'03 - 04;21,29;22,39;-1,1;0;0;0;4080;2806;-1274
3724;04.06.2016;'04 - 05;21,26;22,21;-0,95;6;3;-3;3672;2547;-1125
3725;04.06.2016;'05 - 06;21,3;21,68;-0,38;305;300;-5;3158;2225;-933
3726;04.06.2016;'06 - 07;21,53;22,43;-0,9;1742;1733;-9;2478;1851;-627
3727;04.06.2016;'07 - 08;23,5;23,01;0,49;4732;4692;-40;1682;1141;-541
3728;04.06.2016;'08 - 09;27,49;24,66;2,83;8564;8480;-84;1071;570;-501
3729;04.06.2016;'09 - 10;28,98;31,32;-2,34;12413;12736;323;927;509;-418
3730;04.06.2016;'10 - 11;26,56;30,16;-3,6;15561;16574;1013;1024;747;-277
3731;04.06.2016;'11 - 12;26,91;28,36;-1,45;17523;18794;1271;1241;1169;-72
3732;04.06.2016;'12 - 13;25,73;26,59;-0,86;18424;19918;1494;1537;1541;4
3733;04.06.2016;'13 - 14;22,78;25,7;-2,92;18580;19704;1124;1848;1708;-140
3734;04.06.2016;'14 - 15;21,58;28,02;-6,44;17688;18826;1138;2171;2013;-158
3735;04.06.2016;'15 - 16;21,41;27,76;-6,35;15693;16881;1188;2532;2430;-102
3736;04.06.2016;'16 - 17;21,53;27,57;-6,04;12985;14079;1094;2873;2978;105
3737;04.06.2016;'17 - 18;25,29;27,5;-2,21;9605;10295;690;3177;3328;151
3738;04.06.2016;'18 - 19;28,19;29,04;-0,85;5977;6364;387;3471;3348;-123
3739;04.06.2016;'19 - 20;30,07;31,17;-1,1;2927;3086;159;3621;3416;-205
3740;04.06.2016;'20 - 21;29,87;32,16;-2,29;847;897;50;3544;2854;-690
3741;04.06.2016;'21 - 22;29,88;32,37;-2,49;53;60;7;3630;2888;-742
3742;04.06.2016;'22 - 23;30,99;34,06;-3,07;0;0;0;3734;3108;-626
3743;04.06.2016;'23 - 24;28,88;31,69;-2,81;0;0;0;3627;3064;-563
3744;05.06.2016;'00 - 01;24,43;21,1;3,33;0;0;0;2974;2608;-366
3745;05.06.2016;'01 - 02;22;19,66;2,34;0;0;0;2543;2224;-319
3746;05.06.2016;'02 - 03;20,08;18,18;1,9;0;0;0;2160;1914;-246
3747;05.06.2016;'03 - 04;19,08;15,35;3,73;0;0;0;1894;1589;-305
3748;05.06.2016;'04 - 05;18,03;15,44;2,59;6;3;-3;1651;1368;-283
3749;05.06.2016;'05 - 06;16,61;13,72;2,89;318;318;0;1434;1242;-192
3750;05.06.2016;'06 - 07;16,09;10,22;5,87;1800;1764;-36;1184;1137;-47
3751;05.06.2016;'07 - 08;17,78;16,24;1,54;4972;4653;-319;889;872;-17
3752;05.06.2016;'08 - 09;17,89;19,83;-1,94;9029;8148;-881;632;604;-28
3753;05.06.2016;'09 - 10;17,08;22,36;-5,28;13133;11892;-1241;525;605;80
3754;05.06.2016;'10 - 11;17,84;22,39;-4,55;16503;15441;-1062;535;718;183
3755;05.06.2016;'11 - 12;18,48;23,43;-4,95;18786;18225;-561;618;894;276
3756;05.06.2016;'12 - 13;17,94;22,19;-4,25;19993;20234;241;764;1144;380
3757;05.06.2016;'13 - 14;15,15;20,96;-5,81;20044;20901;857;954;1478;524
3758;05.06.2016;'14 - 15;14,47;17,82;-3,35;18761;20130;1369;1201;1814;613
3759;05.06.2016;'15 - 16;14,03;13,56;0,47;16470;17920;1450;1551;2452;901
3760;05.06.2016;'16 - 17;14,54;14,19;0,35;13604;15126;1522;1934;3077;1143
3761;05.06.2016;'17 - 18;18,62;19,28;-0,66;9973;11061;1088;2318;3559;1241
3762;05.06.2016;'18 - 19;23,91;30,5;-6,59;6104;6590;486;2603;3525;922
3763;05.06.2016;'19 - 20;26,92;35,1;-8,18;2876;3165;289;2836;3330;494
3764;05.06.2016;'20 - 21;28,85;32,76;-3,91;863;994;131;2762;3349;587
3765;05.06.2016;'21 - 22;29,14;34,17;-5,03;60;72;12;2880;3646;766
3766;05.06.2016;'22 - 23;30,74;36,03;-5,29;0;0;0;3137;3784;647
3767;05.06.2016;'23 - 24;27,93;31,37;-3,44;0;0;0;3244;3281;37
3768;06.06.2016;'00 - 01;24,59;26,27;-1,68;0;0;0;3112;2884;-228
3769;06.06.2016;'01 - 02;22,76;25,71;-2,95;0;0;0;2954;2764;-190
3770;06.06.2016;'02 - 03;21,87;25,74;-3,87;0;0;0;2935;2657;-278
3771;06.06.2016;'03 - 04;21,19;24,53;-3,34;0;0;0;3000;2495;-505
3772;06.06.2016;'04 - 05;21,15;22,1;-0,95;6;3;-3;3066;2690;-376
3773;06.06.2016;'05 - 06;22,71;26,64;-3,93;359;354;-5;3014;2780;-234
3774;06.06.2016;'06 - 07;29,98;34,74;-4,76;2005;1932;-73;2677;2558;-119
3775;06.06.2016;'07 - 08;36,16;39,4;-3,24;5782;5612;-170;2209;1781;-428
3776;06.06.2016;'08 - 09;37,82;42,77;-4,95;10951;10620;-331;1895;1366;-529
3777;06.06.2016;'09 - 10;34,94;36,2;-1,26;16216;15891;-325;1757;1035;-722
3778;06.06.2016;'10 - 11;32,57;31,01;1,56;20479;20674;195;1716;936;-780
3779;06.06.2016;'11 - 12;31,93;28,64;3,29;23223;23960;737;1777;1174;-603
3780;06.06.2016;'12 - 13;28,63;24,84;3,79;24518;25468;950;1902;1517;-385
3781;06.06.2016;'13 - 14;28,08;25,21;2,87;24354;25389;1035;2043;1785;-258
3782;06.06.2016;'14 - 15;28,78;25,67;3,11;22776;23967;1191;2195;1946;-249
3783;06.06.2016;'15 - 16;29,63;25,57;4,06;20042;20985;943;2410;2355;-55
3784;06.06.2016;'16 - 17;30,99;24,84;6,15;16407;17340;933;2677;2871;194
3785;06.06.2016;'17 - 18;34,68;29,2;5,48;11826;12581;755;3067;3180;113
3786;06.06.2016;'18 - 19;38,76;32,5;6,26;6926;7677;751;3599;3598;-1
3787;06.06.2016;'19 - 20;41,06;34,76;6,3;3070;3657;587;4138;3800;-338
3788;06.06.2016;'20 - 21;37,31;32,37;4,94;972;1168;196;4502;3762;-740
3789;06.06.2016;'21 - 22;34,2;29,45;4,75;67;69;2;5068;4434;-634
3790;06.06.2016;'22 - 23;33,81;29,05;4,76;0;0;0;5645;5331;-314
3791;06.06.2016;'23 - 24;28,79;25,54;3,25;0;0;0;5902;5519;-383
3792;07.06.2016;'00 - 01;24,85;26,9;-2,05;0;0;0;5594;5262;-332
3793;07.06.2016;'01 - 02;23,34;25,48;-2,14;0;0;0;5209;4730;-479
3794;07.06.2016;'02 - 03;22,59;23,18;-0,59;0;0;0;4774;4051;-723
3795;07.06.2016;'03 - 04;21,58;22,16;-0,58;0;0;0;4394;3544;-850
3796;07.06.2016;'04 - 05;21,67;22,67;-1;6;4;-2;4029;3103;-926
3797;07.06.2016;'05 - 06;22,09;26,55;-4,46;379;386;7;3568;2738;-830
3798;07.06.2016;'06 - 07;29,68;31,33;-1,65;1985;2062;77;2850;2232;-618
3799;07.06.2016;'07 - 08;35,82;34,17;1,65;5925;6152;227;1951;1220;-731
3800;07.06.2016;'08 - 09;39,48;34,98;4,5;11336;11657;321;1256;474;-782
3801;07.06.2016;'09 - 10;34,49;29,7;4,79;16699;16908;209;956;246;-710
3802;07.06.2016;'10 - 11;29,15;29,43;-0,28;20972;21267;295;827;270;-557
3803;07.06.2016;'11 - 12;28,8;27,63;1,17;23661;24148;487;757;422;-335
3804;07.06.2016;'12 - 13;25,94;25,65;0,29;24846;25522;676;712;606;-106
3805;07.06.2016;'13 - 14;25,59;25,64;-0,05;24635;25261;626;655;772;117
3806;07.06.2016;'14 - 15;25,18;26,14;-0,96;23182;23341;159;652;956;304
3807;07.06.2016;'15 - 16;26,41;27,66;-1,25;20516;20241;-275;747;1244;497
3808;07.06.2016;'16 - 17;27,53;28,59;-1,06;16742;16041;-701;865;1726;861
3809;07.06.2016;'17 - 18;32,13;30,21;1,92;11991;11286;-705;993;2059;1066
3810;07.06.2016;'18 - 19;36,02;33,51;2,51;6933;6743;-190;1119;2076;957
3811;07.06.2016;'19 - 20;38,48;33,3;5,18;2965;3004;39;1248;2168;920
3812;07.06.2016;'20 - 21;34,9;30,77;4,13;964;842;-122;1534;1970;436
3813;07.06.2016;'21 - 22;32,97;30,42;2,55;72;62;-10;1965;2454;489
3814;07.06.2016;'22 - 23;32,59;29,83;2,76;0;0;0;2396;3046;650
3815;07.06.2016;'23 - 24;27,54;25,28;2,26;0;0;0;2692;3601;909
3816;08.06.2016;'00 - 01;25,98;21,3;4,68;0;0;0;3226;3747;521
3817;08.06.2016;'01 - 02;23,89;20,58;3,31;0;0;0;3426;3814;388
3818;08.06.2016;'02 - 03;22,83;18,9;3,93;0;0;0;3568;3908;340
3819;08.06.2016;'03 - 04;21,68;18,24;3,44;0;0;0;3608;4038;430
3820;08.06.2016;'04 - 05;21,54;17,61;3,93;7;4;-3;3620;4530;910
3821;08.06.2016;'05 - 06;23,38;17,28;6,1;345;335;-10;3519;4465;946
3822;08.06.2016;'06 - 07;28,21;19,79;8,42;1806;1838;32;3301;4028;727
3823;08.06.2016;'07 - 08;35,07;30,58;4,49;4954;4628;-326;3075;3832;757
3824;08.06.2016;'08 - 09;41,31;36,16;5,15;8840;7851;-989;3021;3420;399
3825;08.06.2016;'09 - 10;37,33;34,18;3,15;12694;11260;-1434;3281;3675;394
3826;08.06.2016;'10 - 11;34,25;35,62;-1,37;15861;14509;-1352;3783;4316;533
3827;08.06.2016;'11 - 12;32,99;35,47;-2,48;18176;16657;-1519;4481;5231;750
3828;08.06.2016;'12 - 13;28,52;31,34;-2,82;19546;17973;-1573;5417;6042;625
3829;08.06.2016;'13 - 14;27,6;29,94;-2,34;19731;18585;-1146;6475;7180;705
3830;08.06.2016;'14 - 15;27,18;29,16;-1,98;18736;17964;-772;7542;8371;829
3831;08.06.2016;'15 - 16;26,37;27,27;-0,9;16593;16098;-495;8551;9445;894
3832;08.06.2016;'16 - 17;26;26,31;-0,31;13689;13339;-350;9353;10300;947
3833;08.06.2016;'17 - 18;28,24;25,86;2,38;9936;9641;-295;9775;11170;1395
3834;08.06.2016;'18 - 19;30,68;26,24;4,44;6034;5755;-279;9701;11254;1553
3835;08.06.2016;'19 - 20;32,9;28,07;4,83;2803;2770;-33;9411;10750;1339
3836;08.06.2016;'20 - 21;32,12;27,87;4,25;870;896;26;9034;9704;670
3837;08.06.2016;'21 - 22;32,55;29,37;3,18;76;84;8;8942;8933;-9
3838;08.06.2016;'22 - 23;30,9;28,65;2,25;0;0;0;9051;8501;-550
3839;08.06.2016;'23 - 24;26,5;26,01;0,49;0;0;0;9018;7578;-1440
3840;09.06.2016;'00 - 01;23,67;23,01;0,66;0;0;0;7808;6638;-1170
3841;09.06.2016;'01 - 02;21,87;20,57;1,3;0;0;0;7350;5422;-1928
3842;09.06.2016;'02 - 03;20,81;22,09;-1,28;0;0;0;6824;4714;-2110
3843;09.06.2016;'03 - 04;20,58;21,62;-1,04;0;0;0;6276;4202;-2074
3844;09.06.2016;'04 - 05;21,11;23,14;-2,03;5;2;-3;5700;3895;-1805
3845;09.06.2016;'05 - 06;23,06;23,38;-0,32;256;249;-7;5122;3652;-1470
3846;09.06.2016;'06 - 07;28,03;31;-2,97;1455;1436;-19;4432;3312;-1120
3847;09.06.2016;'07 - 08;33,97;38,15;-4,18;3677;3490;-187;3667;2608;-1059
3848;09.06.2016;'08 - 09;43,08;42,25;0,83;6404;6138;-266;2937;2031;-906
3849;09.06.2016;'09 - 10;44;43,54;0,46;9331;8811;-520;2600;1712;-888
3850;09.06.2016;'10 - 11;42,89;39,75;3,14;12262;11842;-420;2513;1676;-837
3851;09.06.2016;'11 - 12;41,4;36,87;4,53;14846;14738;-108;2504;1793;-711
3852;09.06.2016;'12 - 13;34,99;32,14;2,85;16762;16717;-45;2600;2107;-493
3853;09.06.2016;'13 - 14;33,93;30,63;3,3;17893;17662;-231;2965;2771;-194
3854;09.06.2016;'14 - 15;30,2;29,42;0,78;18060;17501;-559;3656;3621;-35
3855;09.06.2016;'15 - 16;27,34;25,57;1,77;16963;16810;-153;4579;3898;-681
3856;09.06.2016;'16 - 17;27,01;24,41;2,6;14598;15037;439;5457;4671;-786
3857;09.06.2016;'17 - 18;28,84;26,13;2,71;11068;11868;800;6004;5332;-672
3858;09.06.2016;'18 - 19;32,95;28,11;4,84;6941;7763;822;6239;5794;-445
3859;09.06.2016;'19 - 20;34,94;30,42;4,52;3206;3833;627;6266;5741;-525
3860;09.06.2016;'20 - 21;33,7;30,44;3,26;995;1240;245;6165;5360;-805
3861;09.06.2016;'21 - 22;31,51;28,41;3,1;87;100;13;6041;5502;-539
3862;09.06.2016;'22 - 23;30,49;29,67;0,82;0;0;0;6037;5922;-115
3863;09.06.2016;'23 - 24;25,89;26,46;-0,57;0;0;0;6176;6701;525
3864;10.06.2016;'00 - 01;23,55;23,49;0,06;0;0;0;7227;6849;-378
3865;10.06.2016;'01 - 02;21,57;21,05;0,52;0;0;0;7718;6884;-834
3866;10.06.2016;'02 - 03;21,03;22,06;-1,03;0;0;0;8339;7027;-1312
3867;10.06.2016;'03 - 04;19,91;20,69;-0,78;0;0;0;8883;7284;-1599
3868;10.06.2016;'04 - 05;19,16;19,85;-0,69;7;4;-3;9315;7421;-1894
3869;10.06.2016;'05 - 06;20,97;23,21;-2,24;360;352;-8;9648;7491;-2157
3870;10.06.2016;'06 - 07;27,25;35,64;-8,39;2050;2062;12;10001;7348;-2653
3871;10.06.2016;'07 - 08;33,94;37,59;-3,65;5711;5709;-2;10434;7376;-3058
3872;10.06.2016;'08 - 09;35,95;37,48;-1,53;10669;10741;72;10637;7458;-3179
3873;10.06.2016;'09 - 10;30,97;33,51;-2,54;15729;16228;499;10630;7372;-3258
3874;10.06.2016;'10 - 11;24,68;27,81;-3,13;19813;20808;995;10691;7068;-3623
3875;10.06.2016;'11 - 12;24,47;28,47;-4;22531;23633;1102;10787;7026;-3761
3876;10.06.2016;'12 - 13;22,52;26,36;-3,84;23922;25260;1338;10930;6908;-4022
3877;10.06.2016;'13 - 14;21,37;25,8;-4,43;23994;25412;1418;11083;6987;-4096
3878;10.06.2016;'14 - 15;21,06;24,87;-3,81;22677;24322;1645;11145;7203;-3942
3879;10.06.2016;'15 - 16;21,8;25,09;-3,29;20159;21913;1754;11179;7459;-3720
3880;10.06.2016;'16 - 17;23,09;24,91;-1,82;16631;17940;1309;10886;7297;-3589
3881;10.06.2016;'17 - 18;26,29;29,87;-3,58;12130;13150;1020;10242;6534;-3708
3882;10.06.2016;'18 - 19;30,01;33,85;-3,84;7267;8152;885;9163;5732;-3431
3883;10.06.2016;'19 - 20;32,85;35,25;-2,4;3275;3879;604;7951;4458;-3493
3884;10.06.2016;'20 - 21;32,06;33,45;-1,39;1032;1195;163;6963;3295;-3668
3885;10.06.2016;'21 - 22;31,67;34,04;-2,37;79;84;5;6245;2878;-3367
3886;10.06.2016;'22 - 23;32,86;35,75;-2,89;0;0;0;5590;2914;-2676
3887;10.06.2016;'23 - 24;29,45;33,03;-3,58;0;0;0;4965;2737;-2228
3888;11.06.2016;'00 - 01;26,14;25,88;0,26;0;0;0;2794;2338;-456
3889;11.06.2016;'01 - 02;24,2;24,74;-0,54;0;0;0;2427;1977;-450
3890;11.06.2016;'02 - 03;23,01;25,52;-2,51;0;0;0;2123;1817;-306
3891;11.06.2016;'03 - 04;21,57;23,57;-2;0;0;0;1897;1856;-41
3892;11.06.2016;'04 - 05;21,71;22,74;-1,03;7;4;-3;1706;1985;279
3893;11.06.2016;'05 - 06;21,25;21,7;-0,45;295;276;-19;1531;2042;511
3894;11.06.2016;'06 - 07;21,82;21,04;0,78;1658;1629;-29;1325;1913;588
3895;11.06.2016;'07 - 08;22,85;23,42;-0,57;4221;3914;-307;1074;1348;274
3896;11.06.2016;'08 - 09;26,06;30,07;-4,01;7150;6513;-637;851;1162;311
3897;11.06.2016;'09 - 10;29,47;31,68;-2,21;9894;9416;-478;713;1042;329
3898;11.06.2016;'10 - 11;29,46;31,22;-1,76;12043;11994;-49;629;764;135
3899;11.06.2016;'11 - 12;30,03;28,85;1,18;13476;13733;257;571;582;11
3900;11.06.2016;'12 - 13;28,49;27,63;0,86;14229;14552;323;552;564;12
3901;11.06.2016;'13 - 14;25,69;25,95;-0,26;14106;14952;846;547;596;49
3902;11.06.2016;'14 - 15;23,85;24,37;-0,52;13373;14800;1427;590;661;71
3903;11.06.2016;'15 - 16;23,8;23,45;0,35;12044;13548;1504;733;789;56
3904;11.06.2016;'16 - 17;24,06;24,38;-0,32;10128;11603;1475;922;936;14
3905;11.06.2016;'17 - 18;27,92;25,26;2,66;7643;8636;993;1149;1218;69
3906;11.06.2016;'18 - 19;30,23;30,29;-0,06;4898;5600;702;1420;1672;252
3907;11.06.2016;'19 - 20;31,47;32,73;-1,26;2401;2709;308;1810;2119;309
3908;11.06.2016;'20 - 21;31,85;30,54;1,31;767;829;62;2261;2392;131
3909;11.06.2016;'21 - 22;29,47;30,86;-1,39;67;66;-1;2736;2677;-59
3910;11.06.2016;'22 - 23;30,94;31,68;-0,74;0;0;0;3207;3588;381
3911;11.06.2016;'23 - 24;27,73;25,69;2,04;0;0;0;3439;4045;606
3912;12.06.2016;'00 - 01;22,74;22,76;-0,02;0;0;0;4601;4022;-579
3913;12.06.2016;'01 - 02;18,6;18,85;-0,25;0;0;0;4571;4063;-508
3914;12.06.2016;'02 - 03;18,58;18,8;-0,22;0;0;0;4406;3867;-539
3915;12.06.2016;'03 - 04;18,58;18,5;0,08;0;0;0;4114;3728;-386
3916;12.06.2016;'04 - 05;18,54;17,18;1,36;7;3;-4;3826;3380;-446
3917;12.06.2016;'05 - 06;17,5;15,95;1,55;254;249;-5;3508;3074;-434
3918;12.06.2016;'06 - 07;17,58;14,33;3,25;1347;1462;115;3078;2700;-378
3919;12.06.2016;'07 - 08;19,16;17,86;1,3;3200;3424;224;2619;2294;-325
3920;12.06.2016;'08 - 09;21,57;23,58;-2,01;5196;5806;610;2350;2094;-256
3921;12.06.2016;'09 - 10;22,91;25,34;-2,43;7166;8478;1312;2232;2240;8
3922;12.06.2016;'10 - 11;21,19;20,89;0,3;9015;10971;1956;2171;2460;289
3923;12.06.2016;'11 - 12;25,3;21,15;4,15;10550;12931;2381;2178;2686;508
3924;12.06.2016;'12 - 13;22,94;18,52;4,42;11744;14353;2609;2264;2982;718
3925;12.06.2016;'13 - 14;19,16;12,25;6,91;12292;14576;2284;2392;3335;943
3926;12.06.2016;'14 - 15;18,53;10,69;7,84;12076;13624;1548;2509;3586;1077
3927;12.06.2016;'15 - 16;19,07;12,3;6,77;11036;11686;650;2667;3701;1034
3928;12.06.2016;'16 - 17;21,06;15,54;5,52;9147;9021;-126;2852;3547;695
3929;12.06.2016;'17 - 18;23,93;21,39;2,54;6878;6613;-265;3104;3751;647
3930;12.06.2016;'18 - 19;27,52;26,27;1,25;4458;4316;-142;3446;3916;470
3931;12.06.2016;'19 - 20;29,78;26,59;3,19;2291;2232;-59;3875;3881;6
3932;12.06.2016;'20 - 21;31,33;26,48;4,85;698;581;-117;4367;4013;-354
3933;12.06.2016;'21 - 22;29,4;25,73;3,67;51;37;-14;4874;4185;-689
3934;12.06.2016;'22 - 23;29,81;28,12;1,69;0;0;0;5258;4821;-437
3935;12.06.2016;'23 - 24;23,24;22,41;0,83;0;0;0;5463;5003;-460
3936;13.06.2016;'00 - 01;21,34;18,47;2,87;0;0;0;5255;5055;-200
3937;13.06.2016;'01 - 02;19,46;18,54;0,92;0;0;0;5241;4764;-477
3938;13.06.2016;'02 - 03;17,63;17,45;0,18;0;0;0;5127;4471;-656
3939;13.06.2016;'03 - 04;18,37;16,26;2,11;0;0;0;4903;4312;-591
3940;13.06.2016;'04 - 05;18,57;16,76;1,81;3;2;-1;4710;4197;-513
3941;13.06.2016;'05 - 06;21,03;18,53;2,5;170;186;16;4551;4354;-197
3942;13.06.2016;'06 - 07;27,31;28,98;-1,67;1030;1107;77;4380;4174;-206
3943;13.06.2016;'07 - 08;33,49;32,2;1,29;2580;2573;-7;4152;3791;-361
3944;13.06.2016;'08 - 09;37,13;34,23;2,9;4288;4477;189;3916;3468;-448
3945;13.06.2016;'09 - 10;39,91;35,78;4,13;6056;6794;738;3697;3752;55
3946;13.06.2016;'10 - 11;38,17;37,3;0,87;7792;9366;1574;3559;3819;260
3947;13.06.2016;'11 - 12;39,09;34,84;4,25;9397;12024;2627;3557;3826;269
3948;13.06.2016;'12 - 13;34,23;32,66;1,57;10656;14138;3482;3743;4059;316
3949;13.06.2016;'13 - 14;32,32;29,71;2,61;11434;14885;3451;3966;4256;290
3950;13.06.2016;'14 - 15;31,68;28,69;2,99;11747;13887;2140;4196;4680;484
3951;13.06.2016;'15 - 16;30,89;29,9;0,99;10956;11996;1040;4460;4953;493
3952;13.06.2016;'16 - 17;29,38;31;-1,62;9102;9153;51;4695;4877;182
3953;13.06.2016;'17 - 18;30,45;32,39;-1,94;6841;7282;441;4792;5028;236
3954;13.06.2016;'18 - 19;31,75;31,44;0,31;4477;5159;682;4838;5179;341
3955;13.06.2016;'19 - 20;32,97;31,84;1,13;2309;2629;320;4832;5111;279
3956;13.06.2016;'20 - 21;32,58;32,64;-0,06;711;732;21;4666;4852;186
3957;13.06.2016;'21 - 22;29,98;29,47;0,51;59;52;-7;4687;4650;-37
3958;13.06.2016;'22 - 23;29,31;32,13;-2,82;0;0;0;4772;4647;-125
3959;13.06.2016;'23 - 24;26,14;28,58;-2,44;0;0;0;4782;4420;-362
3960;14.06.2016;'00 - 01;24,82;25,79;-0,97;0;0;0;5041;4468;-573
3961;14.06.2016;'01 - 02;22,76;22,82;-0,06;0;0;0;4994;4303;-691
3962;14.06.2016;'02 - 03;21,88;22,32;-0,44;0;0;0;4868;4053;-815
3963;14.06.2016;'03 - 04;21,64;19,14;2,5;0;0;0;4664;3808;-856
3964;14.06.2016;'04 - 05;22,04;21,39;0,65;5;2;-3;4462;3518;-944
3965;14.06.2016;'05 - 06;23;22,88;0,12;230;222;-8;4256;3390;-866
3966;14.06.2016;'06 - 07;27,4;30,28;-2,88;1272;1393;121;4000;3163;-837
3967;14.06.2016;'07 - 08;35,29;38,85;-3,56;3047;3281;234;3763;2943;-820
3968;14.06.2016;'08 - 09;38,39;40,08;-1,69;5110;5829;719;3514;2700;-814
3969;14.06.2016;'09 - 10;38,44;39,54;-1,1;7347;8935;1588;3202;2529;-673
3970;14.06.2016;'10 - 11;37,25;35,19;2,06;9823;11851;2028;2927;2397;-530
3971;14.06.2016;'11 - 12;35,83;32,4;3,43;12221;14004;1783;2746;2364;-382
3972;14.06.2016;'12 - 13;32;32,34;-0,34;14186;15114;928;2712;2494;-218
3973;14.06.2016;'13 - 14;29,37;32,18;-2,81;15205;16073;868;2744;2664;-80
3974;14.06.2016;'14 - 15;27,55;30,94;-3,39;15181;15744;563;2782;2713;-69
3975;14.06.2016;'15 - 16;27,38;27,8;-0,42;13808;13720;-88;2714;3020;306
3976;14.06.2016;'16 - 17;28,64;28,76;-0,12;11369;11278;-91;2565;2830;265
3977;14.06.2016;'17 - 18;32,51;30,56;1,95;8504;8376;-128;2324;2706;382
3978;14.06.2016;'18 - 19;35,08;34,79;0,29;5426;5358;-68;1940;2284;344
3979;14.06.2016;'19 - 20;37,5;36,51;0,99;2781;2842;61;1615;2176;561
3980;14.06.2016;'20 - 21;36;33,1;2,9;900;906;6;1573;1908;335
3981;14.06.2016;'21 - 22;32,01;30,04;1,97;76;76;0;1875;1983;108
3982;14.06.2016;'22 - 23;30,1;28,9;1,2;0;0;0;2299;2279;-20
3983;14.06.2016;'23 - 24;26,59;26,49;0,1;0;0;0;2676;2668;-8
3984;15.06.2016;'00 - 01;26,19;23,65;2,54;0;0;0;2839;2995;156
3985;15.06.2016;'01 - 02;25,34;23,33;2,01;0;0;0;2915;2974;59
3986;15.06.2016;'02 - 03;24,32;30,74;-6,42;0;0;0;2829;2964;135
3987;15.06.2016;'03 - 04;23,73;24,94;-1,21;0;0;0;2557;2762;205
3988;15.06.2016;'04 - 05;23,52;21,52;2;5;3;-2;2280;2489;209
3989;15.06.2016;'05 - 06;25,31;22,94;2,37;254;228;-26;2001;2253;252
3990;15.06.2016;'06 - 07;28,37;31,95;-3,58;1452;1461;9;1716;1944;228
3991;15.06.2016;'07 - 08;35,91;35,19;0,72;3544;3727;183;1470;1295;-175
3992;15.06.2016;'08 - 09;38,79;39,08;-0,29;6113;6543;430;1325;897;-428
3993;15.06.2016;'09 - 10;36,2;36,47;-0,27;8995;9676;681;1308;914;-394
3994;15.06.2016;'10 - 11;35,91;35,83;0,08;11768;12342;574;1337;988;-349
3995;15.06.2016;'11 - 12;35,51;34,93;0,58;14010;14159;149;1407;1314;-93
3996;15.06.2016;'12 - 13;30,21;30,12;0,09;15487;14574;-913;1584;1798;214
3997;15.06.2016;'13 - 14;28,29;30,67;-2,38;15974;14920;-1054;1783;2206;423
3998;15.06.2016;'14 - 15;27,99;30,48;-2,49;15439;15284;-155;1972;2558;586
3999;15.06.2016;'15 - 16;27,73;30,65;-2,92;13903;14876;973;2131;2916;785
4000;15.06.2016;'16 - 17;29,12;30,03;-0,91;11721;13119;1398;2179;3022;843
4001;15.06.2016;'17 - 18;31;29,44;1,56;8956;10283;1327;2099;3144;1045
4002;15.06.2016;'18 - 19;34,53;33,7;0,83;5783;6463;680;1895;2847;952
4003;15.06.2016;'19 - 20;36,91;35,48;1,43;2948;3289;341;1654;2317;663
4004;15.06.2016;'20 - 21;35,49;35,64;-0,15;972;1096;124;1524;1836;312
4005;15.06.2016;'21 - 22;33,25;33,57;-0,32;76;90;14;1778;1636;-142
4006;15.06.2016;'22 - 23;33,02;37,32;-4,3;0;0;0;2237;1856;-381
4007;15.06.2016;'23 - 24;27,33;29,2;-1,87;0;0;0;2688;2521;-167
4008;16.06.2016;'00 - 01;26,46;28,33;-1,87;0;0;0;3160;2912;-248
4009;16.06.2016;'01 - 02;25,64;26,87;-1,23;0;0;0;3456;3036;-420
4010;16.06.2016;'02 - 03;24,6;25,69;-1,09;0;0;0;3609;3104;-505
4011;16.06.2016;'03 - 04;23,61;23,98;-0,37;0;0;0;3516;3168;-348
4012;16.06.2016;'04 - 05;23,99;21,98;2,01;7;5;-2;3265;3105;-160
4013;16.06.2016;'05 - 06;24,95;24,19;0,76;330;339;9;2823;2817;-6
4014;16.06.2016;'06 - 07;29,84;31,04;-1,2;1828;1841;13;2211;2302;91
4015;16.06.2016;'07 - 08;37,82;34,64;3,18;4927;4999;72;1556;1155;-401
4016;16.06.2016;'08 - 09;39,74;35,51;4,23;8929;8774;-155;1124;590;-534
4017;16.06.2016;'09 - 10;35,43;33,1;2,33;12978;11960;-1018;957;419;-538
4018;16.06.2016;'10 - 11;34,88;34,21;0,67;16226;14598;-1628;913;598;-315
4019;16.06.2016;'11 - 12;33,76;35,12;-1,36;18143;16319;-1824;961;736;-225
4020;16.06.2016;'12 - 13;29,71;34,08;-4,37;18864;16198;-2666;1039;738;-301
4021;16.06.2016;'13 - 14;26,98;33,94;-6,96;18567;14895;-3672;1093;701;-392
4022;16.06.2016;'14 - 15;27,44;35,14;-7,7;17242;12950;-4292;1070;690;-380
4023;16.06.2016;'15 - 16;28,47;35,65;-7,18;14986;10966;-4020;977;718;-259
4024;16.06.2016;'16 - 17;31,75;36,49;-4,74;11815;8592;-3223;853;694;-159
4025;16.06.2016;'17 - 18;33,03;37,52;-4,49;8242;6652;-1590;851;921;70
4026;16.06.2016;'18 - 19;34,71;36,19;-1,48;5023;4286;-737;1034;1083;49
4027;16.06.2016;'19 - 20;35,2;36,39;-1,19;2600;2157;-443;1367;972;-395
4028;16.06.2016;'20 - 21;35,28;37,48;-2,2;855;629;-226;1970;972;-998
4029;16.06.2016;'21 - 22;33,02;34,04;-1,02;73;71;-2;2815;928;-1887
4030;16.06.2016;'22 - 23;31,05;34,04;-2,99;0;0;0;3743;868;-2875
4031;16.06.2016;'23 - 24;26,62;28,55;-1,93;0;0;0;4502;952;-3550
4032;17.06.2016;'00 - 01;25,9;28,22;-2,32;0;0;0;3245;1226;-2019
4033;17.06.2016;'01 - 02;23,73;26,18;-2,45;0;0;0;3593;1606;-1987
4034;17.06.2016;'02 - 03;22,16;25,18;-3,02;0;0;0;3939;1992;-1947
4035;17.06.2016;'03 - 04;21,37;22,96;-1,59;0;0;0;4190;2484;-1706
4036;17.06.2016;'04 - 05;21,72;22,66;-0,94;1;2;1;4459;2816;-1643
4037;17.06.2016;'05 - 06;22,45;24,64;-2,19;129;130;1;4788;3308;-1480
4038;17.06.2016;'06 - 07;27,85;31,55;-3,7;845;899;54;5176;3913;-1263
4039;17.06.2016;'07 - 08;35,3;42,85;-7,55;2210;2284;74;5551;4043;-1508
4040;17.06.2016;'08 - 09;39,7;47,26;-7,56;3939;3787;-152;5989;4596;-1393
4041;17.06.2016;'09 - 10;37,5;44,77;-7,27;5926;5703;-223;6754;5152;-1602
4042;17.06.2016;'10 - 11;34,94;43,47;-8,53;8196;7863;-333;7697;5903;-1794
4043;17.06.2016;'11 - 12;33,25;43,1;-9,85;10626;9765;-861;8485;6810;-1675
4044;17.06.2016;'12 - 13;28,81;36,12;-7,31;12783;12211;-572;9057;7632;-1425
4045;17.06.2016;'13 - 14;24,97;29,82;-4,85;14136;13702;-434;9501;8110;-1391
4046;17.06.2016;'14 - 15;23,92;26,22;-2,3;14518;14487;-31;9637;9093;-544
4047;17.06.2016;'15 - 16;23,01;22,59;0,42;13656;13642;-14;9543;9249;-294
4048;17.06.2016;'16 - 17;23,06;21,23;1,83;11615;11884;269;9431;9138;-293
4049;17.06.2016;'17 - 18;26,55;25,66;0,89;8775;9698;923;9038;9211;173
4050;17.06.2016;'18 - 19;30,72;29,06;1,66;5664;6957;1293;8267;8854;587
4051;17.06.2016;'19 - 20;32,15;30,51;1,64;2934;3610;676;7385;8321;936
4052;17.06.2016;'20 - 21;30,59;28,68;1,91;994;1159;165;6760;7924;1164
4053;17.06.2016;'21 - 22;28,16;27,52;0,64;83;99;16;6848;7930;1082
4054;17.06.2016;'22 - 23;29,08;27,83;1,25;0;0;0;7148;8368;1220
4055;17.06.2016;'23 - 24;26,07;24,11;1,96;0;0;0;7463;8754;1291
4056;18.06.2016;'00 - 01;23,06;19,62;3,44;0;0;0;7893;8756;863
4057;18.06.2016;'01 - 02;22,45;18,23;4,22;0;0;0;7745;8812;1067
4058;18.06.2016;'02 - 03;21,02;17,76;3,26;0;0;0;7478;8712;1234
4059;18.06.2016;'03 - 04;20,09;15,09;5;0;0;0;7146;8331;1185
4060;18.06.2016;'04 - 05;20,06;14,59;5,47;7;5;-2;6734;8149;1415
4061;18.06.2016;'05 - 06;18,75;12,47;6,28;377;353;-24;6189;7738;1549
4062;18.06.2016;'06 - 07;20,73;13,55;7,18;2039;1973;-66;5594;6799;1205
4063;18.06.2016;'07 - 08;22,75;20,21;2,54;5325;5190;-135;5132;5916;784
4064;18.06.2016;'08 - 09;24,47;27,69;-3,22;9416;9287;-129;5026;5639;613
4065;18.06.2016;'09 - 10;23;25,1;-2,1;13390;13260;-130;5172;6078;906
4066;18.06.2016;'10 - 11;21,64;22,7;-1,06;16434;16082;-352;5398;6466;1068
4067;18.06.2016;'11 - 12;21,08;22,94;-1,86;18367;17514;-853;5590;7028;1438
4068;18.06.2016;'12 - 13;16,04;19,03;-2,99;19456;18162;-1294;5666;7201;1535
4069;18.06.2016;'13 - 14;12,85;19,69;-6,84;19322;17975;-1347;5673;6969;1296
4070;18.06.2016;'14 - 15;15,93;19,92;-3,99;18023;17110;-913;5550;6466;916
4071;18.06.2016;'15 - 16;18,67;21,89;-3,22;15710;15310;-400;5308;6055;747
4072;18.06.2016;'16 - 17;21,49;20,98;0,51;12769;13090;321;4963;5417;454
4073;18.06.2016;'17 - 18;23,38;22,03;1,35;9399;9944;545;4488;4792;304
4074;18.06.2016;'18 - 19;26,53;25,99;0,54;6023;6802;779;4023;4344;321
4075;18.06.2016;'19 - 20;27,28;21,82;5,46;3144;3565;421;3654;3676;22
4076;18.06.2016;'20 - 21;26,83;25,64;1,19;1087;1159;72;3518;3333;-185
4077;18.06.2016;'21 - 22;26,97;27,7;-0,73;94;104;10;3665;3374;-291
4078;18.06.2016;'22 - 23;28;28,21;-0,21;0;0;0;3935;3924;-11
4079;18.06.2016;'23 - 24;24,48;23,39;1,09;0;0;0;4236;4496;260
4080;19.06.2016;'00 - 01;20,64;15,36;5,28;0;0;0;4490;5131;641
4081;19.06.2016;'01 - 02;15,16;8,9;6,26;0;0;0;4856;5430;574
4082;19.06.2016;'02 - 03;13,04;7,76;5,28;0;0;0;5005;5250;245
4083;19.06.2016;'03 - 04;10,88;7,5;3,38;0;0;0;4921;5162;241
4084;19.06.2016;'04 - 05;15,04;8,72;6,32;6;4;-2;4745;4957;212
4085;19.06.2016;'05 - 06;13,1;7,04;6,06;295;278;-17;4531;4891;360
4086;19.06.2016;'06 - 07;10,16;6,07;4,09;1622;1570;-52;4349;4542;193
4087;19.06.2016;'07 - 08;10,13;6,13;4;3864;3983;119;4110;3955;-155
4088;19.06.2016;'08 - 09;14,29;11,27;3,02;6488;6811;323;3999;3663;-336
4089;19.06.2016;'09 - 10;16,98;12,08;4,9;9198;9469;271;3943;3742;-201
4090;19.06.2016;'10 - 11;17,55;13,05;4,5;11687;11592;-95;3919;3844;-75
4091;19.06.2016;'11 - 12;19,08;16,4;2,68;13755;12774;-981;4030;3640;-390
4092;19.06.2016;'12 - 13;17,12;20,37;-3,25;15243;13536;-1707;4320;3851;-469
4093;19.06.2016;'13 - 14;11,63;16,5;-4,87;16016;14604;-1412;4637;4035;-602
4094;19.06.2016;'14 - 15;9,04;14,13;-5,09;15777;15082;-695;4793;4332;-461
4095;19.06.2016;'15 - 16;8,9;12,05;-3,15;14661;14432;-229;4867;4228;-639
4096;19.06.2016;'16 - 17;11,79;9,54;2,25;12620;12696;76;4904;4051;-853
4097;19.06.2016;'17 - 18;19,04;18,45;0,59;9758;9999;241;4675;3495;-1180
4098;19.06.2016;'18 - 19;22,97;22,06;0,91;6420;6741;321;4076;3093;-983
4099;19.06.2016;'19 - 20;26,95;29,04;-2,09;3407;3622;215;3427;2796;-631
4100;19.06.2016;'20 - 21;27,8;28,67;-0,87;1185;1229;44;2809;2170;-639
4101;19.06.2016;'21 - 22;29,88;30,83;-0,95;105;116;11;2491;1862;-629
4102;19.06.2016;'22 - 23;29,26;32,71;-3,45;0;0;0;2345;1953;-392
4103;19.06.2016;'23 - 24;27,14;26,66;0,48;0;0;0;2305;2140;-165
4104;20.06.2016;'00 - 01;24,92;24,12;0,8;0;0;0;2199;2487;288
4105;20.06.2016;'01 - 02;21,6;20,6;1;0;0;0;2664;3210;546
4106;20.06.2016;'02 - 03;20,4;19,15;1,25;0;0;0;3269;4589;1320
4107;20.06.2016;'03 - 04;17,45;13,23;4,22;0;0;0;4039;6012;1973
4108;20.06.2016;'04 - 05;17,05;10,2;6,85;8;5;-3;4865;7128;2263
4109;20.06.2016;'05 - 06;19,99;14,28;5,71;382;363;-19;5531;7604;2073
4110;20.06.2016;'06 - 07;28,97;23,69;5,28;2094;1962;-132;5842;7503;1661
4111;20.06.2016;'07 - 08;34,42;33,66;0,76;5775;5731;-44;5957;6896;939
4112;20.06.2016;'08 - 09;34,94;34,34;0,6;10618;11000;382;6182;6729;547
4113;20.06.2016;'09 - 10;29,44;27,87;1,57;15213;16074;861;6848;7923;1075
4114;20.06.2016;'10 - 11;26,84;25,37;1,47;18059;19011;952;7707;9060;1353
4115;20.06.2016;'11 - 12;26,95;23,67;3,28;19248;20184;936;8498;9656;1158
4116;20.06.2016;'12 - 13;25,51;24,11;1,4;19336;20658;1322;9121;9932;811
4117;20.06.2016;'13 - 14;25,24;25,11;0,13;18831;20724;1893;9674;10456;782
4118;20.06.2016;'14 - 15;25,44;23,4;2,04;17510;19561;2051;10076;10557;481
4119;20.06.2016;'15 - 16;25,49;24,31;1,18;15427;17071;1644;10423;10738;315
4120;20.06.2016;'16 - 17;25,19;24,75;0,44;12613;13935;1322;10590;10788;198
4121;20.06.2016;'17 - 18;27,74;25,71;2,03;9149;10170;1021;10491;10880;389
4122;20.06.2016;'18 - 19;32,97;29,86;3,11;5597;5830;233;10320;10836;516
4123;20.06.2016;'19 - 20;34,96;31,44;3,52;2705;2512;-193;10192;10950;758
4124;20.06.2016;'20 - 21;33,57;28,9;4,67;895;662;-233;10334;10978;644
4125;20.06.2016;'21 - 22;31,76;27,99;3,77;65;39;-26;10360;11358;998
4126;20.06.2016;'22 - 23;30,74;27,12;3,62;0;0;0;10302;11889;1587
4127;20.06.2016;'23 - 24;25,38;24,4;0,98;0;0;0;10054;11647;1593
4128;21.06.2016;'00 - 01;24,23;25,05;-0,82;0;0;0;10039;11206;1167
4129;21.06.2016;'01 - 02;23,37;21,64;1,73;0;0;0;9218;10296;1078
4130;21.06.2016;'02 - 03;22,34;20,83;1,51;0;0;0;8262;9378;1116
4131;21.06.2016;'03 - 04;21,23;18,63;2,6;0;0;0;7223;8753;1530
4132;21.06.2016;'04 - 05;21,89;18,18;3,71;1;2;1;6307;8074;1767
4133;21.06.2016;'05 - 06;23,93;19,09;4,84;113;129;16;5622;7145;1523
4134;21.06.2016;'06 - 07;29,54;22,58;6,96;630;907;277;5055;6198;1143
4135;21.06.2016;'07 - 08;38,73;36,3;2,43;1607;2513;906;4519;5135;616
4136;21.06.2016;'08 - 09;40,78;38,67;2,11;2830;4764;1934;4025;4672;647
4137;21.06.2016;'09 - 10;42,59;35,29;7,3;4257;7299;3042;3553;4408;855
4138;21.06.2016;'10 - 11;41,79;34,02;7,77;5955;10188;4233;3191;4388;1197
4139;21.06.2016;'11 - 12;43,73;33,17;10,56;7659;12465;4806;2953;4349;1396
4140;21.06.2016;'12 - 13;39,59;31,35;8,24;9159;13951;4792;2764;4038;1274
4141;21.06.2016;'13 - 14;37,64;30,25;7,39;10280;14669;4389;2593;3761;1168
4142;21.06.2016;'14 - 15;35,84;30,1;5,74;10922;15485;4563;2397;3183;786
4143;21.06.2016;'15 - 16;34,16;29,38;4,78;10714;14840;4126;2195;2679;484
4144;21.06.2016;'16 - 17;32,45;30,08;2,37;9571;12798;3227;1954;2115;161
4145;21.06.2016;'17 - 18;33,05;32,53;0,52;7713;10155;2442;1696;1834;138
4146;21.06.2016;'18 - 19;34,94;36,62;-1,68;5312;6596;1284;1443;1508;65
4147;21.06.2016;'19 - 20;35,91;37,6;-1,69;2914;3288;374;1202;1168;-34
4148;21.06.2016;'20 - 21;37,44;38,81;-1,37;985;1040;55;1165;1162;-3
4149;21.06.2016;'21 - 22;34,98;36,72;-1,74;88;88;0;1566;1415;-151
4150;21.06.2016;'22 - 23;33,93;38,38;-4,45;0;0;0;2167;1710;-457
4151;21.06.2016;'23 - 24;30;33,77;-3,77;0;0;0;2836;2299;-537
4152;22.06.2016;'00 - 01;28,06;29,78;-1,72;0;0;0;2525;2824;299
4153;22.06.2016;'01 - 02;24,95;27,98;-3,03;0;0;0;2846;3379;533
4154;22.06.2016;'02 - 03;23,95;26,48;-2,53;0;0;0;3055;3426;371
4155;22.06.2016;'03 - 04;23,14;25,34;-2,2;0;0;0;3033;3472;439
4156;22.06.2016;'04 - 05;22,97;26,24;-3,27;4;4;0;2880;3435;555
4157;22.06.2016;'05 - 06;24,06;28,73;-4,67;260;254;-6;2588;3167;579
4158;22.06.2016;'06 - 07;29,98;35,25;-5,27;1595;1580;-15;2215;2960;745
4159;22.06.2016;'07 - 08;40;45,25;-5,25;4036;4336;300;1695;2546;851
4160;22.06.2016;'08 - 09;42;45,7;-3,7;7285;8228;943;1315;1989;674
4161;22.06.2016;'09 - 10;40;41,07;-1,07;10893;12638;1745;1356;2203;847
4162;22.06.2016;'10 - 11;37,27;34,84;2,43;14026;16653;2627;1457;2422;965
4163;22.06.2016;'11 - 12;36,62;31,96;4,66;16457;19186;2729;1617;2857;1240
4164;22.06.2016;'12 - 13;33,6;28,95;4,65;17924;20158;2234;1778;3274;1496
4165;22.06.2016;'13 - 14;30,29;26,72;3,57;18433;20657;2224;1856;3082;1226
4166;22.06.2016;'14 - 15;28,94;27,05;1,89;18152;20357;2205;1768;2749;981
4167;22.06.2016;'15 - 16;28,93;27,32;1,61;16891;18740;1849;1605;2371;766
4168;22.06.2016;'16 - 17;30,31;30,16;0,15;14676;16407;1731;1332;1849;517
4169;22.06.2016;'17 - 18;33,7;34,69;-0,99;11351;12741;1390;1072;1326;254
4170;22.06.2016;'18 - 19;38,12;40,65;-2,53;7289;8248;959;838;745;-93
4171;22.06.2016;'19 - 20;39,8;42,04;-2,24;3580;4057;477;672;409;-263
4172;22.06.2016;'20 - 21;38,3;40,19;-1,89;1232;1282;50;766;327;-439
4173;22.06.2016;'21 - 22;37,39;40,18;-2,79;114;109;-5;1264;464;-800
4174;22.06.2016;'22 - 23;35,98;41,39;-5,41;0;0;0;1987;920;-1067
4175;22.06.2016;'23 - 24;30,35;34,81;-4,46;0;0;0;2831;1728;-1103
4176;23.06.2016;'00 - 01;28,09;32,69;-4,6;0;0;0;3121;2889;-232
4177;23.06.2016;'01 - 02;25,64;30,19;-4,55;0;0;0;4019;4046;27
4178;23.06.2016;'02 - 03;24,38;30,28;-5,9;0;0;0;4803;5099;296
4179;23.06.2016;'03 - 04;23,3;26,22;-2,92;0;0;0;5408;6137;729
4180;23.06.2016;'04 - 05;23,24;19,28;3,96;7;4;-3;5871;6750;879
4181;23.06.2016;'05 - 06;24,14;24,06;0,08;366;378;12;6001;7312;1311
4182;23.06.2016;'06 - 07;28,16;31,02;-2,86;2083;2075;-8;5753;7210;1457
4183;23.06.2016;'07 - 08;35,91;35,66;0,25;6009;6141;132;5085;5956;871
4184;23.06.2016;'08 - 09;35,91;37,01;-1,1;11398;11640;242;4254;3970;-284
4185;23.06.2016;'09 - 10;34,97;31,71;3,26;16770;17208;438;4082;3515;-567
4186;23.06.2016;'10 - 11;29,78;29,74;0,04;21157;21720;563;4165;4308;143
4187;23.06.2016;'11 - 12;27,95;26,44;1,51;24158;24675;517;4405;4918;513
4188;23.06.2016;'12 - 13;25,62;25,64;-0,02;25726;25972;246;4817;5325;508
4189;23.06.2016;'13 - 14;25,08;25,31;-0,23;25911;26011;100;5164;5498;334
4190;23.06.2016;'14 - 15;25,37;26,6;-1,23;24877;24540;-337;5366;5612;246
4191;23.06.2016;'15 - 16;25,71;27,49;-1,78;22486;22335;-151;5540;5306;-234
4192;23.06.2016;'16 - 17;27,31;30,22;-2,91;18585;18882;297;5391;5204;-187
4193;23.06.2016;'17 - 18;30,83;34,93;-4,1;13487;14170;683;5060;5147;87
4194;23.06.2016;'18 - 19;35,92;45,02;-9,1;7830;8676;846;4824;5233;409
4195;23.06.2016;'19 - 20;40,06;49,87;-9,81;3403;3869;466;4739;5447;708
4196;23.06.2016;'20 - 21;38,04;48,78;-10,74;1091;1285;194;5146;5920;774
4197;23.06.2016;'21 - 22;32,72;41,53;-8,81;114;133;19;6578;7596;1018
4198;23.06.2016;'22 - 23;30,77;38,9;-8,13;0;0;0;8089;9414;1325
4199;23.06.2016;'23 - 24;26,99;29,85;-2,86;0;0;0;8789;9832;1043
4200;24.06.2016;'00 - 01;26,03;28,86;-2,83;0;0;0;8680;9807;1127
4201;24.06.2016;'01 - 02;24,56;25,69;-1,13;0;0;0;8134;9429;1295
4202;24.06.2016;'02 - 03;24,08;26,25;-2,17;0;0;0;7431;8804;1373
4203;24.06.2016;'03 - 04;23,36;25,57;-2,21;0;0;0;6727;8218;1491
4204;24.06.2016;'04 - 05;23,91;24,7;-0,79;7;4;-3;6108;6893;785
4205;24.06.2016;'05 - 06;26,43;27,13;-0,7;352;350;-2;5557;6524;967
4206;24.06.2016;'06 - 07;31,86;35;-3,14;2025;1990;-35;4846;6697;1851
4207;24.06.2016;'07 - 08;37,03;39,01;-1,98;5850;5610;-240;3964;5859;1895
4208;24.06.2016;'08 - 09;38,84;37,52;1,32;11050;10126;-924;3094;4402;1308
4209;24.06.2016;'09 - 10;34,46;35,62;-1,16;16231;15051;-1180;2733;3485;752
4210;24.06.2016;'10 - 11;31,96;36,39;-4,43;20382;19211;-1171;2501;2800;299
4211;24.06.2016;'11 - 12;30,01;35,62;-5,61;23055;21818;-1237;2472;2431;-41
4212;24.06.2016;'12 - 13;29,93;35,27;-5,34;24328;22940;-1388;2675;2417;-258
4213;24.06.2016;'13 - 14;28,27;34;-5,73;24156;22722;-1434;3032;2218;-814
4214;24.06.2016;'14 - 15;28,66;34,5;-5,84;22732;20906;-1826;3165;2521;-644
4215;24.06.2016;'15 - 16;28,38;34,79;-6,41;20247;18559;-1688;3061;2355;-706
4216;24.06.2016;'16 - 17;29,63;34,89;-5,26;16693;15648;-1045;2952;2541;-411
4217;24.06.2016;'17 - 18;31,65;37,05;-5,4;12083;11654;-429;2737;2860;123
4218;24.06.2016;'18 - 19;34,98;38,98;-4;7197;7171;-26;2523;3393;870
4219;24.06.2016;'19 - 20;35,53;41,21;-5,68;3334;3217;-117;2364;4010;1646
4220;24.06.2016;'20 - 21;34,95;36,98;-2,03;1135;1001;-134;2443;3506;1063
4221;24.06.2016;'21 - 22;33,28;36,33;-3,05;102;89;-13;2806;3694;888
4222;24.06.2016;'22 - 23;34,12;38,27;-4,15;0;0;0;3124;4052;928
4223;24.06.2016;'23 - 24;32,04;32,52;-0,48;0;0;0;3224;4011;787
4224;25.06.2016;'00 - 01;30,14;30,73;-0,59;0;0;0;3606;3477;-129
4225;25.06.2016;'01 - 02;28,97;30,63;-1,66;0;0;0;3355;3292;-63
4226;25.06.2016;'02 - 03;26,64;27,29;-0,65;0;0;0;3110;2842;-268
4227;25.06.2016;'03 - 04;24,28;28,08;-3,8;0;0;0;2995;2780;-215
4228;25.06.2016;'04 - 05;23,35;27,99;-4,64;4;4;0;2961;3099;138
4229;25.06.2016;'05 - 06;23;26,24;-3,24;284;281;-3;2858;3090;232
4230;25.06.2016;'06 - 07;24;25,62;-1,62;1497;1514;17;2578;2889;311
4231;25.06.2016;'07 - 08;26,93;28,17;-1,24;3744;3778;34;2223;2523;300
4232;25.06.2016;'08 - 09;30,25;30,92;-0,67;6429;7056;627;1927;2059;132
4233;25.06.2016;'09 - 10;32,96;32,09;0,87;9111;10295;1184;1878;2023;145
4234;25.06.2016;'10 - 11;33,86;30,6;3,26;11361;12918;1557;1895;1987;92
4235;25.06.2016;'11 - 12;32,95;30,65;2,3;12989;15383;2394;2024;2344;320
4236;25.06.2016;'12 - 13;30,06;28,88;1,18;14003;16708;2705;2370;2901;531
4237;25.06.2016;'13 - 14;27,81;24,06;3,75;14046;16802;2756;2977;3402;425
4238;25.06.2016;'14 - 15;25,08;22,1;2,98;13204;15680;2476;3728;4308;580
4239;25.06.2016;'15 - 16;24,43;22,97;1,46;11625;12873;1248;4357;6062;1705
4240;25.06.2016;'16 - 17;24,43;23,47;0,96;9475;9631;156;4901;7551;2650
4241;25.06.2016;'17 - 18;27,31;23,74;3,57;6990;6242;-748;5078;8718;3640
4242;25.06.2016;'18 - 19;29,42;26;3,42;4589;3406;-1183;5050;8671;3621
4243;25.06.2016;'19 - 20;30,53;26,58;3,95;2474;1707;-767;5003;8218;3215
4244;25.06.2016;'20 - 21;29,8;25,89;3,91;832;620;-212;4811;8288;3477
4245;25.06.2016;'21 - 22;28,81;24,12;4,69;69;69;0;4698;8500;3802
4246;25.06.2016;'22 - 23;29,61;25,67;3,94;0;0;0;4907;8435;3528
4247;25.06.2016;'23 - 24;27,02;24,26;2,76;0;0;0;5330;9669;4339
4248;26.06.2016;'00 - 01;17,29;20,4;-3,11;0;0;0;8919;10132;1213
4249;26.06.2016;'01 - 02;12,78;14,44;-1,66;0;0;0;8984;11063;2079
4250;26.06.2016;'02 - 03;14,25;9,32;4,93;0;0;0;8763;10658;1895
4251;26.06.2016;'03 - 04;13,35;6,97;6,38;0;0;0;8403;10255;1852
4252;26.06.2016;'04 - 05;13,08;5,6;7,48;2;2;0;7949;10067;2118
4253;26.06.2016;'05 - 06;12,43;4,12;8,31;289;266;-23;7496;8661;1165
4254;26.06.2016;'06 - 07;11,53;5,35;6,18;1697;1586;-111;6986;7674;688
4255;26.06.2016;'07 - 08;12,63;7,81;4,82;4421;4296;-125;6496;6792;296
4256;26.06.2016;'08 - 09;13,46;12,36;1,1;8000;8271;271;6240;7144;904
4257;26.06.2016;'09 - 10;13,51;8,9;4,61;11691;12239;548;6264;8051;1787
4258;26.06.2016;'10 - 11;9,79;5,83;3,96;14680;15651;971;6390;8768;2378
4259;26.06.2016;'11 - 12;12,86;5,52;7,34;16602;17484;882;6640;8729;2089
4260;26.06.2016;'12 - 13;12,08;4,84;7,24;17641;18278;637;6851;8559;1708
4261;26.06.2016;'13 - 14;9,29;5,61;3,68;17867;18004;137;6886;7758;872
4262;26.06.2016;'14 - 15;8,05;5,36;2,69;17083;16886;-197;6771;7609;838
4263;26.06.2016;'15 - 16;9,19;11,15;-1,96;15321;14500;-821;6447;7406;959
4264;26.06.2016;'16 - 17;11,67;12,41;-0,74;12755;12186;-569;6030;6670;640
4265;26.06.2016;'17 - 18;15,79;18,36;-2,57;9579;9532;-47;5492;5910;418
4266;26.06.2016;'18 - 19;23,76;23,86;-0,1;6167;6556;389;4903;5124;221
4267;26.06.2016;'19 - 20;26,79;24,07;2,72;3202;3423;221;4448;4533;85
4268;26.06.2016;'20 - 21;29,97;27,98;1,99;1110;1139;29;4361;3785;-576
4269;26.06.2016;'21 - 22;28,46;29,35;-0,89;107;108;1;4576;3834;-742
4270;26.06.2016;'22 - 23;31,91;32,05;-0,14;0;0;0;4984;4290;-694
4271;26.06.2016;'23 - 24;28,12;30,39;-2,27;0;0;0;5565;4913;-652
4272;27.06.2016;'00 - 01;24,1;24,5;-0,4;0;0;0;4675;5117;442
4273;27.06.2016;'01 - 02;20,99;17,58;3,41;0;0;0;5118;5266;148
4274;27.06.2016;'02 - 03;19,04;18,94;0,1;0;0;0;5508;5562;54
4275;27.06.2016;'03 - 04;16,29;17,06;-0,77;0;0;0;5782;6422;640
4276;27.06.2016;'04 - 05;16,12;16,16;-0,04;6;3;-3;5983;6733;750
4277;27.06.2016;'05 - 06;19,02;15,47;3,55;311;268;-43;6039;6836;797
4278;27.06.2016;'06 - 07;27,75;23,91;3,84;1795;1720;-75;6016;6469;453
4279;27.06.2016;'07 - 08;33,07;35,83;-2,76;4920;4950;30;6150;5622;-528
4280;27.06.2016;'08 - 09;34,26;38,09;-3,83;9151;9347;196;6642;5554;-1088
4281;27.06.2016;'09 - 10;31,02;32,1;-1,08;13156;13766;610;7475;7029;-446
4282;27.06.2016;'10 - 11;26,57;27,67;-1,1;15971;16870;899;8495;8566;71
4283;27.06.2016;'11 - 12;26,29;25,16;1,13;17384;18508;1124;9303;9529;226
4284;27.06.2016;'12 - 13;24,82;23,02;1,8;17702;19469;1767;9819;10300;481
4285;27.06.2016;'13 - 14;25,38;22,71;2,67;17228;18832;1604;10186;10719;533
4286;27.06.2016;'14 - 15;24,87;22,07;2,8;15879;17152;1273;10187;10898;711
4287;27.06.2016;'15 - 16;25,95;22,98;2,97;13797;15202;1405;9839;10557;718
4288;27.06.2016;'16 - 17;25,92;23,95;1,97;11296;12753;1457;9163;10091;928
4289;27.06.2016;'17 - 18;28,08;25,4;2,68;8351;9728;1377;8413;9334;921
4290;27.06.2016;'18 - 19;34,98;30,16;4,82;5297;6274;977;7476;7809;333
4291;27.06.2016;'19 - 20;39,05;32,4;6,65;2589;2998;409;6540;6177;-363
4292;27.06.2016;'20 - 21;38,31;31,46;6,85;918;914;-4;5659;4830;-829
4293;27.06.2016;'21 - 22;36,52;30,32;6,2;81;81;0;5035;4258;-777
4294;27.06.2016;'22 - 23;36,4;30,99;5,41;0;0;0;4693;4574;-119
4295;27.06.2016;'23 - 24;31,69;25,75;5,94;0;0;0;4600;5155;555
4296;28.06.2016;'00 - 01;26,84;26,34;0,5;0;0;0;4938;5382;444
4297;28.06.2016;'01 - 02;24,4;24,77;-0,37;0;0;0;4909;5522;613
4298;28.06.2016;'02 - 03;24,09;23,35;0,74;0;0;0;4955;5505;550
4299;28.06.2016;'03 - 04;23,13;21,36;1,77;0;0;0;4665;5087;422
4300;28.06.2016;'04 - 05;22,76;21,41;1,35;2;2;0;4199;4638;439
4301;28.06.2016;'05 - 06;24,19;23,3;0,89;246;260;14;3655;3997;342
4302;28.06.2016;'06 - 07;30;32,04;-2,04;1567;1666;99;3010;3674;664
4303;28.06.2016;'07 - 08;40,08;42,76;-2,68;4031;4378;347;2337;2944;607
4304;28.06.2016;'08 - 09;41,91;42,04;-0,13;7269;8024;755;1953;2991;1038
4305;28.06.2016;'09 - 10;41,98;38,02;3,96;10876;12258;1382;1829;3237;1408
4306;28.06.2016;'10 - 11;38,94;37,08;1,86;14026;15964;1938;1760;3493;1733
4307;28.06.2016;'11 - 12;37,88;36,35;1,53;16399;18658;2259;1748;3760;2012
4308;28.06.2016;'12 - 13;35,36;33,35;2,01;17741;20440;2699;1752;3525;1773
4309;28.06.2016;'13 - 14;34,08;31,28;2,8;18073;20119;2046;1745;3090;1345
4310;28.06.2016;'14 - 15;32,62;31,35;1,27;17358;19192;1834;1696;2786;1090
4311;28.06.2016;'15 - 16;31,37;31,73;-0,36;15630;17665;2035;1604;2388;784
4312;28.06.2016;'16 - 17;30,89;28,14;2,75;13098;15017;1919;1417;2150;733
4313;28.06.2016;'17 - 18;36,04;32,23;3,81;9910;11554;1644;1242;2052;810
4314;28.06.2016;'18 - 19;39,85;35,24;4,61;6368;7393;1025;1113;1917;804
4315;28.06.2016;'19 - 20;41,74;35,63;6,11;3270;3616;346;1094;2030;936
4316;28.06.2016;'20 - 21;38,99;33,58;5,41;1121;1158;37;1389;2490;1101
4317;28.06.2016;'21 - 22;34,56;31,64;2,92;98;93;-5;2248;3747;1499
4318;28.06.2016;'22 - 23;33,84;30,98;2,86;0;0;0;3479;5422;1943
4319;28.06.2016;'23 - 24;28,34;24,99;3,35;0;0;0;5041;7172;2131
4320;29.06.2016;'00 - 01;24,03;19,09;4,94;0;0;0;7062;8410;1348
4321;29.06.2016;'01 - 02;22,14;16,68;5,46;0;0;0;7993;9270;1277
4322;29.06.2016;'02 - 03;20,64;13,31;7,33;0;0;0;8676;9414;738
4323;29.06.2016;'03 - 04;19,91;9;10,91;0;0;0;9191;9029;-162
4324;29.06.2016;'04 - 05;19,17;7,01;12,16;1;2;1;9529;9238;-291
4325;29.06.2016;'05 - 06;19,99;15,58;4,41;212;183;-29;9583;9646;63
4326;29.06.2016;'06 - 07;24,58;27,42;-2,84;1506;1340;-166;9384;9320;-64
4327;29.06.2016;'07 - 08;32,91;35,05;-2,14;4024;3720;-304;9264;8942;-322
4328;29.06.2016;'08 - 09;34,94;37,88;-2,94;7473;7748;275;9384;9684;300
4329;29.06.2016;'09 - 10;31,82;32,49;-0,67;11343;12264;921;10043;11556;1513
4330;29.06.2016;'10 - 11;26,05;25,62;0,43;14970;15337;367;10865;13277;2412
4331;29.06.2016;'11 - 12;24,71;24,54;0,17;17456;17414;-42;11447;14440;2993
4332;29.06.2016;'12 - 13;23,92;24,08;-0,16;18831;19723;892;11638;15306;3668
4333;29.06.2016;'13 - 14;23,6;22,51;1,09;19421;20642;1221;11637;15294;3657
4334;29.06.2016;'14 - 15;23,4;21,58;1,82;19063;20648;1585;11265;14542;3277
4335;29.06.2016;'15 - 16;23,96;23,76;0,2;17568;19637;2069;10539;14184;3645
4336;29.06.2016;'16 - 17;23,71;22,9;0,81;15053;16724;1671;9614;12992;3378
4337;29.06.2016;'17 - 18;26,54;24,09;2,45;11499;12754;1255;8350;11555;3205
4338;29.06.2016;'18 - 19;33,46;30,67;2,79;7256;8251;995;6663;9318;2655
4339;29.06.2016;'19 - 20;38,99;35;3,99;3552;3968;416;4954;6676;1722
4340;29.06.2016;'20 - 21;37,49;33,1;4,39;1226;1193;-33;3894;4634;740
4341;29.06.2016;'21 - 22;34,98;32,78;2,2;110;87;-23;3620;3986;366
4342;29.06.2016;'22 - 23;34,94;33,38;1,56;0;0;0;3821;4541;720
4343;29.06.2016;'23 - 24;29,96;27,66;2,3;0;0;0;4445;5098;653
4344;30.06.2016;'00 - 01;25,16;25,05;0,11;0;0;0;6098;5565;-533
4345;30.06.2016;'01 - 02;23,34;23,37;-0,03;0;0;0;6816;5634;-1182
4346;30.06.2016;'02 - 03;22,08;22,69;-0,61;0;0;0;7507;6143;-1364
4347;30.06.2016;'03 - 04;20,11;22;-1,89;0;0;0;7972;6946;-1026
4348;30.06.2016;'04 - 05;19,82;20,98;-1,16;2;2;0;8362;7513;-849
4349;30.06.2016;'05 - 06;21,58;21,11;0,47;212;222;10;8518;8043;-475
4350;30.06.2016;'06 - 07;26,61;25,96;0,65;1283;1215;-68;8425;8444;19
4351;30.06.2016;'07 - 08;34,94;33,04;1,9;3131;2815;-316;8254;7588;-666
4352;30.06.2016;'08 - 09;39,86;38,8;1,06;5195;4436;-759;8112;6479;-1633
4353;30.06.2016;'09 - 10;38,24;52,34;-14,1;7385;6444;-941;8080;6235;-1845
4354;30.06.2016;'10 - 11;38,49;54,19;-15,7;9671;9517;-154;8198;6811;-1387
4355;30.06.2016;'11 - 12;36;44,06;-8,06;11842;12713;871;8556;7984;-572
4356;30.06.2016;'12 - 13;30,69;36,01;-5,32;13541;13994;453;9020;8686;-334
4357;30.06.2016;'13 - 14;27,63;32,13;-4,5;14285;14008;-277;9473;8679;-794
4358;30.06.2016;'14 - 15;25,8;31,17;-5,37;14096;13874;-222;9440;8275;-1165
4359;30.06.2016;'15 - 16;26,17;33,07;-6,9;12983;13491;508;8859;7489;-1370
4360;30.06.2016;'16 - 17;26,28;34,26;-7,98;10884;11645;761;8112;6302;-1810
4361;30.06.2016;'17 - 18;29,77;37,81;-8,04;8285;9033;748;7302;5209;-2093
4362;30.06.2016;'18 - 19;34,23;41,78;-7,55;5402;5926;524;6326;4309;-2017
4363;30.06.2016;'19 - 20;38,28;46,36;-8,08;2778;2996;218;5437;3307;-2130
4364;30.06.2016;'20 - 21;34,91;42,9;-7,99;898;964;66;4999;2898;-2101
4365;30.06.2016;'21 - 22;31,11;37,67;-6,56;72;83;11;4873;2958;-1915
4366;30.06.2016;'22 - 23;32,38;37,52;-5,14;0;0;0;5026;3808;-1218
4367;30.06.2016;'23 - 24;27,72;32,69;-4,97;0;0;0;5362;4919;-443
4368;01.07.2016;'00 - 01;29,36;30,6;-1,24;0;0;0;5538;5920;382
4369;01.07.2016;'01 - 02;24,69;26,66;-1,97;0;0;0;6325;6709;384
4370;01.07.2016;'02 - 03;23,42;24,64;-1,22;0;0;0;7065;7328;263
4371;01.07.2016;'03 - 04;21,91;24,69;-2,78;0;0;0;7731;8343;612
4372;01.07.2016;'04 - 05;20,19;24,06;-3,87;4;2;-2;8459;9724;1265
4373;01.07.2016;'05 - 06;22,44;23,81;-1,37;274;280;6;9091;11197;2106
4374;01.07.2016;'06 - 07;26,84;30,13;-3,29;1750;1776;26;9514;11860;2346
4375;01.07.2016;'07 - 08;33,58;35,61;-2,03;4626;4822;196;9914;11548;1634
4376;01.07.2016;'08 - 09;35,78;40,78;-5;8349;8921;572;10749;11663;914
4377;01.07.2016;'09 - 10;29,8;32,25;-2,45;12191;12914;723;12134;12706;572
4378;01.07.2016;'10 - 11;24;26,28;-2,28;15112;15993;881;13412;13786;374
4379;01.07.2016;'11 - 12;23,26;24,88;-1,62;16913;17254;341;14284;13926;-358
4380;01.07.2016;'12 - 13;22,56;26,76;-4,2;17816;17090;-726;14487;13954;-533
4381;01.07.2016;'13 - 14;22,09;27,7;-5,61;17978;17215;-763;14305;13072;-1233
4382;01.07.2016;'14 - 15;22,09;27,17;-5,08;17283;17188;-95;13765;11862;-1903
4383;01.07.2016;'15 - 16;24,22;26,05;-1,83;15667;16384;717;12868;11170;-1698
4384;01.07.2016;'16 - 17;27;26,27;0,73;13306;14304;998;11576;10317;-1259
4385;01.07.2016;'17 - 18;28,75;29,13;-0,38;10121;11121;1000;10075;9205;-870
4386;01.07.2016;'18 - 19;32,43;31,92;0,51;6475;7246;771;8497;8418;-79
4387;01.07.2016;'19 - 20;33,95;32,41;1,54;3256;3556;300;7150;7212;62
4388;01.07.2016;'20 - 21;32,67;28,04;4,63;1100;1108;8;6556;6627;71
4389;01.07.2016;'21 - 22;30,07;25,82;4,25;84;76;-8;6705;6931;226
4390;01.07.2016;'22 - 23;31,91;27,22;4,69;0;0;0;7166;8514;1348
4391;01.07.2016;'23 - 24;27,59;23,33;4,26;0;0;0;7769;9950;2181
4392;02.07.2016;'00 - 01;22,03;24,92;-2,89;0;0;0;10332;11192;860
4393;02.07.2016;'01 - 02;20,38;22,84;-2,46;0;0;0;11575;12481;906
4394;02.07.2016;'02 - 03;19,4;18,32;1,08;0;0;0;12405;12865;460
4395;02.07.2016;'03 - 04;17,09;14,03;3,06;0;0;0;12752;12621;-131
4396;02.07.2016;'04 - 05;16,79;13,43;3,36;2;2;0;12963;12467;-496
4397;02.07.2016;'05 - 06;16,58;16,33;0,25;215;208;-7;12896;12828;-68
4398;02.07.2016;'06 - 07;17,99;15,48;2,51;1341;1361;20;12384;12932;548
4399;02.07.2016;'07 - 08;20,05;15,99;4,06;3478;3195;-283;11821;11329;-492
4400;02.07.2016;'08 - 09;21,41;20,59;0,82;6016;5251;-765;11664;10936;-728
4401;02.07.2016;'09 - 10;23,71;29,5;-5,79;8484;7354;-1130;11993;11603;-390
4402;02.07.2016;'10 - 11;22,04;26,77;-4,73;10419;9060;-1359;12387;11998;-389
4403;02.07.2016;'11 - 12;22,03;29,38;-7,35;11789;10146;-1643;12391;12652;261
4404;02.07.2016;'12 - 13;21,87;28,43;-6,56;12461;10881;-1580;11976;12461;485
4405;02.07.2016;'13 - 14;20,86;25,46;-4,6;12454;10519;-1935;11603;12435;832
4406;02.07.2016;'14 - 15;19,4;22,84;-3,44;12015;10641;-1374;11356;12436;1080
4407;02.07.2016;'15 - 16;18,52;22,6;-4,08;11004;10160;-844;11150;11884;734
4408;02.07.2016;'16 - 17;17,95;21,55;-3,6;9729;9088;-641;10994;11201;207
4409;02.07.2016;'17 - 18;19,96;25,02;-5,06;7936;7576;-360;10539;10357;-182
4410;02.07.2016;'18 - 19;23,11;27,51;-4,4;5552;5615;63;9847;9954;107
4411;02.07.2016;'19 - 20;25,33;28,69;-3,36;3068;3022;-46;8987;8697;-290
4412;02.07.2016;'20 - 21;25,48;27,82;-2,34;1054;1126;72;8171;7807;-364
4413;02.07.2016;'21 - 22;25,03;28,85;-3,82;96;124;28;7959;7379;-580
4414;02.07.2016;'22 - 23;25,97;29,27;-3,3;0;0;0;8379;8403;24
4415;02.07.2016;'23 - 24;22,4;24,5;-2,1;0;0;0;9030;10014;984
4416;03.07.2016;'00 - 01;18,07;16,7;1,37;0;0;0;10389;10602;213
4417;03.07.2016;'01 - 02;9,32;7,75;1,57;0;0;0;10900;11305;405
4418;03.07.2016;'02 - 03;7,88;6,94;0,94;0;0;0;11092;11548;456
4419;03.07.2016;'03 - 04;6,97;5,31;1,66;0;0;0;10892;11142;250
4420;03.07.2016;'04 - 05;8,82;4,65;4,17;4;2;-2;10503;10598;95
4421;03.07.2016;'05 - 06;7,77;4,04;3,73;303;276;-27;9966;10000;34
4422;03.07.2016;'06 - 07;8,14;3,63;4,51;1915;1891;-24;9245;8615;-630
4423;03.07.2016;'07 - 08;8,82;5,77;3,05;5476;5339;-137;8364;6756;-1608
4424;03.07.2016;'08 - 09;12,2;9,4;2,8;10101;9776;-325;8090;6416;-1674
4425;03.07.2016;'09 - 10;9,92;7,78;2,14;14481;14069;-412;8490;6933;-1557
4426;03.07.2016;'10 - 11;8,92;6,27;2,65;17639;16676;-963;8991;8145;-846
4427;03.07.2016;'11 - 12;8,86;7,46;1,4;19446;17642;-1804;9356;8705;-651
4428;03.07.2016;'12 - 13;8,92;8,24;0,68;19900;17807;-2093;9526;9123;-403
4429;03.07.2016;'13 - 14;7,09;8,99;-1,9;19196;16786;-2410;9626;9938;312
4430;03.07.2016;'14 - 15;6,98;8,36;-1,38;17820;15179;-2641;9696;10018;322
4431;03.07.2016;'15 - 16;7,14;8,79;-1,65;15853;13884;-1969;9513;10229;716
4432;03.07.2016;'16 - 17;8,97;9,28;-0,31;13355;11979;-1376;8975;9412;437
4433;03.07.2016;'17 - 18;18,08;16,42;1,66;10165;9374;-791;8070;8086;16
4434;03.07.2016;'18 - 19;22,02;24,2;-2,18;6586;6240;-346;6862;7390;528
4435;03.07.2016;'19 - 20;26,76;29,47;-2,71;3401;3197;-204;5583;6053;470
4436;03.07.2016;'20 - 21;27,97;28,84;-0,87;1177;1077;-100;4676;4533;-143
4437;03.07.2016;'21 - 22;30,49;29,02;1,47;103;98;-5;4422;4042;-380
4438;03.07.2016;'22 - 23;32,35;30,32;2,03;0;0;0;4604;4086;-518
4439;03.07.2016;'23 - 24;29,37;29,9;-0,53;0;0;0;4922;4346;-576
4440;04.07.2016;'00 - 01;25,73;23,05;2,68;0;0;0;5164;4430;-734
4441;04.07.2016;'01 - 02;22,73;18,55;4,18;0;0;0;5429;4259;-1170
4442;04.07.2016;'02 - 03;22,26;19,81;2,45;0;0;0;5510;4388;-1122
4443;04.07.2016;'03 - 04;21,65;18,82;2,83;0;0;0;5357;4330;-1027
4444;04.07.2016;'04 - 05;21,69;17,99;3,7;4;2;-2;5083;4296;-787
4445;04.07.2016;'05 - 06;23,37;18,14;5,23;266;234;-32;4589;3901;-688
4446;04.07.2016;'06 - 07;31,93;28,52;3,41;1592;1595;3;3946;3360;-586
4447;04.07.2016;'07 - 08;35,19;34,05;1,14;4413;4482;69;3278;2548;-730
4448;04.07.2016;'08 - 09;37,93;41,38;-3,45;8162;8621;459;2854;2058;-796
4449;04.07.2016;'09 - 10;33,54;35,32;-1,78;12039;13730;1691;2945;2104;-841
4450;04.07.2016;'10 - 11;32,91;29,98;2,93;15214;18274;3060;3293;2427;-866
4451;04.07.2016;'11 - 12;31,68;27,61;4,07;17317;20731;3414;3616;2626;-990
4452;04.07.2016;'12 - 13;29,98;26,76;3,22;18429;20588;2159;3747;2676;-1071
4453;04.07.2016;'13 - 14;29,33;26,92;2,41;18598;19859;1261;3725;2595;-1130
4454;04.07.2016;'14 - 15;29,75;28,94;0,81;17982;18722;740;3579;2657;-922
4455;04.07.2016;'15 - 16;29,26;29,91;-0,65;16490;17392;902;3218;2445;-773
4456;04.07.2016;'16 - 17;30,47;31,09;-0,62;14252;14887;635;2815;2062;-753
4457;04.07.2016;'17 - 18;32,9;32,95;-0,05;10997;11446;449;2343;1539;-804
4458;04.07.2016;'18 - 19;35,98;37,15;-1,17;7090;7700;610;1814;1062;-752
4459;04.07.2016;'19 - 20;38,41;40,31;-1,9;3585;3907;322;1334;591;-743
4460;04.07.2016;'20 - 21;38,65;37,49;1,16;1239;1248;9;919;394;-525
4461;04.07.2016;'21 - 22;35,56;35,59;-0,03;108;106;-2;861;592;-269
4462;04.07.2016;'22 - 23;34,96;35,55;-0,59;0;0;0;1043;890;-153
4463;04.07.2016;'23 - 24;33,98;31,26;2,72;0;0;0;1270;1396;126
4464;05.07.2016;'00 - 01;29,93;26,59;3,34;0;0;0;1851;2040;189
4465;05.07.2016;'01 - 02;27;25,4;1,6;0;0;0;2289;2871;582
4466;05.07.2016;'02 - 03;25,46;22,59;2,87;0;0;0;2663;3506;843
4467;05.07.2016;'03 - 04;23,88;21,22;2,66;0;0;0;2970;3971;1001
4468;05.07.2016;'04 - 05;23,43;19,45;3,98;2;1;-1;3222;4234;1012
4469;05.07.2016;'05 - 06;25,31;21,21;4,1;235;196;-39;3410;4358;948
4470;05.07.2016;'06 - 07;30,28;27,03;3,25;1589;1540;-49;3566;4412;846
4471;05.07.2016;'07 - 08;34,94;31,24;3,7;4128;4254;126;3631;4051;420
4472;05.07.2016;'08 - 09;36,46;30,99;5,47;7393;8367;974;3856;3750;-106
4473;05.07.2016;'09 - 10;35,05;27,49;7,56;10913;12817;1904;4773;5045;272
4474;05.07.2016;'10 - 11;32,54;25,46;7,08;14024;16074;2050;6237;7143;906
4475;05.07.2016;'11 - 12;31,46;25,36;6,1;16284;17054;770;7925;9724;1799
4476;05.07.2016;'12 - 13;28,6;25,78;2,82;17611;16718;-893;9697;12166;2469
4477;05.07.2016;'13 - 14;26,52;26,67;-0,15;18043;16857;-1186;11424;14407;2983
4478;05.07.2016;'14 - 15;24,34;25,66;-1,32;17677;17231;-446;13050;16937;3887
4479;05.07.2016;'15 - 16;22,28;22,58;-0,3;16355;16742;387;14529;19304;4775
4480;05.07.2016;'16 - 17;22,14;16,56;5,58;13964;14956;992;15532;21094;5562
4481;05.07.2016;'17 - 18;23,01;13,37;9,64;10663;11412;749;15878;22552;6674
4482;05.07.2016;'18 - 19;24,6;17,92;6,68;6849;7257;408;15473;23199;7726
4483;05.07.2016;'19 - 20;27,57;22,73;4,84;3474;3590;116;14946;23592;8646
4484;05.07.2016;'20 - 21;26,9;21,9;5;1170;1076;-94;14104;23115;9011
4485;05.07.2016;'21 - 22;23,95;20,98;2,97;96;71;-25;13710;22085;8375
4486;05.07.2016;'22 - 23;22,89;20,5;2,39;0;0;0;13627;21904;8277
4487;05.07.2016;'23 - 24;18,96;13,68;5,28;0;0;0;13776;22570;8794
4488;06.07.2016;'00 - 01;8,18;4,11;4,07;0;0;0;20872;22158;1286
4489;06.07.2016;'01 - 02;9,26;7,16;2,1;0;0;0;20963;21798;835
4490;06.07.2016;'02 - 03;8,17;6,07;2,1;0;0;0;20884;21624;740
4491;06.07.2016;'03 - 04;5,84;4,46;1,38;0;0;0;20675;20844;169
4492;06.07.2016;'04 - 05;4,9;7,22;-2,32;3;1;-2;20476;20292;-184
4493;06.07.2016;'05 - 06;10,72;12,15;-1,43;239;210;-29;20496;19564;-932
4494;06.07.2016;'06 - 07;20,09;21,38;-1,29;1679;1600;-79;20839;18910;-1929
4495;06.07.2016;'07 - 08;24,54;33,35;-8,81;4532;4395;-137;21344;19218;-2126
4496;06.07.2016;'08 - 09;24,15;34,2;-10,05;8425;8390;-35;21984;19494;-2490
4497;06.07.2016;'09 - 10;20,12;28,13;-8,01;12621;12594;-27;22564;20835;-1729
4498;06.07.2016;'10 - 11;13,19;20,78;-7,59;16235;16374;139;22930;21476;-1454
4499;06.07.2016;'11 - 12;13,15;20,44;-7,29;18834;18332;-502;23230;21704;-1526
4500;06.07.2016;'12 - 13;9,36;18,69;-9,33;20431;19345;-1086;23473;22084;-1389
4501;06.07.2016;'13 - 14;8,17;18,84;-10,67;20757;19907;-850;23677;22063;-1614
4502;06.07.2016;'14 - 15;2,55;14,34;-11,79;20022;19671;-351;23699;21679;-2020
4503;06.07.2016;'15 - 16;9,23;16,56;-7,33;18309;18570;261;23713;21372;-2341
4504;06.07.2016;'16 - 17;11,6;18,2;-6,6;15658;16265;607;23375;20650;-2725
4505;06.07.2016;'17 - 18;14,73;22,36;-7,63;11964;12725;761;22656;20018;-2638
4506;06.07.2016;'18 - 19;23,32;30,9;-7,58;7619;8196;577;21480;19061;-2419
4507;06.07.2016;'19 - 20;28,27;32,15;-3,88;3754;4133;379;19900;17209;-2691
4508;06.07.2016;'20 - 21;29,32;32,4;-3,08;1274;1311;37;18116;14330;-3786
4509;06.07.2016;'21 - 22;29,6;33,66;-4,06;110;98;-12;16421;11690;-4731
4510;06.07.2016;'22 - 23;31,75;36,95;-5,2;0;0;0;14657;10250;-4407
4511;06.07.2016;'23 - 24;28,84;32,84;-4;0;0;0;13199;9598;-3601
4512;07.07.2016;'00 - 01;29,09;31,57;-2,48;0;0;0;10371;8565;-1806
4513;07.07.2016;'01 - 02;25,56;30,4;-4,84;0;0;0;9577;8000;-1577
4514;07.07.2016;'02 - 03;24,21;29,66;-5,45;0;0;0;9011;7646;-1365
4515;07.07.2016;'03 - 04;22,11;23,67;-1,56;0;0;0;8613;7685;-928
4516;07.07.2016;'04 - 05;22,98;23,4;-0,42;3;1;-2;8148;7153;-995
4517;07.07.2016;'05 - 06;23,74;28,35;-4,61;288;249;-39;7591;6467;-1124
4518;07.07.2016;'06 - 07;30,6;33,73;-3,13;1914;1808;-106;6976;5196;-1780
4519;07.07.2016;'07 - 08;34,28;39,55;-5,27;5661;5638;-23;6515;3699;-2816
4520;07.07.2016;'08 - 09;35,71;38,22;-2,51;10952;11128;176;6508;3962;-2546
4521;07.07.2016;'09 - 10;31,51;32,49;-0,98;16260;16440;180;6805;4816;-1989
4522;07.07.2016;'10 - 11;28,83;29,52;-0,69;20180;20142;-38;7026;5215;-1811
4523;07.07.2016;'11 - 12;28,79;29,14;-0,35;22494;22473;-21;7197;5072;-2125
4524;07.07.2016;'12 - 13;26,91;28,39;-1,48;23576;24024;448;7326;5282;-2044
4525;07.07.2016;'13 - 14;25,97;27,4;-1,43;23640;24868;1228;7508;5554;-1954
4526;07.07.2016;'14 - 15;24,66;26,22;-1,56;22482;23966;1484;7642;5597;-2045
4527;07.07.2016;'15 - 16;25,41;26,43;-1,02;20050;21869;1819;7719;5564;-2155
4528;07.07.2016;'16 - 17;27,01;27,83;-0,82;16657;18235;1578;7678;5389;-2289
4529;07.07.2016;'17 - 18;30,42;31,35;-0,93;12362;13471;1109;7316;5392;-1924
4530;07.07.2016;'18 - 19;34,68;34,4;0,28;7586;8296;710;6597;5096;-1501
4531;07.07.2016;'19 - 20;37,77;38,85;-1,08;3594;3833;239;5803;4142;-1661
4532;07.07.2016;'20 - 21;37,91;36,45;1,46;1188;1204;16;5030;2952;-2078
4533;07.07.2016;'21 - 22;32,49;33,43;-0,94;98;91;-7;4497;2199;-2298
4534;07.07.2016;'22 - 23;36,53;34,58;1,95;0;0;0;4237;1879;-2358
4535;07.07.2016;'23 - 24;32,8;31,32;1,48;0;0;0;4221;1888;-2333
4536;08.07.2016;'00 - 01;28,62;30,63;-2,01;0;0;0;3536;2240;-1296
4537;08.07.2016;'01 - 02;26,52;29,56;-3,04;0;0;0;4032;2908;-1124
4538;08.07.2016;'02 - 03;25,04;25,78;-0,74;0;0;0;4607;3623;-984
4539;08.07.2016;'03 - 04;23,46;24,46;-1;0;0;0;5273;4438;-835
4540;08.07.2016;'04 - 05;23,18;25,22;-2,04;1;1;0;5806;5086;-720
4541;08.07.2016;'05 - 06;25,02;24,68;0,34;228;210;-18;5946;5344;-602
4542;08.07.2016;'06 - 07;30;32,17;-2,17;1693;1678;-15;5690;5038;-652
4543;08.07.2016;'07 - 08;34,99;37,58;-2,59;4794;4814;20;5169;4143;-1026
4544;08.07.2016;'08 - 09;38,62;38,11;0,51;9114;9150;36;4345;3029;-1316
4545;08.07.2016;'09 - 10;35,26;36,18;-0,92;13681;13530;-151;3824;2288;-1536
4546;08.07.2016;'10 - 11;33,36;35,95;-2,59;17508;17471;-37;3911;2938;-973
4547;08.07.2016;'11 - 12;32,93;33,68;-0,75;19938;20200;262;4473;4558;85
4548;08.07.2016;'12 - 13;30,15;29,16;0,99;20817;20805;-12;5499;6838;1339
4549;08.07.2016;'13 - 14;27,91;26,07;1,84;20045;19902;-143;6757;9092;2335
4550;08.07.2016;'14 - 15;26,53;24,78;1,75;18141;17624;-517;8099;11394;3295
4551;08.07.2016;'15 - 16;25,91;22,89;3,02;15441;15028;-413;9389;13100;3711
4552;08.07.2016;'16 - 17;26,94;22,95;3,99;12350;11964;-386;10464;13711;3247
4553;08.07.2016;'17 - 18;27,38;24,63;2,75;8931;8840;-91;11134;14765;3631
4554;08.07.2016;'18 - 19;28,54;26,39;2,15;5519;5587;68;11460;15807;4347
4555;08.07.2016;'19 - 20;29,79;26,4;3,39;2728;2960;232;11696;15503;3807
4556;08.07.2016;'20 - 21;28,1;25,98;2,12;867;1010;143;12058;15125;3067
4557;08.07.2016;'21 - 22;26,91;26,16;0,75;65;78;13;11842;14965;3123
4558;08.07.2016;'22 - 23;28,08;26,28;1,8;0;0;0;11633;14604;2971
4559;08.07.2016;'23 - 24;24,61;24,57;0,04;0;0;0;11678;14892;3214
4560;09.07.2016;'00 - 01;20,7;23,83;-3,13;0;0;0;15821;15196;-625
4561;09.07.2016;'01 - 02;18,61;19,99;-1,38;0;0;0;15958;14576;-1382
4562;09.07.2016;'02 - 03;17,39;19,22;-1,83;0;0;0;15752;13614;-2138
4563;09.07.2016;'03 - 04;19;20,91;-1,91;0;0;0;15127;12722;-2405
4564;09.07.2016;'04 - 05;17,1;24,37;-7,27;1;0;-1;14424;12424;-2000
4565;09.07.2016;'05 - 06;17,01;22,72;-5,71;221;177;-44;13790;11517;-2273
4566;09.07.2016;'06 - 07;18,12;22,66;-4,54;1677;1471;-206;13178;10118;-3060
4567;09.07.2016;'07 - 08;22,32;28,28;-5,96;4796;4188;-608;12551;8785;-3766
4568;09.07.2016;'08 - 09;21,99;46,88;-24,89;9181;8217;-964;12085;9176;-2909
4569;09.07.2016;'09 - 10;21,78;45,16;-23,38;13787;12691;-1096;11930;10210;-1720
4570;09.07.2016;'10 - 11;16,99;28,16;-11,17;17322;16081;-1241;11844;11050;-794
4571;09.07.2016;'11 - 12;16,99;23,61;-6,62;19457;18759;-698;11627;10853;-774
4572;09.07.2016;'12 - 13;15,32;19,44;-4,12;20558;20453;-105;11343;10538;-805
4573;09.07.2016;'13 - 14;8,98;14,39;-5,41;20710;20711;1;11169;10334;-835
4574;09.07.2016;'14 - 15;11,64;18,21;-6,57;19898;19875;-23;10885;9891;-994
4575;09.07.2016;'15 - 16;11,25;21,69;-10,44;17954;18426;472;10388;9340;-1048
4576;09.07.2016;'16 - 17;16,9;21,47;-4,57;14983;15583;600;9614;8301;-1313
4577;09.07.2016;'17 - 18;22;26,67;-4,67;11206;11674;468;8343;7680;-663
4578;09.07.2016;'18 - 19;27,92;32,46;-4,54;7041;7506;465;6836;6261;-575
4579;09.07.2016;'19 - 20;30,63;35,42;-4,79;3465;3670;205;5253;4620;-633
4580;09.07.2016;'20 - 21;30,25;37,18;-6,93;1146;1068;-78;3976;3162;-814
4581;09.07.2016;'21 - 22;29,86;35,28;-5,42;86;60;-26;3553;3016;-537
4582;09.07.2016;'22 - 23;30,61;37,26;-6,65;0;0;0;3696;3328;-368
4583;09.07.2016;'23 - 24;28;36,67;-8,67;0;0;0;4345;4105;-240
4584;10.07.2016;'00 - 01;23,17;34,04;-10,87;0;0;0;6945;5047;-1898
4585;10.07.2016;'01 - 02;18,54;25,13;-6,59;0;0;0;8411;6175;-2236
4586;10.07.2016;'02 - 03;15,04;20,39;-5,35;0;0;0;9594;7123;-2471
4587;10.07.2016;'03 - 04;11,96;18,84;-6,88;0;0;0;10348;7882;-2466
4588;10.07.2016;'04 - 05;11,17;14,88;-3,71;1;1;0;10866;8532;-2334
4589;10.07.2016;'05 - 06;9,91;13,62;-3,71;209;188;-21;11008;8749;-2259
4590;10.07.2016;'06 - 07;10,63;13,22;-2,59;1641;1576;-65;10675;8506;-2169
4591;10.07.2016;'07 - 08;10,1;13,92;-3,82;4985;4930;-55;10146;7905;-2241
4592;10.07.2016;'08 - 09;12,36;13,19;-0,83;9829;10133;304;9656;6883;-2773
4593;10.07.2016;'09 - 10;10,64;14,46;-3,82;15047;15665;618;9564;7007;-2557
4594;10.07.2016;'10 - 11;7,62;11,81;-4,19;19492;20024;532;9714;8323;-1391
4595;10.07.2016;'11 - 12;9,12;12,55;-3,43;22585;22986;401;9849;9098;-751
4596;10.07.2016;'12 - 13;6,88;6,91;-0,03;24221;24400;179;9968;9400;-568
4597;10.07.2016;'13 - 14;-0,08;3,08;-3,16;24513;24506;-7;10056;9482;-574
4598;10.07.2016;'14 - 15;-0,9;1;-1,9;23550;23604;54;9874;9242;-632
4599;10.07.2016;'15 - 16;3,96;1,31;2,65;21319;21385;66;9269;8812;-457
4600;10.07.2016;'16 - 17;10,14;7,25;2,89;17875;17915;40;8342;7925;-417
4601;10.07.2016;'17 - 18;19,5;16,68;2,82;13141;13098;-43;7146;7098;-48
4602;10.07.2016;'18 - 19;24,18;25,74;-1,56;7884;7944;60;5948;5618;-330
4603;10.07.2016;'19 - 20;29,93;33,48;-3,55;3598;3548;-50;4933;4685;-248
4604;10.07.2016;'20 - 21;30,91;35,28;-4,37;1170;1052;-118;4604;4410;-194
4605;10.07.2016;'21 - 22;30,92;35,62;-4,7;89;69;-20;5209;5434;225
4606;10.07.2016;'22 - 23;31,49;37,09;-5,6;0;0;0;6255;6721;466
4607;10.07.2016;'23 - 24;29,81;34,87;-5,06;0;0;0;7317;8490;1173
4608;11.07.2016;'00 - 01;20,6;27,99;-7,39;0;0;0;9932;10364;432
4609;11.07.2016;'01 - 02;20,56;21,82;-1,26;0;0;0;10469;11395;926
4610;11.07.2016;'02 - 03;21,08;20,65;0,43;0;0;0;10640;12163;1523
4611;11.07.2016;'03 - 04;19,96;17,49;2,47;0;0;0;10605;11660;1055
4612;11.07.2016;'04 - 05;19,77;17,27;2,5;1;0;-1;10428;10904;476
4613;11.07.2016;'05 - 06;22,1;20,96;1,14;207;175;-32;10169;10740;571
4614;11.07.2016;'06 - 07;27,67;29,38;-1,71;1622;1560;-62;9895;10830;935
4615;11.07.2016;'07 - 08;32,03;30,96;1,07;4604;4480;-124;9730;10010;280
4616;11.07.2016;'08 - 09;32,94;35,99;-3,05;8525;8514;-11;10108;10446;338
4617;11.07.2016;'09 - 10;29,95;32,63;-2,68;12601;12858;257;11314;12096;782
4618;11.07.2016;'10 - 11;26,28;28,02;-1,74;16008;16820;812;13103;14018;915
4619;11.07.2016;'11 - 12;24,91;24,74;0,17;18256;19524;1268;14914;16318;1404
4620;11.07.2016;'12 - 13;22,09;19,7;2,39;19214;19980;766;16554;17868;1314
4621;11.07.2016;'13 - 14;20,4;20,12;0,28;19020;19172;152;17953;19066;1113
4622;11.07.2016;'14 - 15;20,08;24,11;-4,03;17818;17613;-205;18754;19576;822
4623;11.07.2016;'15 - 16;20,34;24,7;-4,36;15645;15564;-81;19089;19496;407
4624;11.07.2016;'16 - 17;22,23;27,33;-5,1;12664;12370;-294;18885;19128;243
4625;11.07.2016;'17 - 18;25,45;29,51;-4,06;9192;8964;-228;18115;18268;153
4626;11.07.2016;'18 - 19;28,8;35,71;-6,91;5863;6020;157;16815;17016;201
4627;11.07.2016;'19 - 20;31,25;36,1;-4,85;3064;3112;48;15351;14866;-485
4628;11.07.2016;'20 - 21;31,48;36,28;-4,8;990;1025;35;14100;12273;-1827
4629;11.07.2016;'21 - 22;30,02;35,27;-5,25;73;78;5;13437;10874;-2563
4630;11.07.2016;'22 - 23;28,5;36,07;-7,57;0;0;0;13153;10609;-2544
4631;11.07.2016;'23 - 24;26,97;32,52;-5,55;0;0;0;12996;10872;-2124
4632;12.07.2016;'00 - 01;25,09;26,42;-1,33;0;0;0;12045;10670;-1375
4633;12.07.2016;'01 - 02;23,98;23,99;-0,01;0;0;0;11690;10430;-1260
4634;12.07.2016;'02 - 03;22,39;23,23;-0,84;0;0;0;11182;9544;-1638
4635;12.07.2016;'03 - 04;22,59;21,06;1,53;0;0;0;10554;9088;-1466
4636;12.07.2016;'04 - 05;22,58;23,76;-1,18;1;0;-1;9953;8665;-1288
4637;12.07.2016;'05 - 06;24,51;24,47;0,04;159;121;-38;9393;8047;-1346
4638;12.07.2016;'06 - 07;28,53;28,6;-0,07;1246;1057;-189;8883;7910;-973
4639;12.07.2016;'07 - 08;33,63;34,64;-1,01;3545;3022;-523;8507;7211;-1296
4640;12.07.2016;'08 - 09;34,94;38,09;-3,15;6522;5848;-674;8409;7075;-1334
4641;12.07.2016;'09 - 10;31,98;37,68;-5,7;9603;8766;-837;8463;7647;-816
4642;12.07.2016;'10 - 11;31,96;35,01;-3,05;12083;11442;-641;8569;8590;21
4643;12.07.2016;'11 - 12;32,7;33,94;-1,24;13688;13230;-458;8648;9524;876
4644;12.07.2016;'12 - 13;31,44;32,53;-1,09;14451;14485;34;8506;9676;1170
4645;12.07.2016;'13 - 14;29,99;31,84;-1,85;14404;14406;2;8236;9483;1247
4646;12.07.2016;'14 - 15;30,22;33,12;-2,9;13796;13041;-755;7841;8737;896
4647;12.07.2016;'15 - 16;30,42;36,38;-5,96;12522;10992;-1530;7279;7855;576
4648;12.07.2016;'16 - 17;30,32;35,76;-5,44;10388;8549;-1839;6649;6277;-372
4649;12.07.2016;'17 - 18;31,91;38,31;-6,4;7787;6016;-1771;5779;4710;-1069
4650;12.07.2016;'18 - 19;33,03;46,98;-13,95;5069;4014;-1055;4631;3869;-762
4651;12.07.2016;'19 - 20;33,61;42,56;-8,95;2618;2232;-386;3633;2926;-707
4652;12.07.2016;'20 - 21;33,06;38,75;-5,69;836;766;-70;2818;2346;-472
4653;12.07.2016;'21 - 22;33,67;37,6;-3,93;63;64;1;2413;1998;-415
4654;12.07.2016;'22 - 23;33,38;37,73;-4,35;0;0;0;2227;2202;-25
4655;12.07.2016;'23 - 24;30,84;32,45;-1,61;0;0;0;2122;2285;163
4656;13.07.2016;'00 - 01;27,95;19,57;8,38;0;0;0;1877;2215;338
4657;13.07.2016;'01 - 02;27,16;21,69;5,47;0;0;0;1756;1934;178
4658;13.07.2016;'02 - 03;26,05;22,88;3,17;0;0;0;1660;1555;-105
4659;13.07.2016;'03 - 04;25;23,54;1,46;0;0;0;1599;1430;-169
4660;13.07.2016;'04 - 05;25,1;24,01;1,09;1;0;-1;1536;1313;-223
4661;13.07.2016;'05 - 06;26,18;23,86;2,32;150;130;-20;1437;1371;-66
4662;13.07.2016;'06 - 07;31,85;27,8;4,05;1278;1166;-112;1310;1591;281
4663;13.07.2016;'07 - 08;34,94;33,61;1,33;3666;3308;-358;1189;1348;159
4664;13.07.2016;'08 - 09;40,42;34,04;6,38;6794;6281;-513;1161;960;-201
4665;13.07.2016;'09 - 10;40,62;36,91;3,71;10024;9905;-119;1257;945;-312
4666;13.07.2016;'10 - 11;39,36;35,14;4,22;12678;12949;271;1438;1120;-318
4667;13.07.2016;'11 - 12;39,66;35,05;4,61;14466;14550;84;1698;1356;-342
4668;13.07.2016;'12 - 13;36,03;33,58;2,45;15353;14938;-415;2026;2248;222
4669;13.07.2016;'13 - 14;36,05;33,79;2,26;15272;13561;-1711;2362;2946;584
4670;13.07.2016;'14 - 15;35,36;32,83;2,53;14170;12464;-1706;2750;3134;384
4671;13.07.2016;'15 - 16;32,87;30,11;2,76;12485;11267;-1218;3141;3240;99
4672;13.07.2016;'16 - 17;31,94;31,31;0,63;10274;9255;-1019;3502;3688;186
4673;13.07.2016;'17 - 18;32,94;32,12;0,82;7648;6627;-1021;3822;3706;-116
4674;13.07.2016;'18 - 19;34,22;31,81;2,41;4855;4196;-659;4082;4207;125
4675;13.07.2016;'19 - 20;35,06;31,76;3,3;2466;2105;-361;4345;4092;-253
4676;13.07.2016;'20 - 21;33,01;32,55;0,46;771;628;-143;4355;3829;-526
4677;13.07.2016;'21 - 22;30,81;30,04;0,77;54;54;0;4316;3672;-644
4678;13.07.2016;'22 - 23;31,4;29,45;1,95;0;0;0;4364;3744;-620
4679;13.07.2016;'23 - 24;27,86;27,62;0,24;0;0;0;4564;4242;-322
4680;14.07.2016;'00 - 01;23,46;26,11;-2,65;0;0;0;5120;4907;-213
4681;14.07.2016;'01 - 02;23,24;24,95;-1,71;0;0;0;5503;5724;221
4682;14.07.2016;'02 - 03;22,1;22,66;-0,56;0;0;0;5929;6492;563
4683;14.07.2016;'03 - 04;21,83;19,75;2,08;0;0;0;6515;7004;489
4684;14.07.2016;'04 - 05;21,06;16,6;4,46;0;0;0;7212;7224;12
4685;14.07.2016;'05 - 06;22,05;18,57;3,48;100;80;-20;7843;7760;-83
4686;14.07.2016;'06 - 07;24,06;22,88;1,18;922;777;-145;8220;7946;-274
4687;14.07.2016;'07 - 08;29,42;28,25;1,17;2835;2354;-481;8652;7934;-718
4688;14.07.2016;'08 - 09;32,05;30,49;1,56;5493;4736;-757;9529;8125;-1404
4689;14.07.2016;'09 - 10;31,02;26,4;4,62;8414;7311;-1103;10484;9444;-1040
4690;14.07.2016;'10 - 11;29,8;26,97;2,83;11156;9613;-1543;11345;11309;-36
4691;14.07.2016;'11 - 12;30,43;26,64;3,79;13486;11424;-2062;12120;12829;709
4692;14.07.2016;'12 - 13;27,58;26,18;1,4;15006;12532;-2474;12879;13359;480
4693;14.07.2016;'13 - 14;25,06;23,17;1,89;15448;13088;-2360;13726;14037;311
4694;14.07.2016;'14 - 15;22,54;21,75;0,79;15146;13302;-1844;14440;14240;-200
4695;14.07.2016;'15 - 16;20,65;19,35;1,3;13946;12553;-1393;14815;14467;-348
4696;14.07.2016;'16 - 17;20,66;18,6;2,06;11786;11188;-598;14969;14696;-273
4697;14.07.2016;'17 - 18;22,09;18,93;3,16;8939;8875;-64;14977;15183;206
4698;14.07.2016;'18 - 19;25,74;21,47;4,27;5784;5828;44;14710;15774;1064
4699;14.07.2016;'19 - 20;28,95;23,72;5,23;2929;2838;-91;14457;15963;1506
4700;14.07.2016;'20 - 21;27,93;21,6;6,33;882;820;-62;14252;16035;1783
4701;14.07.2016;'21 - 22;25,65;20,42;5,23;51;42;-9;14396;16488;2092
4702;14.07.2016;'22 - 23;25,56;22,13;3,43;0;0;0;14724;16997;2273
4703;14.07.2016;'23 - 24;21,85;20,87;0,98;0;0;0;15105;17158;2053
4704;15.07.2016;'00 - 01;18,92;14,19;4,73;0;0;0;15398;16964;1566
4705;15.07.2016;'01 - 02;19,87;14,01;5,86;0;0;0;15578;16722;1144
4706;15.07.2016;'02 - 03;17,02;11,55;5,47;0;0;0;15704;16765;1061
4707;15.07.2016;'03 - 04;13,16;4,4;8,76;0;0;0;15771;16503;732
4708;15.07.2016;'04 - 05;15,06;6,64;8,42;1;0;-1;15845;16514;669
4709;15.07.2016;'05 - 06;18,88;9,65;9,23;114;81;-33;15983;16422;439
4710;15.07.2016;'06 - 07;23,44;15,05;8,39;1152;956;-196;16231;16367;136
4711;15.07.2016;'07 - 08;29,08;25,21;3,87;3439;3001;-438;16425;15611;-814
4712;15.07.2016;'08 - 09;30,08;31,9;-1,82;6392;6051;-341;16675;15273;-1402
4713;15.07.2016;'09 - 10;31,82;31,54;0,28;9537;9287;-250;16944;15243;-1701
4714;15.07.2016;'10 - 11;29,94;28,91;1,03;12230;11822;-408;16978;15242;-1736
4715;15.07.2016;'11 - 12;29,73;28,68;1,05;14246;13015;-1231;16783;14916;-1867
4716;15.07.2016;'12 - 13;27,39;30,93;-3,54;15436;13336;-2100;16420;14964;-1456
4717;15.07.2016;'13 - 14;23,8;27,62;-3,82;15890;13687;-2203;16060;15018;-1042
4718;15.07.2016;'14 - 15;22,93;27,13;-4,2;15589;13735;-1854;15725;14504;-1221
4719;15.07.2016;'15 - 16;22,02;24,56;-2,54;14332;12934;-1398;15430;13998;-1432
4720;15.07.2016;'16 - 17;22,82;22,89;-0,07;12240;11430;-810;14847;13182;-1665
4721;15.07.2016;'17 - 18;27,71;25,54;2,17;9438;9049;-389;13755;11868;-1887
4722;15.07.2016;'18 - 19;31,92;29,68;2,24;6168;6230;62;12104;9982;-2122
4723;15.07.2016;'19 - 20;34,67;31,04;3,63;3109;3305;196;10279;7507;-2772
4724;15.07.2016;'20 - 21;32,73;32,03;0,7;943;1024;81;8565;5638;-2927
4725;15.07.2016;'21 - 22;32,25;32,15;0,1;54;61;7;7394;4470;-2924
4726;15.07.2016;'22 - 23;34,94;34,14;0,8;0;0;0;6520;4244;-2276
4727;15.07.2016;'23 - 24;33,78;29,1;4,68;0;0;0;6037;4306;-1731
4728;16.07.2016;'00 - 01;27,53;32,57;-5,04;0;0;0;5257;4572;-685
4729;16.07.2016;'01 - 02;23,82;23,49;0,33;0;0;0;5525;4844;-681
4730;16.07.2016;'02 - 03;23;22,72;0,28;0;0;0;5994;5283;-711
4731;16.07.2016;'03 - 04;22;21,42;0,58;0;0;0;6450;5720;-730
4732;16.07.2016;'04 - 05;21,91;20,11;1,8;1;0;-1;6719;6142;-577
4733;16.07.2016;'05 - 06;21,79;19,3;2,49;160;123;-37;6717;6188;-529
4734;16.07.2016;'06 - 07;22,01;19,1;2,91;1422;1204;-218;6555;6091;-464
4735;16.07.2016;'07 - 08;22,47;20,82;1,65;4533;3908;-625;6389;5513;-876
4736;16.07.2016;'08 - 09;23,34;22,63;0,71;8883;8041;-842;6200;5129;-1071
4737;16.07.2016;'09 - 10;22,96;22,4;0,56;13215;12340;-875;6133;5591;-542
4738;16.07.2016;'10 - 11;21,99;20,57;1,42;16292;15500;-792;6108;6477;369
4739;16.07.2016;'11 - 12;21,93;19,33;2,6;17841;16360;-1481;6042;6645;603
4740;16.07.2016;'12 - 13;22,89;19,47;3,42;18355;17014;-1341;5981;6228;247
4741;16.07.2016;'13 - 14;21,98;18,97;3,01;18068;17560;-508;5992;5947;-45
4742;16.07.2016;'14 - 15;21,93;18,27;3,66;16973;17199;226;6036;5808;-228
4743;16.07.2016;'15 - 16;22,21;18,43;3,78;15045;15894;849;6094;5689;-405
4744;16.07.2016;'16 - 17;23,36;18,11;5,25;12351;13340;989;6031;5477;-554
4745;16.07.2016;'17 - 18;25,38;20,77;4,61;9056;9728;672;5753;5547;-206
4746;16.07.2016;'18 - 19;30,3;26,2;4,1;5505;5840;335;5251;5425;174
4747;16.07.2016;'19 - 20;31,92;27,84;4,08;2549;2742;193;4715;4951;236
4748;16.07.2016;'20 - 21;30,61;25,74;4,87;748;716;-32;4222;4206;-16
4749;16.07.2016;'21 - 22;30,99;27,23;3,76;38;34;-4;3971;3921;-50
4750;16.07.2016;'22 - 23;32,16;26,39;5,77;0;0;0;3914;3813;-101
4751;16.07.2016;'23 - 24;27,78;23,73;4,05;0;0;0;3903;3750;-153
4752;17.07.2016;'00 - 01;24,53;20,72;3,81;0;0;0;3940;3420;-520
4753;17.07.2016;'01 - 02;21,04;18,97;2,07;0;0;0;3815;3384;-431
4754;17.07.2016;'02 - 03;21,03;19,3;1,73;0;0;0;3648;3395;-253
4755;17.07.2016;'03 - 04;20,17;18,53;1,64;0;0;0;3510;3012;-498
4756;17.07.2016;'04 - 05;19,57;19,88;-0,31;0;0;0;3315;2869;-446
4757;17.07.2016;'05 - 06;19,4;20;-0,6;88;73;-15;3041;2502;-539
4758;17.07.2016;'06 - 07;19,01;19,5;-0,49;898;780;-118;2787;2110;-677
4759;17.07.2016;'07 - 08;20,96;19,91;1,05;2769;2610;-159;2678;1871;-807
4760;17.07.2016;'08 - 09;21,13;20,88;0,25;5328;5352;24;2753;1769;-984
4761;17.07.2016;'09 - 10;22,3;22,26;0,04;8253;9042;789;3115;2099;-1016
4762;17.07.2016;'10 - 11;20,77;20,17;0,6;10998;12543;1545;3777;2864;-913
4763;17.07.2016;'11 - 12;21,99;19,51;2,48;13186;15062;1876;4555;3796;-759
4764;17.07.2016;'12 - 13;21,03;17,34;3,69;14564;16059;1495;5264;5096;-168
4765;17.07.2016;'13 - 14;16,19;11,92;4,27;14949;15844;895;5934;6084;150
4766;17.07.2016;'14 - 15;13,06;9,27;3,79;14692;15239;547;6359;7280;921
4767;17.07.2016;'15 - 16;13,06;8,42;4,64;13678;14144;466;6489;7924;1435
4768;17.07.2016;'16 - 17;13,02;9,03;3,99;11885;12744;859;6514;7811;1297
4769;17.07.2016;'17 - 18;20,03;14,97;5,06;9298;10038;740;6355;7542;1187
4770;17.07.2016;'18 - 19;22,4;20,74;1,66;6054;6827;773;5875;6670;795
4771;17.07.2016;'19 - 20;27,37;24,56;2,81;2998;3411;413;5180;5454;274
4772;17.07.2016;'20 - 21;28,07;26,98;1,09;888;997;109;4550;4748;198
4773;17.07.2016;'21 - 22;30,09;28,97;1,12;48;56;8;4172;4570;398
4774;17.07.2016;'22 - 23;30,57;26,83;3,74;0;0;0;4075;4313;238
4775;17.07.2016;'23 - 24;29;27,33;1,67;0;0;0;4121;4129;8
4776;18.07.2016;'00 - 01;26,03;24,34;1,69;0;0;0;4195;3879;-316
4777;18.07.2016;'01 - 02;24,05;24,61;-0,56;0;0;0;4104;3776;-328
4778;18.07.2016;'02 - 03;23,31;24,95;-1,64;0;0;0;4146;3865;-281
4779;18.07.2016;'03 - 04;22,58;24,16;-1,58;0;0;0;4260;3914;-346
4780;18.07.2016;'04 - 05;23,02;24,37;-1,35;1;0;-1;4341;3828;-513
4781;18.07.2016;'05 - 06;23,81;27,88;-4,07;130;96;-34;4298;3883;-415
4782;18.07.2016;'06 - 07;28,82;33,95;-5,13;1344;1149;-195;4158;3903;-255
4783;18.07.2016;'07 - 08;33,09;39,56;-6,47;4223;3768;-455;3994;3332;-662
4784;18.07.2016;'08 - 09;35,39;38,89;-3,5;8400;7698;-702;3997;3001;-996
4785;18.07.2016;'09 - 10;32,98;38,09;-5,11;13220;12696;-524;4588;3422;-1166
4786;18.07.2016;'10 - 11;30,53;34,69;-4,16;17350;17311;-39;5251;4189;-1062
4787;18.07.2016;'11 - 12;30,22;33,01;-2,79;19915;19740;-175;5849;5187;-662
4788;18.07.2016;'12 - 13;27,17;30,7;-3,53;21048;20477;-571;6320;5903;-417
4789;18.07.2016;'13 - 14;27,92;31,36;-3,44;21364;20532;-832;6706;6482;-224
4790;18.07.2016;'14 - 15;26,4;30,23;-3,83;20826;20360;-466;6873;6816;-57
4791;18.07.2016;'15 - 16;26,51;27,91;-1,4;19237;19208;-29;6776;6547;-229
4792;18.07.2016;'16 - 17;26,76;26,5;0,26;16454;16647;193;6512;6466;-46
4793;18.07.2016;'17 - 18;29,95;29,46;0,49;12497;12846;349;5955;6243;288
4794;18.07.2016;'18 - 19;33;31,52;1,48;7713;8090;377;5071;5466;395
4795;18.07.2016;'19 - 20;39,39;35,44;3,95;3485;3703;218;4127;4579;452
4796;18.07.2016;'20 - 21;40;35,49;4,51;1010;1006;-4;3230;3179;-51
4797;18.07.2016;'21 - 22;38,61;36,74;1,87;57;56;-1;2810;2613;-197
4798;18.07.2016;'22 - 23;35,9;36,26;-0,36;0;0;0;2655;2540;-115
4799;18.07.2016;'23 - 24;30,45;31,29;-0,84;0;0;0;2634;2573;-61
4800;19.07.2016;'00 - 01;27,59;30,25;-2,66;0;0;0;2971;2590;-381
4801;19.07.2016;'01 - 02;27,09;28,14;-1,05;0;0;0;2902;2628;-274
4802;19.07.2016;'02 - 03;26,41;21,59;4,82;0;0;0;2778;2392;-386
4803;19.07.2016;'03 - 04;25,89;23,18;2,71;0;0;0;2605;2213;-392
4804;19.07.2016;'04 - 05;25,61;22,08;3,53;1;0;-1;2392;1950;-442
4805;19.07.2016;'05 - 06;26,14;22,54;3,6;148;109;-39;2111;1692;-419
4806;19.07.2016;'06 - 07;31;30,58;0,42;1461;1264;-197;1776;1526;-250
4807;19.07.2016;'07 - 08;36,99;34,53;2,46;5002;4510;-492;1437;1212;-225
4808;19.07.2016;'08 - 09;40,01;35,78;4,23;10416;9473;-943;1156;849;-307
4809;19.07.2016;'09 - 10;35,7;33,4;2,3;15968;14558;-1410;1177;801;-376
4810;19.07.2016;'10 - 11;32,99;32,74;0,25;20246;19030;-1216;1300;1059;-241
4811;19.07.2016;'11 - 12;32,91;33,85;-0,94;22837;22091;-746;1432;1284;-148
4812;19.07.2016;'12 - 13;31,38;34,07;-2,69;24054;23807;-247;1534;1493;-41
4813;19.07.2016;'13 - 14;30,91;33,1;-2,19;24235;24179;-56;1626;1645;19
4814;19.07.2016;'14 - 15;30,08;31,86;-1,78;23269;23256;-13;1700;1784;84
4815;19.07.2016;'15 - 16;31,28;32,46;-1,18;21075;21344;269;1712;1716;4
4816;19.07.2016;'16 - 17;32,4;32,04;0,36;17818;18034;216;1631;1484;-147
4817;19.07.2016;'17 - 18;35,25;35,43;-0,18;13334;13544;210;1462;1330;-132
4818;19.07.2016;'18 - 19;39,91;36,03;3,88;8044;8432;388;1264;1181;-83
4819;19.07.2016;'19 - 20;44;40,31;3,69;3493;3707;214;1158;1086;-72
4820;19.07.2016;'20 - 21;37,03;40,66;-3,63;994;1009;15;1305;1163;-142
4821;19.07.2016;'21 - 22;37;38,8;-1,8;55;57;2;1889;1894;5
4822;19.07.2016;'22 - 23;32,92;37,12;-4,2;0;0;0;2681;2826;145
4823;19.07.2016;'23 - 24;27,91;32,25;-4,34;0;0;0;3253;3349;96
4824;20.07.2016;'00 - 01;28,01;31,95;-3,94;0;0;0;3838;3644;-194
4825;20.07.2016;'01 - 02;26,32;30,07;-3,75;0;0;0;4029;3783;-246
4826;20.07.2016;'02 - 03;25,1;29,45;-4,35;0;0;0;4094;3924;-170
4827;20.07.2016;'03 - 04;24,79;28,2;-3,41;0;0;0;4154;3941;-213
4828;20.07.2016;'04 - 05;24,83;27,53;-2,7;1;0;-1;4311;4127;-184
4829;20.07.2016;'05 - 06;25,85;28,44;-2,59;147;117;-30;4532;4348;-184
4830;20.07.2016;'06 - 07;29,35;33,59;-4,24;1459;1314;-145;4626;4430;-196
4831;20.07.2016;'07 - 08;33,52;39,07;-5,55;5212;4882;-330;4216;3828;-388
4832;20.07.2016;'08 - 09;36,79;37,1;-0,31;10952;10407;-545;3407;2712;-695
4833;20.07.2016;'09 - 10;34,1;34,29;-0,19;16896;16139;-757;3101;2648;-453
4834;20.07.2016;'10 - 11;32,39;33,07;-0,68;21726;20690;-1036;3234;2923;-311
4835;20.07.2016;'11 - 12;31,43;32;-0,57;24718;23670;-1048;3502;3397;-105
4836;20.07.2016;'12 - 13;28,02;29,61;-1,59;25967;25143;-824;3939;4024;85
4837;20.07.2016;'13 - 14;26,63;28,14;-1,51;26263;25580;-683;4387;4735;348
4838;20.07.2016;'14 - 15;25,93;27,11;-1,18;25525;24824;-701;4811;5268;457
4839;20.07.2016;'15 - 16;26,43;27,27;-0,84;23280;22834;-446;5240;5956;716
4840;20.07.2016;'16 - 17;28,08;28,62;-0,54;19624;19299;-325;5727;6564;837
4841;20.07.2016;'17 - 18;31,66;31,76;-0,1;14443;14461;18;6235;6998;763
4842;20.07.2016;'18 - 19;33,3;34,97;-1,67;8388;8435;47;6773;6905;132
4843;20.07.2016;'19 - 20;34,48;37,58;-3,1;3392;3231;-161;7559;6579;-980
4844;20.07.2016;'20 - 21;33,41;42,41;-9;936;690;-246;8588;7966;-622
4845;20.07.2016;'21 - 22;31,96;37,72;-5,76;51;30;-21;10176;9748;-428
4846;20.07.2016;'22 - 23;28,94;38,31;-9,37;0;0;0;11502;10569;-933
4847;20.07.2016;'23 - 24;25,35;30,64;-5,29;0;0;0;11895;10228;-1667
4848;21.07.2016;'00 - 01;26,43;27,2;-0,77;0;0;0;10413;9168;-1245
4849;21.07.2016;'01 - 02;26,46;31,35;-4,89;0;0;0;9595;8206;-1389
4850;21.07.2016;'02 - 03;25,9;32,44;-6,54;0;0;0;8381;7508;-873
4851;21.07.2016;'03 - 04;25,52;30,39;-4,87;0;0;0;7197;7436;239
4852;21.07.2016;'04 - 05;25,55;28,69;-3,14;0;0;0;6330;6632;302
4853;21.07.2016;'05 - 06;27,49;29,88;-2,39;99;82;-17;5414;6100;686
4854;21.07.2016;'06 - 07;32,84;34,43;-1,59;1034;972;-62;4427;5821;1394
4855;21.07.2016;'07 - 08;36,61;39,22;-2,61;3271;2889;-382;3259;4112;853
4856;21.07.2016;'08 - 09;39,16;38,34;0,82;6229;5137;-1092;2091;2637;546
4857;21.07.2016;'09 - 10;36,04;38,67;-2,63;9306;7881;-1425;1585;2435;850
4858;21.07.2016;'10 - 11;37,02;38,97;-1,95;11846;11200;-646;1496;2539;1043
4859;21.07.2016;'11 - 12;36,01;36,61;-0,6;13721;13846;125;1408;2671;1263
4860;21.07.2016;'12 - 13;35,04;35,74;-0,7;14805;16012;1207;1303;2643;1340
4861;21.07.2016;'13 - 14;34,24;35,33;-1,09;15176;17190;2014;1236;2455;1219
4862;21.07.2016;'14 - 15;32,94;33,04;-0,1;14915;16421;1506;1214;2206;992
4863;21.07.2016;'15 - 16;33;34,57;-1,57;13953;14671;718;1254;1894;640
4864;21.07.2016;'16 - 17;33,31;37,65;-4,34;12080;12986;906;1332;1710;378
4865;21.07.2016;'17 - 18;34,37;38,86;-4,49;9325;9900;575;1432;1990;558
4866;21.07.2016;'18 - 19;34,76;40,19;-5,43;5932;6435;503;1577;2554;977
4867;21.07.2016;'19 - 20;38,38;44,1;-5,72;2851;3156;305;1732;2522;790
4868;21.07.2016;'20 - 21;35,95;41,18;-5,23;799;848;49;1842;2546;704
4869;21.07.2016;'21 - 22;35,7;37,96;-2,26;36;37;1;2009;2727;718
4870;21.07.2016;'22 - 23;32,92;36,91;-3,99;0;0;0;2214;3050;836
4871;21.07.2016;'23 - 24;31,01;33,69;-2,68;0;0;0;2333;3068;735
4872;22.07.2016;'00 - 01;29,26;28,17;1,09;0;0;0;2211;2924;713
4873;22.07.2016;'01 - 02;27,24;31,85;-4,61;0;0;0;2138;2670;532
4874;22.07.2016;'02 - 03;27,1;29;-1,9;0;0;0;2074;2437;363
4875;22.07.2016;'03 - 04;26,56;26,96;-0,4;0;0;0;2000;2144;144
4876;22.07.2016;'04 - 05;26,5;28,17;-1,67;0;0;0;1883;1958;75
4877;22.07.2016;'05 - 06;28,06;29,29;-1,23;106;91;-15;1731;1905;174
4878;22.07.2016;'06 - 07;32,36;34,25;-1,89;1250;1214;-36;1513;1970;457
4879;22.07.2016;'07 - 08;35,99;37,92;-1,93;4205;4158;-47;1176;1636;460
4880;22.07.2016;'08 - 09;36,81;39,7;-2,89;8408;8200;-208;846;1338;492
4881;22.07.2016;'09 - 10;36;35,24;0,76;12910;12898;-12;773;1547;774
4882;22.07.2016;'10 - 11;35,16;33,28;1,88;16745;17034;289;789;1789;1000
4883;22.07.2016;'11 - 12;34,41;31,4;3,01;19406;19854;448;800;2018;1218
4884;22.07.2016;'12 - 13;32,15;30,09;2,06;20818;20994;176;862;2046;1184
4885;22.07.2016;'13 - 14;30,78;29,83;0,95;20940;21078;138;937;2132;1195
4886;22.07.2016;'14 - 15;30,68;29,36;1,32;20010;19807;-203;1066;2184;1118
4887;22.07.2016;'15 - 16;31,19;31,54;-0,35;17710;17202;-508;1381;2456;1075
4888;22.07.2016;'16 - 17;31,62;32,34;-0,72;14199;13316;-883;1785;2731;946
4889;22.07.2016;'17 - 18;32,93;35,94;-3,01;10000;8972;-1028;2235;3671;1436
4890;22.07.2016;'18 - 19;34,91;33,65;1,26;5846;5084;-762;2726;4250;1524
4891;22.07.2016;'19 - 20;35,96;33,41;2,55;2663;2336;-327;3099;4705;1606
4892;22.07.2016;'20 - 21;33,26;32,6;0,66;723;610;-113;3425;4414;989
4893;22.07.2016;'21 - 22;31,97;33,29;-1,32;31;35;4;4125;4499;374
4894;22.07.2016;'22 - 23;31,96;35,31;-3,35;0;0;0;4793;4695;-98
4895;22.07.2016;'23 - 24;29;30,87;-1,87;0;0;0;4966;4728;-238
4896;23.07.2016;'00 - 01;31,8;31,34;0,46;0;0;0;5137;4064;-1073
4897;23.07.2016;'01 - 02;30,83;31,17;-0,34;0;0;0;4806;3666;-1140
4898;23.07.2016;'02 - 03;29,1;29,53;-0,43;0;0;0;4455;3358;-1097
4899;23.07.2016;'03 - 04;27,02;27,03;-0,01;0;0;0;4154;2954;-1200
4900;23.07.2016;'04 - 05;25,77;26,58;-0,81;0;0;0;3878;2706;-1172
4901;23.07.2016;'05 - 06;25,65;26,99;-1,34;93;72;-21;3504;2498;-1006
4902;23.07.2016;'06 - 07;26,22;28,9;-2,68;1089;986;-103;3038;2125;-913
4903;23.07.2016;'07 - 08;30,32;32,5;-2,18;3664;3256;-408;2467;1415;-1052
4904;23.07.2016;'08 - 09;31,96;33,46;-1,5;7236;6304;-932;1906;804;-1102
4905;23.07.2016;'09 - 10;32,53;32,9;-0,37;11004;9826;-1178;1608;706;-902
4906;23.07.2016;'10 - 11;32,26;33,32;-1,06;14321;12946;-1375;1562;843;-719
4907;23.07.2016;'11 - 12;31,97;33,73;-1,76;16791;14766;-2025;1546;1084;-462
4908;23.07.2016;'12 - 13;29,02;33,01;-3,99;18170;15471;-2699;1629;1237;-392
4909;23.07.2016;'13 - 14;25,25;30,65;-5,4;18340;15785;-2555;1681;1200;-481
4910;23.07.2016;'14 - 15;24,52;29,5;-4,98;17349;15384;-1965;1718;1164;-554
4911;23.07.2016;'15 - 16;24,97;29,05;-4,08;15267;14370;-897;1859;1139;-720
4912;23.07.2016;'16 - 17;27,72;29,7;-1,98;12374;12091;-283;2018;1185;-833
4913;23.07.2016;'17 - 18;30,57;31,27;-0,7;9016;8705;-311;2231;1368;-863
4914;23.07.2016;'18 - 19;31,86;34,27;-2,41;5513;5343;-170;2518;1411;-1107
4915;23.07.2016;'19 - 20;33,62;36,1;-2,48;2587;2543;-44;2805;1559;-1246
4916;23.07.2016;'20 - 21;32,9;35,99;-3,09;684;662;-22;3170;1712;-1458
4917;23.07.2016;'21 - 22;32,38;36,35;-3,97;28;34;6;3739;1916;-1823
4918;23.07.2016;'22 - 23;32,14;36,61;-4,47;0;0;0;4176;2079;-2097
4919;23.07.2016;'23 - 24;29,07;32,66;-3,59;0;0;0;4157;1888;-2269
4920;24.07.2016;'00 - 01;30,11;32,31;-2,2;0;0;0;3163;1616;-1547
4921;24.07.2016;'01 - 02;28,11;31,04;-2,93;0;0;0;2812;1263;-1549
4922;24.07.2016;'02 - 03;25,99;27,19;-1,2;0;0;0;2517;1061;-1456
4923;24.07.2016;'03 - 04;24,93;27,06;-2,13;0;0;0;2221;895;-1326
4924;24.07.2016;'04 - 05;24,25;26,05;-1,8;0;0;0;1912;799;-1113
4925;24.07.2016;'05 - 06;23,98;25,42;-1,44;83;56;-27;1626;837;-789
4926;24.07.2016;'06 - 07;23,92;24,78;-0,86;1047;874;-173;1323;820;-503
4927;24.07.2016;'07 - 08;24,79;27,73;-2,94;3608;3010;-598;967;539;-428
4928;24.07.2016;'08 - 09;25,67;29,1;-3,43;7298;6197;-1101;583;255;-328
4929;24.07.2016;'09 - 10;25,95;30,22;-4,27;11377;10283;-1094;413;192;-221
4930;24.07.2016;'10 - 11;24,87;29,23;-4,36;15112;14240;-872;420;153;-267
4931;24.07.2016;'11 - 12;25,13;27,99;-2,86;18063;17428;-635;441;135;-306
4932;24.07.2016;'12 - 13;23,47;26,06;-2,59;19881;19753;-128;467;166;-301
4933;24.07.2016;'13 - 14;23,82;24,8;-0,98;20412;20422;10;500;265;-235
4934;24.07.2016;'14 - 15;23,3;24,19;-0,89;19709;19698;-11;571;427;-144
4935;24.07.2016;'15 - 16;23,48;24,96;-1,48;17690;17318;-372;734;602;-132
4936;24.07.2016;'16 - 17;24,76;25,08;-0,32;14585;14403;-182;920;883;-37
4937;24.07.2016;'17 - 18;26,42;28,99;-2,57;10629;10680;51;1130;967;-163
4938;24.07.2016;'18 - 19;29,91;31,27;-1,36;6395;6614;219;1391;1008;-383
4939;24.07.2016;'19 - 20;31,94;33,49;-1,55;2930;3048;118;1683;861;-822
4940;24.07.2016;'20 - 21;32,95;32,89;0,06;765;766;1;1978;861;-1117
4941;24.07.2016;'21 - 22;33,22;34,09;-0,87;29;31;2;2362;982;-1380
4942;24.07.2016;'22 - 23;35,93;35,15;0,78;0;0;0;2652;1088;-1564
4943;24.07.2016;'23 - 24;33,3;31,47;1,83;0;0;0;2780;1129;-1651
4944;25.07.2016;'00 - 01;29,8;30,18;-0,38;0;0;0;1429;1098;-331
4945;25.07.2016;'01 - 02;27,32;29,24;-1,92;0;0;0;1391;1019;-372
4946;25.07.2016;'02 - 03;26,32;29,15;-2,83;0;0;0;1372;978;-394
4947;25.07.2016;'03 - 04;25,93;27,11;-1,18;0;0;0;1335;932;-403
4948;25.07.2016;'04 - 05;25,92;24,94;0,98;0;0;0;1294;883;-411
4949;25.07.2016;'05 - 06;27,8;27,13;0,67;81;68;-13;1222;987;-235
4950;25.07.2016;'06 - 07;35;32,09;2,91;1108;1037;-71;1138;1041;-97
4951;25.07.2016;'07 - 08;38,08;37,25;0,83;3751;3629;-122;1054;1072;18
4952;25.07.2016;'08 - 09;39,52;38,16;1,36;7412;7361;-51;919;944;25
4953;25.07.2016;'09 - 10;37,94;35,19;2,75;11259;11659;400;969;1160;191
4954;25.07.2016;'10 - 11;36,47;33,34;3,13;14490;16032;1542;1105;1401;296
4955;25.07.2016;'11 - 12;36,05;31,63;4,42;16647;18652;2005;1281;1627;346
4956;25.07.2016;'12 - 13;33,64;29,92;3,72;17651;19490;1839;1499;1897;398
4957;25.07.2016;'13 - 14;32,95;30,22;2,73;17746;18934;1188;1757;2511;754
4958;25.07.2016;'14 - 15;32,35;31,47;0,88;16930;17178;248;2073;2671;598
4959;25.07.2016;'15 - 16;32,6;36,34;-3,74;15053;14919;-134;2447;2746;299
4960;25.07.2016;'16 - 17;33,32;36,78;-3,46;12580;11902;-678;2710;2985;275
4961;25.07.2016;'17 - 18;35,18;36,4;-1,22;9479;9000;-479;2779;3061;282
4962;25.07.2016;'18 - 19;35,99;37,55;-1,56;5931;5829;-102;2715;3129;414
4963;25.07.2016;'19 - 20;36,59;37,93;-1,34;2839;2793;-46;2539;2887;348
4964;25.07.2016;'20 - 21;36,47;37,1;-0,63;719;702;-17;2031;2484;453
4965;25.07.2016;'21 - 22;36,08;38,04;-1,96;25;24;-1;1822;2218;396
4966;25.07.2016;'22 - 23;35,47;37,22;-1,75;0;0;0;1803;2065;262
4967;25.07.2016;'23 - 24;30,4;33,97;-3,57;0;0;0;1769;1962;193
4968;26.07.2016;'00 - 01;27,98;29,22;-1,24;0;0;0;1682;2092;410
4969;26.07.2016;'01 - 02;27,5;27,76;-0,26;0;0;0;1659;2224;565
4970;26.07.2016;'02 - 03;26,38;25,45;0,93;0;0;0;1670;2342;672
4971;26.07.2016;'03 - 04;25,88;24,1;1,78;0;0;0;1697;2441;744
4972;26.07.2016;'04 - 05;25,91;24,08;1,83;0;0;0;1657;2452;795
4973;26.07.2016;'05 - 06;26,53;27,56;-1,03;61;52;-9;1512;2445;933
4974;26.07.2016;'06 - 07;30,97;29,4;1,57;913;900;-13;1281;2103;822
4975;26.07.2016;'07 - 08;35,9;36,77;-0,87;3166;3166;0;1042;1600;558
4976;26.07.2016;'08 - 09;39,16;40,05;-0,89;6276;6958;682;854;1190;336
4977;26.07.2016;'09 - 10;37,45;40,81;-3,36;9791;11051;1260;781;1145;364
4978;26.07.2016;'10 - 11;36,46;37,17;-0,71;13092;14554;1462;804;1233;429
4979;26.07.2016;'11 - 12;37,01;37,35;-0,34;15782;16965;1183;934;1451;517
4980;26.07.2016;'12 - 13;33,13;35,24;-2,11;17403;17604;201;1222;1716;494
4981;26.07.2016;'13 - 14;32,91;35,85;-2,94;17726;17344;-382;1586;1695;109
4982;26.07.2016;'14 - 15;31,8;36,79;-4,99;16884;16312;-572;1866;1717;-149
4983;26.07.2016;'15 - 16;32,92;38,23;-5,31;15180;14858;-322;2057;1670;-387
4984;26.07.2016;'16 - 17;32,26;35,97;-3,71;12625;12755;130;2104;1734;-370
4985;26.07.2016;'17 - 18;34,07;36,39;-2,32;9342;9354;12;2004;1528;-476
4986;26.07.2016;'18 - 19;37,13;38,15;-1,02;5774;5952;178;1733;1386;-347
4987;26.07.2016;'19 - 20;39,3;40,73;-1,43;2661;2744;83;1450;1116;-334
4988;26.07.2016;'20 - 21;37,28;38,65;-1,37;669;655;-14;1130;1043;-87
4989;26.07.2016;'21 - 22;36,54;37,09;-0,55;22;19;-3;1115;1158;43
4990;26.07.2016;'22 - 23;35,81;36,58;-0,77;0;0;0;1182;1274;92
4991;26.07.2016;'23 - 24;30,2;32,02;-1,82;0;0;0;1155;1350;195
4992;27.07.2016;'00 - 01;28,12;29,02;-0,9;0;0;0;1290;1622;332
4993;27.07.2016;'01 - 02;27,61;28,24;-0,63;0;0;0;1321;1674;353
4994;27.07.2016;'02 - 03;26,53;27,51;-0,98;0;0;0;1355;1576;221
4995;27.07.2016;'03 - 04;25,87;27,47;-1,6;0;0;0;1418;1614;196
4996;27.07.2016;'04 - 05;26;27,21;-1,21;0;0;0;1523;1824;301
4997;27.07.2016;'05 - 06;26,63;29,13;-2,5;53;38;-15;1636;2143;507
4998;27.07.2016;'06 - 07;31,53;32,11;-0,58;812;785;-27;1736;2522;786
4999;27.07.2016;'07 - 08;36,43;37,44;-1,01;2861;2809;-52;1793;2474;681
5000;27.07.2016;'08 - 09;39,11;37,89;1,22;5690;5765;75;1757;2181;424
5001;27.07.2016;'09 - 10;40,67;36,5;4,17;8851;9406;555;1799;2095;296
5002;27.07.2016;'10 - 11;40,92;35,52;5,4;11822;13334;1512;1989;2731;742
5003;27.07.2016;'11 - 12;41,25;33,89;7,36;14187;16524;2337;2210;3262;1052
5004;27.07.2016;'12 - 13;37,09;29,76;7,33;15725;17930;2205;2544;3617;1073
5005;27.07.2016;'13 - 14;36,53;28,01;8,52;16376;17719;1343;2964;4400;1436
5006;27.07.2016;'14 - 15;33,19;27,52;5,67;16163;16610;447;3391;5400;2009
5007;27.07.2016;'15 - 16;32,6;27,41;5,19;14809;14520;-289;3809;6412;2603
5008;27.07.2016;'16 - 17;32,7;27,57;5,13;12395;12029;-366;4158;6600;2442
5009;27.07.2016;'17 - 18;33,15;29,15;4;9205;8914;-291;4242;6101;1859
5010;27.07.2016;'18 - 19;35,97;32,65;3,32;5652;5465;-187;3983;5376;1393
5011;27.07.2016;'19 - 20;36,61;33,56;3,05;2560;2501;-59;3642;4548;906
5012;27.07.2016;'20 - 21;36,37;33,72;2,65;610;617;7;3366;3770;404
5013;27.07.2016;'21 - 22;35,56;33,43;2,13;18;14;-4;3247;3469;222
5014;27.07.2016;'22 - 23;34,04;31,58;2,46;0;0;0;3148;3803;655
5015;27.07.2016;'23 - 24;29,94;26,42;3,52;0;0;0;3119;3884;765
5016;28.07.2016;'00 - 01;26,9;25,63;1,27;0;0;0;3643;3499;-144
5017;28.07.2016;'01 - 02;26,39;24,43;1,96;0;0;0;3538;3208;-330
5018;28.07.2016;'02 - 03;25,8;24,94;0,86;0;0;0;3352;2944;-408
5019;28.07.2016;'03 - 04;25,29;22,38;2,91;0;0;0;3061;2590;-471
5020;28.07.2016;'04 - 05;25,26;22,62;2,64;0;0;0;2710;2362;-348
5021;28.07.2016;'05 - 06;26,39;23,29;3,1;58;44;-14;2289;2056;-233
5022;28.07.2016;'06 - 07;29,92;24,71;5,21;940;868;-72;1926;1727;-199
5023;28.07.2016;'07 - 08;34,91;29,29;5,62;3392;3283;-109;1627;1362;-265
5024;28.07.2016;'08 - 09;36,94;32,77;4,17;6844;6588;-256;1438;871;-567
5025;28.07.2016;'09 - 10;35,79;32,82;2,97;10523;10454;-69;1388;678;-710
5026;28.07.2016;'10 - 11;33,93;32,14;1,79;13639;14160;521;1422;764;-658
5027;28.07.2016;'11 - 12;33,75;32,07;1,68;15800;16050;250;1529;1098;-431
5028;28.07.2016;'12 - 13;33,81;33,05;0,76;17118;16430;-688;1647;1564;-83
5029;28.07.2016;'13 - 14;31,79;35,11;-3,32;17632;15865;-1767;1775;1874;99
5030;28.07.2016;'14 - 15;30,97;34,14;-3,17;17050;15070;-1980;1835;2032;197
5031;28.07.2016;'15 - 16;31,43;32,5;-1,07;15388;13931;-1457;1828;2051;223
5032;28.07.2016;'16 - 17;31,43;31,76;-0,33;12714;12224;-490;1743;1996;253
5033;28.07.2016;'17 - 18;32,98;30,8;2,18;9378;9447;69;1578;2044;466
5034;28.07.2016;'18 - 19;34,97;31,85;3,12;5693;5831;138;1445;1762;317
5035;28.07.2016;'19 - 20;36,72;32,48;4,24;2525;2614;89;1351;1650;299
5036;28.07.2016;'20 - 21;35,5;32,4;3,1;583;552;-31;1350;1664;314
5037;28.07.2016;'21 - 22;34,04;31,98;2,06;14;17;3;1673;2124;451
5038;28.07.2016;'22 - 23;33,93;32,08;1,85;0;0;0;2190;2634;444
5039;28.07.2016;'23 - 24;29,92;29,46;0,46;0;0;0;2769;3127;358
5040;29.07.2016;'00 - 01;28,21;30,17;-1,96;0;0;0;4046;3606;-440
5041;29.07.2016;'01 - 02;27,04;26,73;0,31;0;0;0;4414;3707;-707
5042;29.07.2016;'02 - 03;26,03;26,05;-0,02;0;0;0;4608;3734;-874
5043;29.07.2016;'03 - 04;24,58;25,04;-0,46;0;0;0;4650;3916;-734
5044;29.07.2016;'04 - 05;24,84;26,81;-1,97;0;0;0;4659;3885;-774
5045;29.07.2016;'05 - 06;25,95;28,62;-2,67;50;36;-14;4674;3646;-1028
5046;29.07.2016;'06 - 07;29,68;31,89;-2,21;840;722;-118;4672;3841;-831
5047;29.07.2016;'07 - 08;33,99;37,09;-3,1;3063;2681;-382;4671;3543;-1128
5048;29.07.2016;'08 - 09;36,13;39,39;-3,26;6391;5963;-428;4897;3236;-1661
5049;29.07.2016;'09 - 10;36,09;39,59;-3,5;10133;9668;-465;5477;3727;-1750
5050;29.07.2016;'10 - 11;33,75;36,67;-2,92;13420;12888;-532;6199;4717;-1482
5051;29.07.2016;'11 - 12;33,21;34,24;-1,03;15686;14855;-831;6832;5210;-1622
5052;29.07.2016;'12 - 13;31,67;34,85;-3,18;17015;16553;-462;7401;6206;-1195
5053;29.07.2016;'13 - 14;29,5;31,81;-2,31;17364;17723;359;8133;6944;-1189
5054;29.07.2016;'14 - 15;27,94;28,24;-0,3;16810;17617;807;8759;7661;-1098
5055;29.07.2016;'15 - 16;27,37;26,31;1,06;15350;16419;1069;9041;8212;-829
5056;29.07.2016;'16 - 17;28,09;26,87;1,22;12893;14339;1446;9115;8222;-893
5057;29.07.2016;'17 - 18;29,11;31,64;-2,53;9505;10640;1135;8761;7854;-907
5058;29.07.2016;'18 - 19;31,5;35,53;-4,03;5662;6424;762;7871;7028;-843
5059;29.07.2016;'19 - 20;34,13;36,05;-1,92;2441;2778;337;6831;5675;-1156
5060;29.07.2016;'20 - 21;32,98;36,09;-3,11;575;584;9;5998;4191;-1807
5061;29.07.2016;'21 - 22;30,86;36,57;-5,71;13;13;0;5956;3926;-2030
5062;29.07.2016;'22 - 23;29,81;35,51;-5,7;0;0;0;6293;4440;-1853
5063;29.07.2016;'23 - 24;28,87;33,75;-4,88;0;0;0;6778;5056;-1722
5064;30.07.2016;'00 - 01;31,07;29,23;1,84;0;0;0;6401;5202;-1199
5065;30.07.2016;'01 - 02;26,51;26,11;0,4;0;0;0;6749;5392;-1357
5066;30.07.2016;'02 - 03;25,59;24,78;0,81;0;0;0;6955;5581;-1374
5067;30.07.2016;'03 - 04;24,56;22,44;2,12;0;0;0;7016;5862;-1154
5068;30.07.2016;'04 - 05;24,17;23,4;0,77;0;0;0;6984;5927;-1057
5069;30.07.2016;'05 - 06;24,39;23,56;0,83;48;34;-14;6903;6032;-871
5070;30.07.2016;'06 - 07;24,72;23,31;1,41;862;878;16;6620;6031;-589
5071;30.07.2016;'07 - 08;25,46;22,26;3,2;3285;3459;174;6227;5483;-744
5072;30.07.2016;'08 - 09;26,74;26,42;0,32;6962;7604;642;5958;5061;-897
5073;30.07.2016;'09 - 10;28,97;27,11;1,86;11153;11876;723;5966;5197;-769
5074;30.07.2016;'10 - 11;28,38;26,69;1,69;14683;15233;550;6178;5816;-362
5075;30.07.2016;'11 - 12;27,93;26,18;1,75;17145;17422;277;6285;6009;-276
5076;30.07.2016;'12 - 13;26,33;26,53;-0,2;18478;18311;-167;6234;6083;-151
5077;30.07.2016;'13 - 14;24,79;25,83;-1,04;18900;18376;-524;6162;6234;72
5078;30.07.2016;'14 - 15;23,99;25,52;-1,53;18337;18462;125;5964;6402;438
5079;30.07.2016;'15 - 16;24,04;23,17;0,87;16598;17248;650;5597;6573;976
5080;30.07.2016;'16 - 17;25,04;22,63;2,41;13853;14526;673;5036;6389;1353
5081;30.07.2016;'17 - 18;26,1;24,02;2,08;10190;10816;626;4220;5824;1604
5082;30.07.2016;'18 - 19;30,51;26,39;4,12;6029;6480;451;3287;4675;1388
5083;30.07.2016;'19 - 20;31,92;30,69;1,23;2538;2651;113;2299;3295;996
5084;30.07.2016;'20 - 21;32,55;31,62;0,93;567;568;1;1573;1995;422
5085;30.07.2016;'21 - 22;32,09;33,84;-1,75;12;10;-2;1355;1378;23
5086;30.07.2016;'22 - 23;36,02;33,82;2,2;0;0;0;1282;1076;-206
5087;30.07.2016;'23 - 24;32,96;30,91;2,05;0;0;0;1235;838;-397
5088;31.07.2016;'00 - 01;28,08;28,23;-0,15;0;0;0;1217;617;-600
5089;31.07.2016;'01 - 02;25,36;24,54;0,82;0;0;0;1122;575;-547
5090;31.07.2016;'02 - 03;23,8;24,72;-0,92;0;0;0;1081;551;-530
5091;31.07.2016;'03 - 04;22,56;24,71;-2,15;0;0;0;1067;549;-518
5092;31.07.2016;'04 - 05;22,14;22,69;-0,55;0;0;0;1035;732;-303
5093;31.07.2016;'05 - 06;21,65;23,65;-2;41;25;-16;965;878;-87
5094;31.07.2016;'06 - 07;20,98;23,8;-2,82;755;672;-83;882;1031;149
5095;31.07.2016;'07 - 08;21,99;22,6;-0,61;2807;2567;-240;820;947;127
5096;31.07.2016;'08 - 09;23,8;22,63;1,17;5635;4845;-790;772;717;-55
5097;31.07.2016;'09 - 10;25,12;25,94;-0,82;8682;7128;-1554;799;636;-163
5098;31.07.2016;'10 - 11;25,28;27,91;-2,63;11135;9108;-2027;900;826;-74
5099;31.07.2016;'11 - 12;26,77;28,36;-1,59;12763;10299;-2464;1101;992;-109
5100;31.07.2016;'12 - 13;26,34;28,13;-1,79;13599;10651;-2948;1373;1219;-154
5101;31.07.2016;'13 - 14;25,56;27,84;-2,28;13542;10664;-2878;1700;1627;-73
5102;31.07.2016;'14 - 15;24,35;26,87;-2,52;12679;9498;-3181;2085;2296;211
5103;31.07.2016;'15 - 16;23,32;26,29;-2,97;11059;9098;-1961;2618;3080;462
5104;31.07.2016;'16 - 17;22,78;24,78;-2;8940;7974;-966;3125;3731;606
5105;31.07.2016;'17 - 18;25,25;24,27;0,98;6571;6800;229;3489;4526;1037
5106;31.07.2016;'18 - 19;25,09;25,99;-0,9;4065;4560;495;3759;5136;1377
5107;31.07.2016;'19 - 20;28,23;27,87;0,36;1855;2220;365;3921;5468;1547
5108;31.07.2016;'20 - 21;28,92;28,11;0,81;414;520;106;4120;5358;1238
5109;31.07.2016;'21 - 22;30,19;27,84;2,35;10;11;1;4442;5188;746
5110;31.07.2016;'22 - 23;31,39;27,98;3,41;0;0;0;4936;5830;894
5111;31.07.2016;'23 - 24;27,78;25,37;2,41;0;0;0;5542;6239;697
5112;01.08.2016;'00 - 01;24,91;22,45;2,46;0;0;0;5439;6245;806
5113;01.08.2016;'01 - 02;23,79;21,05;2,74;0;0;0;5806;6528;722
5114;01.08.2016;'02 - 03;22,55;19,77;2,78;0;0;0;5993;7010;1017
5115;01.08.2016;'03 - 04;22,14;18,87;3,27;0;0;0;6090;7466;1376
5116;01.08.2016;'04 - 05;22,42;18,51;3,91;0;0;0;6200;7610;1410
5117;01.08.2016;'05 - 06;23,93;19,04;4,89;46;33;-13;6095;7356;1261
5118;01.08.2016;'06 - 07;29,06;23,25;5,81;947;904;-43;5810;7100;1290
5119;01.08.2016;'07 - 08;32,17;28,34;3,83;3920;3845;-75;5543;6083;540
5120;01.08.2016;'08 - 09;35;31,4;3,6;8623;8502;-121;5328;5277;-51
5121;01.08.2016;'09 - 10;33,21;30,05;3,16;13856;13681;-175;5390;5619;229
5122;01.08.2016;'10 - 11;30,13;27,55;2,58;18133;17481;-652;5537;6261;724
5123;01.08.2016;'11 - 12;29,8;26,64;3,16;20881;19362;-1519;5703;6553;850
5124;01.08.2016;'12 - 13;27,92;26,82;1,1;22033;19810;-2223;6172;7048;876
5125;01.08.2016;'13 - 14;25,93;27,62;-1,69;21774;19428;-2346;6678;7168;490
5126;01.08.2016;'14 - 15;27,03;27,9;-0,87;20393;18645;-1748;6879;7622;743
5127;01.08.2016;'15 - 16;27,01;28,53;-1,52;18014;16450;-1564;6853;7573;720
5128;01.08.2016;'16 - 17;28,48;28,37;0,11;14678;13556;-1122;6623;7336;713
5129;01.08.2016;'17 - 18;32,05;30,9;1,15;10547;10087;-460;6014;6559;545
5130;01.08.2016;'18 - 19;35,97;34,13;1,84;6118;6432;314;5010;5374;364
5131;01.08.2016;'19 - 20;37,15;35,92;1,23;2528;2939;411;3986;4026;40
5132;01.08.2016;'20 - 21;38,33;35,74;2,59;538;572;34;3215;2941;-274
5133;01.08.2016;'21 - 22;36,95;35,78;1,17;10;9;-1;2872;2723;-149
5134;01.08.2016;'22 - 23;35,99;36,4;-0,41;0;0;0;2814;2791;-23
5135;01.08.2016;'23 - 24;31,63;33,8;-2,17;0;0;0;2872;2931;59
5136;02.08.2016;'00 - 01;27,56;28,36;-0,8;0;0;0;3241;2880;-361
5137;02.08.2016;'01 - 02;25,79;26,8;-1,01;0;0;0;3309;2801;-508
5138;02.08.2016;'02 - 03;25,35;26,45;-1,1;0;0;0;3221;2808;-413
5139;02.08.2016;'03 - 04;24,7;24,61;0,09;0;0;0;3061;2800;-261
5140;02.08.2016;'04 - 05;24,27;23,7;0,57;0;0;0;2961;2708;-253
5141;02.08.2016;'05 - 06;25,9;25,1;0,8;29;19;-10;2880;2567;-313
5142;02.08.2016;'06 - 07;30,43;27,13;3,3;578;537;-41;2831;2615;-216
5143;02.08.2016;'07 - 08;34,87;36,07;-1,2;2211;2183;-28;2876;2622;-254
5144;02.08.2016;'08 - 09;36,87;37,71;-0,84;4364;4210;-154;2952;2483;-469
5145;02.08.2016;'09 - 10;36,92;36,74;0,18;6437;6319;-118;3093;2540;-553
5146;02.08.2016;'10 - 11;36,97;36,6;0,37;7919;8252;333;3306;2504;-802
5147;02.08.2016;'11 - 12;38,09;37,09;1;8857;9501;644;3701;2994;-707
5148;02.08.2016;'12 - 13;37,83;35,69;2,14;9299;10612;1313;4247;3286;-961
5149;02.08.2016;'13 - 14;36,85;35,04;1,81;9046;9832;786;4744;3663;-1081
5150;02.08.2016;'14 - 15;35,98;33,57;2,41;8188;8711;523;4936;4030;-906
5151;02.08.2016;'15 - 16;35,73;33,1;2,63;7012;7714;702;4944;4102;-842
5152;02.08.2016;'16 - 17;34,92;33,11;1,81;5518;6117;599;4866;3986;-880
5153;02.08.2016;'17 - 18;35,94;34,06;1,88;3913;4244;331;4760;4140;-620
5154;02.08.2016;'18 - 19;35,92;34,71;1,21;2318;2544;226;4659;4182;-477
5155;02.08.2016;'19 - 20;34,95;33,84;1,11;973;1107;134;4633;4178;-455
5156;02.08.2016;'20 - 21;32,83;31,31;1,52;201;218;17;4766;4252;-514
5157;02.08.2016;'21 - 22;32,4;31,72;0,68;3;3;0;5185;4754;-431
5158;02.08.2016;'22 - 23;31,19;30,79;0,4;0;0;0;5723;5183;-540
5159;02.08.2016;'23 - 24;28,98;29,43;-0,45;0;0;0;6306;5758;-548
5160;03.08.2016;'00 - 01;26,03;24,22;1,81;0;0;0;5647;6398;751
5161;03.08.2016;'01 - 02;24,53;22,98;1,55;0;0;0;6101;6732;631
5162;03.08.2016;'02 - 03;23,74;20;3,74;0;0;0;6517;7013;496
5163;03.08.2016;'03 - 04;22,69;18,09;4,6;0;0;0;6869;7270;401
5164;03.08.2016;'04 - 05;22,48;19,37;3,11;0;0;0;7297;7524;227
5165;03.08.2016;'05 - 06;23,66;23,17;0,49;13;9;-4;7871;8265;394
5166;03.08.2016;'06 - 07;27,06;24,82;2,24;353;390;37;8603;9180;577
5167;03.08.2016;'07 - 08;31,82;29,94;1,88;1502;1905;403;9385;10060;675
5168;03.08.2016;'08 - 09;33,95;31,28;2,67;3294;4409;1115;10211;10230;19
5169;03.08.2016;'09 - 10;34,97;30,65;4,32;5375;7028;1653;11107;10630;-477
5170;03.08.2016;'10 - 11;35,02;30,89;4,13;7377;9640;2263;12074;11900;-174
5171;03.08.2016;'11 - 12;34,95;30,02;4,93;9163;11560;2397;12934;13172;238
5172;03.08.2016;'12 - 13;33,57;26,54;7,03;10415;12263;1848;13483;14214;731
5173;03.08.2016;'13 - 14;30,04;23,68;6,36;10859;11982;1123;13765;14639;874
5174;03.08.2016;'14 - 15;28,13;24,54;3,59;10642;11422;780;13693;14782;1089
5175;03.08.2016;'15 - 16;28,38;26,93;1,45;9680;10154;474;13393;14698;1305
5176;03.08.2016;'16 - 17;28,45;27,82;0,63;8132;8808;676;13022;14854;1832
5177;03.08.2016;'17 - 18;29,95;28,88;1,07;6156;6429;273;12584;13812;1228
5178;03.08.2016;'18 - 19;32,52;29,95;2,57;3744;3864;120;12064;13004;940
5179;03.08.2016;'19 - 20;33;31,6;1,4;1543;1655;112;11538;12559;1021
5180;03.08.2016;'20 - 21;31,25;30,77;0,48;286;334;48;11401;11932;531
5181;03.08.2016;'21 - 22;30,33;30,52;-0,19;3;6;3;11459;11431;-28
5182;03.08.2016;'22 - 23;28,99;29,62;-0,63;0;0;0;11474;11212;-262
5183;03.08.2016;'23 - 24;26,91;27,47;-0,56;0;0;0;11443;11105;-338
5184;04.08.2016;'00 - 01;23,55;28,9;-5,35;0;0;0;12478;10793;-1685
5185;04.08.2016;'01 - 02;22,43;26,97;-4,54;0;0;0;12699;11296;-1403
5186;04.08.2016;'02 - 03;20,05;24,38;-4,33;0;0;0;12798;11279;-1519
5187;04.08.2016;'03 - 04;19,42;22,11;-2,69;0;0;0;12658;10978;-1680
5188;04.08.2016;'04 - 05;19,83;21,15;-1,32;0;0;0;12508;10873;-1635
5189;04.08.2016;'05 - 06;22,42;25,57;-3,15;26;16;-10;12380;10598;-1782
5190;04.08.2016;'06 - 07;25,49;28,47;-2,98;727;644;-83;12272;10858;-1414
5191;04.08.2016;'07 - 08;30,01;32,28;-2,27;3150;3035;-115;12265;10708;-1557
5192;04.08.2016;'08 - 09;33,05;35,08;-2,03;6828;6624;-204;12502;10640;-1862
5193;04.08.2016;'09 - 10;32,03;34,84;-2,81;10813;10690;-123;12979;11142;-1837
5194;04.08.2016;'10 - 11;29,01;33,92;-4,91;14254;14353;99;13473;12100;-1373
5195;04.08.2016;'11 - 12;27,98;31,79;-3,81;16763;16539;-224;13980;13152;-828
5196;04.08.2016;'12 - 13;25,45;29,15;-3,7;18138;17444;-694;14386;13580;-806
5197;04.08.2016;'13 - 14;23,58;28,87;-5,29;18116;16769;-1347;14648;13461;-1187
5198;04.08.2016;'14 - 15;23,97;30,92;-6,95;16952;15324;-1628;14322;12857;-1465
5199;04.08.2016;'15 - 16;27,02;32,83;-5,81;14715;12969;-1746;13605;12346;-1259
5200;04.08.2016;'16 - 17;29,29;34,29;-5;11457;9925;-1532;12444;11252;-1192
5201;04.08.2016;'17 - 18;32,98;36,36;-3,38;7768;6739;-1029;10893;10334;-559
5202;04.08.2016;'18 - 19;34,58;36,87;-2,29;4303;3648;-655;9286;9046;-240
5203;04.08.2016;'19 - 20;34,9;36,54;-1,64;1713;1488;-225;7983;7774;-209
5204;04.08.2016;'20 - 21;34,58;36,21;-1,63;307;286;-21;7221;6571;-650
5205;04.08.2016;'21 - 22;34,46;36,69;-2,23;4;6;2;6894;6412;-482
5206;04.08.2016;'22 - 23;33,91;37,08;-3,17;0;0;0;6746;6152;-594
5207;04.08.2016;'23 - 24;29,37;31,93;-2,56;0;0;0;6645;5744;-901
5208;05.08.2016;'00 - 01;28,13;26,32;1,81;0;0;0;5876;5210;-666
5209;05.08.2016;'01 - 02;26,83;25,84;0,99;0;0;0;5760;4639;-1121
5210;05.08.2016;'02 - 03;25,12;23,97;1,15;0;0;0;5574;4363;-1211
5211;05.08.2016;'03 - 04;23,95;22,35;1,6;0;0;0;5385;4198;-1187
5212;05.08.2016;'04 - 05;24,07;22,44;1,63;0;0;0;5188;4172;-1016
5213;05.08.2016;'05 - 06;26,24;28;-1,76;13;6;-7;4985;4540;-445
5214;05.08.2016;'06 - 07;30,45;29,22;1,23;357;313;-44;4772;4333;-439
5215;05.08.2016;'07 - 08;34,01;33,81;0,2;1650;1557;-93;4531;3979;-552
5216;05.08.2016;'08 - 09;37,19;37,76;-0,57;3656;3435;-221;4354;3435;-919
5217;05.08.2016;'09 - 10;38,69;38,91;-0,22;5965;5746;-219;4348;3425;-923
5218;05.08.2016;'10 - 11;38,54;39,64;-1,1;8378;8170;-208;4456;4000;-456
5219;05.08.2016;'11 - 12;38;40,15;-2,15;10598;10319;-279;4798;4676;-122
5220;05.08.2016;'12 - 13;36;36,15;-0,15;12183;11524;-659;5375;5616;241
5221;05.08.2016;'13 - 14;33,96;34,85;-0,89;12855;12727;-128;6006;6078;72
5222;05.08.2016;'14 - 15;31,39;31,77;-0,38;12883;12509;-374;6540;6707;167
5223;05.08.2016;'15 - 16;28,23;28,76;-0,53;12037;11801;-236;7019;7482;463
5224;05.08.2016;'16 - 17;28,46;26,69;1,77;10240;10612;372;7246;7645;399
5225;05.08.2016;'17 - 18;31,29;26,89;4,4;7737;8194;457;7149;7986;837
5226;05.08.2016;'18 - 19;33,89;29,32;4,57;4807;5028;221;6765;7518;753
5227;05.08.2016;'19 - 20;34,4;30,54;3,86;2085;2164;79;6380;7477;1097
5228;05.08.2016;'20 - 21;34,15;30,52;3,63;385;410;25;6358;6914;556
5229;05.08.2016;'21 - 22;33,02;30,15;2,87;5;5;0;6716;6302;-414
5230;05.08.2016;'22 - 23;32,3;29,83;2,47;0;0;0;7124;6135;-989
5231;05.08.2016;'23 - 24;28,84;29,11;-0,27;0;0;0;7458;6567;-891
5232;06.08.2016;'00 - 01;29,58;24,16;5,42;0;0;0;6826;6525;-301
5233;06.08.2016;'01 - 02;26,68;24,68;2;0;0;0;6960;6022;-938
5234;06.08.2016;'02 - 03;25,34;22,05;3,29;0;0;0;6978;5673;-1305
5235;06.08.2016;'03 - 04;23,77;20,23;3,54;0;0;0;6868;5460;-1408
5236;06.08.2016;'04 - 05;22,4;18,8;3,6;0;0;0;6717;5286;-1431
5237;06.08.2016;'05 - 06;22,01;18,2;3,81;23;15;-8;6602;5133;-1469
5238;06.08.2016;'06 - 07;22,97;18,7;4,27;709;615;-94;6269;5486;-783
5239;06.08.2016;'07 - 08;25,02;21,3;3,72;3212;2989;-223;5791;5233;-558
5240;06.08.2016;'08 - 09;26,36;21,49;4,87;7034;6631;-403;5544;4590;-954
5241;06.08.2016;'09 - 10;26,47;23,68;2,79;11271;10575;-696;5792;5150;-642
5242;06.08.2016;'10 - 11;24,94;23,48;1,46;14864;13684;-1180;6288;6332;44
5243;06.08.2016;'11 - 12;23,71;21,95;1,76;17210;15620;-1590;7012;7284;272
5244;06.08.2016;'12 - 13;22,07;19,89;2,18;18394;16174;-2220;7852;7466;-386
5245;06.08.2016;'13 - 14;19,81;18,5;1,31;18529;16249;-2280;8736;8128;-608
5246;06.08.2016;'14 - 15;18,38;17,43;0,95;17703;15640;-2063;9587;8730;-857
5247;06.08.2016;'15 - 16;17,83;15,6;2,23;15812;14326;-1486;10399;9162;-1237
5248;06.08.2016;'16 - 17;17,18;13,51;3,67;13047;12120;-927;10972;9915;-1057
5249;06.08.2016;'17 - 18;22,03;19,92;2,11;9471;8948;-523;10869;10206;-663
5250;06.08.2016;'18 - 19;26,32;25,57;0,75;5555;5494;-61;10168;9489;-679
5251;06.08.2016;'19 - 20;28,96;26,48;2,48;2257;2338;81;9244;7852;-1392
5252;06.08.2016;'20 - 21;28,92;27,95;0,97;399;418;19;8732;6074;-2658
5253;06.08.2016;'21 - 22;30,32;30,81;-0,49;5;1;-4;8410;6005;-2405
5254;06.08.2016;'22 - 23;30,44;30,36;0,08;0;0;0;8156;6201;-1955
5255;06.08.2016;'23 - 24;28,12;26,72;1,4;0;0;0;7936;6065;-1871
5256;07.08.2016;'00 - 01;24,6;22,79;1,81;0;0;0;5669;5631;-38
5257;07.08.2016;'01 - 02;20,05;20,73;-0,68;0;0;0;5648;5595;-53
5258;07.08.2016;'02 - 03;17,99;16,71;1,28;0;0;0;5658;5743;85
5259;07.08.2016;'03 - 04;12,86;10,87;1,99;0;0;0;5897;6218;321
5260;07.08.2016;'04 - 05;12,38;9,28;3,1;0;0;0;6122;6653;531
5261;07.08.2016;'05 - 06;12,35;8,79;3,56;26;14;-12;6274;7174;900
5262;07.08.2016;'06 - 07;12,51;8,61;3,9;797;693;-104;6457;7887;1430
5263;07.08.2016;'07 - 08;11,93;7,02;4,91;3858;3594;-264;6713;7417;704
5264;07.08.2016;'08 - 09;12,25;6,18;6,07;8891;8540;-351;7243;6472;-771
5265;07.08.2016;'09 - 10;12,79;7,45;5,34;14481;14254;-227;8001;7582;-419
5266;07.08.2016;'10 - 11;9,95;2,66;7,29;19130;18866;-264;8918;9253;335
5267;07.08.2016;'11 - 12;8,83;0,27;8,56;22209;22227;18;9643;10584;941
5268;07.08.2016;'12 - 13;5,93;-3,66;9,59;23784;24084;300;10214;11362;1148
5269;07.08.2016;'13 - 14;0,02;-14,76;14,78;24042;24258;216;10671;12121;1450
5270;07.08.2016;'14 - 15;0,04;-15,15;15,19;22925;23046;121;10930;12095;1165
5271;07.08.2016;'15 - 16;2,35;-17,77;20,12;20375;20516;141;10959;11882;923
5272;07.08.2016;'16 - 17;5,67;-10,97;16,64;16485;16745;260;10652;11484;832
5273;07.08.2016;'17 - 18;12,84;4,34;8,5;11521;11817;296;10045;10766;721
5274;07.08.2016;'18 - 19;24,7;20,47;4,23;6188;6598;410;9204;9772;568
5275;07.08.2016;'19 - 20;27,77;25,59;2,18;2165;2412;247;8407;8550;143
5276;07.08.2016;'20 - 21;30,48;27,35;3,13;372;401;29;8396;7324;-1072
5277;07.08.2016;'21 - 22;32,37;28;4,37;5;0;-5;8800;7530;-1270
5278;07.08.2016;'22 - 23;32,65;28,57;4,08;0;0;0;9517;8727;-790
5279;07.08.2016;'23 - 24;26,33;25,5;0,83;0;0;0;10227;10156;-71
5280;08.08.2016;'00 - 01;20,62;18,61;2,01;0;0;0;10595;11204;609
5281;08.08.2016;'01 - 02;16,44;13,37;3,07;0;0;0;11495;11491;-4
5282;08.08.2016;'02 - 03;12,91;12,45;0,46;0;0;0;12469;11687;-782
5283;08.08.2016;'03 - 04;8,16;12,09;-3,93;0;0;0;13446;12538;-908
5284;08.08.2016;'04 - 05;8,12;13,8;-5,68;0;0;0;14390;13730;-660
5285;08.08.2016;'05 - 06;8,94;13,43;-4,49;19;10;-9;15178;14715;-463
5286;08.08.2016;'06 - 07;17,85;16,31;1,54;678;592;-86;15795;15433;-362
5287;08.08.2016;'07 - 08;23,71;24,84;-1,13;3379;3171;-208;16265;15394;-871
5288;08.08.2016;'08 - 09;26,29;29,46;-3,17;7711;7688;-23;16914;15250;-1664
5289;08.08.2016;'09 - 10;24,02;27,21;-3,19;12424;12582;158;17917;16229;-1688
5290;08.08.2016;'10 - 11;20,26;22,07;-1,81;16355;16748;393;18977;16916;-2061
5291;08.08.2016;'11 - 12;18,73;21,76;-3,03;19055;19736;681;19919;18238;-1681
5292;08.08.2016;'12 - 13;14,28;17,65;-3,37;20491;20624;133;20595;19364;-1231
5293;08.08.2016;'13 - 14;13,41;18,16;-4,75;20545;20346;-199;20857;19885;-972
5294;08.08.2016;'14 - 15;12,89;17,53;-4,64;19372;19585;213;20741;19683;-1058
5295;08.08.2016;'15 - 16;17,92;21,12;-3,2;17179;17778;599;20508;19577;-931
5296;08.08.2016;'16 - 17;20,82;21,99;-1,17;14041;14598;557;19722;19090;-632
5297;08.08.2016;'17 - 18;26,52;24,49;2,03;9959;10550;591;18562;17711;-851
5298;08.08.2016;'18 - 19;31,29;30,63;0,66;5569;6030;461;16766;16381;-385
5299;08.08.2016;'19 - 20;34,39;33,06;1,33;2133;2208;75;14559;14640;81
5300;08.08.2016;'20 - 21;33,23;31,29;1,94;343;330;-13;12011;12395;384
5301;08.08.2016;'21 - 22;34;33,39;0,61;3;0;-3;10142;10344;202
5302;08.08.2016;'22 - 23;33,93;33,17;0,76;0;0;0;8642;9073;431
5303;08.08.2016;'23 - 24;31,75;29,9;1,85;0;0;0;7644;8038;394
5304;09.08.2016;'00 - 01;23,88;24,51;-0,63;0;0;0;8615;7212;-1403
5305;09.08.2016;'01 - 02;23,06;21,72;1,34;0;0;0;8216;6509;-1707
5306;09.08.2016;'02 - 03;22,6;21,99;0,61;0;0;0;7857;5968;-1889
5307;09.08.2016;'03 - 04;20,32;22,48;-2,16;0;0;0;7512;5470;-2042
5308;09.08.2016;'04 - 05;19,94;21,75;-1,81;0;0;0;7116;5263;-1853
5309;09.08.2016;'05 - 06;22,97;23,5;-0,53;11;4;-7;6802;5240;-1562
5310;09.08.2016;'06 - 07;28,33;25,69;2,64;400;298;-102;6553;5636;-917
5311;09.08.2016;'07 - 08;32,86;31;1,86;1900;1547;-353;6413;5128;-1285
5312;09.08.2016;'08 - 09;34,83;35,08;-0,25;4279;3563;-716;6399;4615;-1784
5313;09.08.2016;'09 - 10;35,03;35,7;-0,67;6989;6210;-779;6744;4776;-1968
5314;09.08.2016;'10 - 11;34,6;33,33;1,27;9427;9334;-93;7423;6046;-1377
5315;09.08.2016;'11 - 12;34,26;30,28;3,98;11305;11736;431;8111;7687;-424
5316;09.08.2016;'12 - 13;33,6;28,84;4,76;12513;13348;835;8882;9328;446
5317;09.08.2016;'13 - 14;32,78;28,17;4,61;12850;14358;1508;9650;10340;690
5318;09.08.2016;'14 - 15;30,22;26,81;3,41;12469;14216;1747;10334;11310;976
5319;09.08.2016;'15 - 16;27,84;24,56;3,28;11371;12618;1247;11047;12266;1219
5320;09.08.2016;'16 - 17;25,97;23,61;2,36;9544;10014;470;11646;12399;753
5321;09.08.2016;'17 - 18;28,12;27,18;0,94;7106;7090;-16;11833;12230;397
5322;09.08.2016;'18 - 19;30,35;28,56;1,79;4248;4210;-38;11426;12075;649
5323;09.08.2016;'19 - 20;32,02;30,85;1,17;1698;1652;-46;11014;9966;-1048
5324;09.08.2016;'20 - 21;30,91;30,22;0,69;259;247;-12;10399;8725;-1674
5325;09.08.2016;'21 - 22;30,47;31,35;-0,88;2;0;-2;9800;7989;-1811
5326;09.08.2016;'22 - 23;29,1;30,87;-1,77;0;0;0;9389;7769;-1620
5327;09.08.2016;'23 - 24;26,45;27,33;-0,88;0;0;0;9258;7352;-1906
5328;10.08.2016;'00 - 01;23,35;23,26;0,09;0;0;0;7813;6955;-858
5329;10.08.2016;'01 - 02;23,11;20,92;2,19;0;0;0;7751;6782;-969
5330;10.08.2016;'02 - 03;22;19,51;2,49;0;0;0;7662;6716;-946
5331;10.08.2016;'03 - 04;19,99;15,63;4,36;0;0;0;7443;6661;-782
5332;10.08.2016;'04 - 05;20,19;16,39;3,8;0;0;0;7355;6614;-741
5333;10.08.2016;'05 - 06;23,18;22,68;0,5;14;6;-8;7235;6536;-699
5334;10.08.2016;'06 - 07;27,59;27,57;0,02;513;396;-117;7165;6273;-892
5335;10.08.2016;'07 - 08;32,21;32,02;0,19;2620;2017;-603;6891;5598;-1293
5336;10.08.2016;'08 - 09;33,95;34,94;-0,99;5962;4594;-1368;6804;5003;-1801
5337;10.08.2016;'09 - 10;33,5;36,8;-3,3;9791;8131;-1660;7038;4989;-2049
5338;10.08.2016;'10 - 11;32,01;33,76;-1,75;13238;11834;-1404;7366;5521;-1845
5339;10.08.2016;'11 - 12;31,87;32,19;-0,32;15927;14291;-1636;7792;6738;-1054
5340;10.08.2016;'12 - 13;29,66;31,55;-1,89;17648;15127;-2521;8043;8268;225
5341;10.08.2016;'13 - 14;26,91;29,9;-2,99;18107;14674;-3433;8369;9053;684
5342;10.08.2016;'14 - 15;25,43;29,39;-3,96;17457;14197;-3260;8869;9596;727
5343;10.08.2016;'15 - 16;24,51;29,45;-4,94;15611;13410;-2201;9303;10330;1027
5344;10.08.2016;'16 - 17;24,31;27;-2,69;12732;11958;-774;9590;10642;1052
5345;10.08.2016;'17 - 18;27,33;28,2;-0,87;9068;9095;27;9351;10255;904
5346;10.08.2016;'18 - 19;31,48;29,08;2,4;5200;5322;122;8803;9498;695
5347;10.08.2016;'19 - 20;33,68;31,54;2,14;2006;2130;124;7959;8277;318
5348;10.08.2016;'20 - 21;33,72;30,97;2,75;292;302;10;7402;6676;-726
5349;10.08.2016;'21 - 22;33,93;31,47;2,46;3;0;-3;6928;6186;-742
5350;10.08.2016;'22 - 23;32,93;30,84;2,09;0;0;0;6561;6665;104
5351;10.08.2016;'23 - 24;28,65;26,65;2;0;0;0;6503;7144;641
5352;11.08.2016;'00 - 01;24,23;21,27;2,96;0;0;0;7007;7904;897
5353;11.08.2016;'01 - 02;23,01;18,44;4,57;0;0;0;6975;7718;743
5354;11.08.2016;'02 - 03;22,72;17,84;4,88;0;0;0;6984;7493;509
5355;11.08.2016;'03 - 04;20,49;15,95;4,54;0;0;0;6984;7444;460
5356;11.08.2016;'04 - 05;21,48;16,21;5,27;0;0;0;6990;7608;618
5357;11.08.2016;'05 - 06;22,77;15,94;6,83;16;8;-8;6811;7476;665
5358;11.08.2016;'06 - 07;27,97;20,97;7;651;566;-85;6343;6782;439
5359;11.08.2016;'07 - 08;34,09;25,35;8,74;3600;3269;-331;5840;5487;-353
5360;11.08.2016;'08 - 09;35,67;29,94;5,73;8520;7762;-758;5639;4174;-1465
5361;11.08.2016;'09 - 10;33,07;30,01;3,06;13861;12799;-1062;6022;4793;-1229
5362;11.08.2016;'10 - 11;30,86;28,59;2,27;17634;16272;-1362;6958;6296;-662
5363;11.08.2016;'11 - 12;30,48;27,83;2,65;19408;17253;-2155;8111;8173;62
5364;11.08.2016;'12 - 13;28,57;28,52;0,05;19834;17279;-2555;9232;9703;471
5365;11.08.2016;'13 - 14;27,17;27,58;-0,41;19180;16811;-2369;10191;10694;503
5366;11.08.2016;'14 - 15;24,99;25,82;-0,83;17426;15727;-1699;11041;10918;-123
5367;11.08.2016;'15 - 16;25,62;25,69;-0,07;14739;13814;-925;11761;11228;-533
5368;11.08.2016;'16 - 17;25,69;22,93;2,76;11325;10903;-422;12018;11144;-874
5369;11.08.2016;'17 - 18;31,4;28,5;2,9;7541;7498;-43;11845;10662;-1183
5370;11.08.2016;'18 - 19;34,37;30,48;3,89;3960;3911;-49;11305;9564;-1741
5371;11.08.2016;'19 - 20;34,95;30,88;4,07;1368;1308;-60;10791;8417;-2374
5372;11.08.2016;'20 - 21;35,11;31,4;3,71;166;124;-42;10912;7787;-3125
5373;11.08.2016;'21 - 22;34,82;31,28;3,54;1;0;-1;11129;7474;-3655
5374;11.08.2016;'22 - 23;33,87;30,2;3,67;0;0;0;11511;7580;-3931
5375;11.08.2016;'23 - 24;28,82;26,43;2,39;0;0;0;12060;7718;-4342
5376;12.08.2016;'00 - 01;24,07;24,11;-0,04;0;0;0;9353;7759;-1594
5377;12.08.2016;'01 - 02;22,97;22,63;0,34;0;0;0;9544;7307;-2237
5378;12.08.2016;'02 - 03;21,05;19,7;1,35;0;0;0;9613;6806;-2807
5379;12.08.2016;'03 - 04;19,9;17,14;2,76;0;0;0;9500;6371;-3129
5380;12.08.2016;'04 - 05;20,05;19,29;0,76;0;0;0;9387;6132;-3255
5381;12.08.2016;'05 - 06;22,98;25,33;-2,35;2;2;0;9282;5789;-3493
5382;12.08.2016;'06 - 07;27,93;29,31;-1,38;138;147;9;9214;5580;-3634
5383;12.08.2016;'07 - 08;32,55;37,13;-4,58;675;869;194;9085;5344;-3741
5384;12.08.2016;'08 - 09;33,8;37,07;-3,27;1536;2105;569;9055;5069;-3986
5385;12.08.2016;'09 - 10;34,04;36;-1,96;2527;3498;971;9381;5178;-4203
5386;12.08.2016;'10 - 11;34,91;36,33;-1,42;3543;5060;1517;9756;5847;-3909
5387;12.08.2016;'11 - 12;35,25;36,38;-1,13;4487;6309;1822;10198;6469;-3729
5388;12.08.2016;'12 - 13;34,95;34,11;0,84;5219;7221;2002;10732;7243;-3489
5389;12.08.2016;'13 - 14;32,1;32,8;-0,7;5550;7733;2183;11223;8526;-2697
5390;12.08.2016;'14 - 15;29,5;29,38;0,12;5570;7906;2336;11576;9446;-2130
5391;12.08.2016;'15 - 16;27,12;27,75;-0,63;5288;7586;2298;12009;9588;-2421
5392;12.08.2016;'16 - 17;24,2;25,98;-1,78;4718;6319;1601;12214;9831;-2383
5393;12.08.2016;'17 - 18;26,9;28,35;-1,45;3826;4735;909;12099;10040;-2059
5394;12.08.2016;'18 - 19;28,09;30,49;-2,4;2448;2833;385;11660;9874;-1786
5395;12.08.2016;'19 - 20;29,06;31,46;-2,4;988;1146;158;11138;9713;-1425
5396;12.08.2016;'20 - 21;29,13;30,31;-1,18;142;147;5;10858;9598;-1260
5397;12.08.2016;'21 - 22;28,99;30,78;-1,79;1;0;-1;10877;9476;-1401
5398;12.08.2016;'22 - 23;28,34;31,24;-2,9;0;0;0;11124;9434;-1690
5399;12.08.2016;'23 - 24;24,7;28,95;-4,25;0;0;0;11342;9382;-1960
5400;13.08.2016;'00 - 01;21,7;23,91;-2,21;0;0;0;11145;9754;-1391
5401;13.08.2016;'01 - 02;19,97;21,73;-1,76;0;0;0;11414;10025;-1389
5402;13.08.2016;'02 - 03;18,09;19,82;-1,73;0;0;0;11521;10052;-1469
5403;13.08.2016;'03 - 04;16,89;19,17;-2,28;0;0;0;11415;9826;-1589
5404;13.08.2016;'04 - 05;16,1;15,95;0,15;0;0;0;11309;9574;-1735
5405;13.08.2016;'05 - 06;14,46;15,49;-1,03;10;5;-5;11218;9718;-1500
5406;13.08.2016;'06 - 07;16,08;17,87;-1,79;510;459;-51;11172;9834;-1338
5407;13.08.2016;'07 - 08;18,05;22,3;-4,25;2987;2922;-65;11072;9727;-1345
5408;13.08.2016;'08 - 09;20,06;25,25;-5,19;7194;7313;119;11407;9546;-1861
5409;13.08.2016;'09 - 10;20,06;24,2;-4,14;12146;12613;467;12524;10548;-1976
5410;13.08.2016;'10 - 11;18,06;20,49;-2,43;16391;17117;726;13666;13110;-556
5411;13.08.2016;'11 - 12;15,85;13,98;1,87;19197;19655;458;14621;15193;572
5412;13.08.2016;'12 - 13;13,64;11,59;2,05;20701;20675;-26;15203;15693;490
5413;13.08.2016;'13 - 14;9,07;7,1;1,97;21016;21117;101;15549;16125;576
5414;13.08.2016;'14 - 15;9,11;4,2;4,91;20013;20726;713;15642;15757;115
5415;13.08.2016;'15 - 16;10,54;5,9;4,64;17764;18762;998;15639;15448;-191
5416;13.08.2016;'16 - 17;12,52;18,12;-5,6;14496;15488;992;15244;14948;-296
5417;13.08.2016;'17 - 18;18,77;19,9;-1,13;10209;10879;670;14456;14072;-384
5418;13.08.2016;'18 - 19;24,72;26,88;-2,16;5504;5891;387;13229;12508;-721
5419;13.08.2016;'19 - 20;26,88;31,33;-4,45;1859;1872;13;11787;10627;-1160
5420;13.08.2016;'20 - 21;27,7;32,36;-4,66;230;211;-19;10828;9204;-1624
5421;13.08.2016;'21 - 22;29,08;33,61;-4,53;1;0;-1;10042;8350;-1692
5422;13.08.2016;'22 - 23;28,31;31,13;-2,82;0;0;0;9274;7329;-1945
5423;13.08.2016;'23 - 24;25,73;29,04;-3,31;0;0;0;8677;6285;-2392
5424;14.08.2016;'00 - 01;23,44;25,32;-1,88;0;0;0;6877;5496;-1381
5425;14.08.2016;'01 - 02;21,18;23,18;-2;0;0;0;6244;4658;-1586
5426;14.08.2016;'02 - 03;19,61;20,69;-1,08;0;0;0;5806;4078;-1728
5427;14.08.2016;'03 - 04;19,03;20,68;-1,65;0;0;0;5383;3675;-1708
5428;14.08.2016;'04 - 05;18,05;19,29;-1,24;0;0;0;5001;3545;-1456
5429;14.08.2016;'05 - 06;18,08;19,89;-1,81;8;4;-4;4566;3408;-1158
5430;14.08.2016;'06 - 07;18,06;20,08;-2,02;502;452;-50;4184;3307;-877
5431;14.08.2016;'07 - 08;19,14;21,31;-2,17;3007;2940;-67;3584;3156;-428
5432;14.08.2016;'08 - 09;19,9;21,02;-1,12;7202;7448;246;3169;2798;-371
5433;14.08.2016;'09 - 10;18,99;20,32;-1,33;11990;12565;575;3778;3462;-316
5434;14.08.2016;'10 - 11;19,74;19,86;-0,12;16038;16442;404;4060;3738;-322
5435;14.08.2016;'11 - 12;20,46;18,69;1,77;18749;19084;335;4293;4262;-31
5436;14.08.2016;'12 - 13;19,1;17,42;1,68;20025;19928;-97;4616;4470;-146
5437;14.08.2016;'13 - 14;17,41;13,18;4,23;19995;19710;-285;4974;4831;-143
5438;14.08.2016;'14 - 15;15,99;13,05;2,94;18841;18742;-99;5259;5187;-72
5439;14.08.2016;'15 - 16;16,57;13,97;2,6;16545;17022;477;5412;5346;-66
5440;14.08.2016;'16 - 17;16,89;15,15;1,74;13373;14235;862;5460;5275;-185
5441;14.08.2016;'17 - 18;20,13;19,26;0,87;9384;10316;932;5199;5247;48
5442;14.08.2016;'18 - 19;26,75;25,92;0,83;5108;5798;690;4742;4789;47
5443;14.08.2016;'19 - 20;29,57;30,06;-0,49;1745;2018;273;4148;4272;124
5444;14.08.2016;'20 - 21;31,56;31,48;0,08;199;222;23;3416;3862;446
5445;14.08.2016;'21 - 22;32,3;30,66;1,64;1;0;-1;3397;4145;748
5446;14.08.2016;'22 - 23;31,56;31,66;-0,1;0;0;0;3273;4139;866
5447;14.08.2016;'23 - 24;28,5;24,7;3,8;0;0;0;3135;4068;933
5448;15.08.2016;'00 - 01;25,15;23,53;1,62;0;0;0;2982;3850;868
5449;15.08.2016;'01 - 02;22,94;23,75;-0,81;0;0;0;2863;3504;641
5450;15.08.2016;'02 - 03;21,61;17,65;3,96;0;0;0;2825;3240;415
5451;15.08.2016;'03 - 04;21,01;18,77;2,24;0;0;0;2840;3164;324
5452;15.08.2016;'04 - 05;21,5;17,99;3,51;0;0;0;2877;3132;255
5453;15.08.2016;'05 - 06;23,29;19,11;4,18;6;3;-3;2774;3097;323
5454;15.08.2016;'06 - 07;27,21;23,17;4,04;481;429;-52;2492;3092;600
5455;15.08.2016;'07 - 08;30,82;26,44;4,38;3058;2855;-203;2032;2487;455
5456;15.08.2016;'08 - 09;32;31,18;0,82;7603;7234;-369;1465;1440;-25
5457;15.08.2016;'09 - 10;30,59;30,94;-0,35;12884;12646;-238;1425;1105;-320
5458;15.08.2016;'10 - 11;28,65;28,56;0,09;17113;17458;345;1577;1298;-279
5459;15.08.2016;'11 - 12;28,32;26,67;1,65;19707;20296;589;1734;1530;-204
5460;15.08.2016;'12 - 13;27,02;23,68;3,34;20916;21129;213;1850;1631;-219
5461;15.08.2016;'13 - 14;25;23,04;1,96;20932;20626;-306;2006;1913;-93
5462;15.08.2016;'14 - 15;23,9;23,29;0,61;19720;19675;-45;2239;2262;23
5463;15.08.2016;'15 - 16;24,1;24,02;0,08;17504;17697;193;2550;2327;-223
5464;15.08.2016;'16 - 17;25,54;25,95;-0,41;14289;14586;297;2810;2538;-272
5465;15.08.2016;'17 - 18;30,62;28,84;1,78;10091;10669;578;2906;2796;-110
5466;15.08.2016;'18 - 19;33,98;31,04;2,94;5477;6142;665;2900;2939;39
5467;15.08.2016;'19 - 20;35,88;32,61;3,27;1829;2108;279;2847;2946;99
5468;15.08.2016;'20 - 21;34,32;33,51;0,81;199;231;32;2817;2980;163
5469;15.08.2016;'21 - 22;34,47;32,88;1,59;1;0;-1;3078;3772;694
5470;15.08.2016;'22 - 23;33,22;31,25;1,97;0;0;0;3161;4172;1011
5471;15.08.2016;'23 - 24;30,42;26,25;4,17;0;0;0;3110;4043;933
5472;16.08.2016;'00 - 01;26,26;24,1;2,16;0;0;0;3139;3746;607
5473;16.08.2016;'01 - 02;23,99;22,35;1,64;0;0;0;2853;3317;464
5474;16.08.2016;'02 - 03;22,94;21,47;1,47;0;0;0;2647;2872;225
5475;16.08.2016;'03 - 04;22,03;19,84;2,19;0;0;0;2486;2474;-12
5476;16.08.2016;'04 - 05;22,1;20,65;1,45;0;0;0;2366;2227;-139
5477;16.08.2016;'05 - 06;24,1;24,4;-0,3;6;2;-4;2209;2149;-60
5478;16.08.2016;'06 - 07;28,71;29,72;-1,01;487;443;-44;2002;2131;129
5479;16.08.2016;'07 - 08;33,63;33,74;-0,11;3181;3135;-46;1698;1894;196
5480;16.08.2016;'08 - 09;34,14;33,03;1,11;7893;8150;257;1133;1166;33
5481;16.08.2016;'09 - 10;33,9;30,49;3,41;13420;13981;561;856;756;-100
5482;16.08.2016;'10 - 11;31,73;29,86;1,87;17945;18825;880;788;928;140
5483;16.08.2016;'11 - 12;30,13;28,36;1,77;20762;21417;655;777;1175;398
5484;16.08.2016;'12 - 13;29,09;29,12;-0,03;21981;22096;115;780;1258;478
5485;16.08.2016;'13 - 14;28,93;30,36;-1,43;21926;21745;-181;810;1592;782
5486;16.08.2016;'14 - 15;28,94;28,99;-0,05;20671;20887;216;929;1936;1007
5487;16.08.2016;'15 - 16;29,29;28,2;1,09;18214;18585;371;1184;2224;1040
5488;16.08.2016;'16 - 17;30,58;29,17;1,41;14688;15332;644;1503;2593;1090
5489;16.08.2016;'17 - 18;33,12;32,3;0,82;10205;11174;969;1910;2860;950
5490;16.08.2016;'18 - 19;34,33;34,19;0,14;5426;6021;595;2336;2884;548
5491;16.08.2016;'19 - 20;35,79;35,63;0,16;1756;1885;129;2731;3073;342
5492;16.08.2016;'20 - 21;34,81;36,32;-1,51;185;204;19;3245;3778;533
5493;16.08.2016;'21 - 22;34,36;35,54;-1,18;1;0;-1;3934;4942;1008
5494;16.08.2016;'22 - 23;31,25;31;0,25;0;0;0;4417;5369;952
5495;16.08.2016;'23 - 24;27,74;25,46;2,28;0;0;0;4523;5108;585
5496;17.08.2016;'00 - 01;25,03;22,84;2,19;0;0;0;4090;4260;170
5497;17.08.2016;'01 - 02;24,01;22,11;1,9;0;0;0;3737;3659;-78
5498;17.08.2016;'02 - 03;23,51;19,76;3,75;0;0;0;3467;3250;-217
5499;17.08.2016;'03 - 04;21,9;17,5;4,4;0;0;0;3124;2870;-254
5500;17.08.2016;'04 - 05;22,56;19,25;3,31;0;0;0;2818;2528;-290
5501;17.08.2016;'05 - 06;25,05;22,32;2,73;6;2;-4;2612;2424;-188
5502;17.08.2016;'06 - 07;29,74;24,57;5,17;453;398;-55;2409;2348;-61
5503;17.08.2016;'07 - 08;34,75;31,49;3,26;3120;2869;-251;2088;1946;-142
5504;17.08.2016;'08 - 09;36,1;34,44;1,66;7916;7368;-548;1336;1246;-90
5505;17.08.2016;'09 - 10;33;33,17;-0,17;13477;12728;-749;960;652;-308
5506;17.08.2016;'10 - 11;28,54;30,77;-2,23;18222;17798;-424;980;547;-433
5507;17.08.2016;'11 - 12;28,03;30,01;-1,98;21390;21366;-24;1035;558;-477
5508;17.08.2016;'12 - 13;27,79;26,86;0,93;22856;22908;52;1058;673;-385
5509;17.08.2016;'13 - 14;27,72;26,1;1,62;22852;23282;430;1074;759;-315
5510;17.08.2016;'14 - 15;27,05;25,14;1,91;21668;22286;618;1061;797;-264
5511;17.08.2016;'15 - 16;28,41;25,92;2,49;19206;20371;1165;1149;887;-262
5512;17.08.2016;'16 - 17;30,47;26,58;3,89;15695;16899;1204;1415;985;-430
5513;17.08.2016;'17 - 18;35,08;33,97;1,11;11040;11782;742;1712;1240;-472
5514;17.08.2016;'18 - 19;35,67;35,9;-0,23;5825;6210;385;2058;1483;-575
5515;17.08.2016;'19 - 20;37,07;36,95;0,12;1805;1870;65;2422;1568;-854
5516;17.08.2016;'20 - 21;36,45;35,64;0,81;179;196;17;2785;2021;-764
5517;17.08.2016;'21 - 22;35,48;34,8;0,68;1;0;-1;3298;2981;-317
5518;17.08.2016;'22 - 23;32,42;32,02;0,4;0;0;0;3796;3543;-253
5519;17.08.2016;'23 - 24;28,82;26,68;2,14;0;0;0;3784;3687;-97
5520;18.08.2016;'00 - 01;25,16;24,75;0,41;0;0;0;3499;3396;-103
5521;18.08.2016;'01 - 02;24,12;27,21;-3,09;0;0;0;3367;3150;-217
5522;18.08.2016;'02 - 03;23,34;25,03;-1,69;0;0;0;3259;2936;-323
5523;18.08.2016;'03 - 04;21,83;24,51;-2,68;0;0;0;3142;2806;-336
5524;18.08.2016;'04 - 05;22,49;21,69;0,8;0;0;0;3002;2784;-218
5525;18.08.2016;'05 - 06;25,05;24,68;0,37;5;1;-4;2786;2660;-126
5526;18.08.2016;'06 - 07;30,26;33,19;-2,93;395;344;-51;2539;2456;-83
5527;18.08.2016;'07 - 08;33,79;35,14;-1,35;2801;2764;-37;2167;2263;96
5528;18.08.2016;'08 - 09;35,67;36,01;-0,34;7327;7266;-61;1475;1848;373
5529;18.08.2016;'09 - 10;35,33;34,54;0,79;12492;12484;-8;1005;1307;302
5530;18.08.2016;'10 - 11;33,38;29,21;4,17;16695;16799;104;881;1251;370
5531;18.08.2016;'11 - 12;30,84;27,91;2,93;19499;19812;313;873;1346;473
5532;18.08.2016;'12 - 13;29,15;28,28;0,87;20891;20615;-276;955;1274;319
5533;18.08.2016;'13 - 14;29,44;28,94;0,5;20730;19976;-754;1077;1292;215
5534;18.08.2016;'14 - 15;29,08;30,23;-1,15;19264;18540;-724;1218;1422;204
5535;18.08.2016;'15 - 16;29,51;30,81;-1,3;16753;16072;-681;1354;1522;168
5536;18.08.2016;'16 - 17;32,78;34,66;-1,88;13337;12708;-629;1469;1616;147
5537;18.08.2016;'17 - 18;35,01;36,83;-1,82;9081;8466;-615;1544;1856;312
5538;18.08.2016;'18 - 19;36,05;38,11;-2,06;4697;4341;-356;1584;2087;503
5539;18.08.2016;'19 - 20;37,34;38,3;-0,96;1439;1364;-75;1635;2172;537
5540;18.08.2016;'20 - 21;36,85;37,49;-0,64;132;127;-5;1713;2415;702
5541;18.08.2016;'21 - 22;36,01;37,12;-1,11;0;0;0;1895;2607;712
5542;18.08.2016;'22 - 23;32,74;33,85;-1,11;0;0;0;2031;2596;565
5543;18.08.2016;'23 - 24;28,92;29,56;-0,64;0;0;0;1942;2242;300
5544;19.08.2016;'00 - 01;27,71;27,55;0,16;0;0;0;1782;1686;-96
5545;19.08.2016;'01 - 02;26,62;27,17;-0,55;0;0;0;1552;1367;-185
5546;19.08.2016;'02 - 03;25;27,31;-2,31;0;0;0;1367;1238;-129
5547;19.08.2016;'03 - 04;23,91;26,78;-2,87;0;0;0;1225;1000;-225
5548;19.08.2016;'04 - 05;24,96;26,54;-1,58;0;0;0;1119;840;-279
5549;19.08.2016;'05 - 06;26,08;27,39;-1,31;5;0;-5;1045;738;-307
5550;19.08.2016;'06 - 07;32,25;31,84;0,41;358;300;-58;1003;740;-263
5551;19.08.2016;'07 - 08;36,25;38,3;-2,05;2733;2529;-204;964;744;-220
5552;19.08.2016;'08 - 09;37,27;39,07;-1,8;7055;6668;-387;719;578;-141
5553;19.08.2016;'09 - 10;36,45;38,4;-1,95;12062;11864;-198;589;308;-281
5554;19.08.2016;'10 - 11;34,48;37,46;-2,98;16543;16476;-67;559;332;-227
5555;19.08.2016;'11 - 12;31,56;35,56;-4;19895;19706;-189;605;381;-224
5556;19.08.2016;'12 - 13;26,95;31,72;-4,77;21833;21198;-635;640;439;-201
5557;19.08.2016;'13 - 14;26,01;31,01;-5;22048;21240;-808;724;484;-240
5558;19.08.2016;'14 - 15;25,78;30,97;-5,19;20748;20253;-495;767;623;-144
5559;19.08.2016;'15 - 16;27,48;32,78;-5,3;17962;17812;-150;892;944;52
5560;19.08.2016;'16 - 17;31,76;34,37;-2,61;14005;13639;-366;1110;1242;132
5561;19.08.2016;'17 - 18;34,09;35,98;-1,89;9274;8832;-442;1370;1401;31
5562;19.08.2016;'18 - 19;36,09;36,74;-0,65;4600;4425;-175;1807;1587;-220
5563;19.08.2016;'19 - 20;36,46;36,57;-0,11;1324;1256;-68;2361;1960;-401
5564;19.08.2016;'20 - 21;34,99;35,85;-0,86;104;76;-28;3753;2777;-976
5565;19.08.2016;'21 - 22;34,32;37,17;-2,85;0;0;0;5583;4427;-1156
5566;19.08.2016;'22 - 23;32,22;33,47;-1,25;0;0;0;7430;6035;-1395
5567;19.08.2016;'23 - 24;28,87;28,43;0,44;0;0;0;8564;6848;-1716
5568;20.08.2016;'00 - 01;26,54;24,72;1,82;0;0;0;7482;7314;-168
5569;20.08.2016;'01 - 02;25,04;21,73;3,31;0;0;0;7425;7586;161
5570;20.08.2016;'02 - 03;23,31;18,72;4,59;0;0;0;7042;7660;618
5571;20.08.2016;'03 - 04;22,81;17,44;5,37;0;0;0;6548;7249;701
5572;20.08.2016;'04 - 05;22,32;18,58;3,74;0;0;0;6281;6470;189
5573;20.08.2016;'05 - 06;22,02;19,55;2,47;2;0;-2;6042;6004;-38
5574;20.08.2016;'06 - 07;22,44;19,34;3,1;264;194;-70;5761;5682;-79
5575;20.08.2016;'07 - 08;23,08;20,16;2,92;2100;1779;-321;5586;6036;450
5576;20.08.2016;'08 - 09;26,94;23,91;3,03;5373;4888;-485;5340;5388;48
5577;20.08.2016;'09 - 10;29,03;25,94;3,09;9266;9174;-92;5001;4740;-261
5578;20.08.2016;'10 - 11;25,79;26,52;-0,73;12804;12895;91;5035;5279;244
5579;20.08.2016;'11 - 12;24,22;25,59;-1,37;15530;15746;216;5338;5924;586
5580;20.08.2016;'12 - 13;23,12;22,7;0,42;17009;16389;-620;5921;6389;468
5581;20.08.2016;'13 - 14;22,09;20,38;1,71;16338;14460;-1878;6516;6480;-36
5582;20.08.2016;'14 - 15;21,71;20,88;0,83;14398;11331;-3067;6773;6374;-399
5583;20.08.2016;'15 - 16;22;22,77;-0,77;11905;8472;-3433;6586;6013;-573
5584;20.08.2016;'16 - 17;20,95;22,15;-1,2;9002;6656;-2346;6261;5892;-369
5585;20.08.2016;'17 - 18;22,73;24,65;-1,92;5909;4696;-1213;5848;5988;140
5586;20.08.2016;'18 - 19;26,99;29,05;-2,06;3098;2554;-544;5379;5468;89
5587;20.08.2016;'19 - 20;29,34;28,91;0,43;995;861;-134;4993;4907;-86
5588;20.08.2016;'20 - 21;30;27,89;2,11;75;90;15;5026;4194;-832
5589;20.08.2016;'21 - 22;30,38;28,27;2,11;0;0;0;5476;5583;107
5590;20.08.2016;'22 - 23;29,11;26,84;2,27;0;0;0;6201;6150;-51
5591;20.08.2016;'23 - 24;25,03;23,31;1,72;0;0;0;6943;7269;326
5592;21.08.2016;'00 - 01;18,51;20;-1,49;0;0;0;7966;7882;-84
5593;21.08.2016;'01 - 02;15,01;11,32;3,69;0;0;0;8344;8586;242
5594;21.08.2016;'02 - 03;12,13;7,59;4,54;0;0;0;8554;9684;1130
5595;21.08.2016;'03 - 04;9,72;6,78;2,94;0;0;0;8820;10203;1383
5596;21.08.2016;'04 - 05;9,83;6,73;3,1;0;0;0;9185;9877;692
5597;21.08.2016;'05 - 06;9,74;6,9;2,84;3;0;-3;9414;10269;855
5598;21.08.2016;'06 - 07;9,62;6,35;3,27;266;202;-64;9501;10610;1109
5599;21.08.2016;'07 - 08;9,13;6,86;2,27;2022;1829;-193;9314;10297;983
5600;21.08.2016;'08 - 09;11,34;8,4;2,94;5441;5110;-331;8998;9735;737
5601;21.08.2016;'09 - 10;11,55;10,16;1,39;9404;8984;-420;9039;10195;1156
5602;21.08.2016;'10 - 11;11,59;10,52;1,07;12921;11284;-1637;9611;11052;1441
5603;21.08.2016;'11 - 12;11,6;14,95;-3,35;15417;13147;-2270;9972;11710;1738
5604;21.08.2016;'12 - 13;11,45;15,48;-4,03;16664;14838;-1826;10240;12574;2334
5605;21.08.2016;'13 - 14;9,09;13,32;-4,23;16524;15407;-1117;10462;13281;2819
5606;21.08.2016;'14 - 15;7,19;10,08;-2,89;15459;14787;-672;10425;13970;3545
5607;21.08.2016;'15 - 16;7,88;6,06;1,82;13666;13844;178;10281;13731;3450
5608;21.08.2016;'16 - 17;8,94;4,18;4,76;11088;11735;647;9750;12754;3004
5609;21.08.2016;'17 - 18;10,86;8,99;1,87;7648;8454;806;8974;11801;2827
5610;21.08.2016;'18 - 19;22,04;18,62;3,42;4044;4867;823;7966;10116;2150
5611;21.08.2016;'19 - 20;28,13;23,89;4,24;1213;1407;194;6914;7712;798
5612;21.08.2016;'20 - 21;30,74;28,88;1,86;75;92;17;6395;6715;320
5613;21.08.2016;'21 - 22;31,9;32,8;-0,9;0;0;0;6528;7308;780
5614;21.08.2016;'22 - 23;30,59;32,06;-1,47;0;0;0;6940;7794;854
5615;21.08.2016;'23 - 24;23,54;26,78;-3,24;0;0;0;7350;8178;828
5616;22.08.2016;'00 - 01;20,68;24,99;-4,31;0;0;0;8720;8534;-186
5617;22.08.2016;'01 - 02;19,04;22,66;-3,62;0;0;0;8745;8659;-86
5618;22.08.2016;'02 - 03;18,78;20,91;-2,13;0;0;0;8726;8603;-123
5619;22.08.2016;'03 - 04;17,5;13,35;4,15;0;0;0;8619;8350;-269
5620;22.08.2016;'04 - 05;18,07;13,68;4,39;0;0;0;8399;8004;-395
5621;22.08.2016;'05 - 06;20,81;17,56;3,25;3;0;-3;7935;7459;-476
5622;22.08.2016;'06 - 07;26,82;24,59;2,23;270;215;-55;7336;6740;-596
5623;22.08.2016;'07 - 08;31,42;32,52;-1,1;2301;1982;-319;6693;6264;-429
5624;22.08.2016;'08 - 09;34,41;35,37;-0,96;5912;5190;-722;6185;5866;-319
5625;22.08.2016;'09 - 10;35;36,8;-1,8;9925;9039;-886;6179;6165;-14
5626;22.08.2016;'10 - 11;31,66;34,45;-2,79;13008;12261;-747;6593;6720;127
5627;22.08.2016;'11 - 12;29,06;32,5;-3,44;14700;14319;-381;7181;7564;383
5628;22.08.2016;'12 - 13;27,25;32,58;-5,33;15353;15548;195;7738;8032;294
5629;22.08.2016;'13 - 14;27,19;31,21;-4,02;14988;15442;454;8297;8404;107
5630;22.08.2016;'14 - 15;27,3;29,18;-1,88;13752;14642;890;8459;8266;-193
5631;22.08.2016;'15 - 16;27,81;30,15;-2,34;11871;13019;1148;8162;7896;-266
5632;22.08.2016;'16 - 17;28,49;30,3;-1,81;9551;10590;1039;7653;7984;331
5633;22.08.2016;'17 - 18;32,9;33,35;-0,45;6596;7569;973;7023;8264;1241
5634;22.08.2016;'18 - 19;36,59;34,94;1,65;3417;4034;617;6330;7992;1662
5635;22.08.2016;'19 - 20;37,71;36,87;0,84;957;1220;263;5615;7554;1939
5636;22.08.2016;'20 - 21;37,64;36,31;1,33;52;75;23;5104;7314;2210
5637;22.08.2016;'21 - 22;35,02;34,49;0,53;0;0;0;4945;7459;2514
5638;22.08.2016;'22 - 23;30,99;31,34;-0,35;0;0;0;4935;7534;2599
5639;22.08.2016;'23 - 24;27,92;28,41;-0,49;0;0;0;4882;7465;2583
5640;23.08.2016;'00 - 01;23,68;23,39;0,29;0;0;0;7050;6936;-114
5641;23.08.2016;'01 - 02;22,35;22,08;0,27;0;0;0;6836;6459;-377
5642;23.08.2016;'02 - 03;21,62;22,77;-1,15;0;0;0;6453;5806;-647
5643;23.08.2016;'03 - 04;20,29;23,75;-3,46;0;0;0;5797;5023;-774
5644;23.08.2016;'04 - 05;22,01;24,11;-2,1;0;0;0;5221;4460;-761
5645;23.08.2016;'05 - 06;23,52;28,35;-4,83;2;0;-2;4706;4126;-580
5646;23.08.2016;'06 - 07;30,56;35,83;-5,27;215;202;-13;4208;3877;-331
5647;23.08.2016;'07 - 08;35,24;38,58;-3,34;2032;2209;177;3706;3618;-88
5648;23.08.2016;'08 - 09;37,31;35,92;1,39;6068;6789;721;3002;2622;-380
5649;23.08.2016;'09 - 10;37,95;33,2;4,75;11256;12293;1037;2531;1837;-694
5650;23.08.2016;'10 - 11;34,94;31,95;2,99;15716;16860;1144;2419;1712;-707
5651;23.08.2016;'11 - 12;32,36;30,64;1,72;18869;20106;1237;2387;1709;-678
5652;23.08.2016;'12 - 13;28,78;29,12;-0,34;20637;21643;1006;2304;1632;-672
5653;23.08.2016;'13 - 14;28,07;28,39;-0,32;20946;21802;856;2184;1505;-679
5654;23.08.2016;'14 - 15;27,95;28,35;-0,4;19942;20579;637;1961;1372;-589
5655;23.08.2016;'15 - 16;30,2;30,2;0;17627;18364;737;1582;1223;-359
5656;23.08.2016;'16 - 17;34,63;35,51;-0,88;14290;14692;402;1228;1034;-194
5657;23.08.2016;'17 - 18;37,96;37,59;0,37;9813;10184;371;953;758;-195
5658;23.08.2016;'18 - 19;40,2;37,96;2,24;4925;5189;264;834;542;-292
5659;23.08.2016;'19 - 20;41,6;42,58;-0,98;1301;1391;90;799;504;-295
5660;23.08.2016;'20 - 21;42;43,13;-1,13;75;81;6;1097;953;-144
5661;23.08.2016;'21 - 22;38,92;41,65;-2,73;0;0;0;1638;1914;276
5662;23.08.2016;'22 - 23;33,38;36,04;-2,66;0;0;0;2185;2704;519
5663;23.08.2016;'23 - 24;27,57;30,4;-2,83;0;0;0;2616;3162;546
5664;24.08.2016;'00 - 01;26,19;29,17;-2,98;0;0;0;3040;3585;545
5665;24.08.2016;'01 - 02;23,9;25,79;-1,89;0;0;0;3443;3853;410
5666;24.08.2016;'02 - 03;22,82;24,38;-1,56;0;0;0;3782;4022;240
5667;24.08.2016;'03 - 04;22,24;23,6;-1,36;0;0;0;3954;4010;56
5668;24.08.2016;'04 - 05;22,25;23,63;-1,38;0;0;0;4151;4060;-91
5669;24.08.2016;'05 - 06;24,23;26,16;-1,93;2;0;-2;4293;4163;-130
5670;24.08.2016;'06 - 07;30,85;31,07;-0,22;252;224;-28;4385;4408;23
5671;24.08.2016;'07 - 08;34,9;33,91;0,99;2470;2613;143;4303;4541;238
5672;24.08.2016;'08 - 09;36,02;37,71;-1,69;7620;7981;361;3870;3684;-186
5673;24.08.2016;'09 - 10;34,93;34,78;0,15;13736;14112;376;3178;2667;-511
5674;24.08.2016;'10 - 11;29,96;34,06;-4,1;18854;19264;410;3140;2667;-473
5675;24.08.2016;'11 - 12;27,56;31,22;-3,66;22424;22677;253;3246;2999;-247
5676;24.08.2016;'12 - 13;26,83;30,48;-3,65;24348;24582;234;3212;2990;-222
5677;24.08.2016;'13 - 14;26,24;30,03;-3,79;24779;25076;297;3115;2980;-135
5678;24.08.2016;'14 - 15;26;30,34;-4,34;23742;23985;243;3016;2893;-123
5679;24.08.2016;'15 - 16;30,48;31,74;-1,26;21065;21350;285;2812;2741;-71
5680;24.08.2016;'16 - 17;32,97;33,35;-0,38;16934;17273;339;2633;2754;121
5681;24.08.2016;'17 - 18;34,95;36,25;-1,3;11303;11652;349;2710;2922;212
5682;24.08.2016;'18 - 19;37,69;39,36;-1,67;5349;5612;263;2997;3135;138
5683;24.08.2016;'19 - 20;38,44;40,37;-1,93;1325;1369;44;3585;3542;-43
5684;24.08.2016;'20 - 21;37,99;38,95;-0,96;70;70;0;5163;5553;390
5685;24.08.2016;'21 - 22;34,01;35,88;-1,87;0;0;0;6850;8476;1626
5686;24.08.2016;'22 - 23;28,61;27,84;0,77;0;0;0;8232;10402;2170
5687;24.08.2016;'23 - 24;24,49;22,49;2;0;0;0;9025;11250;2225
5688;25.08.2016;'00 - 01;21,96;21,87;0,09;0;0;0;11210;11685;475
5689;25.08.2016;'01 - 02;21,86;20,32;1,54;0;0;0;10887;11758;871
5690;25.08.2016;'02 - 03;20,97;19,4;1,57;0;0;0;10347;11214;867
5691;25.08.2016;'03 - 04;21,16;18,1;3,06;0;0;0;9731;10459;728
5692;25.08.2016;'04 - 05;21,45;19,91;1,54;0;0;0;9260;10137;877
5693;25.08.2016;'05 - 06;23,3;20,62;2,68;2;0;-2;8781;10030;1249
5694;25.08.2016;'06 - 07;30,33;28,54;1,79;282;227;-55;8392;9710;1318
5695;25.08.2016;'07 - 08;34,2;32,85;1,35;2870;2716;-154;7854;8494;640
5696;25.08.2016;'08 - 09;35,7;33,04;2,66;8219;8109;-110;6456;5639;-817
5697;25.08.2016;'09 - 10;34,91;33,29;1,62;14427;14382;-45;4860;3826;-1034
5698;25.08.2016;'10 - 11;29,26;30,88;-1,62;19697;19469;-228;4291;3822;-469
5699;25.08.2016;'11 - 12;27,78;26,22;1,56;23335;23114;-221;3797;3958;161
5700;25.08.2016;'12 - 13;26,81;24,49;2,32;25262;24960;-302;3522;3966;444
5701;25.08.2016;'13 - 14;25,42;24,09;1,33;25635;25225;-410;3433;4222;789
5702;25.08.2016;'14 - 15;24,98;23,11;1,87;24483;24024;-459;3399;4522;1123
5703;25.08.2016;'15 - 16;27,26;24,09;3,17;21687;21389;-298;3409;5026;1617
5704;25.08.2016;'16 - 17;30,17;26,38;3,79;17365;17277;-88;3427;5469;2042
5705;25.08.2016;'17 - 18;34;29,2;4,8;11519;11606;87;3592;5565;1973
5706;25.08.2016;'18 - 19;36,65;32,97;3,68;5422;5546;124;3998;5344;1346
5707;25.08.2016;'19 - 20;38,78;37,69;1,09;1284;1298;14;4648;5415;767
5708;25.08.2016;'20 - 21;37,96;37,17;0,79;62;62;0;5960;7360;1400
5709;25.08.2016;'21 - 22;34,16;31,82;2,34;0;0;0;7406;10014;2608
5710;25.08.2016;'22 - 23;27,98;26,38;1,6;0;0;0;8515;11627;3112
5711;25.08.2016;'23 - 24;24,26;23,46;0,8;0;0;0;9150;12046;2896
5712;26.08.2016;'00 - 01;22,1;25,13;-3,03;0;0;0;11180;11702;522
5713;26.08.2016;'01 - 02;20,34;24,66;-4,32;0;0;0;10980;11394;414
5714;26.08.2016;'02 - 03;20,31;24,38;-4,07;0;0;0;10707;10926;219
5715;26.08.2016;'03 - 04;20,23;22,96;-2,73;0;0;0;10417;10600;183
5716;26.08.2016;'04 - 05;21,25;22,5;-1,25;0;0;0;10199;10462;263
5717;26.08.2016;'05 - 06;23,1;24,94;-1,84;2;0;-2;9970;10534;564
5718;26.08.2016;'06 - 07;29;29,67;-0,67;258;208;-50;9699;10544;845
5719;26.08.2016;'07 - 08;34,47;30,63;3,84;2756;2600;-156;9077;9225;148
5720;26.08.2016;'08 - 09;35,9;34,82;1,08;8070;7986;-84;7640;6626;-1014
5721;26.08.2016;'09 - 10;34,92;35,9;-0,98;14253;13976;-277;5694;4257;-1437
5722;26.08.2016;'10 - 11;32,55;34,63;-2,08;19534;18944;-590;4224;3529;-695
5723;26.08.2016;'11 - 12;28,87;31,76;-2,89;23173;22356;-817;3594;3420;-174
5724;26.08.2016;'12 - 13;26,67;29,79;-3,12;25096;24150;-946;3422;3222;-200
5725;26.08.2016;'13 - 14;25,13;28,73;-3,6;25400;24340;-1060;3404;2989;-415
5726;26.08.2016;'14 - 15;24,49;27,81;-3,32;24159;23017;-1142;3478;3304;-174
5727;26.08.2016;'15 - 16;26,68;27,9;-1,22;21253;20333;-920;3601;3278;-323
5728;26.08.2016;'16 - 17;29,73;30,2;-0,47;16855;16248;-607;3636;3067;-569
5729;26.08.2016;'17 - 18;34,92;35,89;-0,97;11063;10846;-217;3628;2819;-809
5730;26.08.2016;'18 - 19;38,45;38,37;0,08;5181;5096;-85;3725;2608;-1117
5731;26.08.2016;'19 - 20;41,99;39,14;2,85;1196;1161;-35;4161;2542;-1619
5732;26.08.2016;'20 - 21;39,01;37,95;1,06;48;51;3;4998;3192;-1806
5733;26.08.2016;'21 - 22;37,06;36,35;0,71;0;0;0;5503;3958;-1545
5734;26.08.2016;'22 - 23;32,09;31,71;0,38;0;0;0;5609;4161;-1448
5735;26.08.2016;'23 - 24;27,22;28,4;-1,18;0;0;0;5303;4170;-1133
5736;27.08.2016;'00 - 01;25,93;26,37;-0,44;0;0;0;4522;3746;-776
5737;27.08.2016;'01 - 02;24,05;25,14;-1,09;0;0;0;4092;3394;-698
5738;27.08.2016;'02 - 03;23;23,25;-0,25;0;0;0;3715;3102;-613
5739;27.08.2016;'03 - 04;23,07;25,27;-2,2;0;0;0;3354;2950;-404
5740;27.08.2016;'04 - 05;23,28;23,97;-0,69;0;0;0;3056;2707;-349
5741;27.08.2016;'05 - 06;23,18;21,97;1,21;2;0;-2;2782;2584;-198
5742;27.08.2016;'06 - 07;25,28;22,84;2,44;224;181;-43;2488;2581;93
5743;27.08.2016;'07 - 08;26,84;25,91;0,93;2460;2430;-30;2092;2252;160
5744;27.08.2016;'08 - 09;29,5;29,26;0,24;7427;7388;-39;1653;1377;-276
5745;27.08.2016;'09 - 10;29,56;28,82;0,74;13282;13284;2;1197;839;-358
5746;27.08.2016;'10 - 11;25,14;25,4;-0,26;18445;18226;-219;854;636;-218
5747;27.08.2016;'11 - 12;23,02;23,2;-0,18;22149;21718;-431;720;635;-85
5748;27.08.2016;'12 - 13;21,93;21,11;0,82;24217;23641;-576;743;739;-4
5749;27.08.2016;'13 - 14;20,03;20,06;-0,03;24619;23914;-705;837;864;27
5750;27.08.2016;'14 - 15;19,96;19,65;0,31;23474;22769;-705;993;1038;45
5751;27.08.2016;'15 - 16;20,76;20,32;0,44;20648;20001;-647;1248;1374;126
5752;27.08.2016;'16 - 17;23,03;21,06;1,97;16272;15882;-390;1556;1936;380
5753;27.08.2016;'17 - 18;28,41;24,47;3,94;10552;10353;-199;1976;2776;800
5754;27.08.2016;'18 - 19;34,94;32,28;2,66;4805;4715;-90;2585;3199;614
5755;27.08.2016;'19 - 20;35,36;32,63;2,73;1068;1056;-12;3375;4030;655
5756;27.08.2016;'20 - 21;34,95;32,27;2,68;43;37;-6;4352;5870;1518
5757;27.08.2016;'21 - 22;33,61;29,72;3,89;0;0;0;5378;7933;2555
5758;27.08.2016;'22 - 23;29,92;25,93;3,99;0;0;0;6259;9571;3312
5759;27.08.2016;'23 - 24;24,73;23,15;1,58;0;0;0;6891;11003;4112
5760;28.08.2016;'00 - 01;23,14;23,71;-0,57;0;0;0;9540;11104;1564
5761;28.08.2016;'01 - 02;20,98;20,12;0,86;0;0;0;9642;10186;544
5762;28.08.2016;'02 - 03;21,01;22,3;-1,29;0;0;0;9747;8349;-1398
5763;28.08.2016;'03 - 04;21,29;20,93;0,36;0;0;0;9421;7564;-1857
5764;28.08.2016;'04 - 05;19,85;23,59;-3,74;0;0;0;8933;8143;-790
5765;28.08.2016;'05 - 06;19,83;22,51;-2,68;1;0;-1;8646;8310;-336
5766;28.08.2016;'06 - 07;20,48;22,01;-1,53;216;170;-46;8443;8657;214
5767;28.08.2016;'07 - 08;20,18;20,55;-0,37;2542;2345;-197;8116;7682;-434
5768;28.08.2016;'08 - 09;22,07;24,43;-2,36;7458;6610;-848;7294;7252;-42
5769;28.08.2016;'09 - 10;23,19;25,4;-2,21;13229;11715;-1514;6131;6157;26
5770;28.08.2016;'10 - 11;20,07;24,04;-3,97;18225;16547;-1678;5140;4952;-188
5771;28.08.2016;'11 - 12;20,09;21,83;-1,74;21588;19971;-1617;4500;4338;-162
5772;28.08.2016;'12 - 13;13,38;13,05;0,33;23148;21820;-1328;4429;5151;722
5773;28.08.2016;'13 - 14;10,05;9,33;0,72;22847;21762;-1085;4701;6127;1426
5774;28.08.2016;'14 - 15;8,99;9,05;-0,06;20956;20170;-786;5377;7810;2433
5775;28.08.2016;'15 - 16;13,51;12,99;0,52;17713;16559;-1154;6381;9312;2931
5776;28.08.2016;'16 - 17;18,15;17,4;0,75;13365;12594;-771;7442;10568;3126
5777;28.08.2016;'17 - 18;22,26;20,97;1,29;8410;7980;-430;8511;11495;2984
5778;28.08.2016;'18 - 19;29,01;29;0,01;3887;3488;-399;9311;12166;2855
5779;28.08.2016;'19 - 20;32,95;31,91;1,04;877;745;-132;10044;12640;2596
5780;28.08.2016;'20 - 21;33,92;31,89;2,03;27;32;5;10730;13685;2955
5781;28.08.2016;'21 - 22;33,25;28,11;5,14;0;0;0;11135;13678;2543
5782;28.08.2016;'22 - 23;29,97;27,14;2,83;0;0;0;11566;11486;-80
5783;28.08.2016;'23 - 24;23,3;24,55;-1,25;0;0;0;11839;10658;-1181
5784;29.08.2016;'00 - 01;22,16;28,65;-6,49;0;0;0;12045;9752;-2293
5785;29.08.2016;'01 - 02;23,02;29,63;-6,61;0;0;0;11349;9544;-1805
5786;29.08.2016;'02 - 03;22,09;26,49;-4,4;0;0;0;10766;9791;-975
5787;29.08.2016;'03 - 04;22,09;24,84;-2,75;0;0;0;10320;9591;-729
5788;29.08.2016;'04 - 05;22,61;24,46;-1,85;0;0;0;10095;9589;-506
5789;29.08.2016;'05 - 06;24,52;27;-2,48;1;0;-1;10135;9744;-391
5790;29.08.2016;'06 - 07;34,95;35,84;-0,89;145;94;-51;10302;9578;-724
5791;29.08.2016;'07 - 08;40,26;41,35;-1,09;1642;1347;-295;10499;9656;-843
5792;29.08.2016;'08 - 09;41,69;42,25;-0,56;4629;4104;-525;10869;9512;-1357
5793;29.08.2016;'09 - 10;35,32;42,21;-6,89;8131;7630;-501;11621;10394;-1227
5794;29.08.2016;'10 - 11;30,98;41,61;-10,63;11456;10482;-974;12407;11282;-1125
5795;29.08.2016;'11 - 12;28,96;41,26;-12,3;13951;11806;-2145;12957;12163;-794
5796;29.08.2016;'12 - 13;26,33;41,9;-15,57;15333;12565;-2768;13321;12078;-1243
5797;29.08.2016;'13 - 14;24,95;42,14;-17,19;15680;13067;-2613;13606;12165;-1441
5798;29.08.2016;'14 - 15;22,98;39,58;-16,6;15240;13406;-1834;13724;12099;-1625
5799;29.08.2016;'15 - 16;23,02;35,19;-12,17;13667;12780;-887;13689;11933;-1756
5800;29.08.2016;'16 - 17;22,99;35,1;-12,11;11013;10793;-220;13471;11820;-1651
5801;29.08.2016;'17 - 18;30;37,46;-7,46;7456;7327;-129;12803;11247;-1556
5802;29.08.2016;'18 - 19;34,01;39,08;-5,07;3648;3577;-71;11554;10022;-1532
5803;29.08.2016;'19 - 20;36,64;41,74;-5,1;818;807;-11;10139;7995;-2144
5804;29.08.2016;'20 - 21;37,55;40,73;-3,18;22;24;2;9267;6879;-2388
5805;29.08.2016;'21 - 22;34,09;37,27;-3,18;0;0;0;8494;6580;-1914
5806;29.08.2016;'22 - 23;29,29;32,15;-2,86;0;0;0;7673;6284;-1389
5807;29.08.2016;'23 - 24;24,19;25,54;-1,35;0;0;0;7052;6269;-783
5808;30.08.2016;'00 - 01;24,85;23,51;1,34;0;0;0;6045;6167;122
5809;30.08.2016;'01 - 02;24,15;23,72;0,43;0;0;0;5830;5925;95
5810;30.08.2016;'02 - 03;23,74;22,5;1,24;0;0;0;5693;5636;-57
5811;30.08.2016;'03 - 04;23,35;22,3;1,05;0;0;0;5537;5760;223
5812;30.08.2016;'04 - 05;22,74;22,99;-0,25;0;0;0;5405;5984;579
5813;30.08.2016;'05 - 06;24,14;24,45;-0,31;0;0;0;5127;6170;1043
5814;30.08.2016;'06 - 07;32,65;34,16;-1,51;178;128;-50;4764;6061;1297
5815;30.08.2016;'07 - 08;40,59;39,71;0,88;2260;2172;-88;4270;5537;1267
5816;30.08.2016;'08 - 09;43,82;41,53;2,29;7139;6954;-185;3448;4004;556
5817;30.08.2016;'09 - 10;38,03;36,88;1,15;12901;12668;-233;3059;3233;174
5818;30.08.2016;'10 - 11;32;32,34;-0,34;17711;17621;-90;3505;3376;-129
5819;30.08.2016;'11 - 12;30,06;30,36;-0,3;20897;20876;-21;3568;3250;-318
5820;30.08.2016;'12 - 13;27,07;26,28;0,79;22423;22582;159;3461;3212;-249
5821;30.08.2016;'13 - 14;26,97;26,87;0,1;22490;22550;60;3341;3295;-46
5822;30.08.2016;'14 - 15;26,86;26,31;0,55;21339;21720;381;3213;3372;159
5823;30.08.2016;'15 - 16;28,96;27,35;1,61;18756;19342;586;3064;3012;-52
5824;30.08.2016;'16 - 17;33,33;30,69;2,64;15070;15713;643;2803;2538;-265
5825;30.08.2016;'17 - 18;37,77;34,32;3,45;9828;10495;667;2466;2228;-238
5826;30.08.2016;'18 - 19;40,6;38,48;2,12;4403;4822;419;2116;1771;-345
5827;30.08.2016;'19 - 20;43,71;39,92;3,79;873;947;74;1865;1464;-401
5828;30.08.2016;'20 - 21;44,83;38,98;5,85;22;27;5;1971;1922;-49
5829;30.08.2016;'21 - 22;40,83;37,96;2,87;0;0;0;2231;2519;288
5830;30.08.2016;'22 - 23;32,96;29,87;3,09;0;0;0;2484;2888;404
5831;30.08.2016;'23 - 24;26,64;25,83;0,81;0;0;0;2659;3039;380
5832;31.08.2016;'00 - 01;25,6;22,85;2,75;0;0;0;3138;3156;18
5833;31.08.2016;'01 - 02;24,02;23,18;0,84;0;0;0;3371;3222;-149
5834;31.08.2016;'02 - 03;23,48;22,76;0,72;0;0;0;3562;3250;-312
5835;31.08.2016;'03 - 04;22,77;22,85;-0,08;0;0;0;3677;3395;-282
5836;31.08.2016;'04 - 05;22,79;23,5;-0,71;0;0;0;3787;3394;-393
5837;31.08.2016;'05 - 06;25,34;25,09;0,25;0;0;0;3891;3383;-508
5838;31.08.2016;'06 - 07;32,98;33,48;-0,5;173;126;-47;3999;3528;-471
5839;31.08.2016;'07 - 08;40,46;40,11;0,35;2326;2300;-26;4056;3668;-388
5840;31.08.2016;'08 - 09;42,04;42,34;-0,3;7523;7483;-40;3675;2968;-707
5841;31.08.2016;'09 - 10;36,13;33,17;2,96;13768;13598;-170;2818;1649;-1169
5842;31.08.2016;'10 - 11;29,59;28,66;0,93;19105;18670;-435;2229;1387;-842
5843;31.08.2016;'11 - 12;28,19;29,04;-0,85;22699;22344;-355;2081;1982;-99
5844;31.08.2016;'12 - 13;26,78;27,18;-0,4;24403;24361;-42;1995;2218;223
5845;31.08.2016;'13 - 14;27,06;26,26;0,8;24454;24667;213;1882;2336;454
5846;31.08.2016;'14 - 15;26,91;25,66;1,25;22972;23215;243;1801;2341;540
5847;31.08.2016;'15 - 16;27,05;25,89;1,16;20016;20364;348;1825;2424;599
5848;31.08.2016;'16 - 17;30,79;28,54;2,25;15628;15886;258;1870;2250;380
5849;31.08.2016;'17 - 18;35,94;34,42;1,52;9830;10163;333;1971;2142;171
5850;31.08.2016;'18 - 19;38,96;38,43;0,53;4208;4433;225;2207;2069;-138
5851;31.08.2016;'19 - 20;40,94;41,92;-0,98;796;842;46;2613;1777;-836
5852;31.08.2016;'20 - 21;39,61;40,24;-0,63;18;14;-4;3369;2068;-1301
5853;31.08.2016;'21 - 22;35,96;36,18;-0,22;0;0;0;4216;2642;-1574
5854;31.08.2016;'22 - 23;28,38;32,84;-4,46;0;0;0;4891;2988;-1903
5855;31.08.2016;'23 - 24;24,2;27,43;-3,23;0;0;0;5180;3374;-1806
5856;01.09.2016;'00 - 01;24,34;28,12;-3,78;0;0;0;5202;3246;-1956
5857;01.09.2016;'01 - 02;23,73;25,94;-2,21;0;0;0;5341;1664;-3677
5858;01.09.2016;'02 - 03;23,37;26,03;-2,66;0;0;0;5253;1628;-3625
5859;01.09.2016;'03 - 04;22,98;25,36;-2,38;0;0;0;4886;1562;-3324
5860;01.09.2016;'04 - 05;23,59;24,33;-0,74;0;0;0;4652;2171;-2481
5861;01.09.2016;'05 - 06;25,1;26,27;-1,17;0;0;0;4491;2703;-1788
5862;01.09.2016;'06 - 07;32,95;34,69;-1,74;140;101;-39;4318;2595;-1723
5863;01.09.2016;'07 - 08;37,97;39,24;-1,27;1915;1849;-66;4072;2787;-1285
5864;01.09.2016;'08 - 09;41,08;40,29;0,79;5786;5826;40;3518;2630;-888
5865;01.09.2016;'09 - 10;38,24;37,5;0,74;10349;10376;27;2933;1698;-1235
5866;01.09.2016;'10 - 11;34,92;35,02;-0,1;14490;14536;46;2868;1641;-1227
5867;01.09.2016;'11 - 12;32,98;33,18;-0,2;17518;17966;448;3282;2663;-619
5868;01.09.2016;'12 - 13;29,93;30,48;-0,55;19206;19886;680;4155;4195;40
5869;01.09.2016;'13 - 14;28,68;27,99;0,69;19161;19391;230;5148;4983;-165
5870;01.09.2016;'14 - 15;27,87;27,37;0,5;17714;17667;-47;5836;5386;-450
5871;01.09.2016;'15 - 16;27,88;27,64;0,24;15112;15250;138;6000;5249;-751
5872;01.09.2016;'16 - 17;28,96;28,5;0,46;11802;11994;192;5851;4918;-933
5873;01.09.2016;'17 - 18;34,06;34,93;-0,87;7689;7868;179;5354;4842;-512
5874;01.09.2016;'18 - 19;36,82;38,04;-1,22;3524;3628;104;4595;4153;-442
5875;01.09.2016;'19 - 20;38,96;41,06;-2,1;682;742;60;3869;3772;-97
5876;01.09.2016;'20 - 21;40,44;41,27;-0,83;13;12;-1;3322;3150;-172
5877;01.09.2016;'21 - 22;37,93;37,57;0,36;0;0;0;3001;2943;-58
5878;01.09.2016;'22 - 23;30,43;32,83;-2,4;0;0;0;2821;3071;250
5879;01.09.2016;'23 - 24;26,93;25,86;1,07;0;0;0;2669;3306;637
5880;02.09.2016;'00 - 01;25,64;27,5;-1,86;0;0;0;2461;2912;451
5881;02.09.2016;'01 - 02;23,89;27,63;-3,74;0;0;0;2541;2988;447
5882;02.09.2016;'02 - 03;23,76;26,45;-2,69;0;0;0;2674;3260;586
5883;02.09.2016;'03 - 04;22,91;24,57;-1,66;0;0;0;2754;3062;308
5884;02.09.2016;'04 - 05;23,1;24,54;-1,44;0;0;0;2764;2795;31
5885;02.09.2016;'05 - 06;25,97;27,24;-1,27;0;0;0;2743;3026;283
5886;02.09.2016;'06 - 07;33,08;36,29;-3,21;131;96;-35;2792;3589;797
5887;02.09.2016;'07 - 08;38,41;39,32;-0,91;2010;1953;-57;2925;3946;1021
5888;02.09.2016;'08 - 09;40,5;38,53;1,97;6400;6360;-40;2974;3884;910
5889;02.09.2016;'09 - 10;37,91;35,66;2,25;11661;11894;233;3085;3735;650
5890;02.09.2016;'10 - 11;32,84;31;1,84;16390;16675;285;3470;4208;738
5891;02.09.2016;'11 - 12;29,59;29,01;0,58;19732;20137;405;3939;5011;1072
5892;02.09.2016;'12 - 13;26,81;26,85;-0,04;21515;21923;408;4339;5756;1417
5893;02.09.2016;'13 - 14;25,69;26,65;-0,96;21685;21628;-57;4663;5592;929
5894;02.09.2016;'14 - 15;25,85;27,33;-1,48;20341;20084;-257;4709;5027;318
5895;02.09.2016;'15 - 16;27,94;30,01;-2,07;17466;17568;102;4498;4924;426
5896;02.09.2016;'16 - 17;29,17;31,03;-1,86;13506;13715;209;4218;4716;498
5897;02.09.2016;'17 - 18;34,01;35,67;-1,66;8535;8382;-153;3896;4644;748
5898;02.09.2016;'18 - 19;37,56;38,78;-1,22;3698;3345;-353;3633;4309;676
5899;02.09.2016;'19 - 20;37,98;39,01;-1,03;668;541;-127;3477;4235;758
5900;02.09.2016;'20 - 21;38,79;38,96;-0,17;12;8;-4;3439;4662;1223
5901;02.09.2016;'21 - 22;34,99;37,02;-2,03;0;0;0;3803;4629;826
5902;02.09.2016;'22 - 23;29,09;31,84;-2,75;0;0;0;4414;4501;87
5903;02.09.2016;'23 - 24;27,61;30,37;-2,76;0;0;0;4988;4477;-511
5904;03.09.2016;'00 - 01;31,41;29,29;2,12;0;0;0;5491;5263;-228
5905;03.09.2016;'01 - 02;28,04;28,57;-0,53;0;0;0;5610;5302;-308
5906;03.09.2016;'02 - 03;25,37;26,67;-1,3;0;0;0;5416;4638;-778
5907;03.09.2016;'03 - 04;24,88;27,8;-2,92;0;0;0;5004;4367;-637
5908;03.09.2016;'04 - 05;24,02;27,57;-3,55;0;0;0;4655;4509;-146
5909;03.09.2016;'05 - 06;24,92;24,89;0,03;0;0;0;4402;4729;327
5910;03.09.2016;'06 - 07;25,65;25,75;-0,1;107;76;-31;4359;4430;71
5911;03.09.2016;'07 - 08;29,44;28,4;1,04;1666;1502;-164;4366;4498;132
5912;03.09.2016;'08 - 09;31,55;30,46;1,09;5189;4952;-237;4223;4305;82
5913;03.09.2016;'09 - 10;32,95;33,41;-0,46;9378;9535;157;3960;4168;208
5914;03.09.2016;'10 - 11;30,35;32,28;-1,93;13332;13340;8;3957;4982;1025
5915;03.09.2016;'11 - 12;29,06;29,5;-0,44;16322;15813;-509;4300;5012;712
5916;03.09.2016;'12 - 13;27,16;29,7;-2,54;18093;17262;-831;4790;5365;575
5917;03.09.2016;'13 - 14;25,09;26,54;-1,45;18207;18088;-119;5199;6003;804
5918;03.09.2016;'14 - 15;25,11;26,15;-1,04;16972;17270;298;5463;6303;840
5919;03.09.2016;'15 - 16;25,36;23,54;1,82;14559;15160;601;5500;6238;738
5920;03.09.2016;'16 - 17;26,85;23,62;3,23;11321;12022;701;5234;5461;227
5921;03.09.2016;'17 - 18;30,44;28,47;1,97;7297;7606;309;4587;4573;-14
5922;03.09.2016;'18 - 19;34,27;32,5;1,77;3270;3200;-70;3574;3506;-68
5923;03.09.2016;'19 - 20;37,56;36,42;1,14;592;581;-11;2706;2352;-354
5924;03.09.2016;'20 - 21;38,56;38,41;0,15;10;9;-1;2320;2407;87
5925;03.09.2016;'21 - 22;37,67;35,29;2,38;0;0;0;2396;2890;494
5926;03.09.2016;'22 - 23;33,01;29,97;3,04;0;0;0;2622;3564;942
5927;03.09.2016;'23 - 24;28,93;26,56;2,37;0;0;0;2981;4042;1061
5928;04.09.2016;'00 - 01;27,7;24,69;3,01;0;0;0;4416;4984;568
5929;04.09.2016;'01 - 02;25,02;22,62;2,4;0;0;0;5717;6112;395
5930;04.09.2016;'02 - 03;23,09;20,71;2,38;0;0;0;6826;6978;152
5931;04.09.2016;'03 - 04;22,04;19,21;2,83;0;0;0;7693;7792;99
5932;04.09.2016;'04 - 05;20,81;18,54;2,27;0;0;0;8444;9269;825
5933;04.09.2016;'05 - 06;20,09;18,81;1,28;0;0;0;8973;9482;509
5934;04.09.2016;'06 - 07;20,03;19,42;0,61;72;55;-17;9353;9495;142
5935;04.09.2016;'07 - 08;22,02;21,77;0,25;1162;1177;15;9782;9190;-592
5936;04.09.2016;'08 - 09;22,38;21,62;0,76;3588;3827;239;9921;9185;-736
5937;04.09.2016;'09 - 10;23,5;22,77;0,73;6197;6552;355;9981;9486;-495
5938;04.09.2016;'10 - 11;23,58;24,28;-0,7;8101;8327;226;10520;9747;-773
5939;04.09.2016;'11 - 12;24,99;25,96;-0,97;9284;8968;-316;11289;11265;-24
5940;04.09.2016;'12 - 13;24,85;26,84;-1,99;9931;9520;-411;12267;11884;-383
5941;04.09.2016;'13 - 14;23,49;26,34;-2,85;9866;8977;-889;13135;11303;-1832
5942;04.09.2016;'14 - 15;20,79;25,91;-5,12;9118;8938;-180;13611;11566;-2045
5943;04.09.2016;'15 - 16;20,52;26,33;-5,81;7830;8335;505;13772;13529;-243
5944;04.09.2016;'16 - 17;21,26;25,31;-4,05;5972;6636;664;13884;15320;1436
5945;04.09.2016;'17 - 18;22,94;25,83;-2,89;3866;3973;107;13786;15566;1780
5946;04.09.2016;'18 - 19;26,94;28,95;-2,01;1765;1527;-238;13243;14575;1332
5947;04.09.2016;'19 - 20;30,31;32,51;-2,2;332;269;-63;12513;13646;1133
5948;04.09.2016;'20 - 21;33,83;33,58;0,25;5;6;1;11617;13071;1454
5949;04.09.2016;'21 - 22;31,79;31,53;0,26;0;0;0;11184;12364;1180
5950;04.09.2016;'22 - 23;29,53;27,48;2,05;0;0;0;10941;11971;1030
5951;04.09.2016;'23 - 24;25,06;23,32;1,74;0;0;0;10810;11978;1168
5952;05.09.2016;'00 - 01;23,18;23,41;-0,23;0;0;0;11697;12010;313
5953;05.09.2016;'01 - 02;22,3;22,08;0,22;0;0;0;11601;11638;37
5954;05.09.2016;'02 - 03;22,42;20,69;1,73;0;0;0;11196;11492;296
5955;05.09.2016;'03 - 04;21,73;19,23;2,5;0;0;0;10672;11002;330
5956;05.09.2016;'04 - 05;22,96;16,97;5,99;0;0;0;10186;10500;314
5957;05.09.2016;'05 - 06;24,96;20,06;4,9;0;0;0;9696;10192;496
5958;05.09.2016;'06 - 07;33,6;34,22;-0,62;61;32;-29;9208;9475;267
5959;05.09.2016;'07 - 08;42,98;44,68;-1,7;992;847;-145;8698;8370;-328
5960;05.09.2016;'08 - 09;44,42;47,05;-2,63;3285;3080;-205;8140;7473;-667
5961;05.09.2016;'09 - 10;43,31;48,26;-4,95;5916;5849;-67;7686;7065;-621
5962;05.09.2016;'10 - 11;44,97;47,79;-2,82;8378;8279;-99;7416;6836;-580
5963;05.09.2016;'11 - 12;48,01;45,04;2,97;10309;10480;171;7106;6418;-688
5964;05.09.2016;'12 - 13;45,98;44,03;1,95;11568;11976;408;6702;5899;-803
5965;05.09.2016;'13 - 14;44,22;42,65;1,57;11969;12308;339;6355;5450;-905
5966;05.09.2016;'14 - 15;42,58;44,2;-1,62;11589;11905;316;6085;5030;-1055
5967;05.09.2016;'15 - 16;43,03;43,74;-0,71;10300;10805;505;5916;4650;-1266
5968;05.09.2016;'16 - 17;41,9;42,7;-0,8;8118;8506;388;5703;4511;-1192
5969;05.09.2016;'17 - 18;41,98;41,7;0,28;5334;5732;398;5302;3879;-1423
5970;05.09.2016;'18 - 19;39,92;41,93;-2,01;2397;2582;185;4656;3150;-1506
5971;05.09.2016;'19 - 20;43,12;43,15;-0,03;395;417;22;4037;2559;-1478
5972;05.09.2016;'20 - 21;44,08;43,62;0,46;5;4;-1;3636;2625;-1011
5973;05.09.2016;'21 - 22;40;39,32;0,68;0;0;0;3399;2640;-759
5974;05.09.2016;'22 - 23;32,96;31,77;1,19;0;0;0;3231;2429;-802
5975;05.09.2016;'23 - 24;28,07;28,39;-0,32;0;0;0;2983;2142;-841
5976;06.09.2016;'00 - 01;27,68;29,76;-2,08;0;0;0;2178;1824;-354
5977;06.09.2016;'01 - 02;25,98;27,51;-1,53;0;0;0;1981;1703;-278
5978;06.09.2016;'02 - 03;24,84;25,92;-1,08;0;0;0;1843;1630;-213
5979;06.09.2016;'03 - 04;23,76;24,31;-0,55;0;0;0;1777;1641;-136
5980;06.09.2016;'04 - 05;23,92;23,62;0,3;0;0;0;1719;1732;13
5981;06.09.2016;'05 - 06;26,43;24,86;1,57;0;0;0;1632;1828;196
5982;06.09.2016;'06 - 07;34,37;34,01;0,36;88;57;-31;1582;1724;142
5983;06.09.2016;'07 - 08;42,97;38,34;4,63;1699;1473;-226;1503;1940;437
5984;06.09.2016;'08 - 09;44,63;42,01;2,62;5929;5434;-495;1332;1764;432
5985;06.09.2016;'09 - 10;41,96;39;2,96;11137;10749;-388;1163;1172;9
5986;06.09.2016;'10 - 11;35,9;33,78;2,12;15824;15364;-460;1152;1159;7
5987;06.09.2016;'11 - 12;33,76;32,17;1,59;19141;18416;-725;1210;1408;198
5988;06.09.2016;'12 - 13;28,48;29,89;-1,41;20975;20791;-184;1300;1590;290
5989;06.09.2016;'13 - 14;27,98;29,11;-1,13;21403;21509;106;1340;1502;162
5990;06.09.2016;'14 - 15;28,59;28,94;-0,35;20442;20311;-131;1310;1481;171
5991;06.09.2016;'15 - 16;29,02;28,77;0,25;17970;18142;172;1230;1324;94
5992;06.09.2016;'16 - 17;31,46;30,7;0,76;14018;14416;398;1127;1139;12
5993;06.09.2016;'17 - 18;37,95;37,27;0,68;8707;9130;423;1080;973;-107
5994;06.09.2016;'18 - 19;42,01;41,85;0,16;3503;3752;249;1206;872;-334
5995;06.09.2016;'19 - 20;45,16;47,04;-1,88;495;514;19;1533;1020;-513
5996;06.09.2016;'20 - 21;43,92;48,91;-4,99;6;5;-1;2179;1734;-445
5997;06.09.2016;'21 - 22;38,55;39,75;-1,2;0;0;0;3013;2869;-144
5998;06.09.2016;'22 - 23;28;29,06;-1,06;0;0;0;3878;4028;150
5999;06.09.2016;'23 - 24;26,82;26,92;-0,1;0;0;0;4555;5082;527
6000;07.09.2016;'00 - 01;24,8;26,79;-1,99;0;0;0;5389;5842;453
6001;07.09.2016;'01 - 02;23,64;23,04;0,6;0;0;0;5512;6017;505
6002;07.09.2016;'02 - 03;23,32;22,61;0,71;0;0;0;5405;5980;575
6003;07.09.2016;'03 - 04;23,16;22,02;1,14;0;0;0;5080;5607;527
6004;07.09.2016;'04 - 05;23,18;23,08;0,1;0;0;0;4743;4922;179
6005;07.09.2016;'05 - 06;25,11;25,11;0;0;0;0;4469;4388;-81
6006;07.09.2016;'06 - 07;32,42;35,24;-2,82;88;52;-36;4317;4096;-221
6007;07.09.2016;'07 - 08;37,97;37,81;0,16;1922;1626;-296;4121;3869;-252
6008;07.09.2016;'08 - 09;38,13;37,59;0,54;6796;6026;-770;3448;3008;-440
6009;07.09.2016;'09 - 10;34,07;34,8;-0,73;12757;11818;-939;2231;1648;-583
6010;07.09.2016;'10 - 11;29,95;31,06;-1,11;18041;17314;-727;1628;1104;-524
6011;07.09.2016;'11 - 12;28,92;29,32;-0,4;21763;21346;-417;1475;1144;-331
6012;07.09.2016;'12 - 13;26,92;28,49;-1,57;23791;23588;-203;1453;1229;-224
6013;07.09.2016;'13 - 14;26,41;28,01;-1,6;24142;24247;105;1497;1258;-239
6014;07.09.2016;'14 - 15;27,25;28,12;-0,87;22864;23032;168;1533;1438;-95
6015;07.09.2016;'15 - 16;27,92;29,73;-1,81;19870;20116;246;1525;1526;1
6016;07.09.2016;'16 - 17;28,93;32,56;-3,63;15237;15604;367;1483;1642;159
6017;07.09.2016;'17 - 18;36,93;38,13;-1,2;9232;9605;373;1512;1750;238
6018;07.09.2016;'18 - 19;40,7;41,69;-0,99;3577;3767;190;1787;1818;31
6019;07.09.2016;'19 - 20;44,35;45,14;-0,79;472;479;7;2291;2121;-170
6020;07.09.2016;'20 - 21;41,9;43,35;-1,45;6;0;-6;3355;3420;65
6021;07.09.2016;'21 - 22;36,94;40,04;-3,1;0;0;0;4794;4766;-28
6022;07.09.2016;'22 - 23;28,85;30,38;-1,53;0;0;0;5860;5335;-525
6023;07.09.2016;'23 - 24;26,59;29,4;-2,81;0;0;0;6469;5534;-935
6024;08.09.2016;'00 - 01;25,59;26,98;-1,39;0;0;0;5263;5492;229
6025;08.09.2016;'01 - 02;24,07;26,41;-2,34;0;0;0;5158;5234;76
6026;08.09.2016;'02 - 03;23,5;25,05;-1,55;0;0;0;5074;5195;121
6027;08.09.2016;'03 - 04;23,08;23,57;-0,49;0;0;0;5068;5043;-25
6028;08.09.2016;'04 - 05;23,1;22,77;0,33;0;0;0;5162;5235;73
6029;08.09.2016;'05 - 06;24,24;25,01;-0,77;0;0;0;5327;5302;-25
6030;08.09.2016;'06 - 07;31,91;37,27;-5,36;77;48;-29;5656;5498;-158
6031;08.09.2016;'07 - 08;38,71;42,3;-3,59;1862;1698;-164;5799;5948;149
6032;08.09.2016;'08 - 09;39,62;41,72;-2,1;6777;6421;-356;4947;5816;869
6033;08.09.2016;'09 - 10;38,31;39,01;-0,7;12854;12498;-356;3162;3690;528
6034;08.09.2016;'10 - 11;32,92;35,46;-2,54;18298;17874;-424;2806;2884;78
6035;08.09.2016;'11 - 12;28,67;34,28;-5,61;22078;21738;-340;2733;3010;277
6036;08.09.2016;'12 - 13;27,48;30,41;-2,93;24040;23751;-289;3004;3423;419
6037;08.09.2016;'13 - 14;26,28;29,31;-3,03;24268;23964;-304;3299;4266;967
6038;08.09.2016;'14 - 15;26,85;29,12;-2,27;22871;22590;-281;3560;4998;1438
6039;08.09.2016;'15 - 16;27,7;28,92;-1,22;19758;19539;-219;3783;5193;1410
6040;08.09.2016;'16 - 17;29,51;30,7;-1,19;15042;14934;-108;3857;5052;1195
6041;08.09.2016;'17 - 18;35,92;36,37;-0,45;8998;8988;-10;3633;4491;858
6042;08.09.2016;'18 - 19;40,41;40,49;-0,08;3403;3421;18;3504;3711;207
6043;08.09.2016;'19 - 20;42,59;41,81;0,78;422;397;-25;3574;3475;-99
6044;08.09.2016;'20 - 21;41,3;43,06;-1,76;6;0;-6;4494;4194;-300
6045;08.09.2016;'21 - 22;36,91;40,37;-3,46;0;0;0;5344;5169;-175
6046;08.09.2016;'22 - 23;28,65;34,79;-6,14;0;0;0;5882;5578;-304
6047;08.09.2016;'23 - 24;25,99;32,34;-6,35;0;0;0;6011;5936;-75
6048;09.09.2016;'00 - 01;25,08;28,83;-3,75;0;0;0;6902;5666;-1236
6049;09.09.2016;'01 - 02;23,81;28,77;-4,96;0;0;0;6783;5566;-1217
6050;09.09.2016;'02 - 03;23,49;27,77;-4,28;0;0;0;6480;5258;-1222
6051;09.09.2016;'03 - 04;22,97;26,87;-3,9;0;0;0;6098;4700;-1398
6052;09.09.2016;'04 - 05;23,26;27,59;-4,33;0;0;0;5756;4207;-1549
6053;09.09.2016;'05 - 06;24,82;27,82;-3;0;0;0;5494;3920;-1574
6054;09.09.2016;'06 - 07;33,77;40,12;-6,35;62;34;-28;5292;3659;-1633
6055;09.09.2016;'07 - 08;40,22;48,19;-7,97;1600;1371;-229;4971;3688;-1283
6056;09.09.2016;'08 - 09;41,94;46,56;-4,62;5837;5212;-625;4098;2877;-1221
6057;09.09.2016;'09 - 10;40,99;43,96;-2,97;11058;10296;-762;2883;1995;-888
6058;09.09.2016;'10 - 11;36,88;39,8;-2,92;15939;15173;-766;2531;1784;-747
6059;09.09.2016;'11 - 12;34,06;38,39;-4,33;19448;18925;-523;2536;2245;-291
6060;09.09.2016;'12 - 13;31,8;34,03;-2,23;21397;20865;-532;2553;2788;235
6061;09.09.2016;'13 - 14;29,04;30,58;-1,54;21614;21070;-544;2519;2868;349
6062;09.09.2016;'14 - 15;27,86;29,14;-1,28;20197;19654;-543;2413;2684;271
6063;09.09.2016;'15 - 16;29,49;29,22;0,27;17284;17066;-218;2170;2234;64
6064;09.09.2016;'16 - 17;30,29;31,34;-1,05;13160;13270;110;1878;1903;25
6065;09.09.2016;'17 - 18;35,89;38,89;-3;7983;8282;299;1652;1488;-164
6066;09.09.2016;'18 - 19;39,77;41,4;-1,63;3072;3208;136;1484;1186;-298
6067;09.09.2016;'19 - 20;41,92;43,36;-1,44;368;363;-5;1502;1034;-468
6068;09.09.2016;'20 - 21;41,42;43,79;-2,37;2;0;-2;1883;1258;-625
6069;09.09.2016;'21 - 22;38,27;39,91;-1,64;0;0;0;2307;1600;-707
6070;09.09.2016;'22 - 23;30,73;33,42;-2,69;0;0;0;2494;1868;-626
6071;09.09.2016;'23 - 24;28,01;30,05;-2,04;0;0;0;2716;2093;-623
6072;10.09.2016;'00 - 01;33,02;28,27;4,75;0;0;0;2465;2379;-86
6073;10.09.2016;'01 - 02;27,11;26,13;0,98;0;0;0;2697;2548;-149
6074;10.09.2016;'02 - 03;27,42;26,25;1,17;0;0;0;2824;2741;-83
6075;10.09.2016;'03 - 04;24,25;25,38;-1,13;0;0;0;2831;2891;60
6076;10.09.2016;'04 - 05;23,75;24,47;-0,72;0;0;0;2817;2870;53
6077;10.09.2016;'05 - 06;24,2;25,78;-1,58;0;0;0;2799;2656;-143
6078;10.09.2016;'06 - 07;25,51;27,04;-1,53;59;33;-26;2758;2288;-470
6079;10.09.2016;'07 - 08;29,04;30,32;-1,28;1590;1430;-160;2678;2087;-591
6080;10.09.2016;'08 - 09;29,75;31,41;-1,66;6122;5766;-356;2349;1874;-475
6081;10.09.2016;'09 - 10;29,94;33,24;-3,3;12033;11610;-423;1623;1388;-235
6082;10.09.2016;'10 - 11;25,22;26,7;-1,48;17289;16698;-591;1294;1052;-242
6083;10.09.2016;'11 - 12;23,69;28;-4,31;20891;20389;-502;1233;1115;-118
6084;10.09.2016;'12 - 13;23,08;26,92;-3,84;22760;22178;-582;1228;1141;-87
6085;10.09.2016;'13 - 14;23,06;25,72;-2,66;22684;22109;-575;1203;1306;103
6086;10.09.2016;'14 - 15;23,06;25,33;-2,27;20932;20490;-442;1173;1368;195
6087;10.09.2016;'15 - 16;25,61;25,86;-0,25;17684;17422;-262;1177;1356;179
6088;10.09.2016;'16 - 17;28,65;27,1;1,55;13288;13189;-99;1194;1221;27
6089;10.09.2016;'17 - 18;31,99;32,85;-0,86;7889;7921;32;1317;1146;-171
6090;10.09.2016;'18 - 19;34,05;35,63;-1,58;2950;2940;-10;1705;1177;-528
6091;10.09.2016;'19 - 20;38,7;38,15;0,55;331;297;-34;2341;1736;-605
6092;10.09.2016;'20 - 21;38,98;38,33;0,65;2;0;-2;3265;2942;-323
6093;10.09.2016;'21 - 22;34,08;33,87;0,21;0;0;0;4105;3914;-191
6094;10.09.2016;'22 - 23;30,65;31,33;-0,68;0;0;0;4875;4493;-382
6095;10.09.2016;'23 - 24;26,76;29,19;-2,43;0;0;0;5328;5129;-199
6096;11.09.2016;'00 - 01;24,05;23,86;0,19;0;0;0;6139;5808;-331
6097;11.09.2016;'01 - 02;22,87;22,24;0,63;0;0;0;6428;6252;-176
6098;11.09.2016;'02 - 03;22,51;21,71;0,8;0;0;0;6340;6587;247
6099;11.09.2016;'03 - 04;21,73;19,7;2,03;0;0;0;6014;6696;682
6100;11.09.2016;'04 - 05;21,1;19,67;1,43;0;0;0;5554;6562;1008
6101;11.09.2016;'05 - 06;22,09;19,78;2,31;0;0;0;4985;6325;1340
6102;11.09.2016;'06 - 07;22,94;19,62;3,32;46;27;-19;4390;5742;1352
6103;11.09.2016;'07 - 08;22,93;19,85;3,08;1331;1229;-102;3839;5170;1331
6104;11.09.2016;'08 - 09;24,07;21,54;2,53;4974;5094;120;3141;3932;791
6105;11.09.2016;'09 - 10;25,11;23,3;1,81;9530;10234;704;2040;2374;334
6106;11.09.2016;'10 - 11;24,96;24,19;0,77;13840;15032;1192;1366;1638;272
6107;11.09.2016;'11 - 12;25,48;22,61;2,87;16835;18310;1475;1336;1205;-131
6108;11.09.2016;'12 - 13;25,16;22,05;3,11;18275;20015;1740;1047;901;-146
6109;11.09.2016;'13 - 14;24,54;21,75;2,79;18416;20026;1610;783;639;-144
6110;11.09.2016;'14 - 15;23,48;20,93;2,55;17289;18334;1045;594;470;-124
6111;11.09.2016;'15 - 16;23,42;20,84;2,58;14849;15779;930;535;441;-94
6112;11.09.2016;'16 - 17;24,01;19,18;4,83;11262;12194;932;486;400;-86
6113;11.09.2016;'17 - 18;28,73;25,81;2,92;6744;7493;749;542;504;-38
6114;11.09.2016;'18 - 19;36,36;34,94;1,42;2544;2734;190;757;679;-78
6115;11.09.2016;'19 - 20;39,85;37,83;2,02;272;260;-12;1106;976;-130
6116;11.09.2016;'20 - 21;42,57;40,84;1,73;1;0;-1;1496;1600;104
6117;11.09.2016;'21 - 22;38,93;34,62;4,31;0;0;0;1872;2430;558
6118;11.09.2016;'22 - 23;35,94;31,89;4,05;0;0;0;2219;3202;983
6119;11.09.2016;'23 - 24;31,27;28,38;2,89;0;0;0;2489;3759;1270
6120;12.09.2016;'00 - 01;24,06;22,51;1,55;0;0;0;3953;4400;447
6121;12.09.2016;'01 - 02;23,45;21,84;1,61;0;0;0;4211;5003;792
6122;12.09.2016;'02 - 03;22,88;21,35;1,53;0;0;0;4421;5401;980
6123;12.09.2016;'03 - 04;22,15;21,48;0,67;0;0;0;4543;5490;947
6124;12.09.2016;'04 - 05;22,75;20,51;2,24;0;0;0;4711;5525;814
6125;12.09.2016;'05 - 06;24,12;22,66;1,46;0;0;0;4851;5572;721
6126;12.09.2016;'06 - 07;36,69;40,13;-3,44;45;24;-21;4891;5077;186
6127;12.09.2016;'07 - 08;43;43,99;-0,99;1471;1339;-132;4751;4685;-66
6128;12.09.2016;'08 - 09;42,53;43,56;-1,03;6088;5851;-237;3882;3658;-224
6129;12.09.2016;'09 - 10;39,43;36,93;2,5;12117;11769;-348;2487;2126;-361
6130;12.09.2016;'10 - 11;33,5;30,19;3,31;17463;16992;-471;1925;1347;-578
6131;12.09.2016;'11 - 12;30,71;29,16;1,55;21154;20470;-684;1641;1138;-503
6132;12.09.2016;'12 - 13;30,16;30,02;0,14;23028;22300;-728;1749;1170;-579
6133;12.09.2016;'13 - 14;29,61;32,69;-3,08;23101;22555;-546;2222;1328;-894
6134;12.09.2016;'14 - 15;31,15;32,71;-1,56;21524;21076;-448;2232;1369;-863
6135;12.09.2016;'15 - 16;32,69;33,58;-0,89;18339;18138;-201;1786;1349;-437
6136;12.09.2016;'16 - 17;36,66;39,66;-3;13714;13567;-147;1521;1354;-167
6137;12.09.2016;'17 - 18;41,81;45,56;-3,75;7948;7919;-29;1650;1490;-160
6138;12.09.2016;'18 - 19;42,97;58,8;-15,83;2793;2744;-49;2163;1837;-326
6139;12.09.2016;'19 - 20;46,73;78,56;-31,83;273;232;-41;3189;2926;-263
6140;12.09.2016;'20 - 21;42,83;87,69;-44,86;0;0;0;4225;5006;781
6141;12.09.2016;'21 - 22;37,93;46,05;-8,12;0;0;0;5125;6567;1442
6142;12.09.2016;'22 - 23;30,65;31,28;-0,63;0;0;0;5768;6944;1176
6143;12.09.2016;'23 - 24;26,59;25,73;0,86;0;0;0;5980;6802;822
6144;13.09.2016;'00 - 01;26,64;29,1;-2,46;0;0;0;6314;6476;162
6145;13.09.2016;'01 - 02;24,8;24,42;0,38;0;0;0;6081;5924;-157
6146;13.09.2016;'02 - 03;24,01;23,92;0,09;0;0;0;5793;5342;-451
6147;13.09.2016;'03 - 04;23,52;22,67;0,85;0;0;0;5553;4872;-681
6148;13.09.2016;'04 - 05;23,55;21,64;1,91;0;0;0;5370;4611;-759
6149;13.09.2016;'05 - 06;26,39;22,92;3,47;0;0;0;5257;4563;-694
6150;13.09.2016;'06 - 07;37,48;32,55;4,93;43;21;-22;5202;4626;-576
6151;13.09.2016;'07 - 08;44,44;41,22;3,22;1566;1382;-184;5091;4631;-460
6152;13.09.2016;'08 - 09;42,76;46,78;-4,02;6397;5832;-565;4662;4132;-530
6153;13.09.2016;'09 - 10;38,92;41,75;-2,83;12436;11638;-798;3576;2677;-899
6154;13.09.2016;'10 - 11;35,91;37,97;-2,06;17786;16749;-1037;2697;1722;-975
6155;13.09.2016;'11 - 12;32,74;38,38;-5,64;21416;20317;-1099;2859;2205;-654
6156;13.09.2016;'12 - 13;28,13;34,78;-6,65;23290;22250;-1040;3602;3506;-96
6157;13.09.2016;'13 - 14;27,62;31,86;-4,24;23451;22407;-1044;4524;4861;337
6158;13.09.2016;'14 - 15;28,73;31,3;-2,57;21998;20966;-1032;5080;5281;201
6159;13.09.2016;'15 - 16;28,25;30,52;-2,27;18843;17992;-851;5129;5217;88
6160;13.09.2016;'16 - 17;30,23;33,75;-3,52;14057;13528;-529;5094;5177;83
6161;13.09.2016;'17 - 18;37,42;41,05;-3,63;8068;7843;-225;5393;5417;24
6162;13.09.2016;'18 - 19;40,42;43,33;-2,91;2743;2677;-66;6250;5882;-368
6163;13.09.2016;'19 - 20;41,93;43,62;-1,69;251;241;-10;7942;8052;110
6164;13.09.2016;'20 - 21;38,94;42,13;-3,19;0;0;0;9735;11722;1987
6165;13.09.2016;'21 - 22;33,52;30,89;2,63;0;0;0;11009;13932;2923
6166;13.09.2016;'22 - 23;25,76;24,14;1,62;0;0;0;11702;14398;2696
6167;13.09.2016;'23 - 24;24,27;21,35;2,92;0;0;0;11798;13952;2154
6168;14.09.2016;'00 - 01;23;21,33;1,67;0;0;0;11219;13025;1806
6169;14.09.2016;'01 - 02;22,17;20,4;1,77;0;0;0;10825;11892;1067
6170;14.09.2016;'02 - 03;21,34;20,28;1,06;0;0;0;10596;10758;162
6171;14.09.2016;'03 - 04;21,85;20,83;1,02;0;0;0;10123;9904;-219
6172;14.09.2016;'04 - 05;22,74;23,23;-0,49;0;0;0;9730;9375;-355
6173;14.09.2016;'05 - 06;23,31;26,65;-3,34;0;0;0;9481;8645;-836
6174;14.09.2016;'06 - 07;33,22;34,16;-0,94;37;18;-19;9270;8404;-866
6175;14.09.2016;'07 - 08;38,98;40,24;-1,26;1480;1262;-218;8897;8254;-643
6176;14.09.2016;'08 - 09;39,9;38,4;1,5;6220;5676;-544;8075;6938;-1137
6177;14.09.2016;'09 - 10;34,95;34,89;0,06;12205;11406;-799;6768;4590;-2178
6178;14.09.2016;'10 - 11;31,8;33,79;-1,99;17548;16658;-890;5862;3610;-2252
6179;14.09.2016;'11 - 12;31,9;31,66;0,24;21233;20380;-853;5784;3903;-1881
6180;14.09.2016;'12 - 13;27,03;28,26;-1,23;23180;22110;-1070;6572;5330;-1242
6181;14.09.2016;'13 - 14;25,23;26,03;-0,8;23392;22200;-1192;7573;7236;-337
6182;14.09.2016;'14 - 15;26,22;25,57;0,65;21907;20739;-1168;8196;7892;-304
6183;14.09.2016;'15 - 16;26,95;25,78;1,17;18736;17640;-1096;8457;7721;-736
6184;14.09.2016;'16 - 17;28,55;28,45;0,1;13917;13105;-812;8730;7428;-1302
6185;14.09.2016;'17 - 18;35,69;34,49;1,2;7925;7571;-354;9431;7566;-1865
6186;14.09.2016;'18 - 19;37,66;37,67;-0,01;2630;2482;-148;10813;8252;-2561
6187;14.09.2016;'19 - 20;37,44;37,11;0,33;227;179;-48;12448;10533;-1915
6188;14.09.2016;'20 - 21;34,1;29,1;5;0;0;0;13744;13806;62
6189;14.09.2016;'21 - 22;26,84;23,02;3,82;0;0;0;14685;15708;1023
6190;14.09.2016;'22 - 23;24,27;22,04;2,23;0;0;0;15120;15974;854
6191;14.09.2016;'23 - 24;22,96;23,16;-0,2;0;0;0;15018;15610;592
6192;15.09.2016;'00 - 01;22,93;22,64;0,29;0;0;0;14403;14932;529
6193;15.09.2016;'01 - 02;21,88;22,02;-0,14;0;0;0;13652;14132;480
6194;15.09.2016;'02 - 03;21,42;20,85;0,57;0;0;0;12990;13398;408
6195;15.09.2016;'03 - 04;21,13;21,9;-0,77;0;0;0;12441;12915;474
6196;15.09.2016;'04 - 05;21,35;24,04;-2,69;0;0;0;12080;12914;834
6197;15.09.2016;'05 - 06;23,05;23,26;-0,21;0;0;0;11896;12518;622
6198;15.09.2016;'06 - 07;27,01;25,55;1,46;35;14;-21;11776;12394;618
6199;15.09.2016;'07 - 08;37,08;34,93;2,15;1428;1246;-182;11518;11790;272
6200;15.09.2016;'08 - 09;37,01;36,77;0,24;6134;5712;-422;10832;9790;-1042
6201;15.09.2016;'09 - 10;33,71;33,66;0,05;12123;11664;-459;9912;7181;-2731
6202;15.09.2016;'10 - 11;27,96;28,21;-0,25;17318;16943;-375;9671;6961;-2710
6203;15.09.2016;'11 - 12;26,83;28,58;-1,75;20885;20236;-649;10049;9791;-258
6204;15.09.2016;'12 - 13;24,79;24,91;-0,12;22494;21634;-860;10474;11388;914
6205;15.09.2016;'13 - 14;24,71;24,29;0,42;22246;21070;-1176;10672;10762;90
6206;15.09.2016;'14 - 15;23,99;25,77;-1,78;20220;19292;-928;10614;9992;-622
6207;15.09.2016;'15 - 16;26,63;28,9;-2,27;16695;15798;-897;10448;9687;-761
6208;15.09.2016;'16 - 17;26,99;28,15;-1,16;12027;11124;-903;10369;9934;-435
6209;15.09.2016;'17 - 18;32,15;30,25;1,9;6630;6159;-471;10349;10460;111
6210;15.09.2016;'18 - 19;37,22;40,19;-2,97;2149;2010;-139;10501;10342;-159
6211;15.09.2016;'19 - 20;38,86;36,86;2;175;136;-39;11245;11162;-83
6212;15.09.2016;'20 - 21;37,41;34,53;2,88;0;0;0;12232;13092;860
6213;15.09.2016;'21 - 22;29;26,17;2,83;0;0;0;12607;13493;886
6214;15.09.2016;'22 - 23;25,06;24,5;0,56;0;0;0;12551;12708;157
6215;15.09.2016;'23 - 24;23,02;22,11;0,91;0;0;0;12045;11837;-208
6216;16.09.2016;'00 - 01;22,26;26,06;-3,8;0;0;0;10814;10404;-410
6217;16.09.2016;'01 - 02;21,24;24,92;-3,68;0;0;0;9864;8936;-928
6218;16.09.2016;'02 - 03;21,22;25,24;-4,02;0;0;0;8961;7876;-1085
6219;16.09.2016;'03 - 04;21,29;22,31;-1,02;0;0;0;8089;6822;-1267
6220;16.09.2016;'04 - 05;20,35;23,56;-3,21;0;0;0;7242;6052;-1190
6221;16.09.2016;'05 - 06;22,59;25,75;-3,16;0;0;0;6493;5647;-846
6222;16.09.2016;'06 - 07;31,47;36,81;-5,34;20;9;-11;5898;5504;-394
6223;16.09.2016;'07 - 08;39,96;43,76;-3,8;876;856;-20;5328;5247;-81
6224;16.09.2016;'08 - 09;40,7;43,18;-2,48;3714;3642;-72;4652;4208;-444
6225;16.09.2016;'09 - 10;39,98;39,19;0,79;7260;7381;121;3930;2876;-1054
6226;16.09.2016;'10 - 11;38,98;38,46;0,52;10480;11225;745;3463;2476;-987
6227;16.09.2016;'11 - 12;37,81;35,04;2,77;12753;14166;1413;3215;2415;-800
6228;16.09.2016;'12 - 13;36;31,65;4,35;13947;15460;1513;3136;2754;-382
6229;16.09.2016;'13 - 14;31,95;29,91;2,04;13908;14576;668;3031;2890;-141
6230;16.09.2016;'14 - 15;29,84;28,46;1,38;12774;11886;-888;2867;3069;202
6231;16.09.2016;'15 - 16;33,99;32,25;1,74;10693;9103;-1590;2643;2808;165
6232;16.09.2016;'16 - 17;35,61;39,56;-3,95;7785;6296;-1489;2444;2442;-2
6233;16.09.2016;'17 - 18;38,28;41,16;-2,88;4473;3448;-1025;2433;2285;-148
6234;16.09.2016;'18 - 19;40,1;42,65;-2,55;1479;1096;-383;2692;2019;-673
6235;16.09.2016;'19 - 20;41,75;41,3;0,45;115;77;-38;3153;2195;-958
6236;16.09.2016;'20 - 21;40,99;40,66;0,33;1;0;-1;3641;2460;-1181
6237;16.09.2016;'21 - 22;36,5;38,07;-1,57;0;0;0;3980;2734;-1246
6238;16.09.2016;'22 - 23;30,74;33,07;-2,33;0;0;0;4230;2977;-1253
6239;16.09.2016;'23 - 24;25,16;27,89;-2,73;0;0;0;4399;3102;-1297
6240;17.09.2016;'00 - 01;29,84;30,27;-0,43;0;0;0;3366;3227;-139
6241;17.09.2016;'01 - 02;26,32;28,61;-2,29;0;0;0;3417;3288;-129
6242;17.09.2016;'02 - 03;24,08;24,93;-0,85;0;0;0;3484;3400;-84
6243;17.09.2016;'03 - 04;22,81;24,38;-1,57;0;0;0;3542;3557;15
6244;17.09.2016;'04 - 05;22,25;23,22;-0,97;0;0;0;3650;3654;4
6245;17.09.2016;'05 - 06;22,91;23,46;-0,55;0;0;0;3850;3807;-43
6246;17.09.2016;'06 - 07;24,91;26,05;-1,14;10;6;-4;4247;4210;-37
6247;17.09.2016;'07 - 08;27,92;32,49;-4,57;382;260;-122;4746;4244;-502
6248;17.09.2016;'08 - 09;31,41;38,57;-7,16;1770;1296;-474;5290;4564;-726
6249;17.09.2016;'09 - 10;36,93;40,54;-3,61;3558;2992;-566;5819;4856;-963
6250;17.09.2016;'10 - 11;36,91;41,6;-4,69;5164;4805;-359;6345;5325;-1020
6251;17.09.2016;'11 - 12;36,08;39,59;-3,51;6393;6425;32;6946;6014;-932
6252;17.09.2016;'12 - 13;30,53;37,38;-6,85;7081;7834;753;7680;6612;-1068
6253;17.09.2016;'13 - 14;25,1;30,88;-5,78;6960;7743;783;8444;7533;-911
6254;17.09.2016;'14 - 15;24,79;29,54;-4,75;6306;6870;564;9097;8257;-840
6255;17.09.2016;'15 - 16;24,14;28,36;-4,22;5168;5305;137;9726;8612;-1114
6256;17.09.2016;'16 - 17;24,93;28,69;-3,76;3727;3546;-181;10215;8918;-1297
6257;17.09.2016;'17 - 18;27,85;31,97;-4,12;2135;1838;-297;10662;9578;-1084
6258;17.09.2016;'18 - 19;27,03;33,05;-6,02;713;510;-203;11206;10056;-1150
6259;17.09.2016;'19 - 20;32,52;40,33;-7,81;61;37;-24;11875;11198;-677
6260;17.09.2016;'20 - 21;31,98;37,08;-5,1;1;0;-1;12127;12172;45
6261;17.09.2016;'21 - 22;24,57;24,37;0,2;0;0;0;12402;12266;-136
6262;17.09.2016;'22 - 23;23,51;24,58;-1,07;0;0;0;12497;11600;-897
6263;17.09.2016;'23 - 24;23,19;25,11;-1,92;0;0;0;12301;10994;-1307
6264;18.09.2016;'00 - 01;21,22;23,09;-1,87;0;0;0;12143;10630;-1513
6265;18.09.2016;'01 - 02;22,39;22,45;-0,06;0;0;0;11652;10205;-1447
6266;18.09.2016;'02 - 03;21,22;21,33;-0,11;0;0;0;11240;10080;-1160
6267;18.09.2016;'03 - 04;20;20,22;-0,22;0;0;0;11002;9962;-1040
6268;18.09.2016;'04 - 05;18,43;19,21;-0,78;0;0;0;10899;10267;-632
6269;18.09.2016;'05 - 06;19,53;19,7;-0,17;0;0;0;10799;10358;-441
6270;18.09.2016;'06 - 07;20,43;20,51;-0,08;9;5;-4;10597;10447;-150
6271;18.09.2016;'07 - 08;20,73;20,78;-0,05;524;431;-93;10288;10174;-114
6272;18.09.2016;'08 - 09;22,77;19,96;2,81;2398;1951;-447;9896;9424;-472
6273;18.09.2016;'09 - 10;24,78;24,32;0,46;4898;4313;-585;9602;8966;-636
6274;18.09.2016;'10 - 11;24,56;24,47;0,09;7378;6630;-748;9395;9176;-219
6275;18.09.2016;'11 - 12;24,98;24,77;0,21;9301;8638;-663;8908;9209;301
6276;18.09.2016;'12 - 13;24;24,73;-0,73;10477;9482;-995;8350;8728;378
6277;18.09.2016;'13 - 14;24,1;23,46;0,64;10594;9583;-1011;7741;8129;388
6278;18.09.2016;'14 - 15;23,15;24,47;-1,32;9841;8514;-1327;7140;7754;614
6279;18.09.2016;'15 - 16;22,93;24,05;-1,12;8318;6889;-1429;6721;7423;702
6280;18.09.2016;'16 - 17;23,2;24,05;-0,85;6063;4785;-1278;6428;7120;692
6281;18.09.2016;'17 - 18;27,16;26,15;1,01;3417;2541;-876;6182;7033;851
6282;18.09.2016;'18 - 19;32,54;30,11;2,43;1064;832;-232;5983;6475;492
6283;18.09.2016;'19 - 20;36,11;32,81;3,3;74;56;-18;5915;6081;166
6284;18.09.2016;'20 - 21;34,94;31,1;3,84;1;0;-1;5993;6072;79
6285;18.09.2016;'21 - 22;31,1;29,29;1,81;0;0;0;6085;5872;-213
6286;18.09.2016;'22 - 23;27,94;25,78;2,16;0;0;0;5947;5290;-657
6287;18.09.2016;'23 - 24;25,46;23,67;1,79;0;0;0;5500;4531;-969
6288;19.09.2016;'00 - 01;24,56;24,73;-0,17;0;0;0;4820;3991;-829
6289;19.09.2016;'01 - 02;24,15;24,4;-0,25;0;0;0;4352;3617;-735
6290;19.09.2016;'02 - 03;23,78;23,69;0,09;0;0;0;3925;3189;-736
6291;19.09.2016;'03 - 04;22,44;22,88;-0,44;0;0;0;3584;2900;-684
6292;19.09.2016;'04 - 05;22,05;23,1;-1,05;0;0;0;3323;2843;-480
6293;19.09.2016;'05 - 06;23,91;21,99;1,92;0;0;0;3138;2915;-223
6294;19.09.2016;'06 - 07;36,06;31,56;4,5;9;7;-2;3019;2888;-131
6295;19.09.2016;'07 - 08;42,31;42,22;0,09;492;314;-178;2848;2916;68
6296;19.09.2016;'08 - 09;44,6;49,01;-4,41;2358;1573;-785;2552;2642;90
6297;19.09.2016;'09 - 10;43,91;47,68;-3,77;4838;3693;-1145;2194;2068;-126
6298;19.09.2016;'10 - 11;43,95;46,15;-2,2;7241;6258;-983;1934;1964;30
6299;19.09.2016;'11 - 12;43,97;43,92;0,05;9139;8380;-759;1835;2082;247
6300;19.09.2016;'12 - 13;41,27;41,24;0,03;10248;9390;-858;1789;2240;451
6301;19.09.2016;'13 - 14;39,31;39,96;-0,65;10188;8969;-1219;1707;2050;343
6302;19.09.2016;'14 - 15;37,68;40,26;-2,58;9250;8262;-988;1618;1880;262
6303;19.09.2016;'15 - 16;37,93;39;-1,07;7621;6431;-1190;1593;1843;250
6304;19.09.2016;'16 - 17;37,78;38,01;-0,23;5453;4456;-997;1631;1772;141
6305;19.09.2016;'17 - 18;39,22;39,56;-0,34;3011;2458;-553;1741;1936;195
6306;19.09.2016;'18 - 19;39,9;38,91;0,99;908;750;-158;1968;1926;-42
6307;19.09.2016;'19 - 20;41,99;39,87;2,12;56;45;-11;2284;2168;-116
6308;19.09.2016;'20 - 21;40,1;37,76;2,34;0;0;0;2596;2566;-30
6309;19.09.2016;'21 - 22;30;29,04;0,96;0;0;0;2720;2691;-29
6310;19.09.2016;'22 - 23;28,01;25,67;2,34;0;0;0;2730;2494;-236
6311;19.09.2016;'23 - 24;26,02;23,94;2,08;0;0;0;2588;2085;-503
6312;20.09.2016;'00 - 01;24,79;24,04;0,75;0;0;0;1816;1859;43
6313;20.09.2016;'01 - 02;24,83;23,16;1,67;0;0;0;1529;1631;102
6314;20.09.2016;'02 - 03;23,51;22,32;1,19;0;0;0;1309;1417;108
6315;20.09.2016;'03 - 04;23,06;20,79;2,27;0;0;0;1180;1186;6
6316;20.09.2016;'04 - 05;23,44;21,25;2,19;0;0;0;1102;1000;-102
6317;20.09.2016;'05 - 06;25,24;23,54;1,7;0;0;0;1052;790;-262
6318;20.09.2016;'06 - 07;32,73;29,66;3,07;8;6;-2;974;685;-289
6319;20.09.2016;'07 - 08;42,96;41,17;1,79;526;421;-105;878;666;-212
6320;20.09.2016;'08 - 09;43,88;41,71;2,17;2643;1766;-877;743;587;-156
6321;20.09.2016;'09 - 10;42,77;42,85;-0,08;5509;4292;-1217;561;493;-68
6322;20.09.2016;'10 - 11;42,18;42,19;-0,01;8464;7456;-1008;420;457;37
6323;20.09.2016;'11 - 12;41,17;40,1;1,07;11074;10514;-560;395;540;145
6324;20.09.2016;'12 - 13;38,21;35,24;2,97;12769;12060;-709;441;647;206
6325;20.09.2016;'13 - 14;35,6;31,18;4,42;13008;11913;-1095;503;796;293
6326;20.09.2016;'14 - 15;34,22;29,79;4,43;12134;10964;-1170;554;814;260
6327;20.09.2016;'15 - 16;34,55;30,33;4,22;10258;8886;-1372;612;840;228
6328;20.09.2016;'16 - 17;36,08;31,76;4,32;7375;6469;-906;680;882;202
6329;20.09.2016;'17 - 18;39,13;35,04;4,09;4010;3515;-495;784;858;74
6330;20.09.2016;'18 - 19;42,07;37,15;4,92;1112;965;-147;967;812;-155
6331;20.09.2016;'19 - 20;46,8;42,08;4,72;63;41;-22;1241;942;-299
6332;20.09.2016;'20 - 21;41,95;37,23;4,72;0;0;0;1566;1229;-337
6333;20.09.2016;'21 - 22;35,06;33,01;2,05;0;0;0;1823;1530;-293
6334;20.09.2016;'22 - 23;28,54;28,5;0,04;0;0;0;1985;1695;-290
6335;20.09.2016;'23 - 24;26,03;26,31;-0,28;0;0;0;1996;1780;-216
6336;21.09.2016;'00 - 01;25,43;26,34;-0,91;0;0;0;1887;1729;-158
6337;21.09.2016;'01 - 02;24,94;25,54;-0,6;0;0;0;1755;1737;-18
6338;21.09.2016;'02 - 03;24,11;25,37;-1,26;0;0;0;1621;1655;34
6339;21.09.2016;'03 - 04;24,13;24,92;-0,79;0;0;0;1530;1622;92
6340;21.09.2016;'04 - 05;24,09;25,33;-1,24;0;0;0;1483;1618;135
6341;21.09.2016;'05 - 06;25,71;26,74;-1,03;0;0;0;1475;1575;100
6342;21.09.2016;'06 - 07;36,97;36,22;0,75;9;6;-3;1452;1470;18
6343;21.09.2016;'07 - 08;48,19;45,44;2,75;636;587;-49;1376;1428;52
6344;21.09.2016;'08 - 09;49,71;48,13;1,58;3553;3627;74;1200;1282;82
6345;21.09.2016;'09 - 10;44,5;40,85;3,65;7944;8508;564;920;852;-68
6346;21.09.2016;'10 - 11;39,98;34,52;5,46;12468;13545;1077;712;706;-6
6347;21.09.2016;'11 - 12;36,03;28;8,03;16081;17281;1200;655;890;235
6348;21.09.2016;'12 - 13;32,15;26,54;5,61;18133;18725;592;675;1006;331
6349;21.09.2016;'13 - 14;31,92;27,23;4,69;18088;18522;434;692;968;276
6350;21.09.2016;'14 - 15;30,7;26,05;4,65;16456;17123;667;715;962;247
6351;21.09.2016;'15 - 16;32,81;25,69;7,12;13619;14362;743;764;1006;242
6352;21.09.2016;'16 - 17;35,36;28,04;7,32;9760;10644;884;867;1144;277
6353;21.09.2016;'17 - 18;42,7;37,69;5,01;5286;5815;529;1032;1009;-23
6354;21.09.2016;'18 - 19;45;43,94;1,06;1451;1603;152;1260;994;-266
6355;21.09.2016;'19 - 20;48,75;46,96;1,79;74;52;-22;1604;1516;-88
6356;21.09.2016;'20 - 21;43,87;43,77;0,1;0;0;0;2020;2230;210
6357;21.09.2016;'21 - 22;37,96;36,32;1,64;0;0;0;2361;2842;481
6358;21.09.2016;'22 - 23;28,49;26,77;1,72;0;0;0;2639;2866;227
6359;21.09.2016;'23 - 24;27,09;25,86;1,23;0;0;0;2760;2889;129
6360;22.09.2016;'00 - 01;25,86;25,61;0,25;0;0;0;2329;2921;592
6361;22.09.2016;'01 - 02;25,09;25,05;0,04;0;0;0;2229;2868;639
6362;22.09.2016;'02 - 03;24,73;24,02;0,71;0;0;0;2058;2686;628
6363;22.09.2016;'03 - 04;24,26;23,58;0,68;0;0;0;1877;2448;571
6364;22.09.2016;'04 - 05;24,24;25,16;-0,92;0;0;0;1737;2248;511
6365;22.09.2016;'05 - 06;26,84;28,57;-1,73;0;0;0;1626;2060;434
6366;22.09.2016;'06 - 07;38,19;36,47;1,72;9;3;-6;1537;1815;278
6367;22.09.2016;'07 - 08;43,34;41,94;1,4;760;756;-4;1436;1698;262
6368;22.09.2016;'08 - 09;42,2;47;-4,8;4525;4839;314;1272;1643;371
6369;22.09.2016;'09 - 10;35,77;33,1;2,67;10214;10814;600;953;1040;87
6370;22.09.2016;'10 - 11;28,79;27,09;1,7;15594;16468;874;613;474;-139
6371;22.09.2016;'11 - 12;27,75;27,01;0,74;19413;20134;721;408;526;118
6372;22.09.2016;'12 - 13;27,11;27,45;-0,34;21139;21604;465;380;671;291
6373;22.09.2016;'13 - 14;27,06;27,16;-0,1;20837;20986;149;369;778;409
6374;22.09.2016;'14 - 15;27,29;27,66;-0,37;18741;18605;-136;345;717;372
6375;22.09.2016;'15 - 16;28,61;28,1;0,51;15225;15189;-36;316;616;300
6376;22.09.2016;'16 - 17;31,87;35,97;-4,1;10651;10761;110;293;538;245
6377;22.09.2016;'17 - 18;39,93;45,08;-5,15;5533;5496;-37;291;566;275
6378;22.09.2016;'18 - 19;43,06;46,05;-2,99;1408;1297;-111;352;620;268
6379;22.09.2016;'19 - 20;49,06;51,82;-2,76;65;32;-33;508;802;294
6380;22.09.2016;'20 - 21;45,82;48,01;-2,19;0;0;0;743;928;185
6381;22.09.2016;'21 - 22;38,95;40,31;-1,36;0;0;0;1021;1124;103
6382;22.09.2016;'22 - 23;29,97;30,11;-0,14;0;0;0;1319;1410;91
6383;22.09.2016;'23 - 24;26,47;26,76;-0,29;0;0;0;1611;1792;181
6384;23.09.2016;'00 - 01;25,84;30,08;-4,24;0;0;0;2227;1984;-243
6385;23.09.2016;'01 - 02;25,03;27,86;-2,83;0;0;0;2384;2138;-246
6386;23.09.2016;'02 - 03;24,68;26,83;-2,15;0;0;0;2427;2037;-390
6387;23.09.2016;'03 - 04;24,78;25,97;-1,19;0;0;0;2441;2073;-368
6388;23.09.2016;'04 - 05;25,14;25,5;-0,36;0;0;0;2470;2142;-328
6389;23.09.2016;'05 - 06;26,47;28,85;-2,38;0;0;0;2543;2195;-348
6390;23.09.2016;'06 - 07;36,06;37,43;-1,37;5;2;-3;2682;2234;-448
6391;23.09.2016;'07 - 08;43,04;44,49;-1,45;662;546;-116;2779;2188;-591
6392;23.09.2016;'08 - 09;43,01;45,97;-2,96;3837;3613;-224;2698;2238;-460
6393;23.09.2016;'09 - 10;38,94;39,95;-1,01;8116;8556;440;2338;1791;-547
6394;23.09.2016;'10 - 11;33,83;34,67;-0,84;12315;13625;1310;1929;1322;-607
6395;23.09.2016;'11 - 12;28,77;28,55;0,22;15505;17308;1803;1958;1833;-125
6396;23.09.2016;'12 - 13;27,69;27,18;0,51;17089;18878;1789;2494;2948;454
6397;23.09.2016;'13 - 14;27,54;26,21;1,33;16783;18163;1380;3101;3865;764
6398;23.09.2016;'14 - 15;26,6;26,91;-0,31;15004;15648;644;3588;4393;805
6399;23.09.2016;'15 - 16;27,66;29,22;-1,56;12182;12286;104;4003;5278;1275
6400;23.09.2016;'16 - 17;27,68;30,04;-2,36;8659;8735;76;4306;5202;896
6401;23.09.2016;'17 - 18;31,06;32,23;-1,17;4648;4856;208;4301;4965;664
6402;23.09.2016;'18 - 19;35,91;37,03;-1,12;1180;1283;103;3954;3989;35
6403;23.09.2016;'19 - 20;41,83;42,8;-0,97;50;34;-16;3667;3260;-407
6404;23.09.2016;'20 - 21;39,98;42,11;-2,13;0;0;0;3401;3485;84
6405;23.09.2016;'21 - 22;30,36;32,47;-2,11;0;0;0;3375;3381;6
6406;23.09.2016;'22 - 23;27,7;30,16;-2,46;0;0;0;3384;3383;-1
6407;23.09.2016;'23 - 24;26,79;28,92;-2,13;0;0;0;3301;3284;-17
6408;24.09.2016;'00 - 01;26,27;28,1;-1,83;0;0;0;4046;3422;-624
6409;24.09.2016;'01 - 02;24,68;25,64;-0,96;0;0;0;3880;3349;-531
6410;24.09.2016;'02 - 03;24,39;25,2;-0,81;0;0;0;3780;3325;-455
6411;24.09.2016;'03 - 04;25,15;24,15;1;0;0;0;3718;3406;-312
6412;24.09.2016;'04 - 05;24,65;24,99;-0,34;0;0;0;3651;3497;-154
6413;24.09.2016;'05 - 06;24,59;27,24;-2,65;0;0;0;3520;3763;243
6414;24.09.2016;'06 - 07;27,31;28,88;-1,57;6;2;-4;3327;3650;323
6415;24.09.2016;'07 - 08;31,15;30,83;0,32;794;603;-191;3114;3466;352
6416;24.09.2016;'08 - 09;34,63;32,3;2,33;4756;4198;-558;2862;3330;468
6417;24.09.2016;'09 - 10;34,04;33,65;0,39;10223;9879;-344;2547;2751;204
6418;24.09.2016;'10 - 11;29;29,36;-0,36;15288;15449;161;2205;2398;193
6419;24.09.2016;'11 - 12;25,43;25,33;0,1;18912;19720;808;2050;2526;476
6420;24.09.2016;'12 - 13;24,32;23,36;0,96;20852;21423;571;2245;2707;462
6421;24.09.2016;'13 - 14;24,26;22,71;1,55;20895;21092;197;2483;3066;583
6422;24.09.2016;'14 - 15;24,4;23,56;0,84;19208;19298;90;2572;3071;499
6423;24.09.2016;'15 - 16;24,93;23,8;1,13;15960;16234;274;2353;2935;582
6424;24.09.2016;'16 - 17;28,01;25,97;2,04;11331;11708;377;2079;2295;216
6425;24.09.2016;'17 - 18;34,58;32,88;1,7;5919;6096;177;2071;1564;-507
6426;24.09.2016;'18 - 19;38,08;37,66;0,42;1425;1513;88;2640;1406;-1234
6427;24.09.2016;'19 - 20;42,63;40,62;2,01;50;33;-17;3669;1972;-1697
6428;24.09.2016;'20 - 21;40,99;41,52;-0,53;0;0;0;4734;3209;-1525
6429;24.09.2016;'21 - 22;34,53;37,33;-2,8;0;0;0;6228;4754;-1474
6430;24.09.2016;'22 - 23;31,15;31,84;-0,69;0;0;0;7707;6324;-1383
6431;24.09.2016;'23 - 24;25,46;27,57;-2,11;0;0;0;8591;7797;-794
6432;25.09.2016;'00 - 01;24,46;23,21;1,25;0;0;0;8715;9042;327
6433;25.09.2016;'01 - 02;22,06;20,6;1,46;0;0;0;9130;9514;384
6434;25.09.2016;'02 - 03;20,55;11,03;9,52;0;0;0;9268;9743;475
6435;25.09.2016;'03 - 04;17,84;7,12;10,72;0;0;0;9143;9876;733
6436;25.09.2016;'04 - 05;17,7;8,36;9,34;0;0;0;9034;9691;657
6437;25.09.2016;'05 - 06;19,68;8,84;10,84;0;0;0;9006;9457;451
6438;25.09.2016;'06 - 07;20,09;10,45;9,64;6;2;-4;9185;9062;-123
6439;25.09.2016;'07 - 08;21,47;17;4,47;741;608;-133;9291;9228;-63
6440;25.09.2016;'08 - 09;22,45;20,26;2,19;4823;4500;-323;8843;8676;-167
6441;25.09.2016;'09 - 10;22,95;21,26;1,69;10880;10535;-345;7585;6828;-757
6442;25.09.2016;'10 - 11;21,09;19,83;1,26;16631;16230;-401;6238;5054;-1184
6443;25.09.2016;'11 - 12;21,09;19,4;1,69;20562;19995;-567;5764;4907;-857
6444;25.09.2016;'12 - 13;15,97;15,28;0,69;22524;22120;-404;6010;5821;-189
6445;25.09.2016;'13 - 14;10,93;11,75;-0,82;22567;22302;-265;6286;6819;533
6446;25.09.2016;'14 - 15;11,49;10,53;0,96;20804;20633;-171;6294;7021;727
6447;25.09.2016;'15 - 16;12,89;9,11;3,78;17312;17189;-123;5954;6369;415
6448;25.09.2016;'16 - 17;19,76;16,48;3,28;12145;12066;-79;5556;5772;216
6449;25.09.2016;'17 - 18;26,55;25,19;1,36;6124;6034;-90;5388;4962;-426
6450;25.09.2016;'18 - 19;35,09;31,89;3,2;1383;1302;-81;5866;4908;-958
6451;25.09.2016;'19 - 20;40,95;40,14;0,81;44;26;-18;6814;6617;-197
6452;25.09.2016;'20 - 21;40,94;40,22;0,72;1;0;-1;7482;7895;413
6453;25.09.2016;'21 - 22;33,53;32,41;1,12;0;0;0;7761;8496;735
6454;25.09.2016;'22 - 23;29,57;30;-0,43;0;0;0;7704;8216;512
6455;25.09.2016;'23 - 24;24,52;25,93;-1,41;0;0;0;7340;7596;256
6456;26.09.2016;'00 - 01;24,27;26,36;-2,09;0;0;0;7285;6880;-405
6457;26.09.2016;'01 - 02;24,2;25,86;-1,66;0;0;0;6435;6386;-49
6458;26.09.2016;'02 - 03;23,42;23,22;0,2;0;0;0;5808;5373;-435
6459;26.09.2016;'03 - 04;23,28;22,52;0,76;0;0;0;5435;4730;-705
6460;26.09.2016;'04 - 05;23,49;24,8;-1,31;0;0;0;5214;4799;-415
6461;26.09.2016;'05 - 06;25,46;25,71;-0,25;0;0;0;5072;4502;-570
6462;26.09.2016;'06 - 07;39,24;37,83;1,41;6;2;-4;4767;3884;-883
6463;26.09.2016;'07 - 08;46,53;45,49;1,04;581;446;-135;4268;3256;-1012
6464;26.09.2016;'08 - 09;49;52,99;-3,99;3586;3230;-356;3492;2556;-936
6465;26.09.2016;'09 - 10;46,84;49,74;-2,9;7761;7542;-219;2505;1522;-983
6466;26.09.2016;'10 - 11;39,97;41,75;-1,78;11684;11984;300;1663;836;-827
6467;26.09.2016;'11 - 12;37,39;38,87;-1,48;14519;15120;601;1212;504;-708
6468;26.09.2016;'12 - 13;34,94;33,59;1,35;15984;16600;616;1080;466;-614
6469;26.09.2016;'13 - 14;33,95;33,31;0,64;15827;16324;497;1004;574;-430
6470;26.09.2016;'14 - 15;32,44;34,21;-1,77;14273;14895;622;934;612;-322
6471;26.09.2016;'15 - 16;35;37,96;-2,96;11651;12154;503;907;538;-369
6472;26.09.2016;'16 - 17;39,87;51,01;-11,14;8085;8286;201;939;559;-380
6473;26.09.2016;'17 - 18;44,65;51,31;-6,66;4098;4063;-35;1032;700;-332
6474;26.09.2016;'18 - 19;49,55;55,13;-5,58;904;836;-68;1231;938;-293
6475;26.09.2016;'19 - 20;54,12;60,45;-6,33;25;17;-8;1537;1601;64
6476;26.09.2016;'20 - 21;51,23;55,46;-4,23;0;0;0;1816;2114;298
6477;26.09.2016;'21 - 22;37,93;42,76;-4,83;0;0;0;1952;2299;347
6478;26.09.2016;'22 - 23;30,52;33,63;-3,11;0;0;0;1989;2268;279
6479;26.09.2016;'23 - 24;28,4;28,96;-0,56;0;0;0;1942;1879;-63
6480;27.09.2016;'00 - 01;31,33;33,58;-2,25;0;0;0;1848;2719;871
6481;27.09.2016;'01 - 02;30,74;31,39;-0,65;0;0;0;1617;2746;1129
6482;27.09.2016;'02 - 03;29,75;30,16;-0,41;0;0;0;1449;2605;1156
6483;27.09.2016;'03 - 04;28,73;29,41;-0,68;0;0;0;1386;2431;1045
6484;27.09.2016;'04 - 05;27,84;30,23;-2,39;0;0;0;1343;2547;1204
6485;27.09.2016;'05 - 06;29,56;33,84;-4,28;0;0;0;1311;2734;1423
6486;27.09.2016;'06 - 07;41,53;38,89;2,64;5;1;-4;1334;2652;1318
6487;27.09.2016;'07 - 08;49;51,37;-2,37;455;398;-57;1364;2787;1423
6488;27.09.2016;'08 - 09;50;56,88;-6,88;3117;3028;-89;1310;3107;1797
6489;27.09.2016;'09 - 10;44,98;50,84;-5,86;7142;7069;-73;1232;2900;1668
6490;27.09.2016;'10 - 11;40,22;42,14;-1,92;11353;11188;-165;1182;2860;1678
6491;27.09.2016;'11 - 12;33,93;36,71;-2,78;14835;15058;223;1270;3256;1986
6492;27.09.2016;'12 - 13;29,17;31,45;-2,28;17052;18287;1235;1558;4006;2448
6493;27.09.2016;'13 - 14;28,28;28,3;-0,02;17482;18950;1468;2000;4616;2616
6494;27.09.2016;'14 - 15;27,91;26,58;1,33;16329;17789;1460;2533;5360;2827
6495;27.09.2016;'15 - 16;28,29;27,03;1,26;13739;14878;1139;3049;6322;3273
6496;27.09.2016;'16 - 17;29,33;25,39;3,94;9654;10427;773;3470;6678;3208
6497;27.09.2016;'17 - 18;38,91;31,69;7,22;4878;5181;303;3816;6186;2370
6498;27.09.2016;'18 - 19;45,2;39,99;5,21;1031;1074;43;4330;5847;1517
6499;27.09.2016;'19 - 20;48,97;46,14;2,83;25;19;-6;5150;6866;1716
6500;27.09.2016;'20 - 21;41,91;37,52;4,39;0;0;0;6077;8084;2007
6501;27.09.2016;'21 - 22;29,94;28,56;1,38;0;0;0;7621;9456;1835
6502;27.09.2016;'22 - 23;27,82;27,16;0,66;0;0;0;9343;10895;1552
6503;27.09.2016;'23 - 24;24,36;24,32;0,04;0;0;0;10862;12132;1270
6504;28.09.2016;'00 - 01;24,01;23,56;0,45;0;0;0;10995;12094;1099
6505;28.09.2016;'01 - 02;21,03;21,69;-0,66;0;0;0;12258;13050;792
6506;28.09.2016;'02 - 03;16,19;17,55;-1,36;0;0;0;13315;13778;463
6507;28.09.2016;'03 - 04;14,66;18,8;-4,14;0;0;0;14115;14505;390
6508;28.09.2016;'04 - 05;14,91;17,32;-2,41;0;0;0;14936;15394;458
6509;28.09.2016;'05 - 06;19,89;25,7;-5,81;0;0;0;15785;16420;635
6510;28.09.2016;'06 - 07;28,52;31,32;-2,8;4;2;-2;16819;17348;529
6511;28.09.2016;'07 - 08;37,94;44,41;-6,47;466;358;-108;17853;18530;677
6512;28.09.2016;'08 - 09;38,1;44,22;-6,12;3184;2736;-448;18490;19374;884
6513;28.09.2016;'09 - 10;32,22;33,89;-1,67;7165;6468;-697;18724;19126;402
6514;28.09.2016;'10 - 11;26;27,8;-1,8;11009;10429;-580;19262;19762;500
6515;28.09.2016;'11 - 12;23,06;25,84;-2,78;13898;14042;144;20443;22076;1633
6516;28.09.2016;'12 - 13;19,79;16,4;3,39;15544;15757;213;21598;23832;2234
6517;28.09.2016;'13 - 14;12,94;11,58;1,36;15667;15624;-43;22425;24708;2283
6518;28.09.2016;'14 - 15;12,95;10,53;2,42;14431;13704;-727;23033;24758;1725
6519;28.09.2016;'15 - 16;16,84;14,46;2,38;11951;11000;-951;23188;24458;1270
6520;28.09.2016;'16 - 17;22,67;23,19;-0,52;8310;7352;-958;22161;23184;1023
6521;28.09.2016;'17 - 18;26,45;31,05;-4,6;4211;3609;-602;20659;20942;283
6522;28.09.2016;'18 - 19;33,53;41,25;-7,72;913;709;-204;19075;18730;-345
6523;28.09.2016;'19 - 20;39,59;51,33;-11,74;25;15;-10;18117;18117;0
6524;28.09.2016;'20 - 21;34,36;42;-7,64;0;0;0;17721;18445;724
6525;28.09.2016;'21 - 22;28,14;30,47;-2,33;0;0;0;17823;18393;570
6526;28.09.2016;'22 - 23;24,41;24,02;0,39;0;0;0;17943;18202;259
6527;28.09.2016;'23 - 24;22,02;18,87;3,15;0;0;0;18094;18096;2
6528;29.09.2016;'00 - 01;19,93;16,42;3,51;0;0;0;16683;17478;795
6529;29.09.2016;'01 - 02;16,1;17,53;-1,43;0;0;0;16559;17447;888
6530;29.09.2016;'02 - 03;18,63;23,72;-5,09;0;0;0;16596;17374;778
6531;29.09.2016;'03 - 04;14,57;22,58;-8,01;0;0;0;16819;17558;739
6532;29.09.2016;'04 - 05;14,15;20,23;-6,08;0;0;0;17320;18015;695
6533;29.09.2016;'05 - 06;21,08;29,02;-7,94;0;0;0;18119;18699;580
6534;29.09.2016;'06 - 07;28,93;31,83;-2,9;3;1;-2;19023;19800;777
6535;29.09.2016;'07 - 08;37,97;42,29;-4,32;466;373;-93;19816;20177;361
6536;29.09.2016;'08 - 09;37,84;41,65;-3,81;3434;3299;-135;20452;19934;-518
6537;29.09.2016;'09 - 10;28,42;34,84;-6,42;7904;8396;492;20852;19908;-944
6538;29.09.2016;'10 - 11;23,59;23,62;-0,03;12293;13439;1146;21399;20919;-480
6539;29.09.2016;'11 - 12;21,71;14,48;7,23;15578;17133;1555;22301;22508;207
6540;29.09.2016;'12 - 13;15,84;11,21;4,63;17411;19230;1819;23365;24071;706
6541;29.09.2016;'13 - 14;12,65;3,64;9,01;17520;19092;1572;24314;24768;454
6542;29.09.2016;'14 - 15;11,43;-2,9;14,33;16038;17062;1024;24947;25760;813
6543;29.09.2016;'15 - 16;12,66;0,8;11,86;13169;13960;791;25414;26685;1271
6544;29.09.2016;'16 - 17;14,78;3,88;10,9;8999;9715;716;25247;26535;1288
6545;29.09.2016;'17 - 18;24,61;19,69;4,92;4334;4660;326;24623;25525;902
6546;29.09.2016;'18 - 19;29,1;31,72;-2,62;842;822;-20;23659;24122;463
6547;29.09.2016;'19 - 20;37,91;38,88;-0,97;17;7;-10;22652;23248;596
6548;29.09.2016;'20 - 21;32,05;30,94;1,11;0;0;0;21953;22538;585
6549;29.09.2016;'21 - 22;25,03;24,64;0,39;0;0;0;21549;21989;440
6550;29.09.2016;'22 - 23;22,69;19,95;2,74;0;0;0;20930;20620;-310
6551;29.09.2016;'23 - 24;16,85;13,68;3,17;0;0;0;20088;19270;-818
6552;30.09.2016;'00 - 01;23,79;27,24;-3,45;0;0;0;17376;17942;566
6553;30.09.2016;'01 - 02;23,32;25,58;-2,26;0;0;0;16238;16552;314
6554;30.09.2016;'02 - 03;23,81;28,31;-4,5;0;0;0;15203;15035;-168
6555;30.09.2016;'03 - 04;23,09;26,93;-3,84;0;0;0;14358;13101;-1257
6556;30.09.2016;'04 - 05;24,02;25,69;-1,67;0;0;0;13686;11763;-1923
6557;30.09.2016;'05 - 06;25,73;28,01;-2,28;0;0;0;13056;10536;-2520
6558;30.09.2016;'06 - 07;39,68;48,79;-9,11;4;1;-3;12406;10196;-2210
6559;30.09.2016;'07 - 08;49,66;71,66;-22;386;294;-92;11782;9956;-1826
6560;30.09.2016;'08 - 09;49,97;66,95;-16,98;2749;2462;-287;11197;9466;-1731
6561;30.09.2016;'09 - 10;43,91;57;-13,09;6304;5955;-349;10546;8894;-1652
6562;30.09.2016;'10 - 11;39,96;53,59;-13,63;9676;9240;-436;10099;8512;-1587
6563;30.09.2016;'11 - 12;39,6;52,02;-12,42;12093;11988;-105;10155;9262;-893
6564;30.09.2016;'12 - 13;37,9;48,36;-10,46;13316;13325;9;10593;11169;576
6565;30.09.2016;'13 - 14;29,65;34,2;-4,55;13175;13119;-56;11005;12082;1077
6566;30.09.2016;'14 - 15;29,37;34,46;-5,09;11891;11571;-320;11092;11926;834
6567;30.09.2016;'15 - 16;31,96;38,72;-6,76;9691;9310;-381;10918;11300;382
6568;30.09.2016;'16 - 17;31,19;41,68;-10,49;6615;6582;-33;10506;10164;-342
6569;30.09.2016;'17 - 18;31,48;39,7;-8,22;3170;3248;78;9481;9301;-180
6570;30.09.2016;'18 - 19;37,99;41;-3,01;612;632;20;8257;7618;-639
6571;30.09.2016;'19 - 20;42,91;48,07;-5,16;9;7;-2;7349;7063;-286
6572;30.09.2016;'20 - 21;38,97;41,6;-2,63;0;0;0;6741;7100;359
6573;30.09.2016;'21 - 22;31,9;36,44;-4,54;0;0;0;6515;7148;633
6574;30.09.2016;'22 - 23;30,93;34,73;-3,8;0;0;0;6301;6713;412
6575;30.09.2016;'23 - 24;28,43;32,72;-4,29;0;0;0;6077;5734;-343
6576;01.10.2016;'00 - 01;29,18;31,12;-1,94;0;0;0;6768;5184;-1584
6577;01.10.2016;'01 - 02;31,06;33,98;-2,92;0;0;0;6215;4450;-1765
6578;01.10.2016;'02 - 03;26;28,53;-2,53;0;0;0;5609;3590;-2019
6579;01.10.2016;'03 - 04;29,02;34,61;-5,59;0;0;0;5111;2957;-2154
6580;01.10.2016;'04 - 05;25,94;27,9;-1,96;0;0;0;4731;3129;-1602
6581;01.10.2016;'05 - 06;29,13;30,55;-1,42;0;0;0;4514;3222;-1292
6582;01.10.2016;'06 - 07;32,55;35,79;-3,24;2;1;-1;4448;3513;-935
6583;01.10.2016;'07 - 08;31,3;30,11;1,19;252;196;-56;4350;3906;-444
6584;01.10.2016;'08 - 09;38,38;28,97;9,41;1855;1933;78;4182;4295;113
6585;01.10.2016;'09 - 10;38,96;32,75;6,21;4296;4677;381;3822;4116;294
6586;01.10.2016;'10 - 11;39,94;33,33;6,61;6706;7117;411;3414;3430;16
6587;01.10.2016;'11 - 12;39,21;34,41;4,8;8577;8846;269;3373;3336;-37
6588;01.10.2016;'12 - 13;34,07;35,42;-1,35;9629;10147;518;3752;3444;-308
6589;01.10.2016;'13 - 14;30,53;32,58;-2,05;9571;10170;599;4208;3654;-554
6590;01.10.2016;'14 - 15;29,63;30,73;-1,1;8518;9209;691;4457;3553;-904
6591;01.10.2016;'15 - 16;29,18;31,3;-2,12;6778;6770;-8;4539;3482;-1057
6592;01.10.2016;'16 - 17;29,44;35,82;-6,38;4493;4092;-401;4582;3573;-1009
6593;01.10.2016;'17 - 18;34,63;39,12;-4,49;2132;1762;-370;4736;3871;-865
6594;01.10.2016;'18 - 19;39,93;47,19;-7,26;403;334;-69;5109;4452;-657
6595;01.10.2016;'19 - 20;45,03;53,62;-8,59;5;4;-1;5607;5518;-89
6596;01.10.2016;'20 - 21;40,06;44,5;-4,44;0;0;0;5757;6658;901
6597;01.10.2016;'21 - 22;30,74;29,81;0,93;0;0;0;6097;7108;1011
6598;01.10.2016;'22 - 23;28,84;28,94;-0,1;0;0;0;6507;7866;1359
6599;01.10.2016;'23 - 24;32,47;31,56;0,91;0;0;0;6851;7722;871
6600;02.10.2016;'00 - 01;32,68;30,57;2,11;0;0;0;8375;7366;-1009
6601;02.10.2016;'01 - 02;27,04;27,83;-0,79;0;0;0;8725;7336;-1389
6602;02.10.2016;'02 - 03;26,28;26,98;-0,7;0;0;0;9005;7532;-1473
6603;02.10.2016;'03 - 04;25,13;25,99;-0,86;0;0;0;9149;7812;-1337
6604;02.10.2016;'04 - 05;24,9;23,62;1,28;0;0;0;9230;7813;-1417
6605;02.10.2016;'05 - 06;25,03;24,26;0,77;0;0;0;9364;7732;-1632
6606;02.10.2016;'06 - 07;25,43;24,87;0,56;3;1;-2;9593;7840;-1753
6607;02.10.2016;'07 - 08;26,09;26,81;-0,72;281;183;-98;9827;8283;-1544
6608;02.10.2016;'08 - 09;29,7;29,81;-0,11;2336;2027;-309;10034;8083;-1951
6609;02.10.2016;'09 - 10;30,99;31,14;-0,15;5579;5087;-492;10278;7372;-2906
6610;02.10.2016;'10 - 11;29,88;32,34;-2,46;8449;7893;-556;10705;7442;-3263
6611;02.10.2016;'11 - 12;32,38;36,81;-4,43;10376;9650;-726;11153;8525;-2628
6612;02.10.2016;'12 - 13;29,11;34,47;-5,36;11239;9864;-1375;11385;9541;-1844
6613;02.10.2016;'13 - 14;26,64;31,59;-4,95;11108;9655;-1453;11574;9182;-2392
6614;02.10.2016;'14 - 15;25,01;29,13;-4,12;10074;9077;-997;11664;8946;-2718
6615;02.10.2016;'15 - 16;24,65;28,49;-3,84;8218;7535;-683;11402;8477;-2925
6616;02.10.2016;'16 - 17;25,06;28,51;-3,45;5594;5315;-279;10908;7794;-3114
6617;02.10.2016;'17 - 18;31,65;32,73;-1,08;2640;2743;103;10280;6830;-3450
6618;02.10.2016;'18 - 19;41,22;42,32;-1,1;457;490;33;9939;6038;-3901
6619;02.10.2016;'19 - 20;49,35;49,52;-0,17;5;6;1;10158;6536;-3622
6620;02.10.2016;'20 - 21;42,4;44,69;-2,29;0;0;0;11337;6825;-4512
6621;02.10.2016;'21 - 22;34,78;37,11;-2,33;0;0;0;12089;6818;-5271
6622;02.10.2016;'22 - 23;29,94;32,83;-2,89;0;0;0;12408;6817;-5591
6623;02.10.2016;'23 - 24;25,19;28,07;-2,88;0;0;0;12593;7188;-5405
6624;03.10.2016;'00 - 01;30,81;25,99;4,82;0;0;0;6485;7059;574
6625;03.10.2016;'01 - 02;26,11;23,88;2,23;0;0;0;6474;6949;475
6626;03.10.2016;'02 - 03;25,09;24,75;0,34;0;0;0;6375;6952;577
6627;03.10.2016;'03 - 04;24,54;24,62;-0,08;0;0;0;6251;6818;567
6628;03.10.2016;'04 - 05;24,59;25,73;-1,14;0;0;0;6047;6781;734
6629;03.10.2016;'05 - 06;25,78;25,82;-0,04;0;0;0;5795;6486;691
6630;03.10.2016;'06 - 07;36,12;26,2;9,92;1;0;-1;5627;6085;458
6631;03.10.2016;'07 - 08;40,96;26,41;14,55;219;164;-55;5587;6060;473
6632;03.10.2016;'08 - 09;38,19;29,8;8,39;1921;1633;-288;5534;6225;691
6633;03.10.2016;'09 - 10;39,76;31,51;8,25;4782;4373;-409;5426;6326;900
6634;03.10.2016;'10 - 11;32,6;31,3;1,3;7541;7122;-419;5339;6604;1265
6635;03.10.2016;'11 - 12;33,17;29,42;3,75;9643;9044;-599;5455;6995;1540
6636;03.10.2016;'12 - 13;26,19;23,5;2,69;10817;9837;-980;5873;7320;1447
6637;03.10.2016;'13 - 14;25,33;23,06;2,27;10764;10118;-646;6441;7613;1172
6638;03.10.2016;'14 - 15;24,59;24,61;-0,02;9747;9389;-358;6919;8445;1526
6639;03.10.2016;'15 - 16;29,39;27,66;1,73;7951;7479;-472;7374;8572;1198
6640;03.10.2016;'16 - 17;31,04;30,7;0,34;5434;4900;-534;7750;8272;522
6641;03.10.2016;'17 - 18;33,37;34,65;-1,28;2598;2280;-318;8011;8179;168
6642;03.10.2016;'18 - 19;37,1;38,17;-1,07;448;359;-89;8169;8314;145
6643;03.10.2016;'19 - 20;37,74;38,07;-0,33;6;4;-2;8480;9324;844
6644;03.10.2016;'20 - 21;32,63;31,89;0,74;0;0;0;9038;9806;768
6645;03.10.2016;'21 - 22;28,42;28,88;-0,46;0;0;0;9326;10202;876
6646;03.10.2016;'22 - 23;25,74;25,95;-0,21;0;0;0;9386;10376;990
6647;03.10.2016;'23 - 24;24,6;24,76;-0,16;0;0;0;9281;10516;1235
6648;04.10.2016;'00 - 01;25,96;27,2;-1,24;0;0;0;9924;10450;526
6649;04.10.2016;'01 - 02;25,28;26,03;-0,75;0;0;0;10306;10819;513
6650;04.10.2016;'02 - 03;24,05;26;-1,95;0;0;0;10822;11261;439
6651;04.10.2016;'03 - 04;22,03;22,23;-0,2;0;0;0;11316;11964;648
6652;04.10.2016;'04 - 05;23,25;19,54;3,71;0;0;0;11775;12526;751
6653;04.10.2016;'05 - 06;25,54;21,58;3,96;0;0;0;12041;13342;1301
6654;04.10.2016;'06 - 07;30,04;29,36;0,68;0;0;0;12170;14166;1996
6655;04.10.2016;'07 - 08;37,1;38,4;-1,3;221;142;-79;12245;14618;2373
6656;04.10.2016;'08 - 09;40,38;40,18;0,2;2112;1696;-416;12193;14740;2547
6657;04.10.2016;'09 - 10;36,78;35,02;1,76;5282;4541;-741;12407;14752;2345
6658;04.10.2016;'10 - 11;32,37;32,12;0,25;8309;7480;-829;13127;15603;2476
6659;04.10.2016;'11 - 12;28,71;32,18;-3,47;10561;9696;-865;13444;16046;2602
6660;04.10.2016;'12 - 13;31,29;33,87;-2,58;11796;11108;-688;13159;16072;2913
6661;04.10.2016;'13 - 14;32,08;36,35;-4,27;12046;11525;-521;12787;15804;3017
6662;04.10.2016;'14 - 15;31,99;38,25;-6,26;11324;11240;-84;12759;15794;3035
6663;04.10.2016;'15 - 16;31,87;35,25;-3,38;9474;9532;58;13112;15620;2508
6664;04.10.2016;'16 - 17;30,49;32,49;-2;6446;6692;246;13507;15650;2143
6665;04.10.2016;'17 - 18;35,7;34,54;1,16;2980;3170;190;13663;15200;1537
6666;04.10.2016;'18 - 19;37,88;35,72;2,16;460;442;-18;13857;14724;867
6667;04.10.2016;'19 - 20;39,09;40,06;-0,97;4;4;0;14532;15941;1409
6668;04.10.2016;'20 - 21;30,21;29,14;1,07;0;0;0;15372;17074;1702
6669;04.10.2016;'21 - 22;26,08;27,15;-1,07;0;0;0;15737;17750;2013
6670;04.10.2016;'22 - 23;24,78;24,22;0,56;0;0;0;15613;17496;1883
6671;04.10.2016;'23 - 24;24,93;22,73;2,2;0;0;0;15035;16629;1594
6672;05.10.2016;'00 - 01;25,06;18,58;6,48;0;0;0;14547;15584;1037
6673;05.10.2016;'01 - 02;23,67;15,49;8,18;0;0;0;13668;14892;1224
6674;05.10.2016;'02 - 03;22,45;13,59;8,86;0;0;0;12911;14731;1820
6675;05.10.2016;'03 - 04;22,23;12,43;9,8;0;0;0;12399;14781;2382
6676;05.10.2016;'04 - 05;22,71;9,64;13,07;0;0;0;12170;14479;2309
6677;05.10.2016;'05 - 06;24,3;14,97;9,33;0;0;0;12114;14180;2066
6678;05.10.2016;'06 - 07;31,17;28,62;2,55;1;0;-1;12203;14092;1889
6679;05.10.2016;'07 - 08;42,45;35,36;7,09;344;241;-103;12356;14037;1681
6680;05.10.2016;'08 - 09;41,97;37,81;4,16;3524;3394;-130;12700;13333;633
6681;05.10.2016;'09 - 10;30,14;28,7;1,44;8751;8552;-199;13288;12406;-882
6682;05.10.2016;'10 - 11;27,58;28,96;-1,38;12993;13460;467;14264;13902;-362
6683;05.10.2016;'11 - 12;27,51;27,54;-0,03;15366;15966;600;15239;15442;203
6684;05.10.2016;'12 - 13;26,33;26,34;-0,01;16082;16054;-28;15690;15771;81
6685;05.10.2016;'13 - 14;26,98;27,34;-0,36;15284;15025;-259;15791;15110;-681
6686;05.10.2016;'14 - 15;28,17;29,24;-1,07;13247;13871;624;15879;14650;-1229
6687;05.10.2016;'15 - 16;28,18;30,27;-2,09;10358;11037;679;15973;15516;-457
6688;05.10.2016;'16 - 17;29,99;29,43;0,56;6902;7349;447;15969;16128;159
6689;05.10.2016;'17 - 18;35;33,39;1,61;3138;3325;187;15831;16609;778
6690;05.10.2016;'18 - 19;42,2;39,38;2,82;485;483;-2;15712;15848;136
6691;05.10.2016;'19 - 20;41,08;41,25;-0,17;2;3;1;15910;16366;456
6692;05.10.2016;'20 - 21;33,37;36,09;-2,72;0;0;0;15959;17614;1655
6693;05.10.2016;'21 - 22;27,67;29,78;-2,11;0;0;0;16196;18272;2076
6694;05.10.2016;'22 - 23;26,98;27,16;-0,18;0;0;0;16262;18057;1795
6695;05.10.2016;'23 - 24;25,02;26,11;-1,09;0;0;0;16054;17797;1743
6696;06.10.2016;'00 - 01;13,65;20,13;-6,48;0;0;0;17531;17854;323
6697;06.10.2016;'01 - 02;17,1;21,85;-4,75;0;0;0;17485;18103;618
6698;06.10.2016;'02 - 03;16,05;20,09;-4,04;0;0;0;17490;17910;420
6699;06.10.2016;'03 - 04;12,3;19,52;-7,22;0;0;0;17369;17618;249
6700;06.10.2016;'04 - 05;19,55;23,51;-3,96;0;0;0;17119;17401;282
6701;06.10.2016;'05 - 06;24,06;27,32;-3,26;0;0;0;16992;17615;623
6702;06.10.2016;'06 - 07;27,63;30,01;-2,38;0;0;0;16839;17605;766
6703;06.10.2016;'07 - 08;33,19;30,97;2,22;59;39;-20;16655;16879;224
6704;06.10.2016;'08 - 09;32,57;38,42;-5,85;632;655;23;16535;16009;-526
6705;06.10.2016;'09 - 10;36,19;41,32;-5,13;1796;1984;188;16434;14890;-1544
6706;06.10.2016;'10 - 11;36,45;46,48;-10,03;2924;3372;448;16349;14611;-1738
6707;06.10.2016;'11 - 12;36,77;45,63;-8,86;3676;4058;382;16335;14185;-2150
6708;06.10.2016;'12 - 13;36,97;43,65;-6,68;3990;4451;461;16267;13663;-2604
6709;06.10.2016;'13 - 14;36,44;42,5;-6,06;3959;4448;489;16138;13460;-2678
6710;06.10.2016;'14 - 15;34,18;39,03;-4,85;3576;3878;302;16021;13293;-2728
6711;06.10.2016;'15 - 16;34,06;37,65;-3,59;2860;3146;286;15719;13427;-2292
6712;06.10.2016;'16 - 17;33,42;36,05;-2,63;1845;2030;185;15209;13510;-1699
6713;06.10.2016;'17 - 18;42,42;48,02;-5,6;812;824;12;14737;13737;-1000
6714;06.10.2016;'18 - 19;42,47;49,87;-7,4;131;108;-23;14354;13696;-658
6715;06.10.2016;'19 - 20;49,69;61,7;-12,01;0;0;0;13998;13610;-388
6716;06.10.2016;'20 - 21;40,02;44,38;-4,36;0;0;0;13380;13158;-222
6717;06.10.2016;'21 - 22;34,23;37,29;-3,06;0;0;0;12565;12060;-505
6718;06.10.2016;'22 - 23;30,68;33,37;-2,69;0;0;0;11736;10845;-891
6719;06.10.2016;'23 - 24;28,43;32,67;-4,24;0;0;0;11024;9925;-1099
6720;07.10.2016;'00 - 01;28,87;33,45;-4,58;0;0;0;11458;8926;-2532
6721;07.10.2016;'01 - 02;26,9;32,58;-5,68;0;0;0;10934;8520;-2414
6722;07.10.2016;'02 - 03;26,98;32,29;-5,31;0;0;0;10327;8395;-1932
6723;07.10.2016;'03 - 04;27,59;31,23;-3,64;0;0;0;9701;7787;-1914
6724;07.10.2016;'04 - 05;27,96;31,44;-3,48;0;0;0;9193;7416;-1777
6725;07.10.2016;'05 - 06;29,93;34,36;-4,43;0;0;0;8817;7086;-1731
6726;07.10.2016;'06 - 07;42,28;50,35;-8,07;0;0;0;8565;6675;-1890
6727;07.10.2016;'07 - 08;42;48,45;-6,45;92;54;-38;8367;6620;-1747
6728;07.10.2016;'08 - 09;45,58;64,51;-18,93;919;764;-155;8174;6686;-1488
6729;07.10.2016;'09 - 10;45,05;57,75;-12,7;2467;2474;7;8038;6362;-1676
6730;07.10.2016;'10 - 11;46,53;57,07;-10,54;4285;4531;246;7953;6106;-1847
6731;07.10.2016;'11 - 12;52,32;60,02;-7,7;5994;6096;102;7679;5880;-1799
6732;07.10.2016;'12 - 13;53,07;59,18;-6,11;7239;6996;-243;7148;5502;-1646
6733;07.10.2016;'13 - 14;47,11;57,46;-10,35;7557;7198;-359;6762;5184;-1578
6734;07.10.2016;'14 - 15;44,06;58,16;-14,1;7076;6412;-664;6667;5190;-1477
6735;07.10.2016;'15 - 16;42,47;52,08;-9,61;5866;4973;-893;6553;5234;-1319
6736;07.10.2016;'16 - 17;41,98;52,05;-10,07;3894;3067;-827;6516;5115;-1401
6737;07.10.2016;'17 - 18;38,49;50,53;-12,04;1702;1255;-447;6538;4922;-1616
6738;07.10.2016;'18 - 19;41,94;57,57;-15,63;232;150;-82;6756;5200;-1556
6739;07.10.2016;'19 - 20;42,46;58,62;-16,16;1;0;-1;7083;5803;-1280
6740;07.10.2016;'20 - 21;33,1;41,96;-8,86;0;0;0;7150;6078;-1072
6741;07.10.2016;'21 - 22;30,53;34,96;-4,43;0;0;0;7112;6631;-481
6742;07.10.2016;'22 - 23;31,12;37,29;-6,17;0;0;0;7039;6365;-674
6743;07.10.2016;'23 - 24;32,97;39,61;-6,64;0;0;0;6856;5852;-1004
6744;08.10.2016;'00 - 01;31,04;30,18;0,86;0;0;0;5690;5539;-151
6745;08.10.2016;'01 - 02;28,78;27,51;1,27;0;0;0;5445;5605;160
6746;08.10.2016;'02 - 03;29,97;28,13;1,84;0;0;0;5367;5526;159
6747;08.10.2016;'03 - 04;29,7;26,36;3,34;0;0;0;5458;5646;188
6748;08.10.2016;'04 - 05;29,99;26,09;3,9;0;0;0;5599;5675;76
6749;08.10.2016;'05 - 06;29,56;26,87;2,69;0;0;0;5767;6278;511
6750;08.10.2016;'06 - 07;31,59;27,87;3,72;0;0;0;5900;6216;316
6751;08.10.2016;'07 - 08;33,39;32,85;0,54;121;69;-52;5942;5989;47
6752;08.10.2016;'08 - 09;40,04;34,91;5,13;1421;1281;-140;5838;5736;-102
6753;08.10.2016;'09 - 10;43,41;37,32;6,09;3932;3804;-128;5578;5602;24
6754;08.10.2016;'10 - 11;44,94;40,42;4,52;6404;6359;-45;5380;5758;378
6755;08.10.2016;'11 - 12;42,08;37,11;4,97;8373;8144;-229;5346;6150;804
6756;08.10.2016;'12 - 13;33,58;31,72;1,86;9477;8857;-620;5246;6278;1032
6757;08.10.2016;'13 - 14;32,48;33,07;-0,59;9522;8154;-1368;5145;6050;905
6758;08.10.2016;'14 - 15;33,03;35,34;-2,31;8726;7424;-1302;5348;5837;489
6759;08.10.2016;'15 - 16;32,44;34,65;-2,21;7111;6196;-915;5588;5545;-43
6760;08.10.2016;'16 - 17;37,02;40,19;-3,17;4716;4164;-552;5795;5422;-373
6761;08.10.2016;'17 - 18;42,69;41,92;0,77;2065;1797;-268;5797;4973;-824
6762;08.10.2016;'18 - 19;46;45,9;0,1;273;206;-67;5729;5094;-635
6763;08.10.2016;'19 - 20;52,75;55,53;-2,78;1;0;-1;5863;5709;-154
6764;08.10.2016;'20 - 21;42,92;42,84;0,08;0;0;0;5901;6196;295
6765;08.10.2016;'21 - 22;35;33,95;1,05;0;0;0;5835;6146;311
6766;08.10.2016;'22 - 23;32,44;34,12;-1,68;0;0;0;5710;5782;72
6767;08.10.2016;'23 - 24;31,12;31,64;-0,52;0;0;0;5534;5424;-110
6768;09.10.2016;'00 - 01;28,71;29,85;-1,14;0;0;0;5480;4927;-553
6769;09.10.2016;'01 - 02;28,45;28,32;0,13;0;0;0;5301;4705;-596
6770;09.10.2016;'02 - 03;29,25;29,48;-0,23;0;0;0;5165;4480;-685
6771;09.10.2016;'03 - 04;28,79;28,34;0,45;0;0;0;5069;4400;-669
6772;09.10.2016;'04 - 05;28,72;28,22;0,5;0;0;0;5029;4392;-637
6773;09.10.2016;'05 - 06;28,09;27,46;0,63;0;0;0;4979;4517;-462
6774;09.10.2016;'06 - 07;28,55;29,91;-1,36;0;0;0;4933;4758;-175
6775;09.10.2016;'07 - 08;29,11;31,3;-2,19;119;66;-53;4880;4708;-172
6776;09.10.2016;'08 - 09;31,87;32,51;-0,64;1582;1376;-206;4749;4535;-214
6777;09.10.2016;'09 - 10;33,68;34,67;-0,99;4507;4042;-465;4474;3855;-619
6778;09.10.2016;'10 - 11;33,34;36,42;-3,08;7386;7122;-264;4226;3569;-657
6779;09.10.2016;'11 - 12;34,13;35,46;-1,33;9628;9492;-136;4025;3183;-842
6780;09.10.2016;'12 - 13;32,06;34,94;-2,88;10887;10651;-236;3840;2800;-1040
6781;09.10.2016;'13 - 14;28,81;31,95;-3,14;10912;10602;-310;3645;2626;-1019
6782;09.10.2016;'14 - 15;28,23;32,73;-4,5;9831;9718;-113;3495;2437;-1058
6783;09.10.2016;'15 - 16;28,21;33,2;-4,99;7822;7774;-48;3325;2322;-1003
6784;09.10.2016;'16 - 17;28,8;31,89;-3,09;5061;5123;62;3124;1944;-1180
6785;09.10.2016;'17 - 18;32,95;32,57;0,38;2114;2196;82;2939;1426;-1513
6786;09.10.2016;'18 - 19;41,29;39,49;1,8;243;216;-27;2820;1320;-1500
6787;09.10.2016;'19 - 20;50,52;50,1;0,42;0;0;0;2738;1280;-1458
6788;09.10.2016;'20 - 21;45,29;45,66;-0,37;0;0;0;2500;1167;-1333
6789;09.10.2016;'21 - 22;43,45;44,1;-0,65;0;0;0;2318;1146;-1172
6790;09.10.2016;'22 - 23;42,24;42,23;0,01;0;0;0;2196;955;-1241
6791;09.10.2016;'23 - 24;34,39;36,51;-2,12;0;0;0;2081;932;-1149
6792;10.10.2016;'00 - 01;29,58;28,8;0,78;0;0;0;866;850;-16
6793;10.10.2016;'01 - 02;31,87;32,75;-0,88;0;0;0;796;645;-151
6794;10.10.2016;'02 - 03;33,49;34,51;-1,02;0;0;0;769;502;-267
6795;10.10.2016;'03 - 04;30,66;31,18;-0,52;0;0;0;802;563;-239
6796;10.10.2016;'04 - 05;30,19;30,31;-0,12;0;0;0;877;657;-220
6797;10.10.2016;'05 - 06;31,28;28,85;2,43;0;0;0;952;616;-336
6798;10.10.2016;'06 - 07;48,85;38,28;10,57;0;0;0;1033;572;-461
6799;10.10.2016;'07 - 08;69,24;52,74;16,5;130;81;-49;1102;610;-492
6800;10.10.2016;'08 - 09;75;64,97;10,03;1903;1362;-541;1113;767;-346
6801;10.10.2016;'09 - 10;70,16;58,39;11,77;5462;3939;-1523;1036;907;-129
6802;10.10.2016;'10 - 11;60,13;63,7;-3,57;9067;6785;-2282;977;814;-163
6803;10.10.2016;'11 - 12;55,66;65,13;-9,47;11783;9254;-2529;941;663;-278
6804;10.10.2016;'12 - 13;51,99;63,45;-11,46;13162;10989;-2173;975;584;-391
6805;10.10.2016;'13 - 14;53,21;58,61;-5,4;12763;10882;-1881;1032;670;-362
6806;10.10.2016;'14 - 15;52,65;58,67;-6,02;10997;9159;-1838;1202;798;-404
6807;10.10.2016;'15 - 16;51,91;57,69;-5,78;8396;6518;-1878;1440;982;-458
6808;10.10.2016;'16 - 17;55;61,83;-6,83;5333;3924;-1409;1764;1211;-553
6809;10.10.2016;'17 - 18;57,24;64,67;-7,43;2179;1483;-696;2222;1596;-626
6810;10.10.2016;'18 - 19;69,94;71,1;-1,16;231;128;-103;2831;2006;-825
6811;10.10.2016;'19 - 20;81,93;73,44;8,49;0;0;0;3412;2174;-1238
6812;10.10.2016;'20 - 21;57,1;54,39;2,71;0;0;0;3658;2563;-1095
6813;10.10.2016;'21 - 22;43,41;41,66;1,75;0;0;0;4015;2718;-1297
6814;10.10.2016;'22 - 23;33,48;33,84;-0,36;0;0;0;4452;2968;-1484
6815;10.10.2016;'23 - 24;30,53;32,37;-1,84;0;0;0;4817;3326;-1491
6816;11.10.2016;'00 - 01;32,34;31,81;0,53;0;0;0;4930;3525;-1405
6817;11.10.2016;'01 - 02;30,23;32,47;-2,24;0;0;0;5334;3838;-1496
6818;11.10.2016;'02 - 03;29,08;30,53;-1,45;0;0;0;5789;4278;-1511
6819;11.10.2016;'03 - 04;29,16;32,11;-2,95;0;0;0;6278;4614;-1664
6820;11.10.2016;'04 - 05;30,18;32,2;-2,02;0;0;0;6724;4669;-2055
6821;11.10.2016;'05 - 06;31,91;34,29;-2,38;0;0;0;7053;5127;-1926
6822;11.10.2016;'06 - 07;36,91;40,92;-4,01;0;0;0;7189;5718;-1471
6823;11.10.2016;'07 - 08;45,93;46,73;-0,8;85;44;-41;7283;6164;-1119
6824;11.10.2016;'08 - 09;49,39;47,56;1,83;1322;968;-354;7331;6318;-1013
6825;11.10.2016;'09 - 10;49,35;52,28;-2,93;3922;3120;-802;7301;6111;-1190
6826;11.10.2016;'10 - 11;47,58;46,75;0,83;6397;5818;-579;7246;6119;-1127
6827;11.10.2016;'11 - 12;45,08;43,59;1,49;8191;7924;-267;7293;6184;-1109
6828;11.10.2016;'12 - 13;40,08;38,47;1,61;8941;8701;-240;7457;6324;-1133
6829;11.10.2016;'13 - 14;39,91;35,61;4,3;8494;7905;-589;7730;6687;-1043
6830;11.10.2016;'14 - 15;37,88;34,26;3,62;7150;6390;-760;8220;7295;-925
6831;11.10.2016;'15 - 16;39,25;36,49;2,76;5313;4412;-901;8470;7753;-717
6832;11.10.2016;'16 - 17;39,96;39,14;0,82;3318;2572;-746;8814;7885;-929
6833;11.10.2016;'17 - 18;42,67;39,61;3,06;1327;914;-413;9123;8201;-922
6834;11.10.2016;'18 - 19;44,97;42,43;2,54;149;73;-76;9307;8824;-483
6835;11.10.2016;'19 - 20;44,54;39,41;5,13;0;0;0;9471;9711;240
6836;11.10.2016;'20 - 21;35,45;34,4;1,05;0;0;0;9603;10359;756
6837;11.10.2016;'21 - 22;34,23;31,59;2,64;0;0;0;9553;10583;1030
6838;11.10.2016;'22 - 23;33,03;31,13;1,9;0;0;0;9419;10280;861
6839;11.10.2016;'23 - 24;30,41;29,42;0,99;0;0;0;9239;9939;700
6840;12.10.2016;'00 - 01;28,17;28,27;-0,1;0;0;0;9052;9650;598
6841;12.10.2016;'01 - 02;27,93;29,83;-1,9;0;0;0;8790;9368;578
6842;12.10.2016;'02 - 03;28,09;27,5;0,59;0;0;0;8520;9013;493
6843;12.10.2016;'03 - 04;28,01;27,48;0,53;0;0;0;8402;8742;340
6844;12.10.2016;'04 - 05;28,16;26,81;1,35;0;0;0;8432;8614;182
6845;12.10.2016;'05 - 06;29,99;27,54;2,45;0;0;0;8502;8569;67
6846;12.10.2016;'06 - 07;32,93;33,69;-0,76;0;0;0;8519;8632;113
6847;12.10.2016;'07 - 08;45,07;43,31;1,76;59;34;-25;8578;8380;-198
6848;12.10.2016;'08 - 09;46,99;42,19;4,8;929;848;-81;8727;7928;-799
6849;12.10.2016;'09 - 10;45,95;42,57;3,38;2863;2758;-105;8912;7634;-1278
6850;12.10.2016;'10 - 11;41,59;43,07;-1,48;4891;5098;207;9090;7626;-1464
6851;12.10.2016;'11 - 12;44,94;44,11;0,83;6488;6822;334;9041;7346;-1695
6852;12.10.2016;'12 - 13;40,54;41,94;-1,4;7260;7670;410;8791;7401;-1390
6853;12.10.2016;'13 - 14;36,77;41,89;-5,12;7289;7422;133;8678;7368;-1310
6854;12.10.2016;'14 - 15;34,93;36,47;-1,54;6679;6762;83;8722;7586;-1136
6855;12.10.2016;'15 - 16;33,87;34,16;-0,29;5443;5335;-108;8627;7804;-823
6856;12.10.2016;'16 - 17;37,44;34,97;2,47;3502;3512;10;8551;8146;-405
6857;12.10.2016;'17 - 18;44,02;42,42;1,6;1396;1492;96;8546;8342;-204
6858;12.10.2016;'18 - 19;45,68;36,1;9,58;146;115;-31;8714;8462;-252
6859;12.10.2016;'19 - 20;47,82;37,97;9,85;0;0;0;9019;8885;-134
6860;12.10.2016;'20 - 21;38,26;37,44;0,82;0;0;0;9332;8951;-381
6861;12.10.2016;'21 - 22;33,57;31,6;1,97;0;0;0;9436;8668;-768
6862;12.10.2016;'22 - 23;33,99;29,75;4,24;0;0;0;9502;8379;-1123
6863;12.10.2016;'23 - 24;30,1;29,49;0,61;0;0;0;9498;8153;-1345
6864;13.10.2016;'00 - 01;28,21;28,65;-0,44;0;0;0;9154;8461;-693
6865;13.10.2016;'01 - 02;28,15;28;0,15;0;0;0;9095;8368;-727
6866;13.10.2016;'02 - 03;28,08;29,17;-1,09;0;0;0;9127;8786;-341
6867;13.10.2016;'03 - 04;28,14;28,56;-0,42;0;0;0;9225;9140;-85
6868;13.10.2016;'04 - 05;28,12;28,72;-0,6;0;0;0;9531;9612;81
6869;13.10.2016;'05 - 06;28,23;28,4;-0,17;0;0;0;9976;9839;-137
6870;13.10.2016;'06 - 07;36,66;44,06;-7,4;0;0;0;10530;10240;-290
6871;13.10.2016;'07 - 08;47,91;51,62;-3,71;88;39;-49;11099;10447;-652
6872;13.10.2016;'08 - 09;49,64;51,24;-1,6;1540;1150;-390;11772;10821;-951
6873;13.10.2016;'09 - 10;44,98;49,67;-4,69;4637;3398;-1239;12618;11198;-1420
6874;13.10.2016;'10 - 11;40,02;48,2;-8,18;7795;6152;-1643;13641;11848;-1793
6875;13.10.2016;'11 - 12;37,64;46,35;-8,71;10155;7790;-2365;14668;13189;-1479
6876;13.10.2016;'12 - 13;31,39;36,16;-4,77;11206;8769;-2437;15526;13967;-1559
6877;13.10.2016;'13 - 14;31,06;36,99;-5,93;10993;8848;-2145;16201;14277;-1924
6878;13.10.2016;'14 - 15;30,12;34,93;-4,81;9610;7111;-2499;16781;14603;-2178
6879;13.10.2016;'15 - 16;32,06;34,7;-2,64;7306;5114;-2192;17337;14959;-2378
6880;13.10.2016;'16 - 17;31,63;34,88;-3,25;4454;3287;-1167;17840;15042;-2798
6881;13.10.2016;'17 - 18;38,13;36,7;1,43;1634;1502;-132;18296;15684;-2612
6882;13.10.2016;'18 - 19;42,76;41,78;0,98;131;91;-40;18832;16423;-2409
6883;13.10.2016;'19 - 20;39,96;38,65;1,31;0;0;0;19414;16986;-2428
6884;13.10.2016;'20 - 21;30,58;34,49;-3,91;0;0;0;19845;16997;-2848
6885;13.10.2016;'21 - 22;28,7;32,05;-3,35;0;0;0;20288;17346;-2942
6886;13.10.2016;'22 - 23;28,2;30,57;-2,37;0;0;0;20250;17296;-2954
6887;13.10.2016;'23 - 24;27,42;30,52;-3,1;0;0;0;20065;17784;-2281
6888;14.10.2016;'00 - 01;20,8;18,45;2,35;0;0;0;18460;17850;-610
6889;14.10.2016;'01 - 02;20,02;20,56;-0,54;0;0;0;18177;17308;-869
6890;14.10.2016;'02 - 03;14,98;17,87;-2,89;0;0;0;17971;16667;-1304
6891;14.10.2016;'03 - 04;20,07;19,4;0,67;0;0;0;17670;16366;-1304
6892;14.10.2016;'04 - 05;21,72;25,49;-3,77;0;0;0;17657;16010;-1647
6893;14.10.2016;'05 - 06;25,2;28,84;-3,64;0;0;0;17818;16049;-1769
6894;14.10.2016;'06 - 07;30,29;34,16;-3,87;0;0;0;17975;16743;-1232
6895;14.10.2016;'07 - 08;40,53;38,57;1,96;89;60;-29;17951;17449;-502
6896;14.10.2016;'08 - 09;40,08;38,12;1,96;1894;1585;-309;17623;17759;136
6897;14.10.2016;'09 - 10;40,1;32,39;7,71;5572;4779;-793;17076;16859;-217
6898;14.10.2016;'10 - 11;34,13;32,42;1,71;9429;7906;-1523;16556;16222;-334
6899;14.10.2016;'11 - 12;29,55;32,19;-2,64;12413;10277;-2136;16210;16095;-115
6900;14.10.2016;'12 - 13;28,17;33,33;-5,16;13872;12052;-1820;16050;16380;330
6901;14.10.2016;'13 - 14;28,1;32,18;-4,08;13597;11724;-1873;15977;17002;1025
6902;14.10.2016;'14 - 15;28,2;31,42;-3,22;11910;9347;-2563;16001;17143;1142
6903;14.10.2016;'15 - 16;30,01;35,1;-5,09;9005;6756;-2249;16115;18210;2095
6904;14.10.2016;'16 - 17;29;30,61;-1,61;5391;3962;-1429;16142;18564;2422
6905;14.10.2016;'17 - 18;37,07;34,55;2,52;1894;1251;-643;16412;18716;2304
6906;14.10.2016;'18 - 19;38,27;36,93;1,34;128;84;-44;17152;19456;2304
6907;14.10.2016;'19 - 20;38,52;35,11;3,41;0;0;0;17794;20290;2496
6908;14.10.2016;'20 - 21;32,32;27,81;4,51;0;0;0;17822;20261;2439
6909;14.10.2016;'21 - 22;29,57;25,48;4,09;0;0;0;17330;19574;2244
6910;14.10.2016;'22 - 23;28,2;26,12;2,08;0;0;0;16526;18234;1708
6911;14.10.2016;'23 - 24;28,01;25,72;2,29;0;0;0;15781;17074;1293
6912;15.10.2016;'00 - 01;15,53;22,5;-6,97;0;0;0;17178;16012;-1166
6913;15.10.2016;'01 - 02;13,1;26,34;-13,24;0;0;0;16812;16083;-729
6914;15.10.2016;'02 - 03;13,66;23,72;-10,06;0;0;0;16453;16616;163
6915;15.10.2016;'03 - 04;13,62;19,39;-5,77;0;0;0;15989;16414;425
6916;15.10.2016;'04 - 05;17,99;20,5;-2,51;0;0;0;15690;15748;58
6917;15.10.2016;'05 - 06;15,5;23,33;-7,83;0;0;0;15319;15345;26
6918;15.10.2016;'06 - 07;15,79;21,73;-5,94;0;0;0;14773;14980;207
6919;15.10.2016;'07 - 08;27,62;31,06;-3,44;47;28;-19;14180;14427;247
6920;15.10.2016;'08 - 09;30,59;30,34;0,25;981;970;-11;13442;13442;0
6921;15.10.2016;'09 - 10;31,62;33,51;-1,89;2967;3346;379;12477;12691;214
6922;15.10.2016;'10 - 11;31,89;34,35;-2,46;4867;5882;1015;11420;11490;70
6923;15.10.2016;'11 - 12;33,34;33,04;0,3;6345;7786;1441;10284;10848;564
6924;15.10.2016;'12 - 13;31,39;30,31;1,08;7199;8917;1718;9052;9781;729
6925;15.10.2016;'13 - 14;31,36;28,11;3,25;7219;9145;1926;7858;8308;450
6926;15.10.2016;'14 - 15;32,24;28,45;3,79;6568;8365;1797;6778;7090;312
6927;15.10.2016;'15 - 16;36,05;30,16;5,89;5286;6249;963;5834;6228;394
6928;15.10.2016;'16 - 17;38,03;33,88;4,15;3371;3545;174;4971;5413;442
6929;15.10.2016;'17 - 18;42,86;39,44;3,42;1247;1340;93;4357;4590;233
6930;15.10.2016;'18 - 19;49,92;47,04;2,88;90;106;16;4214;4050;-164
6931;15.10.2016;'19 - 20;57,05;55,56;1,49;0;0;0;4171;4028;-143
6932;15.10.2016;'20 - 21;48,93;50,05;-1,12;0;0;0;4071;4006;-65
6933;15.10.2016;'21 - 22;44,38;43,39;0,99;0;0;0;3961;3665;-296
6934;15.10.2016;'22 - 23;40,02;38,28;1,74;0;0;0;3685;3206;-479
6935;15.10.2016;'23 - 24;32,96;34,93;-1,97;0;0;0;3344;2921;-423
6936;16.10.2016;'00 - 01;33,08;33,27;-0,19;0;0;0;3307;2527;-780
6937;16.10.2016;'01 - 02;31,1;30,28;0,82;0;0;0;2916;2286;-630
6938;16.10.2016;'02 - 03;31,6;29,79;1,81;0;0;0;2644;2101;-543
6939;16.10.2016;'03 - 04;30,59;31,37;-0,78;0;0;0;2462;2002;-460
6940;16.10.2016;'04 - 05;30,66;30,48;0,18;0;0;0;2322;2101;-221
6941;16.10.2016;'05 - 06;30,61;30,55;0,06;0;0;0;2251;2248;-3
6942;16.10.2016;'06 - 07;30,91;31,58;-0,67;0;0;0;2291;2390;99
6943;16.10.2016;'07 - 08;31,51;31,48;0,03;46;32;-14;2362;2629;267
6944;16.10.2016;'08 - 09;36,63;36,23;0,4;1282;1415;133;2410;2880;470
6945;16.10.2016;'09 - 10;38,48;38,51;-0,03;4599;4929;330;2400;3103;703
6946;16.10.2016;'10 - 11;37,39;34,3;3,09;8553;9447;894;2297;2478;181
6947;16.10.2016;'11 - 12;34,57;31,24;3,33;12141;13144;1003;2109;2134;25
6948;16.10.2016;'12 - 13;33,1;30,26;2,84;14314;15506;1192;1958;2411;453
6949;16.10.2016;'13 - 14;31,54;27,44;4,1;14657;15888;1231;2001;2916;915
6950;16.10.2016;'14 - 15;30,08;27,44;2,64;13337;14714;1377;2180;3296;1116
6951;16.10.2016;'15 - 16;30,44;27,55;2,89;10467;11976;1509;2349;3640;1291
6952;16.10.2016;'16 - 17;31,05;28,5;2,55;6458;7504;1046;2593;4347;1754
6953;16.10.2016;'17 - 18;36,06;31,8;4,26;2305;2572;267;3314;5329;2015
6954;16.10.2016;'18 - 19;45,85;41,48;4,37;157;106;-51;4899;7204;2305
6955;16.10.2016;'19 - 20;48,93;46,56;2,37;0;0;0;6549;9208;2659
6956;16.10.2016;'20 - 21;34,15;33,9;0,25;0;0;0;7687;10366;2679
6957;16.10.2016;'21 - 22;31,06;31,12;-0,06;0;0;0;8256;10950;2694
6958;16.10.2016;'22 - 23;30,57;32,09;-1,52;0;0;0;8539;10829;2290
6959;16.10.2016;'23 - 24;28,84;30,57;-1,73;0;0;0;8562;10610;2048
6960;17.10.2016;'00 - 01;30,6;35,13;-4,53;0;0;0;10556;10206;-350
6961;17.10.2016;'01 - 02;29,56;29,85;-0,29;0;0;0;10274;9978;-296
6962;17.10.2016;'02 - 03;29,17;30,59;-1,42;0;0;0;9946;9863;-83
6963;17.10.2016;'03 - 04;28,44;30,94;-2,5;0;0;0;9559;9758;199
6964;17.10.2016;'04 - 05;28,53;30,07;-1,54;0;0;0;9276;9528;252
6965;17.10.2016;'05 - 06;30,46;31,65;-1,19;0;0;0;9082;9360;278
6966;17.10.2016;'06 - 07;41,75;45,27;-3,52;0;0;0;8907;9143;236
6967;17.10.2016;'07 - 08;45,11;49,62;-4,51;34;32;-2;8638;8802;164
6968;17.10.2016;'08 - 09;48,34;56,09;-7,75;801;978;177;8097;8684;587
6969;17.10.2016;'09 - 10;46,42;52,04;-5,62;3105;3074;-31;7207;8072;865
6970;17.10.2016;'10 - 11;46,48;47,41;-0,93;5784;5294;-490;6254;6698;444
6971;17.10.2016;'11 - 12;46,02;45;1,02;7679;7380;-299;5383;5370;-13
6972;17.10.2016;'12 - 13;41,9;46,46;-4,56;8528;8384;-144;4671;4420;-251
6973;17.10.2016;'13 - 14;45,21;48;-2,79;8023;7638;-385;4098;4018;-80
6974;17.10.2016;'14 - 15;48,97;51,14;-2,17;6606;6274;-332;3744;3753;9
6975;17.10.2016;'15 - 16;52,42;56,06;-3,64;4709;4488;-221;3499;3647;148
6976;17.10.2016;'16 - 17;53,97;61,71;-7,74;2714;2420;-294;3342;3336;-6
6977;17.10.2016;'17 - 18;50,05;66,06;-16,01;849;768;-81;3424;3234;-190
6978;17.10.2016;'18 - 19;55,56;73,27;-17,71;56;49;-7;3769;3338;-431
6979;17.10.2016;'19 - 20;56,08;81,65;-25,57;0;0;0;4056;3546;-510
6980;17.10.2016;'20 - 21;46,44;60,46;-14,02;0;0;0;4164;3617;-547
6981;17.10.2016;'21 - 22;35,74;44,45;-8,71;0;0;0;4072;3410;-662
6982;17.10.2016;'22 - 23;36,87;44,8;-7,93;0;0;0;3943;3116;-827
6983;17.10.2016;'23 - 24;32,57;36,28;-3,71;0;0;0;3883;2720;-1163
6984;18.10.2016;'00 - 01;31,5;33,06;-1,56;0;0;0;3510;2556;-954
6985;18.10.2016;'01 - 02;30,82;32,73;-1,91;0;0;0;3401;2601;-800
6986;18.10.2016;'02 - 03;30,46;31,31;-0,85;0;0;0;3294;2614;-680
6987;18.10.2016;'03 - 04;30,5;30,48;0,02;0;0;0;3253;2839;-414
6988;18.10.2016;'04 - 05;31,11;30,59;0,52;0;0;0;3263;2944;-319
6989;18.10.2016;'05 - 06;32,96;32,05;0,91;0;0;0;3391;3192;-199
6990;18.10.2016;'06 - 07;41,79;35,85;5,94;0;0;0;3693;3436;-257
6991;18.10.2016;'07 - 08;51,33;54,87;-3,54;19;8;-11;4033;3813;-220
6992;18.10.2016;'08 - 09;54,95;57,89;-2,94;629;455;-174;4284;4059;-225
6993;18.10.2016;'09 - 10;51,93;57,31;-5,38;2439;1932;-507;4422;3890;-532
6994;18.10.2016;'10 - 11;50,35;59,4;-9,05;4619;3653;-966;4517;4031;-486
6995;18.10.2016;'11 - 12;50,81;68,22;-17,41;6480;5571;-909;4688;4664;-24
6996;18.10.2016;'12 - 13;46,49;63,1;-16,61;7508;7070;-438;5212;5402;190
6997;18.10.2016;'13 - 14;41,16;53,13;-11,97;7552;7557;5;5835;6677;842
6998;18.10.2016;'14 - 15;35,38;43,7;-8,32;6768;7043;275;6247;7657;1410
6999;18.10.2016;'15 - 16;35,76;40,33;-4,57;5217;5320;103;6463;8041;1578
7000;18.10.2016;'16 - 17;36,8;39,81;-3,01;3112;2972;-140;6678;8669;1991
7001;18.10.2016;'17 - 18;44,9;45,83;-0,93;1002;813;-189;6953;9067;2114
7002;18.10.2016;'18 - 19;48,91;50,72;-1,81;69;34;-35;7395;9938;2543
7003;18.10.2016;'19 - 20;47,47;50,77;-3,3;0;0;0;7988;10833;2845
7004;18.10.2016;'20 - 21;37,63;36,19;1,44;0;0;0;8444;11854;3410
7005;18.10.2016;'21 - 22;34,44;32,31;2,13;0;0;0;8495;12105;3610
7006;18.10.2016;'22 - 23;32,7;29,74;2,96;0;0;0;8440;10907;2467
7007;18.10.2016;'23 - 24;30,49;26,5;3,99;0;0;0;8290;9794;1504
7008;19.10.2016;'00 - 01;30,27;31,57;-1,3;0;0;0;9004;9152;148
7009;19.10.2016;'01 - 02;28,99;28,3;0,69;0;0;0;8571;8746;175
7010;19.10.2016;'02 - 03;28,95;26,65;2,3;0;0;0;8138;8499;361
7011;19.10.2016;'03 - 04;29,08;26,76;2,32;0;0;0;7692;8076;384
7012;19.10.2016;'04 - 05;30,32;26,38;3,94;0;0;0;7320;7574;254
7013;19.10.2016;'05 - 06;30,85;28,37;2,48;0;0;0;6993;7181;188
7014;19.10.2016;'06 - 07;36,66;33,83;2,83;0;0;0;6732;7197;465
7015;19.10.2016;'07 - 08;47,5;41,3;6,2;20;7;-13;6590;7381;791
7016;19.10.2016;'08 - 09;48,68;40,04;8,64;779;510;-269;6569;7086;517
7017;19.10.2016;'09 - 10;48,47;40,9;7,57;2817;2074;-743;6679;7129;450
7018;19.10.2016;'10 - 11;49,29;40,06;9,23;4895;3811;-1084;6839;7476;637
7019;19.10.2016;'11 - 12;49,29;39,86;9,43;6473;5387;-1086;6976;7906;930
7020;19.10.2016;'12 - 13;47,99;38,7;9,29;7327;6031;-1296;7151;7646;495
7021;19.10.2016;'13 - 14;45,92;37,72;8,2;7207;6319;-888;7407;8950;1543
7022;19.10.2016;'14 - 15;42,01;35,05;6,96;6373;5941;-432;7572;8909;1337
7023;19.10.2016;'15 - 16;41,27;33,04;8,23;4911;4661;-250;7397;8766;1369
7024;19.10.2016;'16 - 17;42,12;33,22;8,9;2925;2652;-273;7146;8555;1409
7025;19.10.2016;'17 - 18;48,32;39,66;8,66;896;739;-157;6928;8771;1843
7026;19.10.2016;'18 - 19;48,95;41,66;7,29;49;38;-11;6805;9506;2701
7027;19.10.2016;'19 - 20;49;43,53;5,47;0;0;0;6773;10212;3439
7028;19.10.2016;'20 - 21;44,49;34,63;9,86;0;0;0;6662;10690;4028
7029;19.10.2016;'21 - 22;35,2;32,34;2,86;0;0;0;6439;10204;3765
7030;19.10.2016;'22 - 23;34,99;31,32;3,67;0;0;0;6180;9835;3655
7031;19.10.2016;'23 - 24;31,26;28,83;2,43;0;0;0;5955;9319;3364
7032;20.10.2016;'00 - 01;30,36;29,53;0,83;0;0;0;7958;8958;1000
7033;20.10.2016;'01 - 02;29,99;27,19;2,8;0;0;0;7560;9021;1461
7034;20.10.2016;'02 - 03;29,97;27,6;2,37;0;0;0;7361;8939;1578
7035;20.10.2016;'03 - 04;30,03;31,46;-1,43;0;0;0;7227;9140;1913
7036;20.10.2016;'04 - 05;30,02;28,64;1,38;0;0;0;7011;9016;2005
7037;20.10.2016;'05 - 06;30,83;30,69;0,14;0;0;0;6846;8753;1907
7038;20.10.2016;'06 - 07;35,35;35,93;-0,58;0;0;0;6646;8036;1390
7039;20.10.2016;'07 - 08;41,84;44,6;-2,76;18;8;-10;6447;7527;1080
7040;20.10.2016;'08 - 09;46,95;45,35;1,6;699;522;-177;6236;7133;897
7041;20.10.2016;'09 - 10;47,98;45,99;1,99;2530;2169;-361;5875;6553;678
7042;20.10.2016;'10 - 11;47,06;45,61;1,45;4470;3890;-580;5477;5734;257
7043;20.10.2016;'11 - 12;47,16;45,73;1,43;6063;5566;-497;5253;5360;107
7044;20.10.2016;'12 - 13;44,93;45,34;-0,41;6998;6415;-583;5207;5111;-96
7045;20.10.2016;'13 - 14;44,71;44,26;0,45;6981;6245;-736;5077;5118;41
7046;20.10.2016;'14 - 15;42,6;43,37;-0,77;6207;5657;-550;4859;5289;430
7047;20.10.2016;'15 - 16;43,6;43,23;0,37;4737;4454;-283;4467;5250;783
7048;20.10.2016;'16 - 17;44,98;41,09;3,89;2751;2680;-71;4112;5157;1045
7049;20.10.2016;'17 - 18;48,91;44,41;4,5;797;772;-25;3945;5308;1363
7050;20.10.2016;'18 - 19;48,96;48,59;0,37;39;32;-7;4021;5771;1750
7051;20.10.2016;'19 - 20;56,01;50,93;5,08;0;0;0;4234;5628;1394
7052;20.10.2016;'20 - 21;46,45;41,97;4,48;0;0;0;4462;5571;1109
7053;20.10.2016;'21 - 22;36,11;36,22;-0,11;0;0;0;4522;5016;494
7054;20.10.2016;'22 - 23;34,67;37,86;-3,19;0;0;0;4439;4490;51
7055;20.10.2016;'23 - 24;32,87;34,25;-1,38;0;0;0;4360;3868;-492
7056;21.10.2016;'00 - 01;32,65;32,56;0,09;0;0;0;3344;3609;265
7057;21.10.2016;'01 - 02;31,94;30,46;1,48;0;0;0;3341;3386;45
7058;21.10.2016;'02 - 03;31,39;30,96;0,43;0;0;0;3432;3044;-388
7059;21.10.2016;'03 - 04;31,17;30,43;0,74;0;0;0;3625;2958;-667
7060;21.10.2016;'04 - 05;32,55;32,27;0,28;0;0;0;3809;3154;-655
7061;21.10.2016;'05 - 06;32,84;33,98;-1,14;0;0;0;4082;3208;-874
7062;21.10.2016;'06 - 07;35,9;36,5;-0,6;0;0;0;4490;3397;-1093
7063;21.10.2016;'07 - 08;46,87;47,79;-0,92;14;5;-9;4875;3947;-928
7064;21.10.2016;'08 - 09;48,98;50,4;-1,42;520;368;-152;5286;4181;-1105
7065;21.10.2016;'09 - 10;48,45;53,2;-4,75;2031;1579;-452;5618;4601;-1017
7066;21.10.2016;'10 - 11;48,42;51,14;-2,72;3663;3109;-554;5929;4951;-978
7067;21.10.2016;'11 - 12;47,82;47,87;-0,05;4921;4198;-723;6195;5299;-896
7068;21.10.2016;'12 - 13;46,49;47,49;-1;5583;4858;-725;6454;5890;-564
7069;21.10.2016;'13 - 14;41,84;43,9;-2,06;5624;4864;-760;6780;6179;-601
7070;21.10.2016;'14 - 15;38,31;39,05;-0,74;5050;4372;-678;7136;6262;-874
7071;21.10.2016;'15 - 16;37,41;38,74;-1,33;3837;3239;-598;6995;6134;-861
7072;21.10.2016;'16 - 17;37,96;38,67;-0,71;2187;1852;-335;6743;5904;-839
7073;21.10.2016;'17 - 18;42,06;41,12;0,94;625;512;-113;6547;6190;-357
7074;21.10.2016;'18 - 19;46,44;44,71;1,73;31;23;-8;6453;6363;-90
7075;21.10.2016;'19 - 20;45,95;43,89;2,06;0;0;0;6460;6484;24
7076;21.10.2016;'20 - 21;39,49;38,65;0,84;0;0;0;6592;6399;-193
7077;21.10.2016;'21 - 22;36,09;35,33;0,76;0;0;0;6564;6303;-261
7078;21.10.2016;'22 - 23;34,98;33,5;1,48;0;0;0;6430;5941;-489
7079;21.10.2016;'23 - 24;33,9;32,3;1,6;0;0;0;6226;5524;-702
7080;22.10.2016;'00 - 01;38,45;34,23;4,22;0;0;0;5100;5314;214
7081;22.10.2016;'01 - 02;34,55;33,11;1,44;0;0;0;5043;5407;364
7082;22.10.2016;'02 - 03;33,96;33,44;0,52;0;0;0;5087;5444;357
7083;22.10.2016;'03 - 04;34,11;33,91;0,2;0;0;0;5130;5410;280
7084;22.10.2016;'04 - 05;35,18;34,2;0,98;0;0;0;5179;5285;106
7085;22.10.2016;'05 - 06;35,61;31,6;4,01;0;0;0;5151;5250;99
7086;22.10.2016;'06 - 07;34,55;33,09;1,46;0;0;0;5030;5116;86
7087;22.10.2016;'07 - 08;36,89;36,39;0,5;17;6;-11;4898;5105;207
7088;22.10.2016;'08 - 09;35,21;40,09;-4,88;723;549;-174;4759;4956;197
7089;22.10.2016;'09 - 10;38,07;40,05;-1,98;2749;2356;-393;4481;4871;390
7090;22.10.2016;'10 - 11;37,87;44,53;-6,66;5033;4693;-340;4201;4332;131
7091;22.10.2016;'11 - 12;37,28;42,22;-4,94;6806;6508;-298;4057;3672;-385
7092;22.10.2016;'12 - 13;39,96;45,03;-5,07;7667;6838;-829;3864;3284;-580
7093;22.10.2016;'13 - 14;35,02;40,02;-5;7482;6559;-923;3693;3012;-681
7094;22.10.2016;'14 - 15;34,31;37,77;-3,46;6519;6111;-408;3564;2844;-720
7095;22.10.2016;'15 - 16;34,17;35,56;-1,39;4974;4866;-108;3251;2338;-913
7096;22.10.2016;'16 - 17;35,19;35,48;-0,29;2950;2935;-15;2874;2075;-799
7097;22.10.2016;'17 - 18;46,76;43,34;3,42;861;874;13;2593;1924;-669
7098;22.10.2016;'18 - 19;49,96;45,59;4,37;36;29;-7;2422;1682;-740
7099;22.10.2016;'19 - 20;49,99;48,65;1,34;0;0;0;2283;1767;-516
7100;22.10.2016;'20 - 21;44,11;45,05;-0,94;0;0;0;1966;1596;-370
7101;22.10.2016;'21 - 22;35,88;39,29;-3,41;0;0;0;1764;1280;-484
7102;22.10.2016;'22 - 23;34,53;40,61;-6,08;0;0;0;1629;1128;-501
7103;22.10.2016;'23 - 24;34,51;37,31;-2,8;0;0;0;1532;935;-597
7104;23.10.2016;'00 - 01;33,09;34,85;-1,76;0;0;0;1081;736;-345
7105;23.10.2016;'01 - 02;32,69;32,05;0,64;0;0;0;1088;666;-422
7106;23.10.2016;'02 - 03;32,41;29,9;2,51;0;0;0;1105;608;-497
7107;23.10.2016;'03 - 04;31,85;31,49;0,36;0;0;0;1100;682;-418
7108;23.10.2016;'04 - 05;32,03;32,12;-0,09;0;0;0;1160;766;-394
7109;23.10.2016;'05 - 06;31,9;31,79;0,11;0;0;0;1280;758;-522
7110;23.10.2016;'06 - 07;32,52;31,03;1,49;0;0;0;1438;857;-581
7111;23.10.2016;'07 - 08;33,04;32,04;1;20;6;-14;1586;1188;-398
7112;23.10.2016;'08 - 09;33,75;33,18;0,57;970;580;-390;1642;1730;88
7113;23.10.2016;'09 - 10;35,22;36,15;-0,93;3935;2682;-1253;1604;1993;389
7114;23.10.2016;'10 - 11;34,84;36,23;-1,39;7823;5704;-2119;1532;1962;430
7115;23.10.2016;'11 - 12;33,91;41,6;-7,69;10928;8493;-2435;1536;1763;227
7116;23.10.2016;'12 - 13;32,63;41,55;-8,92;12554;10310;-2244;1595;1808;213
7117;23.10.2016;'13 - 14;32,86;38,42;-5,56;12312;11042;-1270;1696;1820;124
7118;23.10.2016;'14 - 15;31,95;34,65;-2,7;10481;10109;-372;1737;1798;61
7119;23.10.2016;'15 - 16;32,66;34,59;-1,93;7625;7174;-451;1714;1863;149
7120;23.10.2016;'16 - 17;34,44;36,88;-2,44;4213;3522;-691;1783;2296;513
7121;23.10.2016;'17 - 18;37,24;37,55;-0,31;1071;850;-221;2176;3092;916
7122;23.10.2016;'18 - 19;42,01;41,79;0,22;29;20;-9;3108;4555;1447
7123;23.10.2016;'19 - 20;47,02;42,82;4,2;0;0;0;4098;5994;1896
7124;23.10.2016;'20 - 21;39,77;37,79;1,98;0;0;0;4560;6927;2367
7125;23.10.2016;'21 - 22;36,86;34,87;1,99;0;0;0;4850;7150;2300
7126;23.10.2016;'22 - 23;34,75;32,21;2,54;0;0;0;5032;6864;1832
7127;23.10.2016;'23 - 24;33,6;31,1;2,5;0;0;0;4940;6006;1066
7128;24.10.2016;'00 - 01;31,44;28,24;3,2;0;0;0;4692;5387;695
7129;24.10.2016;'01 - 02;31,08;30,19;0,89;0;0;0;4279;4962;683
7130;24.10.2016;'02 - 03;31,53;30,25;1,28;0;0;0;3927;4786;859
7131;24.10.2016;'03 - 04;30,9;30,43;0,47;0;0;0;3710;4528;818
7132;24.10.2016;'04 - 05;31,24;29,88;1,36;0;0;0;3609;4506;897
7133;24.10.2016;'05 - 06;31,68;31,37;0,31;0;0;0;3657;4956;1299
7134;24.10.2016;'06 - 07;43,5;40,16;3,34;0;0;0;3844;4593;749
7135;24.10.2016;'07 - 08;49,92;50,34;-0,42;7;3;-4;3983;4450;467
7136;24.10.2016;'08 - 09;49,92;54,47;-4,55;475;426;-49;3978;4954;976
7137;24.10.2016;'09 - 10;49,9;53,38;-3,48;2055;2077;22;3737;4658;921
7138;24.10.2016;'10 - 11;49,98;52;-2,02;4249;4529;280;3438;4544;1106
7139;24.10.2016;'11 - 12;49,97;50,95;-0,98;6236;6120;-116;3218;4325;1107
7140;24.10.2016;'12 - 13;49,07;50,66;-1,59;7404;6082;-1322;3135;4354;1219
7141;24.10.2016;'13 - 14;46,07;50,53;-4,46;7285;5717;-1568;3288;4311;1023
7142;24.10.2016;'14 - 15;44,73;52,18;-7,45;6195;4736;-1459;3860;4418;558
7143;24.10.2016;'15 - 16;46,09;57,28;-11,19;4469;3068;-1401;4400;4579;179
7144;24.10.2016;'16 - 17;46,47;55,65;-9,18;2389;1605;-784;5028;4549;-479
7145;24.10.2016;'17 - 18;48,21;58,52;-10,31;602;566;-36;5769;4918;-851
7146;24.10.2016;'18 - 19;48,49;58,99;-10,5;29;13;-16;6458;5590;-868
7147;24.10.2016;'19 - 20;48,35;59,17;-10,82;0;0;0;7110;5898;-1212
7148;24.10.2016;'20 - 21;42,32;53,04;-10,72;0;0;0;7584;5632;-1952
7149;24.10.2016;'21 - 22;36,35;41,31;-4,96;0;0;0;7456;5257;-2199
7150;24.10.2016;'22 - 23;35,82;40,53;-4,71;0;0;0;7141;4715;-2426
7151;24.10.2016;'23 - 24;33,07;37,45;-4,38;0;0;0;6753;3982;-2771
7152;25.10.2016;'00 - 01;35,38;39,15;-3,77;0;0;0;4294;3797;-497
7153;25.10.2016;'01 - 02;34,58;38,53;-3,95;0;0;0;3850;3247;-603
7154;25.10.2016;'02 - 03;34,64;38,17;-3,53;0;0;0;3561;3008;-553
7155;25.10.2016;'03 - 04;35,02;37,69;-2,67;0;0;0;3366;3537;171
7156;25.10.2016;'04 - 05;34,97;35,17;-0,2;0;0;0;3250;3984;734
7157;25.10.2016;'05 - 06;37,01;34;3,01;0;0;0;3123;4043;920
7158;25.10.2016;'06 - 07;43,3;42,71;0,59;0;0;0;2955;3713;758
7159;25.10.2016;'07 - 08;68,1;66,65;1,45;3;0;-3;2744;3511;767
7160;25.10.2016;'08 - 09;68,02;70,15;-2,13;277;142;-135;2437;3106;669
7161;25.10.2016;'09 - 10;67,28;71,08;-3,8;1258;910;-348;2035;2334;299
7162;25.10.2016;'10 - 11;73,07;76,55;-3,48;2554;2295;-259;1641;1600;-41
7163;25.10.2016;'11 - 12;74,23;74,23;0;3737;3890;153;1336;1128;-208
7164;25.10.2016;'12 - 13;67,61;65,5;2,11;4567;4664;97;1174;906;-268
7165;25.10.2016;'13 - 14;66,01;61,71;4,3;4683;4410;-273;1081;814;-267
7166;25.10.2016;'14 - 15;57,97;58,91;-0,94;4140;3864;-276;1033;747;-286
7167;25.10.2016;'15 - 16;56,38;59,18;-2,8;3063;2681;-382;1033;719;-314
7168;25.10.2016;'16 - 17;56;59,07;-3,07;1635;1358;-277;1042;760;-282
7169;25.10.2016;'17 - 18;67,71;66,22;1,49;408;314;-94;1078;818;-260
7170;25.10.2016;'18 - 19;67,18;67,32;-0,14;16;9;-7;1144;988;-156
7171;25.10.2016;'19 - 20;60,39;65,55;-5,16;0;0;0;1225;1190;-35
7172;25.10.2016;'20 - 21;51,98;56,23;-4,25;0;0;0;1230;1312;82
7173;25.10.2016;'21 - 22;39,76;42,15;-2,39;0;0;0;1187;1264;77
7174;25.10.2016;'22 - 23;37,38;41,2;-3,82;0;0;0;1085;1063;-22
7175;25.10.2016;'23 - 24;34,7;35,71;-1,01;0;0;0;995;893;-102
7176;26.10.2016;'00 - 01;35,81;37,13;-1,32;0;0;0;680;639;-41
7177;26.10.2016;'01 - 02;34,6;34,45;0,15;0;0;0;614;478;-136
7178;26.10.2016;'02 - 03;34,71;32,17;2,54;0;0;0;597;376;-221
7179;26.10.2016;'03 - 04;35,03;31,67;3,36;0;0;0;606;374;-232
7180;26.10.2016;'04 - 05;35,03;33,39;1,64;0;0;0;629;435;-194
7181;26.10.2016;'05 - 06;36,17;35,46;0,71;0;0;0;654;594;-60
7182;26.10.2016;'06 - 07;41,2;46,73;-5,53;0;0;0;725;784;59
7183;26.10.2016;'07 - 08;52,3;52,33;-0,03;8;2;-6;871;851;-20
7184;26.10.2016;'08 - 09;55,66;53,1;2,56;353;251;-102;1094;956;-138
7185;26.10.2016;'09 - 10;58,21;57;1,21;1810;1537;-273;1324;1404;80
7186;26.10.2016;'10 - 11;58,01;56,27;1,74;3877;3371;-506;1540;1441;-99
7187;26.10.2016;'11 - 12;55,68;54,38;1,3;5845;5005;-840;1773;1442;-331
7188;26.10.2016;'12 - 13;52,15;52,48;-0,33;6996;6292;-704;2052;1522;-530
7189;26.10.2016;'13 - 14;49,88;50,92;-1,04;7030;6518;-512;2385;1797;-588
7190;26.10.2016;'14 - 15;45,67;45,99;-0,32;6152;5806;-346;2725;2326;-399
7191;26.10.2016;'15 - 16;46,81;45,6;1,21;4535;4288;-247;3052;2881;-171
7192;26.10.2016;'16 - 17;47,92;44,68;3,24;2433;2353;-80;3365;3132;-233
7193;26.10.2016;'17 - 18;50,27;47,69;2,58;560;543;-17;3781;3684;-97
7194;26.10.2016;'18 - 19;53,84;51,34;2,5;16;15;-1;4378;4525;147
7195;26.10.2016;'19 - 20;52,49;50,13;2,36;0;0;0;5112;5523;411
7196;26.10.2016;'20 - 21;41,28;39,95;1,33;0;0;0;6022;6204;182
7197;26.10.2016;'21 - 22;39,99;38,08;1,91;0;0;0;6955;6860;-95
7198;26.10.2016;'22 - 23;37,37;37,7;-0,33;0;0;0;7828;7427;-401
7199;26.10.2016;'23 - 24;34,1;34,68;-0,58;0;0;0;8514;7882;-632
7200;27.10.2016;'00 - 01;32,84;30,68;2,16;0;0;0;7970;8002;32
7201;27.10.2016;'01 - 02;32,26;31,03;1,23;0;0;0;8182;7873;-309
7202;27.10.2016;'02 - 03;31,87;31,6;0,27;0;0;0;8323;7727;-596
7203;27.10.2016;'03 - 04;31,25;31,57;-0,32;0;0;0;8285;7708;-577
7204;27.10.2016;'04 - 05;32,34;31,13;1,21;0;0;0;8172;8053;-119
7205;27.10.2016;'05 - 06;33,58;30,56;3,02;0;0;0;7937;7964;27
7206;27.10.2016;'06 - 07;38,12;36,07;2,05;0;0;0;7673;7626;-47
7207;27.10.2016;'07 - 08;47,94;43,58;4,36;8;0;-8;7492;7350;-142
7208;27.10.2016;'08 - 09;48,99;46,13;2,86;447;320;-127;7350;6904;-446
7209;27.10.2016;'09 - 10;47,42;48,63;-1,21;2224;1965;-259;7216;6532;-684
7210;27.10.2016;'10 - 11;47,94;47,58;0,36;4594;4316;-278;7109;6269;-840
7211;27.10.2016;'11 - 12;45,69;43,08;2,61;6472;6479;7;7226;6311;-915
7212;27.10.2016;'12 - 13;44,11;38,96;5,15;7494;7788;294;7709;6884;-825
7213;27.10.2016;'13 - 14;41,77;38,01;3,76;7370;8429;1059;8459;7228;-1231
7214;27.10.2016;'14 - 15;38,68;35,71;2,97;6328;7760;1432;9167;7416;-1751
7215;27.10.2016;'15 - 16;39,51;35;4,51;4602;5611;1009;9201;8246;-955
7216;27.10.2016;'16 - 17;40,91;36,76;4,15;2476;3002;526;9228;8648;-580
7217;27.10.2016;'17 - 18;44,69;39,21;5,48;590;712;122;9669;9316;-353
7218;27.10.2016;'18 - 19;48,73;40,85;7,88;14;10;-4;10585;10184;-401
7219;27.10.2016;'19 - 20;42;40,17;1,83;0;0;0;11655;11256;-399
7220;27.10.2016;'20 - 21;38,02;38,64;-0,62;0;0;0;12696;12118;-578
7221;27.10.2016;'21 - 22;36,76;37,29;-0,53;0;0;0;13470;12944;-526
7222;27.10.2016;'22 - 23;33,82;40,39;-6,57;0;0;0;14145;13857;-288
7223;27.10.2016;'23 - 24;31,05;31,4;-0,35;0;0;0;14782;14332;-450
7224;28.10.2016;'00 - 01;29,06;30,6;-1,54;0;0;0;15256;14762;-494
7225;28.10.2016;'01 - 02;26,87;29,68;-2,81;0;0;0;15742;15508;-234
7226;28.10.2016;'02 - 03;23,43;28,83;-5,4;0;0;0;16172;15773;-399
7227;28.10.2016;'03 - 04;23,65;26,65;-3;0;0;0;16490;16274;-216
7228;28.10.2016;'04 - 05;23,92;22,83;1,09;0;0;0;16805;17059;254
7229;28.10.2016;'05 - 06;29,1;29,98;-0,88;0;0;0;17036;17415;379
7230;28.10.2016;'06 - 07;31,08;31,02;0,06;0;0;0;17220;18103;883
7231;28.10.2016;'07 - 08;37,04;43,9;-6,86;12;1;-11;17339;18466;1127
7232;28.10.2016;'08 - 09;39,3;38,29;1,01;659;491;-168;17226;18605;1379
7233;28.10.2016;'09 - 10;37,72;39,57;-1,85;2980;2168;-812;16832;18418;1586
7234;28.10.2016;'10 - 11;37,76;39,16;-1,4;5524;4142;-1382;16437;18142;1705
7235;28.10.2016;'11 - 12;38,89;40,62;-1,73;7376;5664;-1712;16184;17759;1575
7236;28.10.2016;'12 - 13;37,17;41,43;-4,26;8168;6618;-1550;16106;18053;1947
7237;28.10.2016;'13 - 14;36,82;37,84;-1,02;7788;6799;-989;16068;18003;1935
7238;28.10.2016;'14 - 15;36,31;37,41;-1,1;6474;6131;-343;15879;17415;1536
7239;28.10.2016;'15 - 16;37,23;35,16;2,07;4548;4770;222;15306;16128;822
7240;28.10.2016;'16 - 17;37,99;35,73;2,26;2399;2665;266;14443;15140;697
7241;28.10.2016;'17 - 18;43,74;39,88;3,86;552;581;29;13569;13997;428
7242;28.10.2016;'18 - 19;50,5;45,91;4,59;8;12;4;12878;13668;790
7243;28.10.2016;'19 - 20;47,62;48,31;-0,69;0;0;0;12286;13472;1186
7244;28.10.2016;'20 - 21;41,97;39,53;2,44;0;0;0;11690;13340;1650
7245;28.10.2016;'21 - 22;42,82;38,68;4,14;0;0;0;11049;13255;2206
7246;28.10.2016;'22 - 23;39,93;36,97;2,96;0;0;0;10358;12624;2266
7247;28.10.2016;'23 - 24;33,1;34,47;-1,37;0;0;0;9867;11812;1945
7248;29.10.2016;'00 - 01;31,05;31,59;-0,54;0;0;0;10644;11678;1034
7249;29.10.2016;'01 - 02;29,85;31,86;-2,01;0;0;0;10402;11175;773
7250;29.10.2016;'02 - 03;29,04;30,58;-1,54;0;0;0;10302;10782;480
7251;29.10.2016;'03 - 04;28,65;29,66;-1,01;0;0;0;10210;11046;836
7252;29.10.2016;'04 - 05;28,77;28,01;0,76;0;0;0;10168;11395;1227
7253;29.10.2016;'05 - 06;28,84;28,41;0,43;0;0;0;10134;11549;1415
7254;29.10.2016;'06 - 07;30,77;31,68;-0,91;0;0;0;10099;11833;1734
7255;29.10.2016;'07 - 08;32,5;33,77;-1,27;6;0;-6;10100;12196;2096
7256;29.10.2016;'08 - 09;35,06;35,04;0,02;360;305;-55;10008;11583;1575
7257;29.10.2016;'09 - 10;41,76;37,17;4,59;1999;1872;-127;9820;11468;1648
7258;29.10.2016;'10 - 11;41,54;36,92;4,62;4147;4137;-10;9624;11081;1457
7259;29.10.2016;'11 - 12;36,19;36,68;-0,49;6166;6808;642;9886;11594;1708
7260;29.10.2016;'12 - 13;33,79;34,4;-0,61;7451;8808;1357;10790;12662;1872
7261;29.10.2016;'13 - 14;31,54;28,84;2,7;7692;9249;1557;11742;14666;2924
7262;29.10.2016;'14 - 15;30,03;19,87;10,16;6936;8171;1235;12251;15080;2829
7263;29.10.2016;'15 - 16;31,41;23,11;8,3;5234;6400;1166;11832;14301;2469
7264;29.10.2016;'16 - 17;32,7;30,28;2,42;2765;3512;747;11056;12999;1943
7265;29.10.2016;'17 - 18;37,93;38,19;-0,26;575;715;140;10407;11551;1144
7266;29.10.2016;'18 - 19;45,92;44,32;1,6;10;12;2;10069;10847;778
7267;29.10.2016;'19 - 20;44,27;43,93;0,34;0;0;0;9873;10351;478
7268;29.10.2016;'20 - 21;39,44;40,76;-1,32;0;0;0;9736;10065;329
7269;29.10.2016;'21 - 22;35,24;37,92;-2,68;0;0;0;9704;10113;409
7270;29.10.2016;'22 - 23;35,12;34,53;0,59;0;0;0;9601;9814;213
7271;29.10.2016;'23 - 24;33,81;33;0,81;0;0;0;9413;9342;-71
7272;30.10.2016;'00 - 01;32,57;32,32;0,25;0;0;0;8386;8860;474
7273;30.10.2016;'01 - 02;32,15;31,3;0,85;0;0;0;8097;8520;423
7274;30.10.2016;'02 - 03;31,55;30,28;1,27;0;0;0;7749;8245;496
7275;30.10.2016;'03 - 04;31,4;31,56;-0,16;0;0;0;6996;7870;874
7276;30.10.2016;'04 - 05;31,45;30,29;1,16;0;0;0;6629;7506;877
7277;30.10.2016;'05 - 06;32,03;30,83;1,2;0;0;0;6262;7139;877
7278;30.10.2016;'06 - 07;32,55;30,53;2,02;5;2;-3;5864;6892;1028
7279;30.10.2016;'07 - 08;33,35;30,86;2,49;521;462;-59;5314;6019;705
7280;30.10.2016;'08 - 09;35,02;29,65;5,37;2898;2916;18;4630;5021;391
7281;30.10.2016;'09 - 10;36,49;31,4;5,09;5855;6260;405;3971;3964;-7
7282;30.10.2016;'10 - 11;36,99;31,42;5,57;8274;9206;932;3493;3453;-40
7283;30.10.2016;'11 - 12;38,33;31,8;6,53;9670;11174;1504;3158;3254;96
7284;30.10.2016;'12 - 13;37,2;33,27;3,93;9666;11798;2132;2910;2871;-39
7285;30.10.2016;'13 - 14;33,9;32,18;1,72;8366;10756;2390;2679;2619;-60
7286;30.10.2016;'14 - 15;32,48;32,36;0,12;6063;8019;1956;2309;2387;78
7287;30.10.2016;'15 - 16;33,09;33,07;0,02;3133;4059;926;1969;1977;8
7288;30.10.2016;'16 - 17;34,64;34,28;0,36;649;738;89;1797;1765;-32
7289;30.10.2016;'17 - 18;49,2;45,9;3,3;7;13;6;1831;2058;227
7290;30.10.2016;'18 - 19;52,48;44,99;7,49;0;0;0;1931;2302;371
7291;30.10.2016;'19 - 20;48,28;42,28;6;0;0;0;1944;2394;450
7292;30.10.2016;'20 - 21;40,3;35,23;5,07;0;0;0;1879;2320;441
7293;30.10.2016;'21 - 22;39;34,75;4,25;0;0;0;1733;2064;331
7294;30.10.2016;'22 - 23;39;34,63;4,37;0;0;0;1575;1873;298
7295;30.10.2016;'23 - 24;37,64;33,56;4,08;0;0;0;1441;1454;13
7296;31.10.2016;'00 - 01;35,36;31,78;3,58;0;0;0;1331;1737;406
7297;31.10.2016;'01 - 02;34,94;30,87;4,07;0;0;0;1205;1768;563
7298;31.10.2016;'02 - 03;34,66;32,01;2,65;0;0;0;1113;1874;761
7299;31.10.2016;'03 - 04;33,92;31,13;2,79;0;0;0;1045;1928;883
7300;31.10.2016;'04 - 05;34,39;30,91;3,48;0;0;0;1015;2020;1005
7301;31.10.2016;'05 - 06;40,03;32,77;7,26;0;0;0;1028;2020;992
7302;31.10.2016;'06 - 07;45,29;33,3;11,99;5;3;-2;1045;2056;1011
7303;31.10.2016;'07 - 08;51,68;41,67;10,01;613;453;-160;1040;2258;1218
7304;31.10.2016;'08 - 09;50,47;48,26;2,21;3075;2725;-350;1020;2338;1318
7305;31.10.2016;'09 - 10;47,38;39,5;7,88;6272;5533;-739;985;1936;951
7306;31.10.2016;'10 - 11;45,1;36,42;8,68;9000;8210;-790;922;1522;600
7307;31.10.2016;'11 - 12;44;35,98;8,02;10680;10195;-485;893;1321;428
7308;31.10.2016;'12 - 13;39;33,67;5,33;11014;11257;243;954;1361;407
7309;31.10.2016;'13 - 14;38,08;32,82;5,26;9927;10606;679;1070;1509;439
7310;31.10.2016;'14 - 15;38,64;34,21;4,43;7464;8014;550;1208;1613;405
7311;31.10.2016;'15 - 16;46,04;38,17;7,87;3969;4256;287;1390;1681;291
7312;31.10.2016;'16 - 17;49,73;44,34;5,39;848;804;-44;1615;1654;39
7313;31.10.2016;'17 - 18;59,2;53,79;5,41;8;8;0;1968;1952;-16
7314;31.10.2016;'18 - 19;55,98;51,82;4,16;0;0;0;2346;2340;-6
7315;31.10.2016;'19 - 20;48,96;47,77;1,19;0;0;0;2546;2752;206
7316;31.10.2016;'20 - 21;44,13;40,27;3,86;0;0;0;2960;3145;185
7317;31.10.2016;'21 - 22;40,26;36,18;4,08;0;0;0;3393;3640;247
7318;31.10.2016;'22 - 23;38,62;38,42;0,2;0;0;0;3926;4271;345
7319;31.10.2016;'23 - 24;37,68;36,52;1,16;0;0;0;4561;4816;255
7320;01.11.2016;'00 - 01;33,31;31,11;2,2;0;0;0;5106;5516;410
7321;01.11.2016;'01 - 02;33,68;32,15;1,53;0;0;0;5596;5909;313
7322;01.11.2016;'02 - 03;33,31;32,1;1,21;0;0;0;6148;6431;283
7323;01.11.2016;'03 - 04;32,52;33;-0,48;0;0;0;6743;6615;-128
7324;01.11.2016;'04 - 05;32,99;32,83;0,16;0;0;0;7223;6678;-545
7325;01.11.2016;'05 - 06;33,31;34,21;-0,9;0;0;0;7526;7034;-492
7326;01.11.2016;'06 - 07;36,98;39,3;-2,32;4;2;-2;7788;7856;68
7327;01.11.2016;'07 - 08;41,93;41,45;0,48;583;471;-112;7962;7934;-28
7328;01.11.2016;'08 - 09;41,09;40,35;0,74;3421;2689;-732;7990;7865;-125
7329;01.11.2016;'09 - 10;33,77;34,39;-0,62;7031;5720;-1311;8002;7592;-410
7330;01.11.2016;'10 - 11;31,27;37,35;-6,08;9957;8520;-1437;8101;7807;-294
7331;01.11.2016;'11 - 12;30,9;33,94;-3,04;11493;9659;-1834;8448;8220;-228
7332;01.11.2016;'12 - 13;30,75;32,9;-2,15;11324;9532;-1792;8938;9363;425
7333;01.11.2016;'13 - 14;30,03;32,38;-2,35;9655;8260;-1395;9499;9761;262
7334;01.11.2016;'14 - 15;31,58;33,15;-1,57;6834;5900;-934;10100;10104;4
7335;01.11.2016;'15 - 16;33,28;32,41;0,87;3456;2826;-630;10647;10512;-135
7336;01.11.2016;'16 - 17;39,34;39,91;-0,57;694;472;-222;11274;11376;102
7337;01.11.2016;'17 - 18;47,51;50,19;-2,68;6;5;-1;11962;12178;216
7338;01.11.2016;'18 - 19;49,99;48,99;1;0;0;0;12720;12919;199
7339;01.11.2016;'19 - 20;45,97;41,23;4,74;0;0;0;13774;13902;128
7340;01.11.2016;'20 - 21;35,94;31,62;4,32;0;0;0;14257;15115;858
7341;01.11.2016;'21 - 22;29,59;28,24;1,35;0;0;0;14642;15776;1134
7342;01.11.2016;'22 - 23;28,86;28,59;0,27;0;0;0;15085;15708;623
7343;01.11.2016;'23 - 24;16,02;16,62;-0,6;0;0;0;15583;16319;736
7344;02.11.2016;'00 - 01;27,11;24,01;3,1;0;0;0;15656;16810;1154
7345;02.11.2016;'01 - 02;15,12;14,29;0,83;0;0;0;16337;17488;1151
7346;02.11.2016;'02 - 03;13,2;9,84;3,36;0;0;0;16992;18098;1106
7347;02.11.2016;'03 - 04;12,26;9,5;2,76;0;0;0;17575;18442;867
7348;02.11.2016;'04 - 05;13,16;9,74;3,42;0;0;0;18146;19007;861
7349;02.11.2016;'05 - 06;21,01;15,09;5,92;0;0;0;19055;19337;282
7350;02.11.2016;'06 - 07;33,85;30,08;3,77;1;1;0;19838;20183;345
7351;02.11.2016;'07 - 08;39,04;41,05;-2,01;338;285;-53;20390;20175;-215
7352;02.11.2016;'08 - 09;36,54;46,15;-9,61;2214;1916;-298;20828;20366;-462
7353;02.11.2016;'09 - 10;36,72;41,03;-4,31;4615;4236;-379;21251;20588;-663
7354;02.11.2016;'10 - 11;33,19;38,62;-5,43;6552;6010;-542;21547;21196;-351
7355;02.11.2016;'11 - 12;34,07;37,93;-3,86;7639;6688;-951;21557;21760;203
7356;02.11.2016;'12 - 13;32,93;36,94;-4,01;7821;6807;-1014;21488;21722;234
7357;02.11.2016;'13 - 14;33,18;38,23;-5,05;7131;6036;-1095;21091;22292;1201
7358;02.11.2016;'14 - 15;33,06;37,84;-4,78;5391;4745;-646;20141;21353;1212
7359;02.11.2016;'15 - 16;33,99;37,39;-3,4;2793;2644;-149;18625;19587;962
7360;02.11.2016;'16 - 17;39,16;41,2;-2,04;516;469;-47;17165;17716;551
7361;02.11.2016;'17 - 18;52,91;54,46;-1,55;4;1;-3;15805;16969;1164
7362;02.11.2016;'18 - 19;52,46;53,4;-0,94;0;0;0;14506;16890;2384
7363;02.11.2016;'19 - 20;51,46;44,84;6,62;0;0;0;13321;15866;2545
7364;02.11.2016;'20 - 21;39,98;38,8;1,18;0;0;0;12116;14493;2377
7365;02.11.2016;'21 - 22;37,52;37,49;0,03;0;0;0;10861;12620;1759
7366;02.11.2016;'22 - 23;35,18;34,98;0,2;0;0;0;9779;11233;1454
7367;02.11.2016;'23 - 24;35,67;33,76;1,91;0;0;0;8982;9909;927
7368;03.11.2016;'00 - 01;35,05;33,9;1,15;0;0;0;7559;8824;1265
7369;03.11.2016;'01 - 02;35,07;33,45;1,62;0;0;0;7035;7957;922
7370;03.11.2016;'02 - 03;34,74;33,41;1,33;0;0;0;6538;7426;888
7371;03.11.2016;'03 - 04;35,87;33,3;2,57;0;0;0;6010;7069;1059
7372;03.11.2016;'04 - 05;36,74;33,48;3,26;0;0;0;5461;6502;1041
7373;03.11.2016;'05 - 06;38,95;33,96;4,99;0;0;0;4910;5675;765
7374;03.11.2016;'06 - 07;47,23;48,42;-1,19;1;1;0;4323;4922;599
7375;03.11.2016;'07 - 08;53,41;54,72;-1,31;420;352;-68;3630;4373;743
7376;03.11.2016;'08 - 09;56,06;56,97;-0,91;2951;2560;-391;2943;3615;672
7377;03.11.2016;'09 - 10;50,11;50,37;-0,26;6346;5958;-388;2373;2760;387
7378;03.11.2016;'10 - 11;46,86;47,78;-0,92;9024;8803;-221;2039;2255;216
7379;03.11.2016;'11 - 12;47,63;46,15;1,48;10497;10240;-257;2062;2315;253
7380;03.11.2016;'12 - 13;48;44,22;3,78;10494;9891;-603;2204;2453;249
7381;03.11.2016;'13 - 14;48,95;47,54;1,41;9114;8080;-1034;2312;2368;56
7382;03.11.2016;'14 - 15;48,96;49,28;-0,32;6596;5602;-994;2482;2662;180
7383;03.11.2016;'15 - 16;59,6;53,01;6,59;3306;2698;-608;2680;2708;28
7384;03.11.2016;'16 - 17;56,35;54,01;2,34;559;441;-118;2950;3023;73
7385;03.11.2016;'17 - 18;59,99;61,62;-1,63;4;4;0;3451;3490;39
7386;03.11.2016;'18 - 19;56,03;57,91;-1,88;0;0;0;4123;4856;733
7387;03.11.2016;'19 - 20;48,88;53,35;-4,47;0;0;0;4933;6053;1120
7388;03.11.2016;'20 - 21;42,41;39,34;3,07;0;0;0;6026;6640;614
7389;03.11.2016;'21 - 22;37,27;37,65;-0,38;0;0;0;7232;7242;10
7390;03.11.2016;'22 - 23;36,24;39,24;-3;0;0;0;8414;8104;-310
7391;03.11.2016;'23 - 24;33,98;36,21;-2,23;0;0;0;9377;9171;-206
7392;04.11.2016;'00 - 01;32,4;34,75;-2,35;0;0;0;9655;9850;195
7393;04.11.2016;'01 - 02;32,42;32,94;-0,52;0;0;0;10275;10279;4
7394;04.11.2016;'02 - 03;30,96;33,04;-2,08;0;0;0;10753;11374;621
7395;04.11.2016;'03 - 04;30,8;32,15;-1,35;0;0;0;11229;11690;461
7396;04.11.2016;'04 - 05;31,98;34,88;-2,9;0;0;0;11594;11694;100
7397;04.11.2016;'05 - 06;34,13;38,26;-4,13;0;0;0;11823;11801;-22
7398;04.11.2016;'06 - 07;36,98;44,91;-7,93;0;0;0;12041;12215;174
7399;04.11.2016;'07 - 08;46,78;50,64;-3,86;378;292;-86;12036;12429;393
7400;04.11.2016;'08 - 09;48,69;53,81;-5,12;2465;2154;-311;11858;12096;238
7401;04.11.2016;'09 - 10;47,94;50,36;-2,42;5238;4606;-632;11619;11768;149
7402;04.11.2016;'10 - 11;40,86;49,3;-8,44;7464;6818;-646;11351;11192;-159
7403;04.11.2016;'11 - 12;42,83;50,07;-7,24;8658;8387;-271;11107;10804;-303
7404;04.11.2016;'12 - 13;38,05;46,68;-8,63;8546;8731;185;10851;10494;-357
7405;04.11.2016;'13 - 14;40,49;46,79;-6,3;7252;7437;185;10442;10282;-160
7406;04.11.2016;'14 - 15;43,15;46,78;-3,63;5100;5156;56;9827;9234;-593
7407;04.11.2016;'15 - 16;49,91;53,66;-3,75;2432;2279;-153;9287;8785;-502
7408;04.11.2016;'16 - 17;48,73;57,33;-8,6;400;288;-112;9236;9181;-55
7409;04.11.2016;'17 - 18;52,19;60,04;-7,85;1;3;2;9779;9709;-70
7410;04.11.2016;'18 - 19;49,6;59,36;-9,76;0;0;0;10364;10817;453
7411;04.11.2016;'19 - 20;40,15;49,02;-8,87;0;0;0;10455;11262;807
7412;04.11.2016;'20 - 21;39,23;45,52;-6,29;0;0;0;10003;11054;1051
7413;04.11.2016;'21 - 22;38,31;41,05;-2,74;0;0;0;9427;10681;1254
7414;04.11.2016;'22 - 23;37,02;39,86;-2,84;0;0;0;8850;10018;1168
7415;04.11.2016;'23 - 24;34,9;38,01;-3,11;0;0;0;8228;9442;1214
7416;05.11.2016;'00 - 01;37,05;37,27;-0,22;0;0;0;7493;8442;949
7417;05.11.2016;'01 - 02;37,07;33,26;3,81;0;0;0;7126;8128;1002
7418;05.11.2016;'02 - 03;36,77;34;2,77;0;0;0;6898;8404;1506
7419;05.11.2016;'03 - 04;35,97;33,31;2,66;0;0;0;6775;8412;1637
7420;05.11.2016;'04 - 05;35,54;34,04;1,5;0;0;0;6765;8236;1471
7421;05.11.2016;'05 - 06;35,93;34,7;1,23;0;0;0;6865;8239;1374
7422;05.11.2016;'06 - 07;36,5;34,43;2,07;1;1;0;7060;8356;1296
7423;05.11.2016;'07 - 08;37,02;37,11;-0,09;161;124;-37;7152;8206;1054
7424;05.11.2016;'08 - 09;38,96;41,31;-2,35;936;805;-131;7035;8082;1047
7425;05.11.2016;'09 - 10;39,89;45,27;-5,38;1980;1812;-168;6836;7332;496
7426;05.11.2016;'10 - 11;41,16;44,93;-3,77;2729;3080;351;6541;6620;79
7427;05.11.2016;'11 - 12;44,79;47,46;-2,67;3127;3480;353;6344;6207;-137
7428;05.11.2016;'12 - 13;46,54;47,03;-0,49;3148;3194;46;6330;5812;-518
7429;05.11.2016;'13 - 14;40,8;42,54;-1,74;2760;2690;-70;6400;5671;-729
7430;05.11.2016;'14 - 15;39,35;40,67;-1,32;2009;2075;66;6551;5580;-971
7431;05.11.2016;'15 - 16;38,88;40,69;-1,81;976;1122;146;6828;5348;-1480
7432;05.11.2016;'16 - 17;42,65;42,88;-0,23;166;174;8;7297;5730;-1567
7433;05.11.2016;'17 - 18;48,1;54,18;-6,08;0;3;3;7962;6125;-1837
7434;05.11.2016;'18 - 19;44,78;53,98;-9,2;0;0;0;8781;7127;-1654
7435;05.11.2016;'19 - 20;40,91;47,38;-6,47;0;0;0;9651;7768;-1883
7436;05.11.2016;'20 - 21;37,07;38,73;-1,66;0;0;0;10408;8740;-1668
7437;05.11.2016;'21 - 22;34,32;36,75;-2,43;0;0;0;11126;9061;-2065
7438;05.11.2016;'22 - 23;32,71;38,18;-5,47;0;0;0;11701;9344;-2357
7439;05.11.2016;'23 - 24;29,94;33,08;-3,14;0;0;0;12008;9784;-2224
7440;06.11.2016;'00 - 01;32,23;27,66;4,57;0;0;0;8578;9893;1315
7441;06.11.2016;'01 - 02;27,78;22,19;5,59;0;0;0;8531;9642;1111
7442;06.11.2016;'02 - 03;27,95;16,58;11,37;0;0;0;8375;9397;1022
7443;06.11.2016;'03 - 04;25,03;15,81;9,22;0;0;0;8255;9276;1021
7444;06.11.2016;'04 - 05;30,1;18,34;11,76;0;0;0;8096;8842;746
7445;06.11.2016;'05 - 06;29,82;19,31;10,51;0;0;0;7963;8549;586
7446;06.11.2016;'06 - 07;30,89;24,47;6,42;0;0;0;7914;8552;638
7447;06.11.2016;'07 - 08;30,88;24,67;6,21;132;107;-25;7906;8115;209
7448;06.11.2016;'08 - 09;33,81;29,05;4,76;1137;966;-171;7936;7663;-273
7449;06.11.2016;'09 - 10;37,02;30,34;6,68;2657;2306;-351;7914;6991;-923
7450;06.11.2016;'10 - 11;37,93;33,87;4,06;3982;3599;-383;7775;6638;-1137
7451;06.11.2016;'11 - 12;41,58;37,31;4,27;4788;4417;-371;7456;6539;-917
7452;06.11.2016;'12 - 13;38,94;35,33;3,61;4911;4328;-583;6973;6533;-440
7453;06.11.2016;'13 - 14;37,07;37,18;-0,11;4391;3670;-721;6430;6383;-47
7454;06.11.2016;'14 - 15;37,09;34,32;2,77;3199;2493;-706;5960;6086;126
7455;06.11.2016;'15 - 16;37;35,43;1,57;1507;1092;-415;5608;6506;898
7456;06.11.2016;'16 - 17;39,5;34,22;5,28;241;148;-93;5699;7329;1630
7457;06.11.2016;'17 - 18;48,51;41,53;6,98;1;2;1;6326;8272;1946
7458;06.11.2016;'18 - 19;47,96;38,85;9,11;0;0;0;7010;9223;2213
7459;06.11.2016;'19 - 20;43,27;33,57;9,7;0;0;0;7386;9774;2388
7460;06.11.2016;'20 - 21;37,05;31,26;5,79;0;0;0;7661;10084;2423
7461;06.11.2016;'21 - 22;36;30,15;5,85;0;0;0;7923;10265;2342
7462;06.11.2016;'22 - 23;33,33;30,25;3,08;0;0;0;8143;10336;2193
7463;06.11.2016;'23 - 24;30,23;16,46;13,77;0;0;0;8334;10405;2071
7464;07.11.2016;'00 - 01;10,72;13,18;-2,46;0;0;0;10109;10277;168
7465;07.11.2016;'01 - 02;13,61;12,32;1,29;0;0;0;10187;10319;132
7466;07.11.2016;'02 - 03;13,69;13,07;0,62;0;0;0;10125;10047;-78
7467;07.11.2016;'03 - 04;12,6;12,75;-0,15;0;0;0;9989;9635;-354
7468;07.11.2016;'04 - 05;11,94;12,84;-0,9;0;0;0;9858;9621;-237
7469;07.11.2016;'05 - 06;15,82;14,63;1,19;0;0;0;9749;8959;-790
7470;07.11.2016;'06 - 07;33,02;26,19;6,83;0;0;0;9654;9122;-532
7471;07.11.2016;'07 - 08;40,81;41,16;-0,35;167;118;-49;9560;9084;-476
7472;07.11.2016;'08 - 09;38,01;45,67;-7,66;1422;994;-428;9389;8805;-584
7473;07.11.2016;'09 - 10;38,07;46,98;-8,91;3403;2231;-1172;9138;8197;-941
7474;07.11.2016;'10 - 11;39,93;49,29;-9,36;4919;3299;-1620;8744;7845;-899
7475;07.11.2016;'11 - 12;39,98;52,89;-12,91;5626;4062;-1564;8175;7160;-1015
7476;07.11.2016;'12 - 13;41,76;50,36;-8,6;5529;4086;-1443;7462;6516;-946
7477;07.11.2016;'13 - 14;42,67;49,79;-7,12;4720;3742;-978;6694;5843;-851
7478;07.11.2016;'14 - 15;46,9;52,03;-5,13;3349;2750;-599;5885;5134;-751
7479;07.11.2016;'15 - 16;53,03;54,12;-1,09;1609;1415;-194;5225;4937;-288
7480;07.11.2016;'16 - 17;58,45;56,7;1,75;252;176;-76;4812;4845;33
7481;07.11.2016;'17 - 18;69,83;70,61;-0,78;0;2;2;4699;4878;179
7482;07.11.2016;'18 - 19;65,94;57,96;7,98;0;0;0;4661;5186;525
7483;07.11.2016;'19 - 20;59,93;49,03;10,9;0;0;0;4551;4930;379
7484;07.11.2016;'20 - 21;49,99;40,74;9,25;0;0;0;4219;5066;847
7485;07.11.2016;'21 - 22;37,85;37,58;0,27;0;0;0;3828;4606;778
7486;07.11.2016;'22 - 23;39,7;39,42;0,28;0;0;0;3447;4360;913
7487;07.11.2016;'23 - 24;38,05;35,48;2,57;0;0;0;3104;4158;1054
7488;08.11.2016;'00 - 01;37,47;34,86;2,61;0;0;0;3444;3897;453
7489;08.11.2016;'01 - 02;36,65;33,69;2,96;0;0;0;3194;3688;494
7490;08.11.2016;'02 - 03;36,09;33,76;2,33;0;0;0;3041;3651;610
7491;08.11.2016;'03 - 04;36,17;35,22;0,95;0;0;0;2963;3776;813
7492;08.11.2016;'04 - 05;37,13;35,78;1,35;0;0;0;2966;3984;1018
7493;08.11.2016;'05 - 06;37,17;36,14;1,03;0;0;0;2998;4291;1293
7494;08.11.2016;'06 - 07;46,77;43,74;3,03;0;0;0;3052;4318;1266
7495;08.11.2016;'07 - 08;61,65;59,61;2,04;219;131;-88;3060;4318;1258
7496;08.11.2016;'08 - 09;64,64;61,26;3,38;1653;1054;-599;2947;4224;1277
7497;08.11.2016;'09 - 10;63,89;59,2;4,69;3892;2745;-1147;2792;4022;1230
7498;08.11.2016;'10 - 11;58,97;59,73;-0,76;5861;4256;-1605;2702;4038;1336
7499;08.11.2016;'11 - 12;58,99;60,52;-1,53;6805;4628;-2177;2711;4398;1687
7500;08.11.2016;'12 - 13;58,47;62,16;-3,69;6677;4603;-2074;2743;4631;1888
7501;08.11.2016;'13 - 14;58,94;61,54;-2,6;5605;4409;-1196;2717;4833;2116
7502;08.11.2016;'14 - 15;62,13;62,34;-0,21;3898;3460;-438;2633;4940;2307
7503;08.11.2016;'15 - 16;67,91;65,05;2,86;1838;1580;-258;2564;4880;2316
7504;08.11.2016;'16 - 17;84,92;79,42;5,5;265;173;-92;2643;5094;2451
7505;08.11.2016;'17 - 18;104,96;100,8;4,16;0;2;2;2969;5411;2442
7506;08.11.2016;'18 - 19;70,03;64,48;5,55;0;0;0;3470;5472;2002
7507;08.11.2016;'19 - 20;56,43;51,24;5,19;0;0;0;3976;5572;1596
7508;08.11.2016;'20 - 21;44,15;49,39;-5,24;0;0;0;4221;5767;1546
7509;08.11.2016;'21 - 22;42,45;43,43;-0,98;0;0;0;4371;5610;1239
7510;08.11.2016;'22 - 23;40;39,84;0,16;0;0;0;4498;5700;1202
7511;08.11.2016;'23 - 24;35,98;35,17;0,81;0;0;0;4596;5716;1120
7512;09.11.2016;'00 - 01;35,6;35,81;-0,21;0;0;0;4575;5752;1177
7513;09.11.2016;'01 - 02;33,38;26,54;6,84;0;0;0;4646;5467;821
7514;09.11.2016;'02 - 03;31,46;29,36;2,1;0;0;0;4613;4966;353
7515;09.11.2016;'03 - 04;31,48;31,02;0,46;0;0;0;4583;4592;9
7516;09.11.2016;'04 - 05;34,23;33,23;1;0;0;0;4588;4512;-76
7517;09.11.2016;'05 - 06;35,77;34,31;1,46;0;0;0;4621;4428;-193
7518;09.11.2016;'06 - 07;39,77;41,48;-1,71;0;0;0;4702;4487;-215
7519;09.11.2016;'07 - 08;55,2;58,17;-2,97;231;140;-91;4781;4744;-37
7520;09.11.2016;'08 - 09;55,2;56,7;-1,5;2230;1567;-663;4789;4705;-84
7521;09.11.2016;'09 - 10;54,96;54,35;0,61;5449;3821;-1628;4722;4241;-481
7522;09.11.2016;'10 - 11;49,72;51,8;-2,08;7834;6191;-1643;4669;3648;-1021
7523;09.11.2016;'11 - 12;56,92;54,66;2,26;8683;7700;-983;4695;3236;-1459
7524;09.11.2016;'12 - 13;55,82;49,4;6,42;8110;7654;-456;4709;2909;-1800
7525;09.11.2016;'13 - 14;55,58;48,84;6,74;6404;5951;-453;4627;2716;-1911
7526;09.11.2016;'14 - 15;54,28;52,12;2,16;4135;3500;-635;4736;2890;-1846
7527;09.11.2016;'15 - 16;55,08;55,18;-0,1;1716;1262;-454;5090;3384;-1706
7528;09.11.2016;'16 - 17;62,21;57,58;4,63;175;83;-92;5728;4398;-1330
7529;09.11.2016;'17 - 18;78,44;65,96;12,48;0;0;0;6620;5656;-964
7530;09.11.2016;'18 - 19;60,93;56,15;4,78;0;0;0;7445;7164;-281
7531;09.11.2016;'19 - 20;58,5;51,65;6,85;0;0;0;7773;7882;109
7532;09.11.2016;'20 - 21;48,22;42,09;6,13;0;0;0;7819;8282;463
7533;09.11.2016;'21 - 22;40,85;35,05;5,8;0;0;0;7709;8548;839
7534;09.11.2016;'22 - 23;39,5;34,84;4,66;0;0;0;7474;8529;1055
7535;09.11.2016;'23 - 24;36,1;31;5,1;0;0;0;7248;8554;1306
7536;10.11.2016;'00 - 01;33,53;31,25;2,28;0;0;0;6715;8076;1361
7537;10.11.2016;'01 - 02;32,95;30,46;2,49;0;0;0;6505;8219;1714
7538;10.11.2016;'02 - 03;31,69;30,07;1,62;0;0;0;6103;7972;1869
7539;10.11.2016;'03 - 04;33,2;29,27;3,93;0;0;0;5737;7240;1503
7540;10.11.2016;'04 - 05;33,53;30,68;2,85;0;0;0;5450;6757;1307
7541;10.11.2016;'05 - 06;35;32,57;2,43;0;0;0;5204;6469;1265
7542;10.11.2016;'06 - 07;41,48;36,38;5,1;0;0;0;4925;6324;1399
7543;10.11.2016;'07 - 08;50,37;47,9;2,47;85;71;-14;4586;6119;1533
7544;10.11.2016;'08 - 09;58,91;55,19;3,72;742;736;-6;4230;5494;1264
7545;10.11.2016;'09 - 10;59,98;55,82;4,16;1819;1822;3;3906;5077;1171
7546;10.11.2016;'10 - 11;58,52;55,42;3,1;2768;2709;-59;3627;4568;941
7547;10.11.2016;'11 - 12;59,93;55,24;4,69;3360;3519;159;3438;4098;660
7548;10.11.2016;'12 - 13;61,1;55,53;5,57;3415;3727;312;3268;3994;726
7549;10.11.2016;'13 - 14;65,01;57,62;7,39;2953;3237;284;3056;3645;589
7550;10.11.2016;'14 - 15;63,24;57,1;6,14;2065;2358;293;2806;3260;454
7551;10.11.2016;'15 - 16;65,08;59,31;5,77;902;997;95;2630;3258;628
7552;10.11.2016;'16 - 17;63,08;55,67;7,41;122;106;-16;2669;3710;1041
7553;10.11.2016;'17 - 18;98,15;84,83;13,32;0;0;0;2956;4662;1706
7554;10.11.2016;'18 - 19;67,87;54,03;13,84;0;0;0;3316;5378;2062
7555;10.11.2016;'19 - 20;60,24;51,12;9,12;0;0;0;3652;5739;2087
7556;10.11.2016;'20 - 21;50,39;46,54;3,85;0;0;0;3792;5985;2193
7557;10.11.2016;'21 - 22;41,96;37,66;4,3;0;0;0;3838;5960;2122
7558;10.11.2016;'22 - 23;39,72;36,5;3,22;0;0;0;3828;5790;1962
7559;10.11.2016;'23 - 24;37,76;35,05;2,71;0;0;0;3773;5708;1935
7560;11.11.2016;'00 - 01;37,07;39,71;-2,64;0;0;0;4804;5826;1022
7561;11.11.2016;'01 - 02;36,22;38,22;-2;0;0;0;4833;5785;952
7562;11.11.2016;'02 - 03;34,9;36,4;-1,5;0;0;0;4855;5811;956
7563;11.11.2016;'03 - 04;34,46;37,3;-2,84;0;0;0;4916;5932;1016
7564;11.11.2016;'04 - 05;36,46;36,75;-0,29;0;0;0;5038;5859;821
7565;11.11.2016;'05 - 06;35,45;36,62;-1,17;0;0;0;5185;6382;1197
7566;11.11.2016;'06 - 07;37,6;38,26;-0,66;0;0;0;5282;7113;1831
7567;11.11.2016;'07 - 08;48,46;44,57;3,89;82;55;-27;5214;7253;2039
7568;11.11.2016;'08 - 09;54,97;44,53;10,44;881;584;-297;4896;7155;2259
7569;11.11.2016;'09 - 10;54,92;46,62;8,3;2335;1685;-650;4449;6691;2242
7570;11.11.2016;'10 - 11;55,9;50,23;5,67;3726;3000;-726;3958;5672;1714
7571;11.11.2016;'11 - 12;55,93;53,03;2,9;4646;3868;-778;3509;4976;1467
7572;11.11.2016;'12 - 13;54,93;56,05;-1,12;4825;4143;-682;3148;4448;1300
7573;11.11.2016;'13 - 14;54,42;54,6;-0,18;4211;3886;-325;2909;3905;996
7574;11.11.2016;'14 - 15;51,7;48,1;3,6;2921;2735;-186;2786;3644;858
7575;11.11.2016;'15 - 16;51,71;50,56;1,15;1258;1060;-198;2726;3608;882
7576;11.11.2016;'16 - 17;57,91;56,63;1,28;157;100;-57;2703;3430;727
7577;11.11.2016;'17 - 18;64,92;66,42;-1,5;0;0;0;2710;3487;777
7578;11.11.2016;'18 - 19;56,94;57,91;-0,97;0;0;0;2675;3593;918
7579;11.11.2016;'19 - 20;56,25;58,04;-1,79;0;0;0;2531;3344;813
7580;11.11.2016;'20 - 21;45,79;50,3;-4,51;0;0;0;2242;3071;829
7581;11.11.2016;'21 - 22;42,09;44,89;-2,8;0;0;0;1923;2876;953
7582;11.11.2016;'22 - 23;43,48;44,55;-1,07;0;0;0;1627;2572;945
7583;11.11.2016;'23 - 24;41,27;43,27;-2;0;0;0;1435;2280;845
7584;12.11.2016;'00 - 01;40,21;43,49;-3,28;0;0;0;1543;2038;495
7585;12.11.2016;'01 - 02;38,31;41,95;-3,64;0;0;0;1394;1942;548
7586;12.11.2016;'02 - 03;36,78;39,1;-2,32;0;0;0;1359;2032;673
7587;12.11.2016;'03 - 04;36,09;37,09;-1;0;0;0;1390;2352;962
7588;12.11.2016;'04 - 05;36,05;35,31;0,74;0;0;0;1528;2549;1021
7589;12.11.2016;'05 - 06;36,09;36,32;-0,23;0;0;0;1802;2679;877
7590;12.11.2016;'06 - 07;36,33;36,47;-0,14;0;0;0;2169;2977;808
7591;12.11.2016;'07 - 08;38,38;42,52;-4,14;116;68;-48;2562;3349;787
7592;12.11.2016;'08 - 09;42,21;47,53;-5,32;1635;932;-703;2946;3940;994
7593;12.11.2016;'09 - 10;45,77;47,82;-2,05;4346;3038;-1308;3281;4135;854
7594;12.11.2016;'10 - 11;46,52;50,47;-3,95;6584;5170;-1414;3468;4302;834
7595;12.11.2016;'11 - 12;43,34;49,25;-5,91;7898;6544;-1354;3518;4388;870
7596;12.11.2016;'12 - 13;39,94;47,5;-7,56;8002;6636;-1366;3506;4379;873
7597;12.11.2016;'13 - 14;40,86;45,89;-5,03;6972;5828;-1144;3508;4294;786
7598;12.11.2016;'14 - 15;36,09;40,32;-4,23;4889;3897;-992;3645;4255;610
7599;12.11.2016;'15 - 16;38,06;43,5;-5,44;2114;1510;-604;3924;4568;644
7600;12.11.2016;'16 - 17;45,9;51,09;-5,19;231;133;-98;4489;5424;935
7601;12.11.2016;'17 - 18;51,17;54,54;-3,37;0;0;0;5355;6414;1059
7602;12.11.2016;'18 - 19;48,32;49,04;-0,72;0;0;0;6230;7458;1228
7603;12.11.2016;'19 - 20;39,15;40,03;-0,88;0;0;0;6963;7692;729
7604;12.11.2016;'20 - 21;36,1;39,51;-3,41;0;0;0;7191;7700;509
7605;12.11.2016;'21 - 22;34,77;38,32;-3,55;0;0;0;7183;7883;700
7606;12.11.2016;'22 - 23;34,99;38,14;-3,15;0;0;0;6996;7904;908
7607;12.11.2016;'23 - 24;34,34;35,97;-1,63;0;0;0;6679;7790;1111
7608;13.11.2016;'00 - 01;32,99;35,68;-2,69;0;0;0;6757;7936;1179
7609;13.11.2016;'01 - 02;34,15;37,07;-2,92;0;0;0;6431;7949;1518
7610;13.11.2016;'02 - 03;32,95;34,45;-1,5;0;0;0;6249;7909;1660
7611;13.11.2016;'03 - 04;31,76;33,71;-1,95;0;0;0;6173;7953;1780
7612;13.11.2016;'04 - 05;31,46;32,62;-1,16;0;0;0;6165;7998;1833
7613;13.11.2016;'05 - 06;31,43;31,3;0,13;0;0;0;6208;8120;1912
7614;13.11.2016;'06 - 07;31,63;31,42;0,21;0;0;0;6163;7932;1769
7615;13.11.2016;'07 - 08;31,46;31,15;0,31;119;124;5;6011;7500;1489
7616;13.11.2016;'08 - 09;35,07;33,13;1,94;1472;1512;40;5754;7280;1526
7617;13.11.2016;'09 - 10;36,02;33,17;2,85;4286;4087;-199;5387;6773;1386
7618;13.11.2016;'10 - 11;35,57;34,82;0,75;7082;6984;-98;4870;5833;963
7619;13.11.2016;'11 - 12;36,37;33,07;3,3;8632;8639;7;4278;5270;992
7620;13.11.2016;'12 - 13;36,1;32,81;3,29;8812;8316;-496;3729;4919;1190
7621;13.11.2016;'13 - 14;36,05;30,54;5,51;7681;7936;255;3305;4220;915
7622;13.11.2016;'14 - 15;36,28;29,68;6,6;5350;4922;-428;3207;3605;398
7623;13.11.2016;'15 - 16;39,37;35,09;4,28;2286;1897;-389;3399;3596;197
7624;13.11.2016;'16 - 17;44,74;47,18;-2,44;227;125;-102;4017;4530;513
7625;13.11.2016;'17 - 18;48,82;45,47;3,35;0;0;0;4911;5695;784
7626;13.11.2016;'18 - 19;48,29;43,62;4,67;0;0;0;5711;6588;877
7627;13.11.2016;'19 - 20;46,07;41,25;4,82;0;0;0;6176;7323;1147
7628;13.11.2016;'20 - 21;40,9;36,29;4,61;0;0;0;6199;7708;1509
7629;13.11.2016;'21 - 22;38,06;30,7;7,36;0;0;0;6049;7883;1834
7630;13.11.2016;'22 - 23;37,44;32,35;5,09;0;0;0;5809;8280;2471
7631;13.11.2016;'23 - 24;35,91;27,85;8,06;0;0;0;5547;8232;2685
7632;14.11.2016;'00 - 01;32,56;27,97;4,59;0;0;0;5896;7756;1860
7633;14.11.2016;'01 - 02;31,61;27,86;3,75;0;0;0;5852;7714;1862
7634;14.11.2016;'02 - 03;31,79;28,41;3,38;0;0;0;5794;8103;2309
7635;14.11.2016;'03 - 04;31,68;28,3;3,38;0;0;0;5774;8525;2751
7636;14.11.2016;'04 - 05;31,68;25,46;6,22;0;0;0;5854;8898;3044
7637;14.11.2016;'05 - 06;32,69;27,93;4,76;0;0;0;6090;9570;3480
7638;14.11.2016;'06 - 07;43,92;36,68;7,24;0;0;0;6383;10040;3657
7639;14.11.2016;'07 - 08;54,92;42,41;12,51;231;224;-7;6690;10517;3827
7640;14.11.2016;'08 - 09;51,19;49,94;1,25;3276;3176;-100;7015;10952;3937
7641;14.11.2016;'09 - 10;38,49;39,28;-0,79;8161;7578;-583;7137;10308;3171
7642;14.11.2016;'10 - 11;37,07;38,58;-1,51;11853;11382;-471;6882;9120;2238
7643;14.11.2016;'11 - 12;36,94;39,29;-2,35;13591;13082;-509;6509;8587;2078
7644;14.11.2016;'12 - 13;39,51;43,64;-4,13;13398;12644;-754;6338;8654;2316
7645;14.11.2016;'13 - 14;37,84;45,02;-7,18;11331;10405;-926;6530;8706;2176
7646;14.11.2016;'14 - 15;42,03;47,77;-5,74;7707;6811;-896;7134;8398;1264
7647;14.11.2016;'15 - 16;51,19;48,74;2,45;3262;2488;-774;8137;8683;546
7648;14.11.2016;'16 - 17;49,95;51,64;-1,69;307;172;-135;9421;9826;405
7649;14.11.2016;'17 - 18;56,09;56,57;-0,48;0;0;0;10733;11547;814
7650;14.11.2016;'18 - 19;46,98;47,03;-0,05;0;0;0;11906;13257;1351
7651;14.11.2016;'19 - 20;38,58;44,2;-5,62;0;0;0;12872;14588;1716
7652;14.11.2016;'20 - 21;40,07;35,9;4,17;0;0;0;13543;16042;2499
7653;14.11.2016;'21 - 22;35,36;33,82;1,54;0;0;0;14119;16852;2733
7654;14.11.2016;'22 - 23;32,67;31,25;1,42;0;0;0;14584;16848;2264
7655;14.11.2016;'23 - 24;31,72;30,52;1,2;0;0;0;14881;16486;1605
7656;15.11.2016;'00 - 01;30,08;31,1;-1,02;0;0;0;15271;16009;738
7657;15.11.2016;'01 - 02;30,18;31,33;-1,15;0;0;0;15153;15617;464
7658;15.11.2016;'02 - 03;27,68;32,03;-4,35;0;0;0;14900;15356;456
7659;15.11.2016;'03 - 04;26,58;32,35;-5,77;0;0;0;14664;15080;416
7660;15.11.2016;'04 - 05;30,07;32,67;-2,6;0;0;0;14470;15017;547
7661;15.11.2016;'05 - 06;31,67;34,32;-2,65;0;0;0;14489;15611;1122
7662;15.11.2016;'06 - 07;36,6;36,44;0,16;0;0;0;14662;16652;1990
7663;15.11.2016;'07 - 08;44,65;45,28;-0,63;53;36;-17;14988;17274;2286
7664;15.11.2016;'08 - 09;43,94;47,42;-3,48;492;526;34;15395;17676;2281
7665;15.11.2016;'09 - 10;43,96;47,23;-3,27;1156;1567;411;15809;17214;1405
7666;15.11.2016;'10 - 11;43,96;49,08;-5,12;1611;2708;1097;16134;17706;1572
7667;15.11.2016;'11 - 12;44,65;45,12;-0,47;1782;3286;1504;16316;18282;1966
7668;15.11.2016;'12 - 13;43,08;43,52;-0,44;1604;3059;1455;16400;18204;1804
7669;15.11.2016;'13 - 14;43,58;43,19;0,39;1182;2394;1212;16239;17535;1296
7670;15.11.2016;'14 - 15;43,97;46,32;-2,35;702;1366;664;15832;17137;1305
7671;15.11.2016;'15 - 16;44,01;50,09;-6,08;286;434;148;15335;16872;1537
7672;15.11.2016;'16 - 17;44,97;51,49;-6,52;39;36;-3;14876;16502;1626
7673;15.11.2016;'17 - 18;51,98;54,04;-2,06;0;0;0;14456;16260;1804
7674;15.11.2016;'18 - 19;48,02;49,4;-1,38;0;0;0;14112;16235;2123
7675;15.11.2016;'19 - 20;52,91;48,28;4,63;0;0;0;13815;15878;2063
7676;15.11.2016;'20 - 21;44,74;40,63;4,11;0;0;0;13364;15257;1893
7677;15.11.2016;'21 - 22;38,22;36,89;1,33;0;0;0;12784;14628;1844
7678;15.11.2016;'22 - 23;38,42;37,72;0,7;0;0;0;12118;13604;1486
7679;15.11.2016;'23 - 24;35,4;35,76;-0,36;0;0;0;11423;12648;1225
7680;16.11.2016;'00 - 01;35,55;34,44;1,11;0;0;0;10646;11264;618
7681;16.11.2016;'01 - 02;34,14;34,28;-0,14;0;0;0;9834;10234;400
7682;16.11.2016;'02 - 03;33,4;35,31;-1,91;0;0;0;9236;9568;332
7683;16.11.2016;'03 - 04;33,45;35,04;-1,59;0;0;0;8897;9321;424
7684;16.11.2016;'04 - 05;33,05;34,49;-1,44;0;0;0;8822;9146;324
7685;16.11.2016;'05 - 06;38,59;35,77;2,82;0;0;0;9152;9272;120
7686;16.11.2016;'06 - 07;46,99;37,64;9,35;0;0;0;9727;9783;56
7687;16.11.2016;'07 - 08;51,92;44,3;7,62;23;18;-5;10562;10574;12
7688;16.11.2016;'08 - 09;55,96;46,1;9,86;288;329;41;11779;11562;-217
7689;16.11.2016;'09 - 10;57,81;44,1;13,71;760;1040;280;13278;12510;-768
7690;16.11.2016;'10 - 11;56,36;43,16;13,2;1173;1737;564;14950;13486;-1464
7691;16.11.2016;'11 - 12;53,96;43,12;10,84;1405;2044;639;16641;15369;-1272
7692;16.11.2016;'12 - 13;46,9;43,26;3,64;1454;2086;632;18283;17370;-913
7693;16.11.2016;'13 - 14;45,36;41,06;4,3;1291;1874;583;19602;18516;-1086
7694;16.11.2016;'14 - 15;40,94;39,89;1,05;925;1376;451;20674;19311;-1363
7695;16.11.2016;'15 - 16;40,11;40,52;-0,41;384;559;175;21623;19820;-1803
7696;16.11.2016;'16 - 17;40,83;43,27;-2,44;46;63;17;22058;20653;-1405
7697;16.11.2016;'17 - 18;48,91;46,87;2,04;0;0;0;21960;21238;-722
7698;16.11.2016;'18 - 19;46,95;42,3;4,65;0;0;0;21688;22212;524
7699;16.11.2016;'19 - 20;46,95;35,25;11,7;0;0;0;21366;22792;1426
7700;16.11.2016;'20 - 21;40,58;29,83;10,75;0;0;0;20697;22884;2187
7701;16.11.2016;'21 - 22;36,12;24,35;11,77;0;0;0;19889;22192;2303
7702;16.11.2016;'22 - 23;36,13;23,54;12,59;0;0;0;18996;21311;2315
7703;16.11.2016;'23 - 24;31,73;16,48;15,25;0;0;0;18002;20631;2629
7704;17.11.2016;'00 - 01;27,1;18,17;8,93;0;0;0;18794;19923;1129
7705;17.11.2016;'01 - 02;26,44;13,57;12,87;0;0;0;18340;18836;496
7706;17.11.2016;'02 - 03;22,38;11,39;10,99;0;0;0;17853;18110;257
7707;17.11.2016;'03 - 04;24,99;15,52;9,47;0;0;0;17479;17783;304
7708;17.11.2016;'04 - 05;28,16;24,25;3,91;0;0;0;17134;17783;649
7709;17.11.2016;'05 - 06;30,85;26,33;4,52;0;0;0;16842;17091;249
7710;17.11.2016;'06 - 07;38,54;33,6;4,94;0;0;0;16580;17540;960
7711;17.11.2016;'07 - 08;47,94;40,38;7,56;32;27;-5;16501;17288;787
7712;17.11.2016;'08 - 09;48,93;41,97;6,96;544;437;-107;16748;17146;398
7713;17.11.2016;'09 - 10;43,14;41,35;1,79;1713;1564;-149;17213;17509;296
7714;17.11.2016;'10 - 11;42,93;39,04;3,89;2859;2938;79;17953;18767;814
7715;17.11.2016;'11 - 12;43,91;38,07;5,84;3566;4048;482;18908;19738;830
7716;17.11.2016;'12 - 13;43,65;35,51;8,14;3654;4952;1298;19778;20432;654
7717;17.11.2016;'13 - 14;41,66;31,96;9,7;3223;4421;1198;20550;21040;490
7718;17.11.2016;'14 - 15;37,13;32,72;4,41;2229;3098;869;21544;21554;10
7719;17.11.2016;'15 - 16;37,36;31,41;5,95;870;1238;368;22362;21574;-788
7720;17.11.2016;'16 - 17;37,91;31,66;6,25;91;121;30;22992;22465;-527
7721;17.11.2016;'17 - 18;37,99;34,47;3,52;0;0;0;23855;24672;817
7722;17.11.2016;'18 - 19;37,47;30,19;7,28;0;0;0;25055;25850;795
7723;17.11.2016;'19 - 20;35,62;22,97;12,65;0;0;0;26441;27016;575
7724;17.11.2016;'20 - 21;32,08;22,6;9,48;0;0;0;27849;28657;808
7725;17.11.2016;'21 - 22;26,92;17,91;9,01;0;0;0;29210;30103;893
7726;17.11.2016;'22 - 23;13,72;6,93;6,79;0;0;0;30197;30112;-85
7727;17.11.2016;'23 - 24;8,26;0,97;7,29;0;0;0;30549;30284;-265
7728;18.11.2016;'00 - 01;0,1;-3,19;3,29;0;0;0;30913;29616;-1297
7729;18.11.2016;'01 - 02;-12,1;-6,42;-5,68;0;0;0;30060;28730;-1330
7730;18.11.2016;'02 - 03;-10;-0,74;-9,26;0;0;0;28722;27546;-1176
7731;18.11.2016;'03 - 04;-0,01;6,2;-6,21;0;0;0;27554;27001;-553
7732;18.11.2016;'04 - 05;8,86;13,25;-4,39;0;0;0;26524;26371;-153
7733;18.11.2016;'05 - 06;13,22;22,06;-8,84;0;0;0;25718;27096;1378
7734;18.11.2016;'06 - 07;29,83;37,16;-7,33;0;0;0;25213;27489;2276
7735;18.11.2016;'07 - 08;37,88;38,73;-0,85;55;78;23;25368;26828;1460
7736;18.11.2016;'08 - 09;34,74;38,09;-3,35;915;1036;121;26236;28224;1988
7737;18.11.2016;'09 - 10;34,65;40,89;-6,24;2580;2672;92;26848;27730;882
7738;18.11.2016;'10 - 11;33,86;40,94;-7,08;4129;4580;451;27149;28078;929
7739;18.11.2016;'11 - 12;33,13;42,48;-9,35;5107;5105;-2;27387;27630;243
7740;18.11.2016;'12 - 13;31,04;41,47;-10,43;5146;4573;-573;27704;27041;-663
7741;18.11.2016;'13 - 14;31,06;42,69;-11,63;4298;4058;-240;27262;26710;-552
7742;18.11.2016;'14 - 15;31,79;41,26;-9,47;2897;2888;-9;25905;25596;-309
7743;18.11.2016;'15 - 16;35,99;39,69;-3,7;1161;1160;-1;24352;24055;-297
7744;18.11.2016;'16 - 17;39,96;43,46;-3,5;102;114;12;23311;23878;567
7745;18.11.2016;'17 - 18;39,98;46,68;-6,7;0;0;0;23034;24954;1920
7746;18.11.2016;'18 - 19;39,02;44,82;-5,8;0;0;0;23157;25716;2559
7747;18.11.2016;'19 - 20;34,06;36,86;-2,8;0;0;0;23456;25957;2501
7748;18.11.2016;'20 - 21;34,02;32,86;1,16;0;0;0;23746;25901;2155
7749;18.11.2016;'21 - 22;27,66;27,6;0,06;0;0;0;23776;26066;2290
7750;18.11.2016;'22 - 23;17,88;22,09;-4,21;0;0;0;23574;25025;1451
7751;18.11.2016;'23 - 24;13,57;22,14;-8,57;0;0;0;23273;23935;662
7752;19.11.2016;'00 - 01;13,79;22,71;-8,92;0;0;0;24020;22910;-1110
7753;19.11.2016;'01 - 02;12,69;23,82;-11,13;0;0;0;22901;21401;-1500
7754;19.11.2016;'02 - 03;12,85;23,49;-10,64;0;0;0;21393;19229;-2164
7755;19.11.2016;'03 - 04;15,18;29,22;-14,04;0;0;0;20143;17954;-2189
7756;19.11.2016;'04 - 05;20,56;29,07;-8,51;0;0;0;19289;17567;-1722
7757;19.11.2016;'05 - 06;18,58;29,51;-10,93;0;0;0;18875;17627;-1248
7758;19.11.2016;'06 - 07;20,2;30,39;-10,19;0;0;0;18690;17986;-704
7759;19.11.2016;'07 - 08;33,36;39,28;-5,92;27;11;-16;18444;17666;-778
7760;19.11.2016;'08 - 09;37,01;41,54;-4,53;683;427;-256;18012;17219;-793
7761;19.11.2016;'09 - 10;41,08;43,12;-2,04;2179;1263;-916;17446;16429;-1017
7762;19.11.2016;'10 - 11;41;43,16;-2,16;3506;2038;-1468;16864;15503;-1361
7763;19.11.2016;'11 - 12;40,1;45,6;-5,5;4288;2605;-1683;16466;15208;-1258
7764;19.11.2016;'12 - 13;39,24;46,38;-7,14;4297;3025;-1272;16193;15780;-413
7765;19.11.2016;'13 - 14;36,97;40,27;-3,3;3572;3128;-444;15660;15635;-25
7766;19.11.2016;'14 - 15;36,96;38,88;-1,92;2372;2328;-44;14736;15210;474
7767;19.11.2016;'15 - 16;39,96;38,56;1,4;916;1041;125;13863;14449;586
7768;19.11.2016;'16 - 17;46,9;37,01;9,89;86;97;11;13492;14536;1044
7769;19.11.2016;'17 - 18;46,95;45,3;1,65;0;0;0;13877;15041;1164
7770;19.11.2016;'18 - 19;42,96;44,68;-1,72;0;0;0;14622;16130;1508
7771;19.11.2016;'19 - 20;39,97;39,26;0,71;0;0;0;15287;16894;1607
7772;19.11.2016;'20 - 21;33,8;32,5;1,3;0;0;0;15799;17380;1581
7773;19.11.2016;'21 - 22;33,08;31,59;1,49;0;0;0;16044;17641;1597
7774;19.11.2016;'22 - 23;32,14;32,05;0,09;0;0;0;16149;17180;1031
7775;19.11.2016;'23 - 24;22,09;24,23;-2,14;0;0;0;16177;17354;1177
7776;20.11.2016;'00 - 01;13,66;23,21;-9,55;0;0;0;15847;17558;1711
7777;20.11.2016;'01 - 02;13,62;13,29;0,33;0;0;0;16022;17646;1624
7778;20.11.2016;'02 - 03;14,66;8,59;6,07;0;0;0;16464;18333;1869
7779;20.11.2016;'03 - 04;13,61;6,32;7,29;0;0;0;17125;19491;2366
7780;20.11.2016;'04 - 05;13,64;5,26;8,38;0;0;0;18206;21106;2900
7781;20.11.2016;'05 - 06;5,68;-9,23;14,91;0;0;0;19705;22902;3197
7782;20.11.2016;'06 - 07;1;-23,41;24,41;0;0;0;21357;25514;4157
7783;20.11.2016;'07 - 08;-0,01;-39,55;39,54;63;65;2;23175;27787;4612
7784;20.11.2016;'08 - 09;8,04;-44,27;52,31;1614;1580;-34;24899;29432;4533
7785;20.11.2016;'09 - 10;5,68;-56,7;62,38;4683;4319;-364;26485;30218;3733
7786;20.11.2016;'10 - 11;-0,44;-57,76;57,32;7142;7416;274;27793;30543;2750
7787;20.11.2016;'11 - 12;-0,04;-56,67;56,63;8323;9166;843;28813;31450;2637
7788;20.11.2016;'12 - 13;-9,94;-60,36;50,42;8272;9063;791;29779;31953;2174
7789;20.11.2016;'13 - 14;-22,17;-63,06;40,89;6922;7853;931;30744;31958;1214
7790;20.11.2016;'14 - 15;-30,41;-52,47;22,06;4566;5282;716;31603;32379;776
7791;20.11.2016;'15 - 16;-15,68;-22,86;7,18;1734;1998;264;32353;32558;205
7792;20.11.2016;'16 - 17;-29,04;-5,54;-23,5;139;134;-5;32690;32844;154
7793;20.11.2016;'17 - 18;9,9;16,76;-6,86;0;0;0;32613;32379;-234
7794;20.11.2016;'18 - 19;8,06;15,97;-7,91;0;0;0;32317;31613;-704
7795;20.11.2016;'19 - 20;8,99;16,35;-7,36;0;0;0;31746;30277;-1469
7796;20.11.2016;'20 - 21;-1,58;13,83;-15,41;0;0;0;30926;28403;-2523
7797;20.11.2016;'21 - 22;-3,35;21,3;-24,65;0;0;0;29649;26047;-3602
7798;20.11.2016;'22 - 23;3,45;25,82;-22,37;0;0;0;28101;24210;-3891
7799;20.11.2016;'23 - 24;-14,91;23,24;-38,15;0;0;0;26366;23186;-3180
7800;21.11.2016;'00 - 01;13,56;16,73;-3,17;0;0;0;21661;21607;-54
7801;21.11.2016;'01 - 02;8,81;12,28;-3,47;0;0;0;19800;20467;667
7802;21.11.2016;'02 - 03;9,79;10,46;-0,67;0;0;0;17986;18975;989
7803;21.11.2016;'03 - 04;11,01;11,9;-0,89;0;0;0;16496;17161;665
7804;21.11.2016;'04 - 05;10,88;10,38;0,5;0;0;0;15546;15782;236
7805;21.11.2016;'05 - 06;20;20,15;-0,15;0;0;0;15224;14800;-424
7806;21.11.2016;'06 - 07;38,71;31,63;7,08;0;0;0;15406;15246;-160
7807;21.11.2016;'07 - 08;49,86;43,24;6,62;67;70;3;15823;16042;219
7808;21.11.2016;'08 - 09;49,4;44,26;5,14;1472;1367;-105;16203;16310;107
7809;21.11.2016;'09 - 10;46,25;41,13;5,12;4041;3802;-239;16356;16431;75
7810;21.11.2016;'10 - 11;41,15;45,22;-4,07;6129;5857;-272;15971;15502;-469
7811;21.11.2016;'11 - 12;41,61;47,7;-6,09;7183;6900;-283;15013;14252;-761
7812;21.11.2016;'12 - 13;41,75;46,39;-4,64;6915;6295;-620;14129;12936;-1193
7813;21.11.2016;'13 - 14;45,74;47,52;-1,78;5532;4723;-809;13653;11616;-2037
7814;21.11.2016;'14 - 15;46,91;50,41;-3,5;3430;2674;-756;13835;11631;-2204
7815;21.11.2016;'15 - 16;48;50,4;-2,4;1195;857;-338;14554;13429;-1125
7816;21.11.2016;'16 - 17;44,72;48,65;-3,93;75;63;-12;15558;16078;520
7817;21.11.2016;'17 - 18;45,56;46,6;-1,04;0;0;0;16583;18830;2247
7818;21.11.2016;'18 - 19;38,71;43,38;-4,67;0;0;0;17462;19815;2353
7819;21.11.2016;'19 - 20;36,3;41,8;-5,5;0;0;0;18091;19641;1550
7820;21.11.2016;'20 - 21;35,75;39,08;-3,33;0;0;0;18366;18613;247
7821;21.11.2016;'21 - 22;32,84;36,19;-3,35;0;0;0;18371;17646;-725
7822;21.11.2016;'22 - 23;32,46;38,32;-5,86;0;0;0;18291;16930;-1361
7823;21.11.2016;'23 - 24;22,07;30,94;-8,87;0;0;0;18190;16944;-1246
7824;22.11.2016;'00 - 01;24,1;28,46;-4,36;0;0;0;17637;17392;-245
7825;22.11.2016;'01 - 02;27,11;27,98;-0,87;0;0;0;16876;17048;172
7826;22.11.2016;'02 - 03;21,49;23,01;-1,52;0;0;0;16036;15885;-151
7827;22.11.2016;'03 - 04;21;18,05;2,95;0;0;0;15264;15363;99
7828;22.11.2016;'04 - 05;19,99;19,18;0,81;0;0;0;14585;15536;951
7829;22.11.2016;'05 - 06;29,38;29,04;0,34;0;0;0;14036;14886;850
7830;22.11.2016;'06 - 07;33,89;29,13;4,76;0;0;0;13527;14449;922
7831;22.11.2016;'07 - 08;40,89;37,62;3,27;61;47;-14;12911;14131;1220
7832;22.11.2016;'08 - 09;39,43;40,41;-0,98;1557;971;-586;12089;13647;1558
7833;22.11.2016;'09 - 10;37,16;39,45;-2,29;4504;2618;-1886;11175;12752;1577
7834;22.11.2016;'10 - 11;35,85;39,77;-3,92;6940;4318;-2622;9933;11546;1613
7835;22.11.2016;'11 - 12;36,35;40,65;-4,3;8295;5194;-3101;8436;10037;1601
7836;22.11.2016;'12 - 13;37;41,31;-4,31;8258;4995;-3263;7112;8446;1334
7837;22.11.2016;'13 - 14;38,46;41,66;-3,2;6807;4258;-2549;6159;6869;710
7838;22.11.2016;'14 - 15;46,02;47,74;-1,72;4343;2926;-1417;5661;5772;111
7839;22.11.2016;'15 - 16;51,94;49,99;1,95;1555;1114;-441;5502;5487;-15
7840;22.11.2016;'16 - 17;51,51;48,41;3,1;102;88;-14;5623;6452;829
7841;22.11.2016;'17 - 18;64,2;55,33;8,87;0;0;0;5899;7213;1314
7842;22.11.2016;'18 - 19;54,67;50,4;4,27;0;0;0;6123;7682;1559
7843;22.11.2016;'19 - 20;51,99;45,49;6,5;0;0;0;6132;7844;1712
7844;22.11.2016;'20 - 21;46,98;38,76;8,22;0;0;0;5901;7793;1892
7845;22.11.2016;'21 - 22;38,77;36,81;1,96;0;0;0;5543;7000;1457
7846;22.11.2016;'22 - 23;37,17;34,91;2,26;0;0;0;5142;6150;1008
7847;22.11.2016;'23 - 24;34,8;32,05;2,75;0;0;0;4732;5754;1022
7848;23.11.2016;'00 - 01;34,61;34,16;0,45;0;0;0;5036;5257;221
7849;23.11.2016;'01 - 02;33,65;31,42;2,23;0;0;0;4628;4359;-269
7850;23.11.2016;'02 - 03;33,46;32,47;0,99;0;0;0;4223;3496;-727
7851;23.11.2016;'03 - 04;32,08;32,54;-0,46;0;0;0;3911;2779;-1132
7852;23.11.2016;'04 - 05;33,54;33,3;0,24;0;0;0;3698;2450;-1248
7853;23.11.2016;'05 - 06;35,38;35,35;0,03;0;0;0;3602;2428;-1174
7854;23.11.2016;'06 - 07;46,34;46,62;-0,28;0;0;0;3530;2541;-989
7855;23.11.2016;'07 - 08;48,81;49,14;-0,33;43;34;-9;3425;2677;-748
7856;23.11.2016;'08 - 09;51,1;52,09;-0,99;1178;1290;112;3240;3204;-36
7857;23.11.2016;'09 - 10;53,94;51,03;2,91;3882;3871;-11;2995;3067;72
7858;23.11.2016;'10 - 11;51;47,08;3,92;6356;5960;-396;2605;2756;151
7859;23.11.2016;'11 - 12;51,95;48,2;3,75;7749;6947;-802;2132;2330;198
7860;23.11.2016;'12 - 13;49,99;48,02;1,97;7853;7242;-611;1731;1702;-29
7861;23.11.2016;'13 - 14;51,92;49,41;2,51;6687;6314;-373;1531;1448;-83
7862;23.11.2016;'14 - 15;54,98;50,25;4,73;4361;3890;-471;1641;1362;-279
7863;23.11.2016;'15 - 16;58,48;52,01;6,47;1546;1251;-295;1984;1662;-322
7864;23.11.2016;'16 - 17;55,01;54,77;0,24;100;97;-3;2487;2456;-31
7865;23.11.2016;'17 - 18;62;58,71;3,29;0;0;0;3071;3297;226
7866;23.11.2016;'18 - 19;52,92;52,16;0,76;0;0;0;3653;4108;455
7867;23.11.2016;'19 - 20;50;48,96;1,04;0;0;0;4214;4826;612
7868;23.11.2016;'20 - 21;39,13;39,54;-0,41;0;0;0;4718;5564;846
7869;23.11.2016;'21 - 22;37,21;37,29;-0,08;0;0;0;5200;6225;1025
7870;23.11.2016;'22 - 23;37,79;37,25;0,54;0;0;0;5782;6608;826
7871;23.11.2016;'23 - 24;33,99;32,46;1,53;0;0;0;6565;7414;849
7872;24.11.2016;'00 - 01;32,66;32,87;-0,21;0;0;0;7309;8813;1504
7873;24.11.2016;'01 - 02;31,61;30,06;1,55;0;0;0;8088;10185;2097
7874;24.11.2016;'02 - 03;30,8;28,96;1,84;0;0;0;8581;10981;2400
7875;24.11.2016;'03 - 04;29,58;27,11;2,47;0;0;0;8877;11144;2267
7876;24.11.2016;'04 - 05;29,76;27,58;2,18;0;0;0;9082;11100;2018
7877;24.11.2016;'05 - 06;32,44;29,69;2,75;0;0;0;9225;10832;1607
7878;24.11.2016;'06 - 07;36,5;34,94;1,56;0;0;0;9322;10669;1347
7879;24.11.2016;'07 - 08;43,12;42,8;0,32;26;15;-11;9325;10888;1563
7880;24.11.2016;'08 - 09;45,97;44,63;1,34;846;639;-207;9168;11105;1937
7881;24.11.2016;'09 - 10;44,96;43,04;1,92;2947;2368;-579;8873;10392;1519
7882;24.11.2016;'10 - 11;43,69;44,27;-0,58;4969;4304;-665;8344;8222;-122
7883;24.11.2016;'11 - 12;44,25;46,69;-2,44;6260;5674;-586;7686;7600;-86
7884;24.11.2016;'12 - 13;42,87;45,22;-2,35;6541;6084;-457;7247;6952;-295
7885;24.11.2016;'13 - 14;42,91;46,78;-3,87;5737;5357;-380;7131;6550;-581
7886;24.11.2016;'14 - 15;42,77;45,6;-2,83;3903;3492;-411;7352;6690;-662
7887;24.11.2016;'15 - 16;44,59;46,33;-1,74;1461;1136;-325;7816;7603;-213
7888;24.11.2016;'16 - 17;49,36;50,64;-1,28;98;67;-31;8450;9260;810
7889;24.11.2016;'17 - 18;50,97;51,61;-0,64;0;0;0;9110;9456;346
7890;24.11.2016;'18 - 19;45,23;44,93;0,3;0;0;0;9609;11208;1599
7891;24.11.2016;'19 - 20;44,1;42,01;2,09;0;0;0;9802;11769;1967
7892;24.11.2016;'20 - 21;38,07;36,68;1,39;0;0;0;9699;11671;1972
7893;24.11.2016;'21 - 22;37,71;37,28;0,43;0;0;0;9405;11462;2057
7894;24.11.2016;'22 - 23;35,88;34,01;1,87;0;0;0;9052;10658;1606
7895;24.11.2016;'23 - 24;33,62;33,5;0,12;0;0;0;8735;10200;1465
7896;25.11.2016;'00 - 01;35,23;31,54;3,69;0;0;0;8418;9721;1303
7897;25.11.2016;'01 - 02;32,99;30,54;2,45;0;0;0;8216;9464;1248
7898;25.11.2016;'02 - 03;32,02;30,23;1,79;0;0;0;8099;9293;1194
7899;25.11.2016;'03 - 04;31,05;29,21;1,84;0;0;0;8022;9249;1227
7900;25.11.2016;'04 - 05;31,18;29,24;1,94;0;0;0;7895;9124;1229
7901;25.11.2016;'05 - 06;34,85;33,55;1,3;0;0;0;7782;9008;1226
7902;25.11.2016;'06 - 07;37,98;34,09;3,89;0;0;0;7597;8978;1381
7903;25.11.2016;'07 - 08;47,1;43,45;3,65;16;9;-7;7247;8573;1326
7904;25.11.2016;'08 - 09;48,49;45,56;2,93;630;446;-184;6780;8025;1245
7905;25.11.2016;'09 - 10;47,97;43,7;4,27;2381;2058;-323;6334;7158;824
7906;25.11.2016;'10 - 11;47,42;45,1;2,32;4140;4143;3;5876;6359;483
7907;25.11.2016;'11 - 12;48,25;46,19;2,06;5254;5775;521;5457;5577;120
7908;25.11.2016;'12 - 13;47,95;44,86;3,09;5422;6145;723;5125;5003;-122
7909;25.11.2016;'13 - 14;47,95;44,69;3,26;4658;5226;568;5033;4508;-525
7910;25.11.2016;'14 - 15;47,92;46,39;1,53;3025;3197;172;5186;4176;-1010
7911;25.11.2016;'15 - 16;48,81;47,96;0,85;1047;964;-83;5429;3959;-1470
7912;25.11.2016;'16 - 17;49,96;49,63;0,33;58;58;0;5642;3977;-1665
7913;25.11.2016;'17 - 18;54,75;53,64;1,11;0;0;0;5681;3892;-1789
7914;25.11.2016;'18 - 19;48,29;47,28;1,01;0;0;0;5580;3499;-2081
7915;25.11.2016;'19 - 20;48,94;46,31;2,63;0;0;0;5272;3086;-2186
7916;25.11.2016;'20 - 21;43,52;43,7;-0,18;0;0;0;4813;2783;-2030
7917;25.11.2016;'21 - 22;38,92;38,33;0,59;0;0;0;4353;2606;-1747
7918;25.11.2016;'22 - 23;38,67;39,72;-1,05;0;0;0;3940;2467;-1473
7919;25.11.2016;'23 - 24;35,24;37,05;-1,81;0;0;0;3549;2387;-1162
7920;26.11.2016;'00 - 01;32,5;36,88;-4,38;0;0;0;3283;2302;-981
7921;26.11.2016;'01 - 02;31,93;33,19;-1,26;0;0;0;3083;2339;-744
7922;26.11.2016;'02 - 03;31,82;32,21;-0,39;0;0;0;2968;2186;-782
7923;26.11.2016;'03 - 04;31,84;30,79;1,05;0;0;0;2916;2215;-701
7924;26.11.2016;'04 - 05;32,07;29,44;2,63;0;0;0;2961;2392;-569
7925;26.11.2016;'05 - 06;32,35;31,75;0,6;0;0;0;3098;2668;-430
7926;26.11.2016;'06 - 07;33,36;33,92;-0,56;0;0;0;3259;2799;-460
7927;26.11.2016;'07 - 08;42,22;40,99;1,23;9;4;-5;3408;2948;-460
7928;26.11.2016;'08 - 09;44,1;45,99;-1,89;365;250;-115;3572;3003;-569
7929;26.11.2016;'09 - 10;46,76;49,09;-2,33;1464;1079;-385;3781;3102;-679
7930;26.11.2016;'10 - 11;48,92;50,73;-1,81;2625;2009;-616;4069;3330;-739
7931;26.11.2016;'11 - 12;48,56;52,12;-3,56;3362;2523;-839;4455;3894;-561
7932;26.11.2016;'12 - 13;47,91;51,23;-3,32;3423;2673;-750;4929;4588;-341
7933;26.11.2016;'13 - 14;43,97;47,94;-3,97;2874;2172;-702;5531;5234;-297
7934;26.11.2016;'14 - 15;38,24;42,19;-3,95;1797;1245;-552;6292;5971;-321
7935;26.11.2016;'15 - 16;40,44;43,83;-3,39;583;400;-183;7183;6373;-810
7936;26.11.2016;'16 - 17;45,3;48,07;-2,77;28;25;-3;8235;7198;-1037
7937;26.11.2016;'17 - 18;47,96;52,09;-4,13;0;0;0;9439;8356;-1083
7938;26.11.2016;'18 - 19;43,95;50,51;-6,56;0;0;0;10710;9518;-1192
7939;26.11.2016;'19 - 20;37,5;47,25;-9,75;0;0;0;11815;10558;-1257
7940;26.11.2016;'20 - 21;32,91;37,62;-4,71;0;0;0;12749;11240;-1509
7941;26.11.2016;'21 - 22;32,75;33,99;-1,24;0;0;0;13510;11872;-1638
7942;26.11.2016;'22 - 23;31,72;34,3;-2,58;0;0;0;14110;12876;-1234
7943;26.11.2016;'23 - 24;28,25;33,29;-5,04;0;0;0;14538;13508;-1030
7944;27.11.2016;'00 - 01;22,92;32,03;-9,11;0;0;0;15162;13915;-1247
7945;27.11.2016;'01 - 02;21,14;28,15;-7,01;0;0;0;15134;14112;-1022
7946;27.11.2016;'02 - 03;20,25;25,24;-4,99;0;0;0;14896;14025;-871
7947;27.11.2016;'03 - 04;20,28;25,93;-5,65;0;0;0;14603;13735;-868
7948;27.11.2016;'04 - 05;20,95;26,1;-5,15;0;0;0;14199;13352;-847
7949;27.11.2016;'05 - 06;27;28,35;-1,35;0;0;0;13557;12792;-765
7950;27.11.2016;'06 - 07;28,02;29,62;-1,6;0;0;0;12778;12470;-308
7951;27.11.2016;'07 - 08;28,93;30,81;-1,88;8;8;0;11903;11888;-15
7952;27.11.2016;'08 - 09;31,35;31,39;-0,04;404;476;72;10964;11255;291
7953;27.11.2016;'09 - 10;33,19;34,8;-1,61;1768;2282;514;9974;9803;-171
7954;27.11.2016;'10 - 11;34,24;36,23;-1,99;3342;4550;1208;8935;8460;-475
7955;27.11.2016;'11 - 12;38,13;40,18;-2,05;4543;5752;1209;8089;7728;-361
7956;27.11.2016;'12 - 13;35,69;38,77;-3,08;4888;5988;1100;7648;8084;436
7957;27.11.2016;'13 - 14;33,44;35,15;-1,71;4346;5322;976;7581;8088;507
7958;27.11.2016;'14 - 15;33,53;35,04;-1,51;2819;3189;370;7796;8310;514
7959;27.11.2016;'15 - 16;34,2;36,16;-1,96;897;920;23;8237;8281;44
7960;27.11.2016;'16 - 17;37,48;38,67;-1,19;45;46;1;9003;9444;441
7961;27.11.2016;'17 - 18;41,07;45,84;-4,77;0;0;0;9952;11145;1193
7962;27.11.2016;'18 - 19;41,05;45,05;-4;0;0;0;10784;12198;1414
7963;27.11.2016;'19 - 20;36,08;38,87;-2,79;0;0;0;11293;13672;2379
7964;27.11.2016;'20 - 21;34,69;36,38;-1,69;0;0;0;11420;14445;3025
7965;27.11.2016;'21 - 22;32,69;33,85;-1,16;0;0;0;11463;14134;2671
7966;27.11.2016;'22 - 23;32,16;36,27;-4,11;0;0;0;11464;14000;2536
7967;27.11.2016;'23 - 24;28,43;30,62;-2,19;0;0;0;11400;14410;3010
7968;28.11.2016;'00 - 01;27,06;25,57;1,49;0;0;0;12668;14947;2279
7969;28.11.2016;'01 - 02;28,24;24,85;3,39;0;0;0;12671;15316;2645
7970;28.11.2016;'02 - 03;24,31;17,07;7,24;0;0;0;12500;15118;2618
7971;28.11.2016;'03 - 04;24,03;12,98;11,05;0;0;0;12194;14817;2623
7972;28.11.2016;'04 - 05;26,81;15,87;10,94;0;0;0;11752;14539;2787
7973;28.11.2016;'05 - 06;31,96;26,46;5,5;0;0;0;11162;13757;2595
7974;28.11.2016;'06 - 07;37,94;29,44;8,5;0;0;0;10487;13296;2809
7975;28.11.2016;'07 - 08;47,88;40,2;7,68;27;12;-15;9706;12810;3104
7976;28.11.2016;'08 - 09;46,99;41,28;5,71;1748;1371;-377;8816;11852;3036
7977;28.11.2016;'09 - 10;44,42;39,37;5,05;6211;5762;-449;7803;9958;2155
7978;28.11.2016;'10 - 11;37,92;37;0,92;9977;10309;332;6587;7900;1313
7979;28.11.2016;'11 - 12;43,53;38,71;4,82;12060;12686;626;5516;6791;1275
7980;28.11.2016;'12 - 13;37,38;35,31;2,07;12215;12798;583;4818;6279;1461
7981;28.11.2016;'13 - 14;44,81;39,16;5,65;10491;10686;195;4455;5500;1045
7982;28.11.2016;'14 - 15;45,77;42,38;3,39;6987;6774;-213;4305;4688;383
7983;28.11.2016;'15 - 16;51,38;49,99;1,39;2458;2211;-247;4335;4272;-63
7984;28.11.2016;'16 - 17;57,21;57,78;-0,57;116;102;-14;4586;4502;-84
7985;28.11.2016;'17 - 18;65,11;68,31;-3,2;0;0;0;4996;5339;343
7986;28.11.2016;'18 - 19;51,42;53,09;-1,67;0;0;0;5306;5818;512
7987;28.11.2016;'19 - 20;48,5;49,72;-1,22;0;0;0;5319;5628;309
7988;28.11.2016;'20 - 21;45,97;45,67;0,3;0;0;0;5090;5354;264
7989;28.11.2016;'21 - 22;39,29;44,28;-4,99;0;0;0;4873;4952;79
7990;28.11.2016;'22 - 23;36,14;38,86;-2,72;0;0;0;4834;4601;-233
7991;28.11.2016;'23 - 24;34,59;35,12;-0,53;0;0;0;5040;4560;-480
7992;29.11.2016;'00 - 01;36,92;38,7;-1,78;0;0;0;4972;4730;-242
7993;29.11.2016;'01 - 02;35,78;36,99;-1,21;0;0;0;5387;5122;-265
7994;29.11.2016;'02 - 03;34,81;35,19;-0,38;0;0;0;5857;5736;-121
7995;29.11.2016;'03 - 04;34,43;34,08;0,35;0;0;0;6375;6302;-73
7996;29.11.2016;'04 - 05;34,89;32,86;2,03;0;0;0;6852;6898;46
7997;29.11.2016;'05 - 06;36,75;39,4;-2,65;0;0;0;7275;7499;224
7998;29.11.2016;'06 - 07;44,68;47,4;-2,72;0;0;0;7692;8079;387
7999;29.11.2016;'07 - 08;54,95;62,05;-7,1;30;9;-21;8060;8621;561
8000;29.11.2016;'08 - 09;52,65;57,18;-4,53;1813;1766;-47;8299;9022;723
8001;29.11.2016;'09 - 10;48,5;55,49;-6,99;6516;6250;-266;8277;8790;513
8002;29.11.2016;'10 - 11;43,69;47,91;-4,22;10498;10892;394;7899;7892;-7
8003;29.11.2016;'11 - 12;42,2;46,81;-4,61;12600;13975;1375;7624;6933;-691
8004;29.11.2016;'12 - 13;40,42;44,01;-3,59;12715;14321;1606;7531;6652;-879
8005;29.11.2016;'13 - 14;41,75;44,05;-2,3;10969;12273;1304;7647;6378;-1269
8006;29.11.2016;'14 - 15;43,12;46,56;-3,44;7348;7996;648;8238;6404;-1834
8007;29.11.2016;'15 - 16;50,94;52,11;-1,17;2519;2756;237;9122;7120;-2002
8008;29.11.2016;'16 - 17;55,58;62,34;-6,76;107;140;33;10259;8705;-1554
8009;29.11.2016;'17 - 18;55,66;72,64;-16,98;0;0;0;11357;10518;-839
8010;29.11.2016;'18 - 19;52,61;66,93;-14,32;0;0;0;12197;12009;-188
8011;29.11.2016;'19 - 20;47,94;53,01;-5,07;0;0;0;12912;12932;20
8012;29.11.2016;'20 - 21;39,97;48,18;-8,21;0;0;0;13448;13689;241
8013;29.11.2016;'21 - 22;35,9;43,97;-8,07;0;0;0;13975;14375;400
8014;29.11.2016;'22 - 23;32,9;37,06;-4,16;0;0;0;14604;14708;104
8015;29.11.2016;'23 - 24;30,38;32,75;-2,37;0;0;0;15289;15397;108
8016;30.11.2016;'00 - 01;27,75;33,31;-5,56;0;0;0;16216;16154;-62
8017;30.11.2016;'01 - 02;27,36;34,9;-7,54;0;0;0;16983;16719;-264
8018;30.11.2016;'02 - 03;27,02;34,39;-7,37;0;0;0;17698;17282;-416
8019;30.11.2016;'03 - 04;25,3;32,25;-6,95;0;0;0;18326;17766;-560
8020;30.11.2016;'04 - 05;28,04;33,41;-5,37;0;0;0;18900;17944;-956
8021;30.11.2016;'05 - 06;29,93;37,35;-7,42;0;0;0;19388;18265;-1123
8022;30.11.2016;'06 - 07;34,13;44,58;-10,45;0;0;0;19764;18936;-828
8023;30.11.2016;'07 - 08;47,92;55,28;-7,36;23;5;-18;20014;19340;-674
8024;30.11.2016;'08 - 09;47,91;50,99;-3,08;1107;962;-145;20099;19385;-714
8025;30.11.2016;'09 - 10;44,47;47,78;-3,31;4025;3905;-120;20046;19690;-356
8026;30.11.2016;'10 - 11;37,49;41,41;-3,92;6531;7072;541;19997;19132;-865
8027;30.11.2016;'11 - 12;37,91;39,74;-1,83;7842;8918;1076;19958;18667;-1291
8028;30.11.2016;'12 - 13;37,42;37,91;-0,49;7744;8890;1146;19996;18710;-1286
8029;30.11.2016;'13 - 14;35,98;37,36;-1,38;6418;7267;849;20173;19582;-591
8030;30.11.2016;'14 - 15;39,33;37,63;1,7;4072;4430;358;20502;19806;-696
8031;30.11.2016;'15 - 16;38,74;38,43;0,31;1413;1548;135;20857;20144;-713
8032;30.11.2016;'16 - 17;44,75;45,2;-0,45;70;84;14;21238;21025;-213
8033;30.11.2016;'17 - 18;46,93;49,61;-2,68;0;0;0;21732;22428;696
8034;30.11.2016;'18 - 19;39,95;44,58;-4,63;0;0;0;22200;23602;1402
8035;30.11.2016;'19 - 20;39,47;40,02;-0,55;0;0;0;22643;23989;1346
8036;30.11.2016;'20 - 21;35,08;34,41;0,67;0;0;0;23048;23949;901
8037;30.11.2016;'21 - 22;32,58;34,55;-1,97;0;0;0;23438;23895;457
8038;30.11.2016;'22 - 23;31,86;33,07;-1,21;0;0;0;23790;23732;-58
8039;30.11.2016;'23 - 24;27;31,01;-4,01;0;0;0;24155;24150;-5
8040;01.12.2016;'00 - 01;26,79;28,12;-1,33;0;0;0;24934;24214;-720
8041;01.12.2016;'01 - 02;14,95;24,93;-9,98;0;0;0;25363;24189;-1174
8042;01.12.2016;'02 - 03;11,95;23,79;-11,84;0;0;0;25631;24420;-1211
8043;01.12.2016;'03 - 04;10,27;26,39;-16,12;0;0;0;25974;24897;-1077
8044;01.12.2016;'04 - 05;11,29;26,78;-15,49;0;0;0;26373;25294;-1079
8045;01.12.2016;'05 - 06;21,93;32,27;-10,34;0;0;0;26755;25814;-941
8046;01.12.2016;'06 - 07;32,06;42,8;-10,74;0;0;0;27083;26863;-220
8047;01.12.2016;'07 - 08;35,39;47,02;-11,63;8;8;0;27313;27251;-62
8048;01.12.2016;'08 - 09;34,36;44,55;-10,19;385;308;-77;27580;27189;-391
8049;01.12.2016;'09 - 10;37,01;40,45;-3,44;1553;1153;-400;27870;26713;-1157
8050;01.12.2016;'10 - 11;38,79;43,58;-4,79;2770;2213;-557;28147;26814;-1333
8051;01.12.2016;'11 - 12;36,36;44,29;-7,93;3618;3042;-576;28431;27390;-1041
8052;01.12.2016;'12 - 13;33,99;44,11;-10,12;3845;3412;-433;28663;27753;-910
8053;01.12.2016;'13 - 14;32,29;40,05;-7,76;3377;3260;-117;28922;27974;-948
8054;01.12.2016;'14 - 15;31,37;40,8;-9,43;2228;2306;78;29708;28171;-1537
8055;01.12.2016;'15 - 16;31,38;43,55;-12,17;789;863;74;30057;28692;-1365
8056;01.12.2016;'16 - 17;32,38;45,95;-13,57;45;48;3;30334;29549;-785
8057;01.12.2016;'17 - 18;35,73;44,24;-8,51;0;0;0;30624;29961;-663
8058;01.12.2016;'18 - 19;32,94;41,89;-8,95;0;0;0;30910;30802;-108
8059;01.12.2016;'19 - 20;33,86;40,22;-6,36;0;0;0;31075;31082;7
8060;01.12.2016;'20 - 21;31,32;35,63;-4,31;0;0;0;31351;31207;-144
8061;01.12.2016;'21 - 22;28,01;31,93;-3,92;0;0;0;31442;31158;-284
8062;01.12.2016;'22 - 23;19,66;29,93;-10,27;0;0;0;31439;30359;-1080
8063;01.12.2016;'23 - 24;8,94;22,08;-13,14;0;0;0;31317;30223;-1094
8064;02.12.2016;'00 - 01;7,23;15,49;-8,26;0;0;0;30440;29434;-1006
8065;02.12.2016;'01 - 02;7,2;17,06;-9,86;0;0;0;30127;28953;-1174
8066;02.12.2016;'02 - 03;6,07;13,11;-7,04;0;0;0;29372;28243;-1129
8067;02.12.2016;'03 - 04;8,79;14,18;-5,39;0;0;0;28274;27271;-1003
8068;02.12.2016;'04 - 05;19,83;19,82;0,01;0;0;0;26404;25854;-550
8069;02.12.2016;'05 - 06;26,88;27,78;-0,9;0;0;0;23814;24431;617
8070;02.12.2016;'06 - 07;31,87;35,28;-3,41;0;0;0;20949;22107;1158
8071;02.12.2016;'07 - 08;46,06;48,13;-2,07;7;2;-5;17925;18957;1032
8072;02.12.2016;'08 - 09;46,94;48,37;-1,43;686;550;-136;15163;15804;641
8073;02.12.2016;'09 - 10;44,71;49,39;-4,68;2887;2673;-214;12782;12662;-120
8074;02.12.2016;'10 - 11;43,5;49,13;-5,63;5017;5243;226;10703;10220;-483
8075;02.12.2016;'11 - 12;46,9;50,78;-3,88;6253;6894;641;9020;8675;-345
8076;02.12.2016;'12 - 13;46,93;50,27;-3,34;6345;7466;1121;7643;7784;141
8077;02.12.2016;'13 - 14;47,97;48,42;-0,45;5325;6233;908;6813;6921;108
8078;02.12.2016;'14 - 15;49,54;50,95;-1,41;3326;3792;466;6497;5840;-657
8079;02.12.2016;'15 - 16;51,11;57,79;-6,68;965;1055;90;6626;5312;-1314
8080;02.12.2016;'16 - 17;49,99;61,66;-11,67;35;34;-1;7062;5693;-1369
8081;02.12.2016;'17 - 18;56,85;66,02;-9,17;0;0;0;7608;6586;-1022
8082;02.12.2016;'18 - 19;58,1;61,56;-3,46;0;0;0;7798;7043;-755
8083;02.12.2016;'19 - 20;50,03;52,1;-2,07;0;0;0;7613;7180;-433
8084;02.12.2016;'20 - 21;52,07;44,26;7,81;0;0;0;7160;6864;-296
8085;02.12.2016;'21 - 22;47,91;41,42;6,49;0;0;0;6555;6374;-181
8086;02.12.2016;'22 - 23;44,02;36,84;7,18;0;0;0;5910;6089;179
8087;02.12.2016;'23 - 24;36,03;34,16;1,87;0;0;0;5401;5587;186
8088;03.12.2016;'00 - 01;32,9;33,11;-0,21;0;0;0;5147;4784;-363
8089;03.12.2016;'01 - 02;33,11;35,08;-1,97;0;0;0;4597;4124;-473
8090;03.12.2016;'02 - 03;33,71;35,21;-1,5;0;0;0;4035;3710;-325
8091;03.12.2016;'03 - 04;33,49;35,29;-1,8;0;0;0;3530;3497;-33
8092;03.12.2016;'04 - 05;33,63;35,63;-2;0;0;0;3081;3396;315
8093;03.12.2016;'05 - 06;33,21;35,76;-2,55;0;0;0;2676;3226;550
8094;03.12.2016;'06 - 07;36,69;36,21;0,48;0;0;0;2338;3020;682
8095;03.12.2016;'07 - 08;36;34,82;1,18;11;3;-8;2043;2784;741
8096;03.12.2016;'08 - 09;39;39,58;-0,58;807;826;19;1799;2582;783
8097;03.12.2016;'09 - 10;45,96;40,11;5,85;4056;4169;113;1587;2238;651
8098;03.12.2016;'10 - 11;40,13;37,32;2,81;7739;8346;607;1384;1776;392
8099;03.12.2016;'11 - 12;38,22;33,98;4,24;9879;11260;1381;1239;1250;11
8100;03.12.2016;'12 - 13;37,32;32,46;4,86;10259;12044;1785;1180;1058;-122
8101;03.12.2016;'13 - 14;36,18;31,93;4,25;8879;10462;1583;1230;1147;-83
8102;03.12.2016;'14 - 15;39,69;34,48;5,21;5799;6690;891;1474;1359;-115
8103;03.12.2016;'15 - 16;47,94;43,61;4,33;1940;2149;209;1860;1746;-114
8104;03.12.2016;'16 - 17;52;48,79;3,21;81;72;-9;2352;2443;91
8105;03.12.2016;'17 - 18;64,6;58,85;5,75;3;0;-3;2853;3210;357
8106;03.12.2016;'18 - 19;58,94;50,49;8,45;0;0;0;3252;3834;582
8107;03.12.2016;'19 - 20;48,9;44,37;4,53;0;0;0;3467;4237;770
8108;03.12.2016;'20 - 21;44,97;37,99;6,98;0;0;0;3519;4127;608
8109;03.12.2016;'21 - 22;40,73;37,76;2,97;0;0;0;3510;4076;566
8110;03.12.2016;'22 - 23;41,9;38,73;3,17;0;0;0;3493;4076;583
8111;03.12.2016;'23 - 24;34,42;33,77;0,65;0;0;0;3523;4322;799
8112;04.12.2016;'00 - 01;35,6;37,06;-1,46;0;0;0;3616;4252;636
8113;04.12.2016;'01 - 02;33,9;34,92;-1,02;0;0;0;3547;4162;615
8114;04.12.2016;'02 - 03;34,22;34,48;-0,26;0;0;0;3571;4055;484
8115;04.12.2016;'03 - 04;34,28;34,45;-0,17;0;0;0;3569;3974;405
8116;04.12.2016;'04 - 05;33,75;33,38;0,37;0;0;0;3456;3962;506
8117;04.12.2016;'05 - 06;33,75;34,61;-0,86;0;0;0;3333;3870;537
8118;04.12.2016;'06 - 07;33,85;33,41;0,44;0;0;0;3227;3675;448
8119;04.12.2016;'07 - 08;33,1;34,16;-1,06;13;2;-11;3143;3394;251
8120;04.12.2016;'08 - 09;35,08;37,43;-2,35;1031;790;-241;3064;3324;260
8121;04.12.2016;'09 - 10;36,28;37,55;-1,27;4390;3826;-564;2949;3186;237
8122;04.12.2016;'10 - 11;35,88;38,14;-2,26;7900;7163;-737;2711;2868;157
8123;04.12.2016;'11 - 12;36,33;38,82;-2,49;10068;9759;-309;2351;2518;167
8124;04.12.2016;'12 - 13;34,42;35,45;-1,03;10445;10277;-168;2099;2201;102
8125;04.12.2016;'13 - 14;34,02;34,98;-0,96;8968;8807;-161;2041;2164;123
8126;04.12.2016;'14 - 15;34,2;36,94;-2,74;5825;5548;-277;2292;2310;18
8127;04.12.2016;'15 - 16;35,68;40,72;-5,04;1964;1799;-165;2766;2682;-84
8128;04.12.2016;'16 - 17;44;49,13;-5,13;77;68;-9;3378;3577;199
8129;04.12.2016;'17 - 18;47,98;50,43;-2,45;0;0;0;3811;4751;940
8130;04.12.2016;'18 - 19;48,96;49,8;-0,84;0;0;0;4099;5369;1270
8131;04.12.2016;'19 - 20;49,9;47,73;2,17;0;0;0;4245;5550;1305
8132;04.12.2016;'20 - 21;46,95;45,87;1,08;0;0;0;4254;5630;1376
8133;04.12.2016;'21 - 22;43,91;42,03;1,88;0;0;0;4205;5584;1379
8134;04.12.2016;'22 - 23;46,34;43,57;2,77;0;0;0;4074;5358;1284
8135;04.12.2016;'23 - 24;35,75;38,67;-2,92;0;0;0;3896;5278;1382
8136;05.12.2016;'00 - 01;35,77;37,93;-2,16;0;0;0;4173;5079;906
8137;05.12.2016;'01 - 02;35,03;37,48;-2,45;0;0;0;3925;4637;712
8138;05.12.2016;'02 - 03;33,56;37,46;-3,9;0;0;0;3702;4326;624
8139;05.12.2016;'03 - 04;33,27;37,7;-4,43;0;0;0;3488;4117;629
8140;05.12.2016;'04 - 05;34,93;38,27;-3,34;0;0;0;3318;3788;470
8141;05.12.2016;'05 - 06;37,44;41,15;-3,71;0;0;0;3212;3635;423
8142;05.12.2016;'06 - 07;50,38;51,17;-0,79;0;0;0;3119;3505;386
8143;05.12.2016;'07 - 08;62,55;64,06;-1,51;12;2;-10;3054;3250;196
8144;05.12.2016;'08 - 09;64,79;71,72;-6,93;812;558;-254;2991;3141;150
8145;05.12.2016;'09 - 10;56,45;69,43;-12,98;3953;3066;-887;2886;2948;62
8146;05.12.2016;'10 - 11;47,93;59,61;-11,68;7692;6174;-1518;2635;2606;-29
8147;05.12.2016;'11 - 12;46,98;63,85;-16,87;10234;8370;-1864;2332;2132;-200
8148;05.12.2016;'12 - 13;39,65;55,07;-15,42;10737;8805;-1932;2115;1698;-417
8149;05.12.2016;'13 - 14;54,45;68,93;-14,48;9458;7307;-2151;1978;1570;-408
8150;05.12.2016;'14 - 15;62,36;71,82;-9,46;6223;4472;-1751;2054;1746;-308
8151;05.12.2016;'15 - 16;62,36;71,93;-9,57;2067;1296;-771;2389;2160;-229
8152;05.12.2016;'16 - 17;63,45;75,13;-11,68;75;42;-33;2845;2717;-128
8153;05.12.2016;'17 - 18;78,39;87,75;-9,36;0;0;0;3337;3458;121
8154;05.12.2016;'18 - 19;58,42;82,78;-24,36;0;0;0;3788;3886;98
8155;05.12.2016;'19 - 20;56,96;77,78;-20,82;0;0;0;4209;4216;7
8156;05.12.2016;'20 - 21;48,9;60,32;-11,42;0;0;0;4516;4466;-50
8157;05.12.2016;'21 - 22;40,99;48,08;-7,09;0;0;0;4711;4654;-57
8158;05.12.2016;'22 - 23;33,94;42,44;-8,5;0;0;0;4847;4852;5
8159;05.12.2016;'23 - 24;33,51;38,54;-5,03;0;0;0;4986;5058;72
8160;06.12.2016;'00 - 01;38,02;38,44;-0,42;0;0;0;6237;5223;-1014
8161;06.12.2016;'01 - 02;41,58;41,7;-0,12;0;0;0;6203;5292;-911
8162;06.12.2016;'02 - 03;36,53;34,98;1,55;0;0;0;5989;5093;-896
8163;06.12.2016;'03 - 04;38,15;35,73;2,42;0;0;0;5584;4833;-751
8164;06.12.2016;'04 - 05;42,93;40,16;2,77;0;0;0;5066;4538;-528
8165;06.12.2016;'05 - 06;46,66;41,54;5,12;0;0;0;4519;4205;-314
8166;06.12.2016;'06 - 07;49,5;47,11;2,39;0;0;0;4017;3979;-38
8167;06.12.2016;'07 - 08;74,73;62,51;12,22;6;1;-5;3544;3774;230
8168;06.12.2016;'08 - 09;80,09;73,1;6,99;498;364;-134;3107;3434;327
8169;06.12.2016;'09 - 10;76;70,02;5,98;2401;2219;-182;2665;3033;368
8170;06.12.2016;'10 - 11;66,39;67,21;-0,82;4751;4606;-145;2223;2694;471
8171;06.12.2016;'11 - 12;58,99;68,61;-9,62;6359;6526;167;1827;2022;195
8172;06.12.2016;'12 - 13;56,77;63,48;-6,71;6887;6852;-35;1542;1762;220
8173;06.12.2016;'13 - 14;58,12;64,4;-6,28;5918;5695;-223;1370;1592;222
8174;06.12.2016;'14 - 15;63,61;66,06;-2,45;3903;3492;-411;1322;1333;11
8175;06.12.2016;'15 - 16;66,31;67,5;-1,19;1345;1062;-283;1351;1488;137
8176;06.12.2016;'16 - 17;72,97;77,99;-5,02;58;34;-24;1437;1537;100
8177;06.12.2016;'17 - 18;89,25;87,5;1,75;0;0;0;1532;1807;275
8178;06.12.2016;'18 - 19;82,71;77,84;4,87;0;0;0;1705;2037;332
8179;06.12.2016;'19 - 20;75,39;69,04;6,35;0;0;0;2129;2491;362
8180;06.12.2016;'20 - 21;62,76;55,23;7,53;0;0;0;2764;3077;313
8181;06.12.2016;'21 - 22;46,98;43,29;3,69;0;0;0;3450;4199;749
8182;06.12.2016;'22 - 23;39,47;35,51;3,96;0;0;0;4038;5181;1143
8183;06.12.2016;'23 - 24;36,08;32,25;3,83;0;0;0;4580;5705;1125
8184;07.12.2016;'00 - 01;33,09;30,94;2,15;0;0;0;5784;6039;255
8185;07.12.2016;'01 - 02;32,77;30,96;1,81;0;0;0;6663;6258;-405
8186;07.12.2016;'02 - 03;31,91;31,74;0,17;0;0;0;7140;6331;-809
8187;07.12.2016;'03 - 04;31,41;33;-1,59;0;0;0;7295;6893;-402
8188;07.12.2016;'04 - 05;31,07;33,79;-2,72;0;0;0;7622;7672;50
8189;07.12.2016;'05 - 06;32,43;34,83;-2,4;0;0;0;8119;8244;125
8190;07.12.2016;'06 - 07;38;42,79;-4,79;0;0;0;8622;8849;227
8191;07.12.2016;'07 - 08;45,28;45,75;-0,47;5;1;-4;9250;9971;721
8192;07.12.2016;'08 - 09;47,96;46,71;1,25;381;286;-95;9983;10925;942
8193;07.12.2016;'09 - 10;46,95;47,1;-0,15;1877;1694;-183;10694;11838;1144
8194;07.12.2016;'10 - 11;46,98;45,33;1,65;3641;3458;-183;11053;12276;1223
8195;07.12.2016;'11 - 12;44,89;42,53;2,36;4934;4792;-142;11226;12041;815
8196;07.12.2016;'12 - 13;40;42,66;-2,66;5235;5308;73;11497;11868;371
8197;07.12.2016;'13 - 14;39,13;41,97;-2,84;4464;4218;-246;12136;12060;-76
8198;07.12.2016;'14 - 15;39,11;42,36;-3,25;2864;2401;-463;13191;12983;-208
8199;07.12.2016;'15 - 16;41,12;44,29;-3,17;932;671;-261;14553;13881;-672
8200;07.12.2016;'16 - 17;44,47;47,82;-3,35;48;27;-21;16024;15520;-504
8201;07.12.2016;'17 - 18;45,28;45,57;-0,29;0;0;0;17402;16850;-552
8202;07.12.2016;'18 - 19;38,39;40,6;-2,21;0;0;0;18592;18296;-296
8203;07.12.2016;'19 - 20;36,03;39,32;-3,29;0;0;0;19618;19536;-82
8204;07.12.2016;'20 - 21;34,14;36,38;-2,24;0;0;0;20502;20413;-89
8205;07.12.2016;'21 - 22;32,03;34,14;-2,11;0;0;0;21282;20840;-442
8206;07.12.2016;'22 - 23;30,85;34,2;-3,35;0;0;0;21973;20659;-1314
8207;07.12.2016;'23 - 24;27,03;33,43;-6,4;0;0;0;22521;21144;-1377
8208;08.12.2016;'00 - 01;22,46;30,59;-8,13;0;0;0;23729;21326;-2403
8209;08.12.2016;'01 - 02;13,7;28,8;-15,1;0;0;0;24029;21046;-2983
8210;08.12.2016;'02 - 03;11,57;28,97;-17,4;0;0;0;24074;21065;-3009
8211;08.12.2016;'03 - 04;11,79;30,02;-18,23;0;0;0;24147;21190;-2957
8212;08.12.2016;'04 - 05;13,33;28,42;-15,09;0;0;0;24128;21183;-2945
8213;08.12.2016;'05 - 06;17,94;30,02;-12,08;0;0;0;24039;21222;-2817
8214;08.12.2016;'06 - 07;29,36;32,87;-3,51;0;0;0;23914;21782;-2132
8215;08.12.2016;'07 - 08;33,56;40,52;-6,96;5;1;-4;23696;22545;-1151
8216;08.12.2016;'08 - 09;36,01;45,72;-9,71;482;498;16;23398;22796;-602
8217;08.12.2016;'09 - 10;36,34;42,42;-6,08;2793;3081;288;23027;21767;-1260
8218;08.12.2016;'10 - 11;32,88;32,99;-0,11;5840;6206;366;22441;20562;-1879
8219;08.12.2016;'11 - 12;31,97;32,92;-0,95;7613;8291;678;21673;19327;-2346
8220;08.12.2016;'12 - 13;30,83;31,39;-0,56;7784;8438;654;20960;18428;-2532
8221;08.12.2016;'13 - 14;32,46;32,59;-0,13;6471;7038;567;20548;17852;-2696
8222;08.12.2016;'14 - 15;36,33;37,25;-0,92;4087;4278;191;20592;17120;-3472
8223;08.12.2016;'15 - 16;42,33;43,14;-0,81;1360;1316;-44;20841;17457;-3384
8224;08.12.2016;'16 - 17;43,97;46,88;-2,91;63;50;-13;21225;18374;-2851
8225;08.12.2016;'17 - 18;46,99;46,46;0,53;0;0;0;21703;19344;-2359
8226;08.12.2016;'18 - 19;43,41;42,5;0,91;0;0;0;22145;20155;-1990
8227;08.12.2016;'19 - 20;39,96;38,62;1,34;0;0;0;22320;20690;-1630
8228;08.12.2016;'20 - 21;35;37,72;-2,72;0;0;0;22106;21607;-499
8229;08.12.2016;'21 - 22;30,7;32,6;-1,9;0;0;0;21821;22002;181
8230;08.12.2016;'22 - 23;29,9;29,73;0,17;0;0;0;21412;21105;-307
8231;08.12.2016;'23 - 24;27,27;26,62;0,65;0;0;0;20871;20128;-743
8232;09.12.2016;'00 - 01;27,59;25,65;1,94;0;0;0;19880;20134;254
8233;09.12.2016;'01 - 02;25,56;20,72;4,84;0;0;0;19794;19979;185
8234;09.12.2016;'02 - 03;25,12;20,97;4,15;0;0;0;19575;19020;-555
8235;09.12.2016;'03 - 04;25,52;18,78;6,74;0;0;0;19257;17944;-1313
8236;09.12.2016;'04 - 05;27,46;26,39;1,07;0;0;0;18859;17719;-1140
8237;09.12.2016;'05 - 06;27,55;28,54;-0,99;0;0;0;18448;18444;-4
8238;09.12.2016;'06 - 07;31,57;31,1;0,47;0;0;0;18085;18755;670
8239;09.12.2016;'07 - 08;44,47;43,78;0,69;3;1;-2;17705;18832;1127
8240;09.12.2016;'08 - 09;46,99;43,35;3,64;357;437;80;17386;18964;1578
8241;09.12.2016;'09 - 10;43,68;43,38;0,3;1559;1980;421;17207;18276;1069
8242;09.12.2016;'10 - 11;45,93;40,4;5,53;2979;3527;548;17109;17846;737
8243;09.12.2016;'11 - 12;42,51;38,56;3,95;4319;4395;76;16999;17812;813
8244;09.12.2016;'12 - 13;39,02;40,4;-1,38;4775;4363;-412;16808;17431;623
8245;09.12.2016;'13 - 14;37,5;41,28;-3,78;4093;3334;-759;16441;16513;72
8246;09.12.2016;'14 - 15;37,44;43,01;-5,57;2660;1989;-671;15973;15640;-333
8247;09.12.2016;'15 - 16;40,82;43,06;-2,24;916;563;-353;15405;14945;-460
8248;09.12.2016;'16 - 17;41,91;44,56;-2,65;46;22;-24;15068;15289;221
8249;09.12.2016;'17 - 18;41,96;46,36;-4,4;0;0;0;15135;16196;1061
8250;09.12.2016;'18 - 19;39,15;42,52;-3,37;0;0;0;15321;16984;1663
8251;09.12.2016;'19 - 20;40,86;38,74;2,12;0;0;0;15639;17102;1463
8252;09.12.2016;'20 - 21;35;34,12;0,88;0;0;0;16022;17272;1250
8253;09.12.2016;'21 - 22;32,46;33,43;-0,97;0;0;0;16465;18092;1627
8254;09.12.2016;'22 - 23;31,24;33,56;-2,32;0;0;0;17014;18414;1400
8255;09.12.2016;'23 - 24;29;29,76;-0,76;0;0;0;17641;19223;1582
8256;10.12.2016;'00 - 01;25,98;29,81;-3,83;0;0;0;19872;20040;168
8257;10.12.2016;'01 - 02;24,02;29,99;-5,97;0;0;0;20588;20903;315
8258;10.12.2016;'02 - 03;23,95;26,8;-2,85;0;0;0;21064;21192;128
8259;10.12.2016;'03 - 04;20,3;25,19;-4,89;0;0;0;21579;21438;-141
8260;10.12.2016;'04 - 05;20,55;28,54;-7,99;0;0;0;21933;21747;-186
8261;10.12.2016;'05 - 06;23,25;30,02;-6,77;0;0;0;22053;21558;-495
8262;10.12.2016;'06 - 07;23,08;28,06;-4,98;0;0;0;22003;21620;-383
8263;10.12.2016;'07 - 08;24,13;30,48;-6,35;7;1;-6;21718;21141;-577
8264;10.12.2016;'08 - 09;28,49;31,13;-2,64;648;624;-24;21251;20562;-689
8265;10.12.2016;'09 - 10;31,08;36,01;-4,93;3178;3156;-22;20745;20059;-686
8266;10.12.2016;'10 - 11;31,86;35,78;-3,92;5776;6045;269;20104;19514;-590
8267;10.12.2016;'11 - 12;33,77;33,61;0,16;7301;8106;805;19263;18484;-779
8268;10.12.2016;'12 - 13;33;29,85;3,15;7447;8781;1334;18360;17386;-974
8269;10.12.2016;'13 - 14;32,35;29,65;2,7;6221;7387;1166;17443;16354;-1089
8270;10.12.2016;'14 - 15;35,02;32,68;2,34;3956;4595;639;16621;14744;-1877
8271;10.12.2016;'15 - 16;41,92;42,49;-0,57;1367;1489;122;15802;13426;-2376
8272;10.12.2016;'16 - 17;43,67;47;-3,33;65;53;-12;15090;12825;-2265
8273;10.12.2016;'17 - 18;50,03;60,58;-10,55;0;0;0;14533;12312;-2221
8274;10.12.2016;'18 - 19;45,12;51,6;-6,48;0;0;0;14021;12111;-1910
8275;10.12.2016;'19 - 20;40,17;48,37;-8,2;0;0;0;13585;11752;-1833
8276;10.12.2016;'20 - 21;39,94;43,54;-3,6;0;0;0;13370;11401;-1969
8277;10.12.2016;'21 - 22;34,72;38,26;-3,54;0;0;0;13326;10688;-2638
8278;10.12.2016;'22 - 23;34,94;40,09;-5,15;0;0;0;13467;10369;-3098
8279;10.12.2016;'23 - 24;31,4;36,83;-5,43;0;0;0;13783;10230;-3553
8280;11.12.2016;'00 - 01;30,58;32,63;-2,05;0;0;0;11606;10392;-1214
8281;11.12.2016;'01 - 02;28,44;29,62;-1,18;0;0;0;11944;10660;-1284
8282;11.12.2016;'02 - 03;28,95;32,97;-4,02;0;0;0;12802;12149;-653
8283;11.12.2016;'03 - 04;28,08;28,4;-0,32;0;0;0;13895;14676;781
8284;11.12.2016;'04 - 05;27,56;25,59;1,97;0;0;0;14977;17996;3019
8285;11.12.2016;'05 - 06;27,94;15,4;12,54;0;0;0;15882;20913;5031
8286;11.12.2016;'06 - 07;26,16;4,31;21,85;0;0;0;16914;23662;6748
8287;11.12.2016;'07 - 08;26,51;2,51;24;3;1;-2;17692;24900;7208
8288;11.12.2016;'08 - 09;26,84;7,54;19,3;188;205;17;18155;25806;7651
8289;11.12.2016;'09 - 10;29,51;9,89;19,62;878;845;-33;19081;26681;7600
8290;11.12.2016;'10 - 11;29,75;12,17;17,58;1653;1469;-184;20261;27283;7022
8291;11.12.2016;'11 - 12;30,42;16,76;13,66;2213;2068;-145;21161;27314;6153
8292;11.12.2016;'12 - 13;29,03;18,82;10,21;2362;2485;123;21813;27287;5474
8293;11.12.2016;'13 - 14;25,1;18,59;6,51;2032;2237;205;22017;26584;4567
8294;11.12.2016;'14 - 15;24,01;16,19;7,82;1261;1495;234;21727;25388;3661
8295;11.12.2016;'15 - 16;24,7;21,28;3,42;377;542;165;21292;24779;3487
8296;11.12.2016;'16 - 17;34,57;30,63;3,94;19;28;9;20885;24477;3592
8297;11.12.2016;'17 - 18;32,83;28,06;4,77;0;0;0;20693;23936;3243
8298;11.12.2016;'18 - 19;34,07;29,19;4,88;0;0;0;20637;23867;3230
8299;11.12.2016;'19 - 20;32,9;28,12;4,78;0;0;0;20579;23792;3213
8300;11.12.2016;'20 - 21;32,01;26,64;5,37;0;0;0;20463;23724;3261
8301;11.12.2016;'21 - 22;29,09;20,46;8,63;0;0;0;20299;22854;2555
8302;11.12.2016;'22 - 23;30,44;27,51;2,93;0;0;0;20053;21878;1825
8303;11.12.2016;'23 - 24;25,92;21,36;4,56;0;0;0;19688;20910;1222
8304;12.12.2016;'00 - 01;23,98;26,33;-2,35;0;0;0;21401;20173;-1228
8305;12.12.2016;'01 - 02;28,82;28,2;0,62;0;0;0;20264;18875;-1389
8306;12.12.2016;'02 - 03;28,24;27,48;0,76;0;0;0;18624;17331;-1293
8307;12.12.2016;'03 - 04;27,49;26,7;0,79;0;0;0;17214;16124;-1090
8308;12.12.2016;'04 - 05;26,6;27,7;-1,1;0;0;0;15640;14915;-725
8309;12.12.2016;'05 - 06;28,78;30,42;-1,64;0;0;0;13690;13111;-579
8310;12.12.2016;'06 - 07;43,7;47,39;-3,69;0;0;0;11706;11260;-446
8311;12.12.2016;'07 - 08;57,36;59,63;-2,27;3;1;-2;9803;9633;-170
8312;12.12.2016;'08 - 09;47,93;50,29;-2,36;184;95;-89;8064;8042;-22
8313;12.12.2016;'09 - 10;50,09;51,94;-1,85;1039;702;-337;6541;6424;-117
8314;12.12.2016;'10 - 11;52,32;52,81;-0,49;2169;1776;-393;5240;4901;-339
8315;12.12.2016;'11 - 12;59,54;57,48;2,06;3016;2846;-170;4144;3914;-230
8316;12.12.2016;'12 - 13;53,91;55,45;-1,54;3256;3573;317;3282;3048;-234
8317;12.12.2016;'13 - 14;63,67;59,65;4,02;2840;3310;470;2659;2084;-575
8318;12.12.2016;'14 - 15;63,81;64,94;-1,13;1805;2134;329;2270;1584;-686
8319;12.12.2016;'15 - 16;56,29;66,03;-9,74;572;596;24;2011;1365;-646
8320;12.12.2016;'16 - 17;70,25;76,57;-6,32;31;25;-6;1999;1510;-489
8321;12.12.2016;'17 - 18;80,62;96,44;-15,82;0;0;0;2358;2025;-333
8322;12.12.2016;'18 - 19;65,2;80,73;-15,53;0;0;0;2944;2570;-374
8323;12.12.2016;'19 - 20;57,18;65,6;-8,42;0;0;0;3536;2968;-568
8324;12.12.2016;'20 - 21;46,96;54,39;-7,43;0;0;0;4014;3488;-526
8325;12.12.2016;'21 - 22;37,73;42,61;-4,88;0;0;0;4520;3888;-632
8326;12.12.2016;'22 - 23;35,07;41,91;-6,84;0;0;0;4862;4124;-738
8327;12.12.2016;'23 - 24;33,33;40,48;-7,15;0;0;0;4962;4422;-540
8328;13.12.2016;'00 - 01;35,88;40,44;-4,56;0;0;0;5040;4872;-168
8329;13.12.2016;'01 - 02;33,04;39,26;-6,22;0;0;0;5190;4949;-241
8330;13.12.2016;'02 - 03;33,04;39,27;-6,23;0;0;0;5379;4711;-668
8331;13.12.2016;'03 - 04;33,02;39,94;-6,92;0;0;0;5528;4753;-775
8332;13.12.2016;'04 - 05;34,97;40,24;-5,27;0;0;0;5636;4694;-942
8333;13.12.2016;'05 - 06;32,84;39,38;-6,54;0;0;0;5706;4731;-975
8334;13.12.2016;'06 - 07;47,41;53,95;-6,54;0;0;0;5806;4845;-961
8335;13.12.2016;'07 - 08;49,9;56,67;-6,77;5;0;-5;5949;5254;-695
8336;13.12.2016;'08 - 09;54,39;74,22;-19,83;263;279;16;6104;5079;-1025
8337;13.12.2016;'09 - 10;58,12;72,5;-14,38;1368;1753;385;6180;4933;-1247
8338;13.12.2016;'10 - 11;62,76;71,42;-8,66;2798;3650;852;6051;4526;-1525
8339;13.12.2016;'11 - 12;60,09;67,67;-7,58;3782;4872;1090;5808;3922;-1886
8340;13.12.2016;'12 - 13;58;65,86;-7,86;3968;4933;965;5629;3495;-2134
8341;13.12.2016;'13 - 14;59,39;68,99;-9,6;3334;3800;466;5435;3202;-2233
8342;13.12.2016;'14 - 15;59,6;71,28;-11,68;2069;2030;-39;5326;3148;-2178
8343;13.12.2016;'15 - 16;61,6;73,35;-11,75;655;533;-122;5325;3245;-2080
8344;13.12.2016;'16 - 17;63,02;78,39;-15,37;32;22;-10;5518;3600;-1918
8345;13.12.2016;'17 - 18;70,42;86,51;-16,09;0;0;0;5836;4034;-1802
8346;13.12.2016;'18 - 19;60,09;80,96;-20,87;0;0;0;6123;4424;-1699
8347;13.12.2016;'19 - 20;57,76;68,94;-11,18;0;0;0;6296;4659;-1637
8348;13.12.2016;'20 - 21;45,66;53,56;-7,9;0;0;0;6280;4574;-1706
8349;13.12.2016;'21 - 22;40,19;42,56;-2,37;0;0;0;6170;4668;-1502
8350;13.12.2016;'22 - 23;37,02;41,32;-4,3;0;0;0;6011;4662;-1349
8351;13.12.2016;'23 - 24;32,53;34,47;-1,94;0;0;0;5744;4785;-959
8352;14.12.2016;'00 - 01;33,09;28,98;4,11;0;0;0;4845;4790;-55
8353;14.12.2016;'01 - 02;33,28;29,31;3,97;0;0;0;4617;4459;-158
8354;14.12.2016;'02 - 03;33;29,7;3,3;0;0;0;4310;4248;-62
8355;14.12.2016;'03 - 04;32,64;28,12;4,52;0;0;0;3941;3911;-30
8356;14.12.2016;'04 - 05;32,66;27,39;5,27;0;0;0;3462;3535;73
8357;14.12.2016;'05 - 06;36,9;31,38;5,52;0;0;0;2976;3150;174
8358;14.12.2016;'06 - 07;49,91;43,1;6,81;0;0;0;2612;2823;211
8359;14.12.2016;'07 - 08;75,06;65,33;9,73;3;0;-3;2355;2634;279
8360;14.12.2016;'08 - 09;82,26;78,73;3,53;203;149;-54;2176;2414;238
8361;14.12.2016;'09 - 10;78,58;76,54;2,04;1121;1008;-113;2016;1979;-37
8362;14.12.2016;'10 - 11;77,17;70,56;6,61;2324;2254;-70;1786;1609;-177
8363;14.12.2016;'11 - 12;75,94;71,28;4,66;3282;3214;-68;1497;1467;-30
8364;14.12.2016;'12 - 13;70,55;65,78;4,77;3662;3590;-72;1289;1293;4
8365;14.12.2016;'13 - 14;69,91;63,21;6,7;3278;3284;6;1198;1179;-19
8366;14.12.2016;'14 - 15;69,69;62,73;6,96;2181;2226;45;1240;1306;66
8367;14.12.2016;'15 - 16;72,52;66,27;6,25;771;688;-83;1394;1524;130
8368;14.12.2016;'16 - 17;75,15;75,12;0,03;45;38;-7;1676;1930;254
8369;14.12.2016;'17 - 18;91,81;97,04;-5,23;0;0;0;2063;2403;340
8370;14.12.2016;'18 - 19;79,9;78,03;1,87;0;0;0;2476;2593;117
8371;14.12.2016;'19 - 20;78,62;68,63;9,99;0;0;0;2792;2614;-178
8372;14.12.2016;'20 - 21;67,54;55,71;11,83;0;0;0;3007;2626;-381
8373;14.12.2016;'21 - 22;47,94;43,02;4,92;0;0;0;3253;2747;-506
8374;14.12.2016;'22 - 23;41,71;41,89;-0,18;0;0;0;3516;2891;-625
8375;14.12.2016;'23 - 24;35,57;38,32;-2,75;0;0;0;3753;3095;-658
8376;15.12.2016;'00 - 01;35,05;34,49;0,56;0;0;0;3903;3358;-545
8377;15.12.2016;'01 - 02;33,31;33,76;-0,45;0;0;0;4075;3579;-496
8378;15.12.2016;'02 - 03;34,2;34,66;-0,46;0;0;0;4196;3617;-579
8379;15.12.2016;'03 - 04;33,51;34,75;-1,24;0;0;0;4274;3856;-418
8380;15.12.2016;'04 - 05;34,53;36,44;-1,91;0;0;0;4469;4197;-272
8381;15.12.2016;'05 - 06;35,61;34,96;0,65;0;0;0;4842;4445;-397
8382;15.12.2016;'06 - 07;49,55;47,77;1,78;0;0;0;5363;4716;-647
8383;15.12.2016;'07 - 08;67,91;70,53;-2,62;4;0;-4;5993;5370;-623
8384;15.12.2016;'08 - 09;67,07;86,62;-19,55;297;174;-123;6676;6269;-407
8385;15.12.2016;'09 - 10;62,27;72,63;-10,36;1708;1143;-565;7313;6922;-391
8386;15.12.2016;'10 - 11;59,13;69,78;-10,65;3662;2461;-1201;7632;7533;-99
8387;15.12.2016;'11 - 12;57,69;63,4;-5,71;5058;3420;-1638;7618;7870;252
8388;15.12.2016;'12 - 13;53,72;66,83;-13,11;5363;3472;-1891;7604;7979;375
8389;15.12.2016;'13 - 14;54,95;67,27;-12,32;4583;2878;-1705;7759;7828;69
8390;15.12.2016;'14 - 15;55;69;-14;2909;1731;-1178;8147;8104;-43
8391;15.12.2016;'15 - 16;60,24;68,98;-8,74;947;475;-472;8722;8929;207
8392;15.12.2016;'16 - 17;62,05;66,81;-4,76;43;19;-24;9510;10116;606
8393;15.12.2016;'17 - 18;70,03;71,16;-1,13;0;0;0;10409;10869;460
8394;15.12.2016;'18 - 19;58,95;59,45;-0,5;0;0;0;11143;11546;403
8395;15.12.2016;'19 - 20;54,65;49,19;5,46;0;0;0;11520;11816;296
8396;15.12.2016;'20 - 21;45,37;41,35;4,02;0;0;0;11525;11706;181
8397;15.12.2016;'21 - 22;40;38,45;1,55;0;0;0;11330;11189;-141
8398;15.12.2016;'22 - 23;37,53;37,21;0,32;0;0;0;10947;10727;-220
8399;15.12.2016;'23 - 24;33,98;34,77;-0,79;0;0;0;10448;10748;300
8400;16.12.2016;'00 - 01;34,25;34,66;-0,41;0;0;0;9884;10515;631
8401;16.12.2016;'01 - 02;33,29;32,37;0,92;0;0;0;9565;10002;437
8402;16.12.2016;'02 - 03;32;32,03;-0,03;0;0;0;9321;9834;513
8403;16.12.2016;'03 - 04;31,92;31,14;0,78;0;0;0;8973;9876;903
8404;16.12.2016;'04 - 05;33,15;33,16;-0,01;0;0;0;8547;9734;1187
8405;16.12.2016;'05 - 06;35,51;33,13;2,38;0;0;0;8151;9202;1051
8406;16.12.2016;'06 - 07;46,76;46,49;0,27;0;0;0;7841;8689;848
8407;16.12.2016;'07 - 08;58,99;57,16;1,83;4;0;-4;7581;8398;817
8408;16.12.2016;'08 - 09;62,65;58,73;3,92;579;284;-295;7229;7916;687
8409;16.12.2016;'09 - 10;59,99;58,11;1,88;3411;1922;-1489;6664;6930;266
8410;16.12.2016;'10 - 11;59,04;63,17;-4,13;6740;4153;-2587;5591;5650;59
8411;16.12.2016;'11 - 12;59,56;65,91;-6,35;8946;5714;-3232;4175;4356;181
8412;16.12.2016;'12 - 13;56,96;61,72;-4,76;9500;6365;-3135;3055;3318;263
8413;16.12.2016;'13 - 14;57,98;61,39;-3,41;8186;5652;-2534;2499;2654;155
8414;16.12.2016;'14 - 15;64,88;61,26;3,62;5248;3654;-1594;2648;2272;-376
8415;16.12.2016;'15 - 16;65,1;59,47;5,63;1700;1043;-657;3099;2234;-865
8416;16.12.2016;'16 - 17;69,46;63,44;6,02;62;40;-22;3656;2886;-770
8417;16.12.2016;'17 - 18;80,99;67,81;13,18;0;0;0;4053;3618;-435
8418;16.12.2016;'18 - 19;68;59,33;8,67;0;0;0;4250;3898;-352
8419;16.12.2016;'19 - 20;71,71;57,99;13,72;0;0;0;4134;3766;-368
8420;16.12.2016;'20 - 21;63,6;53,87;9,73;0;0;0;3741;3545;-196
8421;16.12.2016;'21 - 22;48,09;40,56;7,53;0;0;0;3335;3058;-277
8422;16.12.2016;'22 - 23;42,49;39,93;2,56;0;0;0;2962;2747;-215
8423;16.12.2016;'23 - 24;37,06;36,91;0,15;0;0;0;2688;2417;-271
8424;17.12.2016;'00 - 01;42,1;39,07;3,03;0;0;0;1994;2076;82
8425;17.12.2016;'01 - 02;39,44;37;2,44;0;0;0;1884;1996;112
8426;17.12.2016;'02 - 03;38,36;34,7;3,66;0;0;0;1734;2168;434
8427;17.12.2016;'03 - 04;38,28;35,81;2,47;0;0;0;1543;2262;719
8428;17.12.2016;'04 - 05;39,07;35,25;3,82;0;0;0;1361;2204;843
8429;17.12.2016;'05 - 06;39,01;34,18;4,83;0;0;0;1223;2112;889
8430;17.12.2016;'06 - 07;36;32,66;3,34;0;0;0;1183;2067;884
8431;17.12.2016;'07 - 08;39,01;35,23;3,78;4;0;-4;1209;2252;1043
8432;17.12.2016;'08 - 09;47,84;40,6;7,24;392;126;-266;1270;2377;1107
8433;17.12.2016;'09 - 10;54,97;44,86;10,11;2256;1238;-1018;1367;2438;1071
8434;17.12.2016;'10 - 11;54,91;51,62;3,29;4388;2852;-1536;1424;2448;1024
8435;17.12.2016;'11 - 12;54,35;52,03;2,32;5630;4039;-1591;1403;2237;834
8436;17.12.2016;'12 - 13;50,1;50,38;-0,28;5748;4229;-1519;1402;2127;725
8437;17.12.2016;'13 - 14;47,65;48,1;-0,45;4755;3307;-1448;1448;2273;825
8438;17.12.2016;'14 - 15;49,68;46,52;3,16;2949;1866;-1083;1648;2279;631
8439;17.12.2016;'15 - 16;50,68;46,56;4,12;945;533;-412;2027;2584;557
8440;17.12.2016;'16 - 17;54,8;51,6;3,2;45;18;-27;2493;3146;653
8441;17.12.2016;'17 - 18;61,01;55,37;5,64;0;0;0;2909;4104;1195
8442;17.12.2016;'18 - 19;63,53;54,16;9,37;0;0;0;3315;5023;1708
8443;17.12.2016;'19 - 20;54,98;46,27;8,71;0;0;0;3665;6130;2465
8444;17.12.2016;'20 - 21;46,22;37,65;8,57;0;0;0;4014;7000;2986
8445;17.12.2016;'21 - 22;40,93;35,87;5,06;0;0;0;4386;8074;3688
8446;17.12.2016;'22 - 23;40,98;36,94;4,04;0;0;0;4737;9040;4303
8447;17.12.2016;'23 - 24;39,1;33,2;5,9;0;0;0;5103;9616;4513
8448;18.12.2016;'00 - 01;35,78;39,03;-3,25;0;0;0;9379;9840;461
8449;18.12.2016;'01 - 02;35,23;40,04;-4,81;0;0;0;9890;9929;39
8450;18.12.2016;'02 - 03;33,96;39,99;-6,03;0;0;0;10283;10196;-87
8451;18.12.2016;'03 - 04;34,32;39,27;-4,95;0;0;0;10537;10410;-127
8452;18.12.2016;'04 - 05;33,96;36,94;-2,98;0;0;0;10700;10109;-591
8453;18.12.2016;'05 - 06;33,93;37,78;-3,85;0;0;0;10747;9682;-1065
8454;18.12.2016;'06 - 07;34,36;39,44;-5,08;0;0;0;10708;9582;-1126
8455;18.12.2016;'07 - 08;38,37;42,53;-4,16;1;0;-1;10484;9092;-1392
8456;18.12.2016;'08 - 09;36,88;44,49;-7,61;104;84;-20;10040;8673;-1367
8457;18.12.2016;'09 - 10;44,72;44,65;0,07;560;578;18;9636;7814;-1822
8458;18.12.2016;'10 - 11;45,94;46,54;-0,6;1270;1329;59;9233;6851;-2382
8459;18.12.2016;'11 - 12;52,29;50,92;1,37;1821;1847;26;8696;5938;-2758
8460;18.12.2016;'12 - 13;52;50,4;1,6;1958;1955;-3;8070;5131;-2939
8461;18.12.2016;'13 - 14;49,78;50,48;-0,7;1649;1530;-119;7415;4278;-3137
8462;18.12.2016;'14 - 15;45,82;49,54;-3,72;1031;863;-168;6719;3462;-3257
8463;18.12.2016;'15 - 16;47,43;50,36;-2,93;342;243;-99;6010;2817;-3193
8464;18.12.2016;'16 - 17;49,98;55,24;-5,26;19;10;-9;5318;2274;-3044
8465;18.12.2016;'17 - 18;54,92;63,26;-8,34;0;0;0;4662;1827;-2835
8466;18.12.2016;'18 - 19;53,98;64,42;-10,44;0;0;0;4047;1509;-2538
8467;18.12.2016;'19 - 20;50,13;59,28;-9,15;0;0;0;3421;1161;-2260
8468;18.12.2016;'20 - 21;49,92;55,41;-5,49;0;0;0;2839;789;-2050
8469;18.12.2016;'21 - 22;45,73;50,74;-5,01;0;0;0;2387;581;-1806
8470;18.12.2016;'22 - 23;47,14;50,29;-3,15;0;0;0;2052;442;-1610
8471;18.12.2016;'23 - 24;42,06;43,36;-1,3;0;0;0;1873;384;-1489
8472;19.12.2016;'00 - 01;39,9;36,7;3,2;0;0;0;688;412;-276
8473;19.12.2016;'01 - 02;39,08;36,42;2,66;0;0;0;740;450;-290
8474;19.12.2016;'02 - 03;39,02;34,76;4,26;0;0;0;828;612;-216
8475;19.12.2016;'03 - 04;38,56;34,13;4,43;0;0;0;962;834;-128
8476;19.12.2016;'04 - 05;39,01;34,18;4,83;0;0;0;1173;1128;-45
8477;19.12.2016;'05 - 06;39,05;37;2,05;0;0;0;1454;1344;-110
8478;19.12.2016;'06 - 07;54,11;49,05;5,06;0;0;0;1802;1576;-226
8479;19.12.2016;'07 - 08;66,7;60,04;6,66;1;0;-1;2174;1893;-281
8480;19.12.2016;'08 - 09;65,38;62,31;3,07;206;129;-77;2506;2236;-270
8481;19.12.2016;'09 - 10;75,1;61,18;13,92;1249;923;-326;2800;2569;-231
8482;19.12.2016;'10 - 11;74,99;57,86;17,13;2712;2250;-462;2919;3048;129
8483;19.12.2016;'11 - 12;72,19;56,72;15,47;3943;3484;-459;2870;3268;398
8484;19.12.2016;'12 - 13;70,8;57,1;13,7;4493;4123;-370;2897;3352;455
8485;19.12.2016;'13 - 14;71,48;59,74;11,74;4150;3818;-332;2989;3593;604
8486;19.12.2016;'14 - 15;70,82;59,71;11,11;2808;2466;-342;3185;3756;571
8487;19.12.2016;'15 - 16;72,99;60,89;12,1;950;780;-170;3491;4097;606
8488;19.12.2016;'16 - 17;69,24;69,56;-0,32;47;28;-19;3879;4470;591
8489;19.12.2016;'17 - 18;79,46;72,42;7,04;0;0;0;4324;4552;228
8490;19.12.2016;'18 - 19;66;62,04;3,96;0;0;0;4757;4311;-446
8491;19.12.2016;'19 - 20;67;60,15;6,85;0;0;0;4971;4332;-639
8492;19.12.2016;'20 - 21;50,94;48,82;2,12;0;0;0;4947;4466;-481
8493;19.12.2016;'21 - 22;40,16;39,8;0,36;0;0;0;4851;4411;-440
8494;19.12.2016;'22 - 23;40,05;40,01;0,04;0;0;0;4703;4294;-409
8495;19.12.2016;'23 - 24;35,74;38,2;-2,46;0;0;0;4629;4390;-239
8496;20.12.2016;'00 - 01;37,49;41,03;-3,54;0;0;0;3760;4552;792
8497;20.12.2016;'01 - 02;37,06;35,75;1,31;0;0;0;3953;4894;941
8498;20.12.2016;'02 - 03;37,06;34,84;2,22;0;0;0;4340;5271;931
8499;20.12.2016;'03 - 04;34,96;31,71;3,25;0;0;0;4689;5518;829
8500;20.12.2016;'04 - 05;37;34,14;2,86;0;0;0;4909;5633;724
8501;20.12.2016;'05 - 06;38,14;36,32;1,82;0;0;0;5034;5628;594
8502;20.12.2016;'06 - 07;43,27;41,67;1,6;0;0;0;5165;5698;533
8503;20.12.2016;'07 - 08;55,94;50,4;5,54;4;1;-3;5313;5923;610
8504;20.12.2016;'08 - 09;55,95;58,94;-2,99;426;204;-222;5450;6062;612
8505;20.12.2016;'09 - 10;58,13;62,56;-4,43;2420;1570;-850;5528;6146;618
8506;20.12.2016;'10 - 11;54,97;59,08;-4,11;5169;3726;-1443;5426;5770;344
8507;20.12.2016;'11 - 12;58,92;61,97;-3,05;7282;5462;-1820;5206;5334;128
8508;20.12.2016;'12 - 13;54,91;60,26;-5,35;7907;6111;-1796;5103;5033;-70
8509;20.12.2016;'13 - 14;58,53;64,85;-6,32;6885;5226;-1659;5252;5425;173
8510;20.12.2016;'14 - 15;58,17;64,37;-6,2;4469;3190;-1279;5782;5861;79
8511;20.12.2016;'15 - 16;54,97;61,81;-6,84;1530;935;-595;6495;6172;-323
8512;20.12.2016;'16 - 17;57,82;68,63;-10,81;71;30;-41;7272;6728;-544
8513;20.12.2016;'17 - 18;66,33;71,67;-5,34;0;0;0;7887;7433;-454
8514;20.12.2016;'18 - 19;58,91;69,61;-10,7;0;0;0;8347;7948;-399
8515;20.12.2016;'19 - 20;55,09;62,48;-7,39;0;0;0;8569;8748;179
8516;20.12.2016;'20 - 21;43,53;48,19;-4,66;0;0;0;8610;8831;221
8517;20.12.2016;'21 - 22;39,27;43,32;-4,05;0;0;0;8640;9272;632
8518;20.12.2016;'22 - 23;39,04;40,8;-1,76;0;0;0;8626;10019;1393
8519;20.12.2016;'23 - 24;36,34;37,45;-1,11;0;0;0;8470;10878;2408
8520;21.12.2016;'00 - 01;31,88;33,36;-1,48;0;0;0;9334;10947;1613
8521;21.12.2016;'01 - 02;31,35;33,16;-1,81;0;0;0;9187;10648;1461
8522;21.12.2016;'02 - 03;31,74;35,95;-4,21;0;0;0;8977;10240;1263
8523;21.12.2016;'03 - 04;31,35;36,18;-4,83;0;0;0;8944;9664;720
8524;21.12.2016;'04 - 05;31,34;37,01;-5,67;0;0;0;9202;9426;224
8525;21.12.2016;'05 - 06;31,34;39,49;-8,15;0;0;0;9842;10668;826
8526;21.12.2016;'06 - 07;36,09;40,31;-4,22;0;0;0;10671;12029;1358
8527;21.12.2016;'07 - 08;46,97;49,91;-2,94;4;1;-3;11469;13281;1812
8528;21.12.2016;'08 - 09;49,97;54,5;-4,53;414;162;-252;12128;13464;1336
8529;21.12.2016;'09 - 10;46,27;50,52;-4,25;2643;1415;-1228;12547;13454;907
8530;21.12.2016;'10 - 11;46,9;56,1;-9,2;5720;3326;-2394;12511;13057;546
8531;21.12.2016;'11 - 12;43,96;58,83;-14,87;7904;4802;-3102;12076;12910;834
8532;21.12.2016;'12 - 13;39,53;60,17;-20,64;8429;5254;-3175;11803;12582;779
8533;21.12.2016;'13 - 14;39,38;58,67;-19,29;7144;4505;-2639;11976;12470;494
8534;21.12.2016;'14 - 15;41,97;54,4;-12,43;4501;2741;-1760;12738;12204;-534
8535;21.12.2016;'15 - 16;47,95;60,39;-12,44;1459;742;-717;13847;12540;-1307
8536;21.12.2016;'16 - 17;47,95;62,44;-14,49;72;26;-46;15059;13777;-1282
8537;21.12.2016;'17 - 18;48,95;57,48;-8,53;0;0;0;16129;14928;-1201
8538;21.12.2016;'18 - 19;47;54,49;-7,49;0;0;0;16945;15220;-1725
8539;21.12.2016;'19 - 20;44,62;49,71;-5,09;0;0;0;17329;15512;-1817
8540;21.12.2016;'20 - 21;39,05;43,91;-4,86;0;0;0;17152;15220;-1932
8541;21.12.2016;'21 - 22;37,22;39,85;-2,63;0;0;0;16749;15130;-1619
8542;21.12.2016;'22 - 23;34,57;36,1;-1,53;0;0;0;16048;14471;-1577
8543;21.12.2016;'23 - 24;33,94;36,5;-2,56;0;0;0;14955;13770;-1185
8544;22.12.2016;'00 - 01;34,34;35,31;-0,97;0;0;0;13624;12903;-721
8545;22.12.2016;'01 - 02;32,72;34,48;-1,76;0;0;0;12829;12176;-653
8546;22.12.2016;'02 - 03;33,34;33,84;-0,5;0;0;0;12161;11658;-503
8547;22.12.2016;'03 - 04;34,42;32,8;1,62;0;0;0;11545;11401;-144
8548;22.12.2016;'04 - 05;34,9;32,25;2,65;0;0;0;11070;11679;609
8549;22.12.2016;'05 - 06;36,03;37,31;-1,28;0;0;0;10784;11468;684
8550;22.12.2016;'06 - 07;41,88;38,05;3,83;0;0;0;10480;10938;458
8551;22.12.2016;'07 - 08;51,84;50,15;1,69;3;1;-2;10249;10283;34
8552;22.12.2016;'08 - 09;51,78;52,58;-0,8;282;179;-103;10141;10042;-99
8553;22.12.2016;'09 - 10;50,99;54,55;-3,56;1509;1283;-226;10087;9727;-360
8554;22.12.2016;'10 - 11;55,62;54,49;1,13;2986;2835;-151;9911;9144;-767
8555;22.12.2016;'11 - 12;54,26;54,02;0,24;4039;4089;50;9533;9101;-432
8556;22.12.2016;'12 - 13;51,4;49,42;1,98;4344;4610;266;9233;9010;-223
8557;22.12.2016;'13 - 14;50,94;49,32;1,62;3719;3921;202;9027;8879;-148
8558;22.12.2016;'14 - 15;50,93;48,85;2,08;2365;2413;48;9074;8765;-309
8559;22.12.2016;'15 - 16;51,97;51,65;0,32;812;751;-61;9354;8616;-738
8560;22.12.2016;'16 - 17;56,7;54,66;2,04;52;27;-25;9809;8993;-816
8561;22.12.2016;'17 - 18;54,46;54,72;-0,26;0;0;0;10389;9670;-719
8562;22.12.2016;'18 - 19;54,92;53,76;1,16;0;0;0;10969;10352;-617
8563;22.12.2016;'19 - 20;51;49,36;1,64;0;0;0;11519;10768;-751
8564;22.12.2016;'20 - 21;39,94;39,92;0,02;0;0;0;12032;11763;-269
8565;22.12.2016;'21 - 22;37,66;34,68;2,98;0;0;0;12529;12826;297
8566;22.12.2016;'22 - 23;38,62;33,72;4,9;0;0;0;12890;12943;53
8567;22.12.2016;'23 - 24;34,95;31,16;3,79;0;0;0;13159;13382;223
8568;23.12.2016;'00 - 01;29,02;34,09;-5,07;0;0;0;14396;13613;-783
8569;23.12.2016;'01 - 02;29,58;36,06;-6,48;0;0;0;14662;13922;-740
8570;23.12.2016;'02 - 03;27,58;36,7;-9,12;0;0;0;14941;14470;-471
8571;23.12.2016;'03 - 04;26,78;33,77;-6,99;0;0;0;15175;15200;25
8572;23.12.2016;'04 - 05;29,02;33,87;-4,85;0;0;0;15273;15674;401
8573;23.12.2016;'05 - 06;30;34,81;-4,81;0;0;0;15048;15547;499
8574;23.12.2016;'06 - 07;36,3;37,59;-1,29;0;0;0;14562;15234;672
8575;23.12.2016;'07 - 08;45,91;46,81;-0,9;0;0;0;13827;14261;434
8576;23.12.2016;'08 - 09;50,91;48,02;2,89;135;115;-20;13015;13251;236
8577;23.12.2016;'09 - 10;51,15;44,8;6,35;1054;990;-64;12498;12610;112
8578;23.12.2016;'10 - 11;50,98;46,71;4,27;2415;2117;-298;12299;12807;508
8579;23.12.2016;'11 - 12;48,89;45,03;3,86;3420;3181;-239;12311;12909;598
8580;23.12.2016;'12 - 13;45,91;40,37;5,54;3726;3838;112;12385;13235;850
8581;23.12.2016;'13 - 14;45,12;36,02;9,1;3255;3323;68;12603;13140;537
8582;23.12.2016;'14 - 15;44,95;34,84;10,11;2098;1978;-120;13191;12802;-389
8583;23.12.2016;'15 - 16;44,96;36,12;8,84;691;546;-145;14175;13338;-837
8584;23.12.2016;'16 - 17;46,96;37,74;9,22;38;23;-15;15525;14714;-811
8585;23.12.2016;'17 - 18;48,39;38,48;9,91;0;0;0;17351;16592;-759
8586;23.12.2016;'18 - 19;40,84;40,44;0,4;0;0;0;19337;18086;-1251
8587;23.12.2016;'19 - 20;38,15;40,12;-1,97;0;0;0;21143;19490;-1653
8588;23.12.2016;'20 - 21;36,28;37,77;-1,49;0;0;0;22714;20934;-1780
8589;23.12.2016;'21 - 22;33;35,87;-2,87;0;0;0;24312;22486;-1826
8590;23.12.2016;'22 - 23;27,57;32,98;-5,41;0;0;0;25997;23391;-2606
8591;23.12.2016;'23 - 24;7,82;18,97;-11,15;0;0;0;27731;25115;-2616
8592;24.12.2016;'00 - 01;10,38;16,12;-5,74;0;0;0;28922;26088;-2834
8593;24.12.2016;'01 - 02;3,71;14,16;-10,45;0;0;0;29610;27095;-2515
8594;24.12.2016;'02 - 03;-7,62;12,68;-20,3;0;0;0;29709;27197;-2512
8595;24.12.2016;'03 - 04;-2,57;12,32;-14,89;0;0;0;29054;26802;-2252
8596;24.12.2016;'04 - 05;8,47;17,2;-8,73;0;0;0;27847;26380;-1467
8597;24.12.2016;'05 - 06;8,59;16,83;-8,24;0;0;0;26764;25322;-1442
8598;24.12.2016;'06 - 07;3,97;14,39;-10,42;0;0;0;25714;25228;-486
8599;24.12.2016;'07 - 08;8,69;16,37;-7,68;0;0;0;24831;25244;413
8600;24.12.2016;'08 - 09;15,99;20,36;-4,37;117;82;-35;24316;24554;238
8601;24.12.2016;'09 - 10;20,36;26,31;-5,95;774;664;-110;24275;23896;-379
8602;24.12.2016;'10 - 11;21;30,85;-9,85;1825;1738;-87;24580;24423;-157
8603;24.12.2016;'11 - 12;20,02;33,05;-13,03;2682;2656;-26;25259;26403;1144
8604;24.12.2016;'12 - 13;18,04;20,27;-2,23;3074;2726;-348;26137;27500;1363
8605;24.12.2016;'13 - 14;15,3;13,94;1,36;2811;2661;-150;27017;28597;1580
8606;24.12.2016;'14 - 15;10,41;13,91;-3,5;1880;1726;-154;27838;28474;636
8607;24.12.2016;'15 - 16;10,51;13,94;-3,43;633;565;-68;28479;29033;554
8608;24.12.2016;'16 - 17;13,79;23,52;-9,73;30;25;-5;29217;30118;901
8609;24.12.2016;'17 - 18;13,69;27,74;-14,05;0;0;0;30061;30702;641
8610;24.12.2016;'18 - 19;8,67;20,71;-12,04;0;0;0;30773;31582;809
8611;24.12.2016;'19 - 20;2,16;14,58;-12,42;0;0;0;31336;32264;928
8612;24.12.2016;'20 - 21;2,93;7,71;-4,78;0;0;0;31885;32830;945
8613;24.12.2016;'21 - 22;0,11;-0,12;0,23;0;0;0;32161;32529;368
8614;24.12.2016;'22 - 23;8,31;0,86;7,45;0;0;0;32121;31862;-259
8615;24.12.2016;'23 - 24;-12,05;-1,77;-10,28;0;0;0;31925;31904;-21
8616;25.12.2016;'00 - 01;-18,07;-2,49;-15,58;0;0;0;31558;31570;12
8617;25.12.2016;'01 - 02;-36,1;-7,5;-28,6;0;0;0;31223;30847;-376
8618;25.12.2016;'02 - 03;-38,78;-11,93;-26,85;0;0;0;30718;29627;-1091
8619;25.12.2016;'03 - 04;-26,87;-8,81;-18,06;0;0;0;30263;28783;-1480
8620;25.12.2016;'04 - 05;-15,06;1,74;-16,8;0;0;0;30026;28570;-1456
8621;25.12.2016;'05 - 06;-12,1;3,71;-15,81;0;0;0;29903;27767;-2136
8622;25.12.2016;'06 - 07;-30,07;5,24;-35,31;0;0;0;29912;27758;-2154
8623;25.12.2016;'07 - 08;-4,02;11,46;-15,48;0;0;0;30035;28512;-1523
8624;25.12.2016;'08 - 09;0,1;8,23;-8,13;63;46;-17;30418;29246;-1172
8625;25.12.2016;'09 - 10;10,6;14,2;-3,6;344;309;-35;30736;29832;-904
8626;25.12.2016;'10 - 11;13,49;16,32;-2,83;760;770;10;31019;30990;-29
8627;25.12.2016;'11 - 12;13,67;16,47;-2,8;1145;1208;63;31266;31708;442
8628;25.12.2016;'12 - 13;8,76;12,55;-3,79;1290;1438;148;31424;32501;1077
8629;25.12.2016;'13 - 14;0,13;-2,21;2,34;1154;1415;261;31321;32384;1063
8630;25.12.2016;'14 - 15;-0,1;-5,1;5;763;1036;273;31042;31931;889
8631;25.12.2016;'15 - 16;0,08;-2,04;2,12;294;364;70;30753;31505;752
8632;25.12.2016;'16 - 17;8,67;2,07;6,6;30;22;-8;30446;31088;642
8633;25.12.2016;'17 - 18;13,63;5,84;7,79;0;0;0;30151;30436;285
8634;25.12.2016;'18 - 19;10,7;3,43;7,27;0;0;0;29960;29885;-75
8635;25.12.2016;'19 - 20;8,98;1,17;7,81;0;0;0;29783;30108;325
8636;25.12.2016;'20 - 21;10,67;-1,36;12,03;0;0;0;29496;29968;472
8637;25.12.2016;'21 - 22;9,94;-3,64;13,58;0;0;0;29373;29711;338
8638;25.12.2016;'22 - 23;10,02;-1,76;11,78;0;0;0;29343;29131;-212
8639;25.12.2016;'23 - 24;-2,95;-13,34;10,39;0;0;0;29395;28970;-425
8640;26.12.2016;'00 - 01;0,04;-22,99;23,03;0;0;0;28649;28520;-129
8641;26.12.2016;'01 - 02;-9,92;-23;13,08;0;0;0;28581;27718;-863
8642;26.12.2016;'02 - 03;-14,9;-33,45;18,55;0;0;0;28661;27836;-825
8643;26.12.2016;'03 - 04;-16,09;-33,42;17,33;0;0;0;28842;27875;-967
8644;26.12.2016;'04 - 05;-15,05;-29,66;14,61;0;0;0;29077;27535;-1542
8645;26.12.2016;'05 - 06;-51,49;-38,66;-12,83;0;0;0;29350;26929;-2421
8646;26.12.2016;'06 - 07;-67,07;-39,8;-27,27;0;0;0;29620;27396;-2224
8647;26.12.2016;'07 - 08;-67,09;-38,44;-28,65;0;0;0;29947;28042;-1905
8648;26.12.2016;'08 - 09;-54,2;-12,29;-41,91;116;79;-37;30312;29038;-1274
8649;26.12.2016;'09 - 10;-3,08;0,2;-3,28;666;800;134;30507;29403;-1104
8650;26.12.2016;'10 - 11;0,11;2,37;-2,26;1461;2140;679;30780;30247;-533
8651;26.12.2016;'11 - 12;5,87;6,31;-0,44;2022;3352;1330;31261;31372;111
8652;26.12.2016;'12 - 13;1,05;1,21;-0,16;2246;3569;1323;31741;32187;446
8653;26.12.2016;'13 - 14;-6,71;-2,42;-4,29;2068;2998;930;31798;32538;740
8654;26.12.2016;'14 - 15;-13,31;-1,45;-11,86;1458;1826;368;31052;31271;219
8655;26.12.2016;'15 - 16;-6,74;2,28;-9,02;538;661;123;30439;30592;153
8656;26.12.2016;'16 - 17;-2,98;4,09;-7,07;30;38;8;30128;30776;648
8657;26.12.2016;'17 - 18;8,78;13,22;-4,44;0;0;0;30047;30867;820
8658;26.12.2016;'18 - 19;9,68;13,51;-3,83;0;0;0;30244;30931;687
8659;26.12.2016;'19 - 20;10,69;21,25;-10,56;0;0;0;30478;31073;595
8660;26.12.2016;'20 - 21;8,32;13,25;-4,93;0;0;0;30971;31327;356
8661;26.12.2016;'21 - 22;-0,91;7,2;-8,11;0;0;0;31432;31336;-96
8662;26.12.2016;'22 - 23;4,39;7,38;-2,99;0;0;0;31798;30586;-1212
8663;26.12.2016;'23 - 24;-13,34;-0,07;-13,27;0;0;0;32091;30674;-1417
8664;27.12.2016;'00 - 01;-13;-2,09;-10,91;0;0;0;31804;30611;-1193
8665;27.12.2016;'01 - 02;-24,92;-9,83;-15,09;0;0;0;31995;30854;-1141
8666;27.12.2016;'02 - 03;-49,98;-25,4;-24,58;0;0;0;32554;30788;-1766
8667;27.12.2016;'03 - 04;-53,62;-32,23;-21,39;0;0;0;32591;30681;-1910
8668;27.12.2016;'04 - 05;-50,19;-39,51;-10,68;0;0;0;32501;30741;-1760
8669;27.12.2016;'05 - 06;-23,36;-25,11;1,75;0;0;0;32244;30184;-2060
8670;27.12.2016;'06 - 07;-12,15;-1,82;-10,33;0;0;0;31962;30122;-1840
8671;27.12.2016;'07 - 08;8,77;19,65;-10,88;2;1;-1;31573;30286;-1287
8672;27.12.2016;'08 - 09;13,7;25,71;-12,01;206;166;-40;31020;30087;-933
8673;27.12.2016;'09 - 10;12,17;27,87;-15,7;1385;1418;33;30508;29764;-744
8674;27.12.2016;'10 - 11;10,63;28,45;-17,82;3173;3410;237;30097;29632;-465
8675;27.12.2016;'11 - 12;10,64;29,35;-18,71;4406;5022;616;29578;29492;-86
8676;27.12.2016;'12 - 13;10,68;27,39;-16,71;4659;5410;751;29032;28862;-170
8677;27.12.2016;'13 - 14;13,75;29,01;-15,26;3900;4389;489;28423;28293;-130
8678;27.12.2016;'14 - 15;13,76;32,49;-18,73;2492;2654;162;27656;26973;-683
8679;27.12.2016;'15 - 16;21,04;38,12;-17,08;920;915;-5;26688;25522;-1166
8680;27.12.2016;'16 - 17;29,58;48,02;-18,44;76;63;-13;25747;24645;-1102
8681;27.12.2016;'17 - 18;29,76;49,68;-19,92;0;0;0;25002;24266;-736
8682;27.12.2016;'18 - 19;29,69;54,89;-25,2;0;0;0;24394;23514;-880
8683;27.12.2016;'19 - 20;29,45;51,05;-21,6;0;0;0;23813;23032;-781
8684;27.12.2016;'20 - 21;31,91;50,49;-18,58;0;0;0;23252;22002;-1250
8685;27.12.2016;'21 - 22;28,5;47,37;-18,87;0;0;0;22710;20840;-1870
8686;27.12.2016;'22 - 23;27,01;45,56;-18,55;0;0;0;22093;20409;-1684
8687;27.12.2016;'23 - 24;13,71;35,48;-21,77;0;0;0;21300;20225;-1075
8688;28.12.2016;'00 - 01;21,8;28,8;-7;0;0;0;18283;19681;1398
8689;28.12.2016;'01 - 02;21,28;26,31;-5,03;0;0;0;17681;19099;1418
8690;28.12.2016;'02 - 03;22,1;21,21;0,89;0;0;0;16956;18198;1242
8691;28.12.2016;'03 - 04;20,28;20,19;0,09;0;0;0;16157;17324;1167
8692;28.12.2016;'04 - 05;23,01;26,23;-3,22;0;0;0;15327;16279;952
8693;28.12.2016;'05 - 06;28,09;30,86;-2,77;0;0;0;14382;15285;903
8694;28.12.2016;'06 - 07;30;36,4;-6,4;0;0;0;13351;14704;1353
8695;28.12.2016;'07 - 08;32,07;40,06;-7,99;2;1;-1;12264;13526;1262
8696;28.12.2016;'08 - 09;40,06;43,18;-3,12;169;109;-60;11310;12351;1041
8697;28.12.2016;'09 - 10;45,57;43,78;1,79;1061;1075;14;10637;10871;234
8698;28.12.2016;'10 - 11;45,46;46,32;-0,86;2370;2694;324;10115;9578;-537
8699;28.12.2016;'11 - 12;43,93;45,75;-1,82;3363;3870;507;9572;8012;-1560
8700;28.12.2016;'12 - 13;44,4;45,83;-1,43;3618;4283;665;8963;7227;-1736
8701;28.12.2016;'13 - 14;45,82;49,1;-3,28;3156;3798;642;8239;6587;-1652
8702;28.12.2016;'14 - 15;50,77;50,52;0,25;2121;2591;470;7329;6024;-1305
8703;28.12.2016;'15 - 16;51,6;52,85;-1,25;841;960;119;6344;5322;-1022
8704;28.12.2016;'16 - 17;55,2;57,79;-2,59;75;69;-6;5605;4595;-1010
8705;28.12.2016;'17 - 18;62,8;64,47;-1,67;0;0;0;5222;4205;-1017
8706;28.12.2016;'18 - 19;63,7;62,74;0,96;0;0;0;4935;3594;-1341
8707;28.12.2016;'19 - 20;59,82;58,79;1,03;0;0;0;4606;3310;-1296
8708;28.12.2016;'20 - 21;49,95;51,9;-1,95;0;0;0;4204;3362;-842
8709;28.12.2016;'21 - 22;50;51,1;-1,1;0;0;0;3903;3378;-525
8710;28.12.2016;'22 - 23;45,64;48,36;-2,72;0;0;0;3746;3387;-359
8711;28.12.2016;'23 - 24;37,92;40,99;-3,07;0;0;0;3767;4053;286
8712;29.12.2016;'00 - 01;42,28;39,38;2,9;0;0;0;4127;4719;592
8713;29.12.2016;'01 - 02;39,3;36,5;2,8;0;0;0;4372;5050;678
8714;29.12.2016;'02 - 03;36,83;37,46;-0,63;0;0;0;4593;5243;650
8715;29.12.2016;'03 - 04;34,11;36,38;-2,27;0;0;0;4774;5244;470
8716;29.12.2016;'04 - 05;34,99;35,68;-0,69;0;0;0;4893;5023;130
8717;29.12.2016;'05 - 06;37,64;36,68;0,96;0;0;0;4976;5150;174
8718;29.12.2016;'06 - 07;41,05;39,36;1,69;0;0;0;5139;5926;787
8719;29.12.2016;'07 - 08;49,3;48,82;0,48;3;1;-2;5252;6436;1184
8720;29.12.2016;'08 - 09;53,38;45,57;7,81;338;238;-100;5352;6814;1462
8721;29.12.2016;'09 - 10;54,01;45,91;8,1;2422;2460;38;5487;6899;1412
8722;29.12.2016;'10 - 11;51,14;41,8;9,34;5352;5778;426;5517;6488;971
8723;29.12.2016;'11 - 12;50,96;41,95;9,01;7488;8388;900;5073;6242;1169
8724;29.12.2016;'12 - 13;47,09;39,62;7,47;8292;9310;1018;4999;6048;1049
8725;29.12.2016;'13 - 14;46,62;37,94;8,68;7508;8471;963;5141;5932;791
8726;29.12.2016;'14 - 15;49,6;40,54;9,06;5183;5844;661;5233;5786;553
8727;29.12.2016;'15 - 16;51,63;47,36;4,27;2045;2286;241;5409;5776;367
8728;29.12.2016;'16 - 17;54,43;51,33;3,1;138;134;-4;6174;6642;468
8729;29.12.2016;'17 - 18;63,95;56,19;7,76;0;0;0;7230;8148;918
8730;29.12.2016;'18 - 19;57,2;49,2;8;0;0;0;8092;9106;1014
8731;29.12.2016;'19 - 20;54,02;46,65;7,37;0;0;0;8559;9396;837
8732;29.12.2016;'20 - 21;47,98;41,82;6,16;0;0;0;8441;9516;1075
8733;29.12.2016;'21 - 22;42,93;42,01;0,92;0;0;0;8262;9528;1266
8734;29.12.2016;'22 - 23;38,04;38,65;-0,61;0;0;0;8191;9128;937
8735;29.12.2016;'23 - 24;36,03;36,99;-0,96;0;0;0;8203;9211;1008
8736;30.12.2016;'00 - 01;36,01;39,47;-3,46;0;0;0;7998;8966;968
8737;30.12.2016;'01 - 02;35,96;38,45;-2,49;0;0;0;7922;8986;1064
8738;30.12.2016;'02 - 03;32,06;35,31;-3,25;0;0;0;8130;8860;730
8739;30.12.2016;'03 - 04;32,54;33,45;-0,91;0;0;0;8513;8900;387
8740;30.12.2016;'04 - 05;33,09;34,27;-1,18;0;0;0;8863;9237;374
8741;30.12.2016;'05 - 06;33,09;36,22;-3,13;0;0;0;9147;9738;591
8742;30.12.2016;'06 - 07;33,94;35,8;-1,86;0;0;0;9417;10388;971
8743;30.12.2016;'07 - 08;46;49,63;-3,63;4;1;-3;9769;10854;1085
8744;30.12.2016;'08 - 09;49,96;48,79;1,17;367;295;-72;10050;11349;1299
8745;30.12.2016;'09 - 10;47,19;47,87;-0,68;2938;3076;138;10147;11554;1407
8746;30.12.2016;'10 - 11;43;42,85;0,15;6839;6853;14;9371;10594;1223
8747;30.12.2016;'11 - 12;37,27;42,33;-5,06;9616;9676;60;8621;9181;560
8748;30.12.2016;'12 - 13;36,3;40,71;-4,41;10293;10794;501;8463;7989;-474
8749;30.12.2016;'13 - 14;36,72;39,69;-2,97;8962;9520;558;8382;7389;-993
8750;30.12.2016;'14 - 15;47,19;48,34;-1,15;6000;6129;129;8422;7055;-1367
8751;30.12.2016;'15 - 16;52,78;53,46;-0,68;2332;2106;-226;8681;7615;-1066
8752;30.12.2016;'16 - 17;54,99;58,12;-3,13;154;96;-58;9534;9178;-356
8753;30.12.2016;'17 - 18;56,04;60,65;-4,61;0;0;0;10726;10386;-340
8754;30.12.2016;'18 - 19;52,92;55,84;-2,92;0;0;0;11366;10775;-591
8755;30.12.2016;'19 - 20;52,82;53,71;-0,89;0;0;0;11632;11117;-515
8756;30.12.2016;'20 - 21;43,32;48,37;-5,05;0;0;0;11678;11422;-256
8757;30.12.2016;'21 - 22;41,03;45,05;-4,02;0;0;0;11771;11732;-39
8758;30.12.2016;'22 - 23;40,55;45,1;-4,55;0;0;0;11872;11626;-246
8759;30.12.2016;'23 - 24;33,06;36,01;-2,95;0;0;0;11933;11642;-291
8760;31.12.2016;'00 - 01;36,1;43,56;-7,46;0;0;0;11308;11690;382
8761;31.12.2016;'01 - 02;33,04;41,1;-8,06;0;0;0;11375;11799;424
8762;31.12.2016;'02 - 03;29,9;36,74;-6,84;0;0;0;11700;11696;-4
8763;31.12.2016;'03 - 04;27,63;40,51;-12,88;0;0;0;12072;11706;-366
8764;31.12.2016;'04 - 05;27,52;38,82;-11,3;0;0;0;12368;11588;-780
8765;31.12.2016;'05 - 06;27,28;38,12;-10,84;0;0;0;12608;11699;-909
8766;31.12.2016;'06 - 07;21,43;37,48;-16,05;0;0;0;12826;12179;-647
8767;31.12.2016;'07 - 08;31,68;39,24;-7,56;3;1;-2;13001;12408;-593
8768;31.12.2016;'08 - 09;35,02;44,56;-9,54;390;214;-176;13141;12941;-200
8769;31.12.2016;'09 - 10;41,88;49,01;-7,13;2667;2147;-520;13161;13026;-135
8770;31.12.2016;'10 - 11;39,94;49,93;-9,99;5643;4871;-772;12736;12803;67
8771;31.12.2016;'11 - 12;39,96;48,85;-8,89;7809;7038;-771;12154;12218;64
8772;31.12.2016;'12 - 13;38,86;46,47;-7,61;8450;7882;-568;11998;12017;19
8773;31.12.2016;'13 - 14;35,04;44,04;-9;7459;6680;-779;12043;11746;-297
8774;31.12.2016;'14 - 15;37,5;49,61;-12,11;5067;4236;-831;12407;11522;-885
8775;31.12.2016;'15 - 16;43,81;54,41;-10,6;2020;1443;-577;13039;12394;-645
8776;31.12.2016;'16 - 17;49,76;57,64;-7,88;147;68;-79;14004;13234;-770
8777;31.12.2016;'17 - 18;53,98;64,86;-10,88;0;0;0;14847;14072;-775
8778;31.12.2016;'18 - 19;49,76;61,36;-11,6;0;0;0;15440;14836;-604
8779;31.12.2016;'19 - 20;40,84;58,24;-17,4;0;0;0;15908;15196;-712
8780;31.12.2016;'20 - 21;35,05;51,2;-16,15;0;0;0;16207;15303;-904
8781;31.12.2016;'21 - 22;33,02;48,41;-15,39;0;0;0;16450;15354;-1096
8782;31.12.2016;'22 - 23;33,71;49,31;-15,6;0;0;0;16595;14848;-1747
8783;31.12.2016;'23 - 24;27,95;50,48;-22,53;0;0;0;16588;15056;-1532
8784;01.01.2017;'00 - 01;20,96;43,61;-22,65;0;0;0;16166;15422;-744
8785;01.01.2017;'01 - 02;20,9;42,31;-21,41;0;0;0;15968;15363;-605
8786;01.01.2017;'02 - 03;18,13;38,19;-20,06;0;0;0;15904;15080;-824
8787;01.01.2017;'03 - 04;16,03;33,25;-17,22;0;0;0;15786;14731;-1055
8788;01.01.2017;'04 - 05;16,43;32,79;-16,36;0;0;0;15720;14865;-855
8789;01.01.2017;'05 - 06;13,75;36,08;-22,33;0;0;0;15810;15254;-556
8790;01.01.2017;'06 - 07;11,1;25,97;-14,87;0;0;0;16042;15904;-138
8791;01.01.2017;'07 - 08;15,47;23,28;-7,81;2;1;-1;16317;15903;-414
8792;01.01.2017;'08 - 09;16,88;31,14;-14,26;427;274;-153;16562;15816;-746
8793;01.01.2017;'09 - 10;21,81;35,05;-13,24;2602;2083;-519;16703;15722;-981
8794;01.01.2017;'10 - 11;26,24;34,92;-8,68;5269;4679;-590;16437;14505;-1932
8795;01.01.2017;'11 - 12;26,42;35,06;-8,64;7180;6830;-350;15567;13300;-2267
8796;01.01.2017;'12 - 13;27,66;36,25;-8,59;7807;7926;119;14640;12236;-2404
8797;01.01.2017;'13 - 14;28,7;35,22;-6,52;6934;7084;150;14070;11020;-3050
8798;01.01.2017;'14 - 15;29,66;37,3;-7,64;4709;4635;-74;13818;9829;-3989
8799;01.01.2017;'15 - 16;35,33;49,86;-14,53;1878;1661;-217;13826;8994;-4832
8800;01.01.2017;'16 - 17;44,12;55,32;-11,2;148;118;-30;13990;9147;-4843
8801;01.01.2017;'17 - 18;51,59;59,55;-7,96;3;0;-3;14242;9738;-4504
8802;01.01.2017;'18 - 19;53,95;64,04;-10,09;0;0;0;14512;9876;-4636
8803;01.01.2017;'19 - 20;50,97;60,22;-9,25;0;0;0;14707;10227;-4480
8804;01.01.2017;'20 - 21;44,93;53,62;-8,69;0;0;0;14741;11094;-3647
8805;01.01.2017;'21 - 22;38,83;48,83;-10;0;0;0;14715;11533;-3182
8806;01.01.2017;'22 - 23;42,17;52,03;-9,86;0;0;0;14622;12339;-2283
8807;01.01.2017;'23 - 24;33,06;47,07;-14,01;0;0;0;14386;12260;-2126
8808;02.01.2017;'00 - 01;30,54;38,61;-8,07;0;0;0;13567;12389;-1178
8809;02.01.2017;'01 - 02;28,91;37,51;-8,6;0;0;0;13715;12910;-805
8810;02.01.2017;'02 - 03;28,11;32,87;-4,76;0;0;0;13806;12710;-1096
8811;02.01.2017;'03 - 04;27,89;32,13;-4,24;0;0;0;13852;12694;-1158
8812;02.01.2017;'04 - 05;27,73;32,21;-4,48;0;0;0;13733;11989;-1744
8813;02.01.2017;'05 - 06;31,18;37,51;-6,33;0;0;0;13440;11863;-1577
8814;02.01.2017;'06 - 07;37,99;43,76;-5,77;0;0;0;13164;12128;-1036
8815;02.01.2017;'07 - 08;50,98;54,76;-3,78;1;0;-1;12853;11925;-928
8816;02.01.2017;'08 - 09;53,88;57,19;-3,31;229;105;-124;12310;11406;-904
8817;02.01.2017;'09 - 10;53,94;57,05;-3,11;1238;774;-464;11805;10518;-1287
8818;02.01.2017;'10 - 11;53,54;59,42;-5,88;2623;1627;-996;11117;10322;-795
8819;02.01.2017;'11 - 12;54,91;61,66;-6,75;3608;2401;-1207;10479;9825;-654
8820;02.01.2017;'12 - 13;54,08;65,99;-11,91;3757;2868;-889;10273;10077;-196
8821;02.01.2017;'13 - 14;55,67;67,5;-11,83;3016;2528;-488;10243;10096;-147
8822;02.01.2017;'14 - 15;55,98;64,97;-8,99;1809;1572;-237;10306;10510;204
8823;02.01.2017;'15 - 16;56;64,38;-8,38;633;556;-77;10433;10562;129
8824;02.01.2017;'16 - 17;57,77;67,33;-9,56;53;48;-5;10654;11042;388
8825;02.01.2017;'17 - 18;67,66;72,41;-4,75;2;0;-2;11081;12126;1045
8826;02.01.2017;'18 - 19;55,1;67,28;-12,18;0;0;0;11464;13440;1976
8827;02.01.2017;'19 - 20;53,92;57,44;-3,52;0;0;0;11619;13900;2281
8828;02.01.2017;'20 - 21;49,07;48,35;0,72;0;0;0;11655;13906;2251
8829;02.01.2017;'21 - 22;40,25;39,97;0,28;0;0;0;11789;14249;2460
8830;02.01.2017;'22 - 23;45,92;42,86;3,06;0;0;0;11921;14722;2801
8831;02.01.2017;'23 - 24;38,88;38,58;0,3;0;0;0;11988;15678;3690
8832;03.01.2017;'00 - 01;36,02;35,36;0,66;0;0;0;16171;16501;330
8833;03.01.2017;'01 - 02;34,98;34,3;0,68;0;0;0;16666;16640;-26
8834;03.01.2017;'02 - 03;33,64;32,09;1,55;0;0;0;17169;17128;-41
8835;03.01.2017;'03 - 04;33,89;34,83;-0,94;0;0;0;17716;18205;489
8836;03.01.2017;'04 - 05;33,5;34,05;-0,55;0;0;0;18244;18855;611
8837;03.01.2017;'05 - 06;33,91;31,84;2,07;0;0;0;18684;19734;1050
8838;03.01.2017;'06 - 07;48,13;35,13;13;0;0;0;19027;20756;1729
8839;03.01.2017;'07 - 08;54,61;41,88;12,73;1;0;-1;19390;22145;2755
8840;03.01.2017;'08 - 09;57,93;42;15,93;164;70;-94;20035;22753;2718
8841;03.01.2017;'09 - 10;57,18;46,27;10,91;925;538;-387;21024;24081;3057
8842;03.01.2017;'10 - 11;52,27;43,88;8,39;2120;1166;-954;22398;25909;3511
8843;03.01.2017;'11 - 12;49,94;42,69;7,25;3075;1817;-1258;23950;27726;3776
8844;03.01.2017;'12 - 13;46,3;41;5,3;3453;2147;-1306;25474;29098;3624
8845;03.01.2017;'13 - 14;41,51;38,36;3,15;3118;1908;-1210;26885;30230;3345
8846;03.01.2017;'14 - 15;37,08;35,23;1,85;2150;1220;-930;28068;30829;2761
8847;03.01.2017;'15 - 16;37,03;35,38;1,65;906;439;-467;29127;31969;2842
8848;03.01.2017;'16 - 17;39,08;35,72;3,36;98;46;-52;30201;33058;2857
8849;03.01.2017;'17 - 18;42,14;37,07;5,07;3;0;-3;31256;33917;2661
8850;03.01.2017;'18 - 19;36,67;37,55;-0,88;0;0;0;32245;34739;2494
8851;03.01.2017;'19 - 20;36,03;34,35;1,68;0;0;0;33038;35220;2182
8852;03.01.2017;'20 - 21;33,55;31,4;2,15;0;0;0;33731;35692;1961
8853;03.01.2017;'21 - 22;24,56;23,91;0,65;0;0;0;34165;35723;1558
8854;03.01.2017;'22 - 23;17,77;19,36;-1,59;0;0;0;34588;34704;116
8855;03.01.2017;'23 - 24;9,49;7,04;2,45;0;0;0;34969;34412;-557
8856;04.01.2017;'00 - 01;8,5;8,25;0,25;0;0;0;35375;32650;-2725
8857;04.01.2017;'01 - 02;-0,05;8,31;-8,36;0;0;0;35389;31757;-3632
8858;04.01.2017;'02 - 03;-6,27;20,7;-26,97;0;0;0;35155;30978;-4177
8859;04.01.2017;'03 - 04;-5,09;14,36;-19,45;0;0;0;35048;30633;-4415
8860;04.01.2017;'04 - 05;0,06;15,82;-15,76;0;0;0;35089;30701;-4388
8861;04.01.2017;'05 - 06;10,55;21,23;-10,68;0;0;0;35122;30838;-4284
8862;04.01.2017;'06 - 07;10,98;36,19;-25,21;0;0;0;35195;31701;-3494
8863;04.01.2017;'07 - 08;31,63;43,85;-12,22;0;0;0;35327;32627;-2700
8864;04.01.2017;'08 - 09;34,94;49,14;-14,2;80;49;-31;35186;33379;-1807
8865;04.01.2017;'09 - 10;33,27;43,48;-10,21;621;675;54;34829;32921;-1908
8866;04.01.2017;'10 - 11;33,52;43,77;-10,25;1535;1747;212;34378;32260;-2118
8867;04.01.2017;'11 - 12;34,81;47,74;-12,93;2214;2619;405;33831;32198;-1633
8868;04.01.2017;'12 - 13;35,08;49,07;-13,99;2424;2968;544;33237;32234;-1003
8869;04.01.2017;'13 - 14;35,88;45,67;-9,79;2131;2560;429;32479;31422;-1057
8870;04.01.2017;'14 - 15;36,03;44,93;-8,9;1417;1596;179;31579;30136;-1443
8871;04.01.2017;'15 - 16;36,17;49,85;-13,68;562;556;-6;30525;29088;-1437
8872;04.01.2017;'16 - 17;36,58;50,88;-14,3;52;44;-8;29176;27927;-1249
8873;04.01.2017;'17 - 18;46,95;54,38;-7,43;0;0;0;27729;26062;-1667
8874;04.01.2017;'18 - 19;49,45;54,83;-5,38;0;0;0;26223;25478;-745
8875;04.01.2017;'19 - 20;48,37;49,81;-1,44;0;0;0;24650;25132;482
8876;04.01.2017;'20 - 21;38,02;39;-0,98;0;0;0;23206;23856;650
8877;04.01.2017;'21 - 22;34,55;37,74;-3,19;0;0;0;21939;23136;1197
8878;04.01.2017;'22 - 23;33,33;36,28;-2,95;0;0;0;20726;21622;896
8879;04.01.2017;'23 - 24;32,05;34,21;-2,16;0;0;0;19306;20924;1618
8880;05.01.2017;'00 - 01;36,07;43;-6,93;0;0;0;18083;19568;1485
8881;05.01.2017;'01 - 02;36,32;40,07;-3,75;0;0;0;16731;18151;1420
8882;05.01.2017;'02 - 03;30,99;32,91;-1,92;0;0;0;15424;17270;1846
8883;05.01.2017;'03 - 04;30,97;32,38;-1,41;0;0;0;14323;16276;1953
8884;05.01.2017;'04 - 05;35,64;35,98;-0,34;0;0;0;13432;15572;2140
8885;05.01.2017;'05 - 06;35,73;36,08;-0,35;0;0;0;12646;14819;2173
8886;05.01.2017;'06 - 07;39,03;39,18;-0,15;0;0;0;11887;13865;1978
8887;05.01.2017;'07 - 08;51,7;51,18;0,52;1;0;-1;11121;13474;2353
8888;05.01.2017;'08 - 09;57,98;53,06;4,92;168;116;-52;10276;13034;2758
8889;05.01.2017;'09 - 10;54,11;50,79;3,32;1322;1267;-55;9522;12300;2778
8890;05.01.2017;'10 - 11;53,13;50,32;2,81;3081;2991;-90;9067;11856;2789
8891;05.01.2017;'11 - 12;50,06;50,73;-0,67;4410;4276;-134;8993;11987;2994
8892;05.01.2017;'12 - 13;49,97;52,13;-2,16;4956;4453;-503;9093;12074;2981
8893;05.01.2017;'13 - 14;48,84;50;-1,16;4595;3876;-719;9011;11062;2051
8894;05.01.2017;'14 - 15;50,99;52,56;-1,57;3296;2642;-654;8561;9947;1386
8895;05.01.2017;'15 - 16;57,48;59,75;-2,27;1385;1079;-306;7928;9464;1536
8896;05.01.2017;'16 - 17;69,7;66,97;2,73;123;97;-26;7477;8888;1411
8897;05.01.2017;'17 - 18;73,92;68,3;5,62;2;0;-2;7258;8612;1354
8898;05.01.2017;'18 - 19;73,76;70,02;3,74;0;0;0;7138;8174;1036
8899;05.01.2017;'19 - 20;65,15;61,64;3,51;0;0;0;6760;7375;615
8900;05.01.2017;'20 - 21;64,24;58,55;5,69;0;0;0;6088;6753;665
8901;05.01.2017;'21 - 22;43,09;43,12;-0,03;0;0;0;5380;6172;792
8902;05.01.2017;'22 - 23;53,11;46,54;6,57;0;0;0;4797;5452;655
8903;05.01.2017;'23 - 24;37,08;35,61;1,47;0;0;0;4343;4957;614
8904;06.01.2017;'00 - 01;40,84;36,71;4,13;0;0;0;3777;4224;447
8905;06.01.2017;'01 - 02;41,15;36,24;4,91;0;0;0;3436;3849;413
8906;06.01.2017;'02 - 03;43,77;39,22;4,55;0;0;0;3151;3637;486
8907;06.01.2017;'03 - 04;39,97;37,48;2,49;0;0;0;2891;3555;664
8908;06.01.2017;'04 - 05;40,81;37,46;3,35;0;0;0;2771;3613;842
8909;06.01.2017;'05 - 06;43,04;38,68;4,36;0;0;0;2772;3420;648
8910;06.01.2017;'06 - 07;45,37;39,99;5,38;0;0;0;2797;3408;611
8911;06.01.2017;'07 - 08;49,49;48,67;0,82;0;0;0;2789;3684;895
8912;06.01.2017;'08 - 09;59,92;51,35;8,57;292;130;-162;2754;3519;765
8913;06.01.2017;'09 - 10;60;50,86;9,14;2276;1675;-601;2753;3097;344
8914;06.01.2017;'10 - 11;60,04;51,03;9,01;4821;4064;-757;2741;2724;-17
8915;06.01.2017;'11 - 12;57,7;50,77;6,93;6436;6262;-174;2712;2534;-178
8916;06.01.2017;'12 - 13;52,86;50,36;2,5;6895;7288;393;2760;2818;58
8917;06.01.2017;'13 - 14;50,05;44,05;6;6110;6842;732;2908;3112;204
8918;06.01.2017;'14 - 15;50,94;43,46;7,48;4266;4852;586;3168;3242;74
8919;06.01.2017;'15 - 16;54,04;45,93;8,11;1812;2046;234;3488;3585;97
8920;06.01.2017;'16 - 17;57,52;51,67;5,85;154;182;28;4020;4131;111
8921;06.01.2017;'17 - 18;64,91;55,8;9,11;0;0;0;4869;5008;139
8922;06.01.2017;'18 - 19;59,92;50,98;8,94;0;0;0;5827;6237;410
8923;06.01.2017;'19 - 20;57,99;47,8;10,19;0;0;0;6654;7407;753
8924;06.01.2017;'20 - 21;43,68;38,73;4,95;0;0;0;7275;7917;642
8925;06.01.2017;'21 - 22;38,46;37,24;1,22;0;0;0;7890;8026;136
8926;06.01.2017;'22 - 23;40,94;39,59;1,35;0;0;0;8449;8488;39
8927;06.01.2017;'23 - 24;35,89;34,26;1,63;0;0;0;8917;9002;85
8928;07.01.2017;'00 - 01;36,83;37,77;-0,94;0;0;0;8566;9710;1144
8929;07.01.2017;'01 - 02;34,37;36,23;-1,86;0;0;0;9038;10204;1166
8930;07.01.2017;'02 - 03;33,84;35,2;-1,36;0;0;0;9589;10708;1119
8931;07.01.2017;'03 - 04;33,83;37,08;-3,25;0;0;0;10114;11015;901
8932;07.01.2017;'04 - 05;33,62;38,57;-4,95;0;0;0;10587;11440;853
8933;07.01.2017;'05 - 06;32,96;38,25;-5,29;0;0;0;11015;12010;995
8934;07.01.2017;'06 - 07;30,07;33,03;-2,96;0;0;0;11476;12347;871
8935;07.01.2017;'07 - 08;33,58;36,09;-2,51;1;0;-1;11846;12438;592
8936;07.01.2017;'08 - 09;36,02;35,53;0,49;150;93;-57;11954;12838;884
8937;07.01.2017;'09 - 10;36,86;37,14;-0,28;837;657;-180;11973;12897;924
8938;07.01.2017;'10 - 11;36,43;36,18;0,25;1681;1372;-309;11828;12279;451
8939;07.01.2017;'11 - 12;39,01;39,99;-0,98;2205;1773;-432;11555;11919;364
8940;07.01.2017;'12 - 13;39,5;44,35;-4,85;2194;1786;-408;11356;10919;-437
8941;07.01.2017;'13 - 14;39,02;45,19;-6,17;1753;1475;-278;11321;10527;-794
8942;07.01.2017;'14 - 15;38,6;47,71;-9,11;1099;876;-223;11390;10544;-846
8943;07.01.2017;'15 - 16;39,28;48,83;-9,55;445;326;-119;11556;10686;-870
8944;07.01.2017;'16 - 17;46,95;57,76;-10,81;52;29;-23;11600;10682;-918
8945;07.01.2017;'17 - 18;57,01;65,7;-8,69;1;0;-1;11483;10099;-1384
8946;07.01.2017;'18 - 19;54,02;64,46;-10,44;0;0;0;11462;9480;-1982
8947;07.01.2017;'19 - 20;46,92;61,36;-14,44;0;0;0;11389;8842;-2547
8948;07.01.2017;'20 - 21;38,12;57,53;-19,41;0;0;0;11192;8712;-2480
8949;07.01.2017;'21 - 22;35,09;55;-19,91;0;0;0;10890;8937;-1953
8950;07.01.2017;'22 - 23;38,1;56,34;-18,24;0;0;0;10416;8330;-2086
8951;07.01.2017;'23 - 24;34,53;49,13;-14,6;0;0;0;9796;7732;-2064
8952;08.01.2017;'00 - 01;33,86;45,65;-11,79;0;0;0;9572;6722;-2850
8953;08.01.2017;'01 - 02;34,14;46,69;-12,55;0;0;0;8799;5858;-2941
8954;08.01.2017;'02 - 03;33,96;48,87;-14,91;0;0;0;7900;4800;-3100
8955;08.01.2017;'03 - 04;35,01;50,85;-15,84;0;0;0;6924;3981;-2943
8956;08.01.2017;'04 - 05;36,07;55,41;-19,34;0;0;0;5889;3470;-2419
8957;08.01.2017;'05 - 06;36,07;53,07;-17;0;0;0;4901;2952;-1949
8958;08.01.2017;'06 - 07;36,01;49,5;-13,49;0;0;0;4071;2627;-1444
8959;08.01.2017;'07 - 08;35,37;47,47;-12,1;0;0;0;3393;2240;-1153
8960;08.01.2017;'08 - 09;37,29;54,28;-16,99;54;23;-31;2852;1608;-1244
8961;08.01.2017;'09 - 10;39,15;57,8;-18,65;368;239;-129;2370;1234;-1136
8962;08.01.2017;'10 - 11;41,25;58,34;-17,09;887;619;-268;1855;990;-865
8963;08.01.2017;'11 - 12;51,93;62,42;-10,49;1311;966;-345;1417;775;-642
8964;08.01.2017;'12 - 13;45,37;61,86;-16,49;1487;1114;-373;1112;625;-487
8965;08.01.2017;'13 - 14;40,53;58,58;-18,05;1361;1016;-345;901;495;-406
8966;08.01.2017;'14 - 15;39,73;57,14;-17,41;929;710;-219;783;349;-434
8967;08.01.2017;'15 - 16;42,75;57,63;-14,88;379;279;-100;681;284;-397
8968;08.01.2017;'16 - 17;53,87;60,27;-6,4;48;25;-23;659;287;-372
8969;08.01.2017;'17 - 18;60,95;67,84;-6,89;0;0;0;717;394;-323
8970;08.01.2017;'18 - 19;64,93;70,07;-5,14;0;0;0;837;509;-328
8971;08.01.2017;'19 - 20;58,91;64,91;-6;0;0;0;988;721;-267
8972;08.01.2017;'20 - 21;50,03;58,19;-8,16;0;0;0;1181;995;-186
8973;08.01.2017;'21 - 22;39,06;49,08;-10,02;0;0;0;1445;1221;-224
8974;08.01.2017;'22 - 23;40,06;50,04;-9,98;0;0;0;1732;1326;-406
8975;08.01.2017;'23 - 24;37,09;41,79;-4,7;0;0;0;1987;1602;-385
8976;09.01.2017;'00 - 01;40;39,89;0,11;0;0;0;2657;1918;-739
8977;09.01.2017;'01 - 02;39,05;39,76;-0,71;0;0;0;2855;2169;-686
8978;09.01.2017;'02 - 03;39,21;39,71;-0,5;0;0;0;3096;2324;-772
8979;09.01.2017;'03 - 04;39,24;39,95;-0,71;0;0;0;3350;2677;-673
8980;09.01.2017;'04 - 05;40,26;39,35;0,91;0;0;0;3675;3138;-537
8981;09.01.2017;'05 - 06;43,84;41,43;2,41;0;0;0;4092;3484;-608
8982;09.01.2017;'06 - 07;58,99;50,31;8,68;0;0;0;4597;3815;-782
8983;09.01.2017;'07 - 08;74,04;67,25;6,79;0;0;0;5093;4496;-597
8984;09.01.2017;'08 - 09;75,49;67,42;8,07;89;35;-54;5712;5285;-427
8985;09.01.2017;'09 - 10;74,63;64,75;9,88;544;322;-222;6367;5674;-693
8986;09.01.2017;'10 - 11;73,97;64,28;9,69;1191;819;-372;6883;5692;-1191
8987;09.01.2017;'11 - 12;72;63,07;8,93;1681;1346;-335;7196;5730;-1466
8988;09.01.2017;'12 - 13;72,12;67,02;5,1;1848;1640;-208;7486;5868;-1618
8989;09.01.2017;'13 - 14;70,09;67,03;3,06;1662;1491;-171;7911;6206;-1705
8990;09.01.2017;'14 - 15;67,41;65,84;1,57;1171;1022;-149;8598;6544;-2054
8991;09.01.2017;'15 - 16;65,21;65,75;-0,54;514;357;-157;9375;7264;-2111
8992;09.01.2017;'16 - 17;65,09;70,57;-5,48;65;38;-27;10402;8940;-1462
8993;09.01.2017;'17 - 18;74,72;77,48;-2,76;0;0;0;11717;10577;-1140
8994;09.01.2017;'18 - 19;59,94;67,9;-7,96;0;0;0;13102;11904;-1198
8995;09.01.2017;'19 - 20;52,2;57,83;-5,63;0;0;0;14256;13056;-1200
8996;09.01.2017;'20 - 21;39,1;44,19;-5,09;0;0;0;15147;14132;-1015
8997;09.01.2017;'21 - 22;36,62;40,13;-3,51;0;0;0;15968;14912;-1056
8998;09.01.2017;'22 - 23;36,08;38,8;-2,72;0;0;0;16571;15129;-1442
8999;09.01.2017;'23 - 24;32,76;36,43;-3,67;0;0;0;16923;15713;-1210
9000;10.01.2017;'00 - 01;32,45;28,66;3,79;0;0;0;17720;16254;-1466
9001;10.01.2017;'01 - 02;31,52;27,27;4,25;0;0;0;18020;16697;-1323
9002;10.01.2017;'02 - 03;29,08;25,82;3,26;0;0;0;18135;16900;-1235
9003;10.01.2017;'03 - 04;28,92;22,83;6,09;0;0;0;18033;17193;-840
9004;10.01.2017;'04 - 05;31,49;24,2;7,29;0;0;0;17431;16838;-593
9005;10.01.2017;'05 - 06;33,06;27,19;5,87;0;0;0;16399;16095;-304
9006;10.01.2017;'06 - 07;36,26;31,8;4,46;0;0;0;15438;15918;480
9007;10.01.2017;'07 - 08;46;40,68;5,32;0;0;0;14607;14517;-90
9008;10.01.2017;'08 - 09;59,89;58,64;1,25;103;77;-26;13764;12422;-1342
9009;10.01.2017;'09 - 10;59,96;68,8;-8,84;641;722;81;12888;11518;-1370
9010;10.01.2017;'10 - 11;62,69;73,82;-11,13;1435;1838;403;11836;10564;-1272
9011;10.01.2017;'11 - 12;66,82;72,91;-6,09;2053;2573;520;10539;9864;-675
9012;10.01.2017;'12 - 13;71,42;72,77;-1,35;2263;2798;535;9301;9444;143
9013;10.01.2017;'13 - 14;72,33;71,72;0,61;2021;2524;503;8505;8917;412
9014;10.01.2017;'14 - 15;69,5;65,1;4,4;1365;1761;396;8389;8183;-206
9015;10.01.2017;'15 - 16;70,64;64,01;6,63;541;694;153;8563;7752;-811
9016;10.01.2017;'16 - 17;66,96;69,88;-2,92;57;57;0;8954;7979;-975
9017;10.01.2017;'17 - 18;88,38;92,26;-3,88;0;1;1;9494;8780;-714
9018;10.01.2017;'18 - 19;98,93;91,15;7,78;0;0;0;9890;9298;-592
9019;10.01.2017;'19 - 20;69,65;66,34;3,31;0;0;0;10027;9522;-505
9020;10.01.2017;'20 - 21;58,82;54,65;4,17;0;0;0;9991;9928;-63
9021;10.01.2017;'21 - 22;47,63;41,95;5,68;0;0;0;9882;10382;500
9022;10.01.2017;'22 - 23;40,08;40,17;-0,09;0;0;0;9904;10218;314
9023;10.01.2017;'23 - 24;38,06;39,05;-0,99;0;0;0;10154;10404;250
9024;11.01.2017;'00 - 01;38,99;38,35;0,64;0;0;0;10895;11040;145
9025;11.01.2017;'01 - 02;37,2;37,72;-0,52;0;0;0;11819;11893;74
9026;11.01.2017;'02 - 03;34,03;35,48;-1,45;0;0;0;13157;13018;-139
9027;11.01.2017;'03 - 04;34,78;36,84;-2,06;0;0;0;14746;14277;-469
9028;11.01.2017;'04 - 05;32,7;36,41;-3,71;0;0;0;16618;16040;-578
9029;11.01.2017;'05 - 06;31,21;34,7;-3,49;0;0;0;18953;18168;-785
9030;11.01.2017;'06 - 07;37,2;38,68;-1,48;0;0;0;21410;21544;134
9031;11.01.2017;'07 - 08;49,97;50,06;-0,09;1;0;-1;23981;24248;267
9032;11.01.2017;'08 - 09;46,98;43,36;3,62;137;75;-62;26665;26608;-57
9033;11.01.2017;'09 - 10;44,7;44,49;0,21;766;558;-208;29106;28345;-761
9034;11.01.2017;'10 - 11;44,41;48,77;-4,36;1471;1004;-467;31101;30334;-767
9035;11.01.2017;'11 - 12;41,06;46,39;-5,33;1856;1371;-485;32446;31573;-873
9036;11.01.2017;'12 - 13;36,94;42,36;-5,42;1808;1507;-301;33324;31707;-1617
9037;11.01.2017;'13 - 14;34,09;41,95;-7,86;1492;1382;-110;33852;31168;-2684
9038;11.01.2017;'14 - 15;33,68;42,58;-8,9;998;1004;6;33967;30396;-3571
9039;11.01.2017;'15 - 16;33,64;43,79;-10,15;411;430;19;33986;30732;-3254
9040;11.01.2017;'16 - 17;33,66;48,02;-14,36;43;46;3;33800;30638;-3162
9041;11.01.2017;'17 - 18;38,53;51,04;-12,51;0;2;2;33365;29780;-3585
9042;11.01.2017;'18 - 19;37,4;48,26;-10,86;0;0;0;32844;30127;-2717
9043;11.01.2017;'19 - 20;37,07;46,83;-9,76;0;0;0;32490;30444;-2046
9044;11.01.2017;'20 - 21;34;42,19;-8,19;0;0;0;32280;31447;-833
9045;11.01.2017;'21 - 22;31,83;34,66;-2,83;0;0;0;32307;31714;-593
9046;11.01.2017;'22 - 23;26,27;30,55;-4,28;0;0;0;32452;30808;-1644
9047;11.01.2017;'23 - 24;11,68;18,68;-7;0;0;0;32587;31043;-1544
9048;12.01.2017;'00 - 01;12,12;17,04;-4,92;0;0;0;32325;31207;-1118
9049;12.01.2017;'01 - 02;9,83;15,75;-5,92;0;0;0;32412;30839;-1573
9050;12.01.2017;'02 - 03;9,02;15,75;-6,73;0;0;0;32365;30415;-1950
9051;12.01.2017;'03 - 04;9,27;13,93;-4,66;0;0;0;32288;30150;-2138
9052;12.01.2017;'04 - 05;9,84;15,58;-5,74;0;0;0;32117;29882;-2235
9053;12.01.2017;'05 - 06;10,55;23,34;-12,79;0;0;0;31809;29579;-2230
9054;12.01.2017;'06 - 07;28,29;39,04;-10,75;0;0;0;31473;30768;-705
9055;12.01.2017;'07 - 08;40,02;47,37;-7,35;0;0;0;31128;30285;-843
9056;12.01.2017;'08 - 09;40,07;50,08;-10,01;113;84;-29;30881;30072;-809
9057;12.01.2017;'09 - 10;38,2;49,43;-11,23;804;904;100;30686;29740;-946
9058;12.01.2017;'10 - 11;38,61;46,85;-8,24;1839;2421;582;30626;29631;-995
9059;12.01.2017;'11 - 12;38,43;42,55;-4,12;2654;3475;821;30611;29776;-835
9060;12.01.2017;'12 - 13;36,7;40,99;-4,29;2963;4026;1063;30411;29506;-905
9061;12.01.2017;'13 - 14;39,61;41,95;-2,34;2649;3520;871;29556;28280;-1276
9062;12.01.2017;'14 - 15;40,05;43,08;-3,03;1818;2327;509;27913;25606;-2307
9063;12.01.2017;'15 - 16;45,32;54,24;-8,92;703;991;288;25978;23766;-2212
9064;12.01.2017;'16 - 17;46,98;57,84;-10,86;72;113;41;24183;21204;-2979
9065;12.01.2017;'17 - 18;57,09;65,36;-8,27;0;4;4;22839;18895;-3944
9066;12.01.2017;'18 - 19;57,13;65,11;-7,98;0;0;0;21644;16440;-5204
9067;12.01.2017;'19 - 20;57,05;64,07;-7,02;0;0;0;20440;15244;-5196
9068;12.01.2017;'20 - 21;45,01;54,85;-9,84;0;0;0;19383;15028;-4355
9069;12.01.2017;'21 - 22;40,09;49,15;-9,06;0;0;0;18389;14506;-3883
9070;12.01.2017;'22 - 23;37,89;47,45;-9,56;0;0;0;17705;14236;-3469
9071;12.01.2017;'23 - 24;33,07;37,44;-4,37;0;0;0;17523;14969;-2554
9072;13.01.2017;'00 - 01;35,19;30,05;5,14;0;0;0;13145;15975;2830
9073;13.01.2017;'01 - 02;33,44;26,8;6,64;0;0;0;13466;17101;3635
9074;13.01.2017;'02 - 03;32,44;20,56;11,88;0;0;0;14542;17798;3256
9075;13.01.2017;'03 - 04;29,8;18,88;10,92;0;0;0;15780;18515;2735
9076;13.01.2017;'04 - 05;29,25;24,17;5,08;0;0;0;17305;20394;3089
9077;13.01.2017;'05 - 06;30,64;30,52;0,12;0;0;0;19208;21590;2382
9078;13.01.2017;'06 - 07;37,27;35,4;1,87;0;0;0;20897;22796;1899
9079;13.01.2017;'07 - 08;46,98;46,9;0,08;0;0;0;21946;23583;1637
9080;13.01.2017;'08 - 09;45,5;47,98;-2,48;140;115;-25;22613;24386;1773
9081;13.01.2017;'09 - 10;45,48;46,9;-1,42;848;820;-28;23685;23648;-37
9082;13.01.2017;'10 - 11;46,96;47,98;-1,02;1753;1822;69;24678;23659;-1019
9083;13.01.2017;'11 - 12;46,7;48,44;-1,74;2404;2538;134;25375;23340;-2035
9084;13.01.2017;'12 - 13;43,07;44,81;-1,74;2668;2935;267;25906;22399;-3507
9085;13.01.2017;'13 - 14;42,06;44,44;-2,38;2453;2800;347;25712;22434;-3278
9086;13.01.2017;'14 - 15;41,98;43,37;-1,39;1776;2148;372;24938;22240;-2698
9087;13.01.2017;'15 - 16;43,03;41,65;1,38;804;998;194;23972;21631;-2341
9088;13.01.2017;'16 - 17;44,87;45,18;-0,31;98;132;34;23175;21989;-1186
9089;13.01.2017;'17 - 18;48,72;46,67;2,05;0;3;3;22969;22198;-771
9090;13.01.2017;'18 - 19;45,17;40,52;4,65;0;0;0;23203;22674;-529
9091;13.01.2017;'19 - 20;44,94;35,59;9,35;0;0;0;23326;21980;-1346
9092;13.01.2017;'20 - 21;39,94;33,22;6,72;0;0;0;23265;21570;-1695
9093;13.01.2017;'21 - 22;36,7;31,39;5,31;0;0;0;23330;20766;-2564
9094;13.01.2017;'22 - 23;33,99;31,09;2,9;0;0;0;23521;20273;-3248
9095;13.01.2017;'23 - 24;30,99;29,31;1,68;0;0;0;23389;20306;-3083
9096;14.01.2017;'00 - 01;29,82;19,58;10,24;0;0;0;17283;21348;4065
9097;14.01.2017;'01 - 02;28,98;14,85;14,13;0;0;0;17772;22732;4960
9098;14.01.2017;'02 - 03;28,64;6,2;22,44;0;0;0;18109;23232;5123
9099;14.01.2017;'03 - 04;28,5;4,27;24,23;0;0;0;18492;23108;4616
9100;14.01.2017;'04 - 05;28,61;4,02;24,59;0;0;0;18942;22600;3658
9101;14.01.2017;'05 - 06;28,05;7,68;20,37;0;0;0;19313;22154;2841
9102;14.01.2017;'06 - 07;29,49;13,77;15,72;0;0;0;19934;22776;2842
9103;14.01.2017;'07 - 08;28,97;16,56;12,41;0;0;0;20074;21898;1824
9104;14.01.2017;'08 - 09;33,19;25,14;8,05;127;80;-47;19671;20533;862
9105;14.01.2017;'09 - 10;36,78;33,41;3,37;893;787;-106;19325;19071;-254
9106;14.01.2017;'10 - 11;39,81;39,15;0,66;1955;1800;-155;19185;18406;-779
9107;14.01.2017;'11 - 12;40,05;40,64;-0,59;2686;2872;186;19372;18538;-834
9108;14.01.2017;'12 - 13;36,47;38,85;-2,38;2913;3646;733;19790;19176;-614
9109;14.01.2017;'13 - 14;34,76;36,13;-1,37;2602;3640;1038;20300;19029;-1271
9110;14.01.2017;'14 - 15;33,37;33,64;-0,27;1848;2630;782;20483;19448;-1035
9111;14.01.2017;'15 - 16;34,29;34,05;0,24;849;1169;320;20357;19361;-996
9112;14.01.2017;'16 - 17;38,54;35,45;3,09;113;140;27;20248;19838;-410
9113;14.01.2017;'17 - 18;41,97;35,39;6,58;0;3;3;20234;20118;-116
9114;14.01.2017;'18 - 19;39,64;32,88;6,76;0;0;0;20532;21132;600
9115;14.01.2017;'19 - 20;37,01;31,18;5,83;0;0;0;20573;20782;209
9116;14.01.2017;'20 - 21;32,52;25,26;7,26;0;0;0;20156;19795;-361
9117;14.01.2017;'21 - 22;30,66;25,35;5,31;0;0;0;19601;19300;-301
9118;14.01.2017;'22 - 23;30,25;22,48;7,77;0;0;0;18900;18293;-607
9119;14.01.2017;'23 - 24;29,55;20,88;8,67;0;0;0;18156;17955;-201
9120;15.01.2017;'00 - 01;28,75;24,24;4,51;0;0;0;17893;17914;21
9121;15.01.2017;'01 - 02;28,11;21,25;6,86;0;0;0;17380;17607;227
9122;15.01.2017;'02 - 03;26,03;15,21;10,82;0;0;0;16863;17247;384
9123;15.01.2017;'03 - 04;19,96;10,99;8,97;0;0;0;16283;17024;741
9124;15.01.2017;'04 - 05;22,93;8,31;14,62;0;0;0;15476;16416;940
9125;15.01.2017;'05 - 06;22,8;11,16;11,64;0;0;0;14436;15918;1482
9126;15.01.2017;'06 - 07;14,91;8,16;6,75;0;0;0;13387;14995;1608
9127;15.01.2017;'07 - 08;20,37;10,78;9,59;0;0;0;12145;13594;1449
9128;15.01.2017;'08 - 09;33,28;21,55;11,73;145;67;-78;10838;12545;1707
9129;15.01.2017;'09 - 10;33,96;26,94;7,02;982;570;-412;9646;11354;1708
9130;15.01.2017;'10 - 11;35,98;33,5;2,48;2140;1593;-547;8509;10097;1588
9131;15.01.2017;'11 - 12;44,65;39,85;4,8;2998;2736;-262;7619;9083;1464
9132;15.01.2017;'12 - 13;41,68;38,47;3,21;3408;3394;-14;7002;8506;1504
9133;15.01.2017;'13 - 14;36,66;35,28;1,38;3205;3445;240;6465;7633;1168
9134;15.01.2017;'14 - 15;35,72;34,82;0,9;2400;2729;329;5930;7102;1172
9135;15.01.2017;'15 - 16;36,35;34,58;1,77;1182;1376;194;5468;6265;797
9136;15.01.2017;'16 - 17;38,71;35,15;3,56;176;192;16;5251;6038;787
9137;15.01.2017;'17 - 18;54,35;43,77;10,58;0;3;3;5215;5786;571
9138;15.01.2017;'18 - 19;58,02;49,96;8,06;0;0;0;5176;5623;447
9139;15.01.2017;'19 - 20;55,12;48,75;6,37;0;0;0;4975;5489;514
9140;15.01.2017;'20 - 21;47,91;43,12;4,79;0;0;0;4681;5072;391
9141;15.01.2017;'21 - 22;36,92;33,73;3,19;0;0;0;4398;4535;137
9142;15.01.2017;'22 - 23;43;40,13;2,87;0;0;0;4217;4240;23
9143;15.01.2017;'23 - 24;38,64;36,25;2,39;0;0;0;4104;3897;-207
9144;16.01.2017;'00 - 01;45,07;44;1,07;0;0;0;3829;3704;-125
9145;16.01.2017;'01 - 02;43,25;36,29;6,96;0;0;0;3625;3659;34
9146;16.01.2017;'02 - 03;39,08;37,8;1,28;0;0;0;3557;3739;182
9147;16.01.2017;'03 - 04;37,57;38,24;-0,67;0;0;0;3491;3875;384
9148;16.01.2017;'04 - 05;38,24;36,88;1,36;0;0;0;3498;3739;241
9149;16.01.2017;'05 - 06;39,06;39,63;-0,57;0;0;0;3543;3477;-66
9150;16.01.2017;'06 - 07;64,8;69,6;-4,8;0;0;0;3585;3270;-315
9151;16.01.2017;'07 - 08;94,43;104,47;-10,04;0;0;0;3527;3220;-307
9152;16.01.2017;'08 - 09;99,76;135,79;-36,03;210;63;-147;3327;3082;-245
9153;16.01.2017;'09 - 10;100,88;131,08;-30,2;1365;656;-709;3033;2802;-231
9154;16.01.2017;'10 - 11;99,97;121,65;-21,68;2865;1801;-1064;2642;2377;-265
9155;16.01.2017;'11 - 12;99,56;120,61;-21,05;3917;2950;-967;2260;1963;-297
9156;16.01.2017;'12 - 13;98,56;106,88;-8,32;4301;3749;-552;2026;1568;-458
9157;16.01.2017;'13 - 14;98,92;101,17;-2,25;3998;3842;-156;1996;1530;-466
9158;16.01.2017;'14 - 15;100,26;99,36;0,9;2996;2900;-96;2222;1715;-507
9159;16.01.2017;'15 - 16;103,84;97,31;6,53;1511;1408;-103;2590;1864;-726
9160;16.01.2017;'16 - 17;102,06;92,39;9,67;231;228;-3;3131;2168;-963
9161;16.01.2017;'17 - 18;120;116,14;3,86;1;3;2;3782;2769;-1013
9162;16.01.2017;'18 - 19;124,83;112,92;11,91;0;0;0;4311;3413;-898
9163;16.01.2017;'19 - 20;113,69;85,64;28,05;0;0;0;4461;3507;-954
9164;16.01.2017;'20 - 21;88,98;87,38;1,6;0;0;0;4197;3301;-896
9165;16.01.2017;'21 - 22;73,59;71,96;1,63;0;0;0;3852;3062;-790
9166;16.01.2017;'22 - 23;55,19;56,24;-1,05;0;0;0;3509;2952;-557
9167;16.01.2017;'23 - 24;45,06;47,57;-2,51;0;0;0;3221;3070;-151
9168;17.01.2017;'00 - 01;45,83;51,26;-5,43;0;0;0;3491;3087;-404
9169;17.01.2017;'01 - 02;41,64;49,06;-7,42;0;0;0;3347;3196;-151
9170;17.01.2017;'02 - 03;34,61;46,6;-11,99;0;0;0;3236;3174;-62
9171;17.01.2017;'03 - 04;36,28;39,44;-3,16;0;0;0;3110;2925;-185
9172;17.01.2017;'04 - 05;35,25;39,32;-4,07;0;0;0;3011;2531;-480
9173;17.01.2017;'05 - 06;39,94;47,56;-7,62;0;0;0;2855;2494;-361
9174;17.01.2017;'06 - 07;58,29;60,73;-2,44;0;0;0;2702;2468;-234
9175;17.01.2017;'07 - 08;111,04;110,42;0,62;0;0;0;2546;2358;-188
9176;17.01.2017;'08 - 09;121,67;111,91;9,76;167;117;-50;2396;2306;-90
9177;17.01.2017;'09 - 10;125,61;104,61;21;1087;1132;45;2324;2200;-124
9178;17.01.2017;'10 - 11;121,49;95,45;26,04;2415;2786;371;2268;1884;-384
9179;17.01.2017;'11 - 12;117,34;87,55;29,79;3460;4108;648;2226;1875;-351
9180;17.01.2017;'12 - 13;106,15;76,96;29,19;3843;4955;1112;2240;1974;-266
9181;17.01.2017;'13 - 14;101,91;72,25;29,66;3509;4626;1117;2304;2119;-185
9182;17.01.2017;'14 - 15;100,03;70,74;29,29;2606;3340;734;2403;2464;61
9183;17.01.2017;'15 - 16;103,42;66,39;37,03;1338;1589;251;2512;2904;392
9184;17.01.2017;'16 - 17;110,91;68,86;42,05;222;253;31;2719;3360;641
9185;17.01.2017;'17 - 18;142,78;97,08;45,7;2;3;1;3081;3787;706
9186;17.01.2017;'18 - 19;143,09;81,94;61,15;0;0;0;3465;4303;838
9187;17.01.2017;'19 - 20;124,94;77,42;47,52;0;0;0;3741;4593;852
9188;17.01.2017;'20 - 21;84,97;57,01;27,96;0;0;0;3895;4840;945
9189;17.01.2017;'21 - 22;55,08;42,61;12,47;0;0;0;4094;5044;950
9190;17.01.2017;'22 - 23;48,95;40,35;8,6;0;0;0;4329;5172;843
9191;17.01.2017;'23 - 24;37,74;42,41;-4,67;0;0;0;4552;5547;995
9192;18.01.2017;'00 - 01;38,28;38,04;0,24;0;0;0;4526;5845;1319
9193;18.01.2017;'01 - 02;37,74;37,32;0,42;0;0;0;4694;6076;1382
9194;18.01.2017;'02 - 03;35,09;35,15;-0,06;0;0;0;4853;6130;1277
9195;18.01.2017;'03 - 04;35,07;34,79;0,28;0;0;0;4924;6227;1303
9196;18.01.2017;'04 - 05;35,07;37,55;-2,48;0;0;0;4991;6296;1305
9197;18.01.2017;'05 - 06;36,62;36,54;0,08;0;0;0;5087;6404;1317
9198;18.01.2017;'06 - 07;55,08;45,19;9,89;0;0;0;5195;6425;1230
9199;18.01.2017;'07 - 08;89,64;76,71;12,93;1;0;-1;5259;6309;1050
9200;18.01.2017;'08 - 09;91,75;73,85;17,9;194;155;-39;5268;6482;1214
9201;18.01.2017;'09 - 10;84,92;69,77;15,15;1190;1194;4;5254;6318;1064
9202;18.01.2017;'10 - 11;82,93;66,28;16,65;2588;2654;66;5189;5969;780
9203;18.01.2017;'11 - 12;85,97;68,29;17,68;3701;3883;182;5034;5777;743
9204;18.01.2017;'12 - 13;86,03;68,75;17,28;4172;4570;398;4866;5324;458
9205;18.01.2017;'13 - 14;91,02;70,2;20,82;3835;4563;728;4785;5274;489
9206;18.01.2017;'14 - 15;89,92;69,07;20,85;2878;3534;656;4838;5232;394
9207;18.01.2017;'15 - 16;86,7;74,3;12,4;1499;1818;319;4943;5164;221
9208;18.01.2017;'16 - 17;92,45;80,65;11,8;280;334;54;5179;5248;69
9209;18.01.2017;'17 - 18;115,7;91,91;23,79;2;4;2;5557;5741;184
9210;18.01.2017;'18 - 19;91,25;81,67;9,58;0;0;0;5961;6331;370
9211;18.01.2017;'19 - 20;83,91;75,36;8,55;0;0;0;6211;6805;594
9212;18.01.2017;'20 - 21;79,73;60,07;19,66;0;0;0;6220;6876;656
9213;18.01.2017;'21 - 22;55,03;45,71;9,32;0;0;0;6119;7151;1032
9214;18.01.2017;'22 - 23;48,86;43,9;4,96;0;0;0;6010;7166;1156
9215;18.01.2017;'23 - 24;44,9;38,48;6,42;0;0;0;5964;7226;1262
9216;19.01.2017;'00 - 01;38,53;34,08;4,45;0;0;0;6174;6964;790
9217;19.01.2017;'01 - 02;37,88;36,86;1,02;0;0;0;6033;6479;446
9218;19.01.2017;'02 - 03;36,61;36,56;0,05;0;0;0;5923;6108;185
9219;19.01.2017;'03 - 04;36,32;37,56;-1,24;0;0;0;5794;5939;145
9220;19.01.2017;'04 - 05;36,45;37,67;-1,22;0;0;0;5722;6207;485
9221;19.01.2017;'05 - 06;38,67;37,95;0,72;0;0;0;5712;6648;936
9222;19.01.2017;'06 - 07;50,04;47,46;2,58;0;0;0;5696;6250;554
9223;19.01.2017;'07 - 08;82,9;76,87;6,03;1;0;-1;5621;6185;564
9224;19.01.2017;'08 - 09;89,95;86,94;3,01;312;304;-8;5492;6001;509
9225;19.01.2017;'09 - 10;82,14;76,75;5,39;1677;2034;357;5325;5457;132
9226;19.01.2017;'10 - 11;80;77,91;2,09;3408;4429;1021;5093;4848;-245
9227;19.01.2017;'11 - 12;79,92;73,83;6,09;4658;6435;1777;4789;4085;-704
9228;19.01.2017;'12 - 13;79,97;70,53;9,44;5112;7680;2568;4486;3715;-771
9229;19.01.2017;'13 - 14;79,92;63,98;15,94;4711;7580;2869;4241;3316;-925
9230;19.01.2017;'14 - 15;73,95;63,25;10,7;3578;6015;2437;4131;3070;-1061
9231;19.01.2017;'15 - 16;73,91;73,76;0,15;1940;3151;1211;4115;3101;-1014
9232;19.01.2017;'16 - 17;74,62;82,21;-7,59;390;557;167;4272;3566;-706
9233;19.01.2017;'17 - 18;100,1;96,14;3,96;3;6;3;4604;4442;-162
9234;19.01.2017;'18 - 19;114,92;97,14;17,78;0;0;0;4922;4997;75
9235;19.01.2017;'19 - 20;90,75;80,09;10,66;0;0;0;5075;5124;49
9236;19.01.2017;'20 - 21;74,99;65,45;9,54;0;0;0;5059;5240;181
9237;19.01.2017;'21 - 22;56,17;46,54;9,63;0;0;0;5041;5132;91
9238;19.01.2017;'22 - 23;50,05;46,27;3,78;0;0;0;5023;4896;-127
9239;19.01.2017;'23 - 24;45,83;45,27;0,56;0;0;0;4992;4630;-362
9240;20.01.2017;'00 - 01;45,09;48,41;-3,32;0;0;0;5725;5836;111
9241;20.01.2017;'01 - 02;39,51;40,8;-1,29;0;0;0;5604;5440;-164
9242;20.01.2017;'02 - 03;38,03;42,05;-4,02;0;0;0;5509;5336;-173
9243;20.01.2017;'03 - 04;36,85;42,47;-5,62;0;0;0;5400;5396;-4
9244;20.01.2017;'04 - 05;38,06;41,38;-3,32;0;0;0;5278;5420;142
9245;20.01.2017;'05 - 06;38,73;40,05;-1,32;0;0;0;5128;5300;172
9246;20.01.2017;'06 - 07;55,63;48,88;6,75;0;0;0;4935;5184;249
9247;20.01.2017;'07 - 08;69,99;68,21;1,78;3;0;-3;4758;5189;431
9248;20.01.2017;'08 - 09;87,42;76,73;10,69;368;423;55;4552;5098;546
9249;20.01.2017;'09 - 10;87,61;74,79;12,82;1922;2476;554;4315;4854;539
9250;20.01.2017;'10 - 11;79,86;68,69;11,17;3740;5059;1319;3933;4211;278
9251;20.01.2017;'11 - 12;77,84;62,46;15,38;5106;6922;1816;3489;3562;73
9252;20.01.2017;'12 - 13;70,44;52,59;17,85;5677;7790;2113;3202;3127;-75
9253;20.01.2017;'13 - 14;72,8;53,31;19,49;5263;7460;2197;3045;3094;49
9254;20.01.2017;'14 - 15;65,93;51,95;13,98;3979;5805;1826;3062;3246;184
9255;20.01.2017;'15 - 16;72,93;54,24;18,69;2125;3116;991;3204;3402;198
9256;20.01.2017;'16 - 17;77,34;62,3;15,04;439;576;137;3494;3765;271
9257;20.01.2017;'17 - 18;90,07;70;20,07;4;6;2;3871;4384;513
9258;20.01.2017;'18 - 19;87,95;68,64;19,31;0;0;0;4177;4757;580
9259;20.01.2017;'19 - 20;76,94;60,78;16,16;0;0;0;4269;4984;715
9260;20.01.2017;'20 - 21;62,98;44,78;18,2;0;0;0;4132;5029;897
9261;20.01.2017;'21 - 22;47,1;39,71;7,39;0;0;0;3961;4893;932
9262;20.01.2017;'22 - 23;45,02;40,35;4,67;0;0;0;3804;4714;910
9263;20.01.2017;'23 - 24;45,09;39,03;6,06;0;0;0;3668;4604;936
9264;21.01.2017;'00 - 01;45,9;40,01;5,89;0;0;0;3811;4394;583
9265;21.01.2017;'01 - 02;39,34;38,81;0,53;0;0;0;3520;4169;649
9266;21.01.2017;'02 - 03;40,99;39,34;1,65;0;0;0;3306;3926;620
9267;21.01.2017;'03 - 04;44,04;40,78;3,26;0;0;0;3102;3713;611
9268;21.01.2017;'04 - 05;43,07;40,36;2,71;0;0;0;2943;3551;608
9269;21.01.2017;'05 - 06;41,56;38,5;3,06;0;0;0;2778;3520;742
9270;21.01.2017;'06 - 07;40,62;35,05;5,57;0;0;0;2619;3524;905
9271;21.01.2017;'07 - 08;43,93;36,29;7,64;5;0;-5;2530;3482;952
9272;21.01.2017;'08 - 09;50,99;43,23;7,76;534;391;-143;2497;3400;903
9273;21.01.2017;'09 - 10;54,98;46,23;8,75;2531;2521;-10;2418;3080;662
9274;21.01.2017;'10 - 11;53,05;47,11;5,94;4838;5489;651;2111;2624;513
9275;21.01.2017;'11 - 12;48,34;42,09;6,25;6509;7915;1406;1641;2008;367
9276;21.01.2017;'12 - 13;45,89;38,42;7,47;7204;9137;1933;1269;1473;204
9277;21.01.2017;'13 - 14;43,3;36,45;6,85;6765;8866;2101;1065;1136;71
9278;21.01.2017;'14 - 15;44;35,57;8,43;5151;6894;1743;1093;1055;-38
9279;21.01.2017;'15 - 16;47,56;37,46;10,1;2777;3601;824;1229;1247;18
9280;21.01.2017;'16 - 17;61,94;47,05;14,89;605;650;45;1562;1715;153
9281;21.01.2017;'17 - 18;65,91;49,59;16,32;7;13;6;2135;2736;601
9282;21.01.2017;'18 - 19;65,01;46,89;18,12;0;0;0;2738;3889;1151
9283;21.01.2017;'19 - 20;62,92;43,7;19,22;0;0;0;3199;4656;1457
9284;21.01.2017;'20 - 21;47,01;37,6;9,41;0;0;0;3415;4936;1521
9285;21.01.2017;'21 - 22;44,03;36,78;7,25;0;0;0;3563;5104;1541
9286;21.01.2017;'22 - 23;44,33;40,78;3,55;0;0;0;3629;4912;1283
9287;21.01.2017;'23 - 24;39,54;37,95;1,59;0;0;0;3562;4593;1031
9288;22.01.2017;'00 - 01;38,6;37,26;1,34;0;0;0;3871;4444;573
9289;22.01.2017;'01 - 02;38,22;36,34;1,88;0;0;0;3541;4298;757
9290;22.01.2017;'02 - 03;38,6;39,58;-0,98;0;0;0;3346;3994;648
9291;22.01.2017;'03 - 04;37,43;38,29;-0,86;0;0;0;3184;4013;829
9292;22.01.2017;'04 - 05;38,27;38,82;-0,55;0;0;0;3160;4008;848
9293;22.01.2017;'05 - 06;37,83;38,45;-0,62;0;0;0;3143;3817;674
9294;22.01.2017;'06 - 07;35,97;33,43;2,54;0;0;0;3100;3766;666
9295;22.01.2017;'07 - 08;39,24;40,06;-0,82;6;0;-6;3016;3685;669
9296;22.01.2017;'08 - 09;37,76;41,97;-4,21;590;461;-129;2809;3488;679
9297;22.01.2017;'09 - 10;39,26;45,83;-6,57;2916;2702;-214;2485;2950;465
9298;22.01.2017;'10 - 11;38,03;44,12;-6,09;5706;5835;129;1972;2168;196
9299;22.01.2017;'11 - 12;38,16;43,48;-5,32;7787;8241;454;1387;1334;-53
9300;22.01.2017;'12 - 13;37,07;39,58;-2,51;8609;9516;907;930;777;-153
9301;22.01.2017;'13 - 14;36,03;36,38;-0,35;8104;9210;1106;719;548;-171
9302;22.01.2017;'14 - 15;37,32;35,93;1,39;6217;7064;847;756;490;-266
9303;22.01.2017;'15 - 16;38,29;36,63;1,66;3269;3677;408;921;544;-377
9304;22.01.2017;'16 - 17;44,06;46,43;-2,37;691;664;-27;1223;767;-456
9305;22.01.2017;'17 - 18;61,92;57,88;4,04;11;16;5;1629;1133;-496
9306;22.01.2017;'18 - 19;57,72;59,55;-1,83;0;0;0;1990;1350;-640
9307;22.01.2017;'19 - 20;57,38;60,76;-3,38;0;0;0;2200;1388;-812
9308;22.01.2017;'20 - 21;46;53,53;-7,53;0;0;0;2256;1398;-858
9309;22.01.2017;'21 - 22;39,39;48,8;-9,41;0;0;0;2239;1422;-817
9310;22.01.2017;'22 - 23;44,05;58,12;-14,07;0;0;0;2211;1302;-909
9311;22.01.2017;'23 - 24;35,93;42,18;-6,25;0;0;0;2252;1144;-1108
9312;23.01.2017;'00 - 01;39,1;46,92;-7,82;0;0;0;1920;990;-930
9313;23.01.2017;'01 - 02;38,28;45,05;-6,77;0;0;0;2059;931;-1128
9314;23.01.2017;'02 - 03;39,43;42,8;-3,37;0;0;0;2177;1331;-846
9315;23.01.2017;'03 - 04;37,29;39,75;-2,46;0;0;0;2287;1538;-749
9316;23.01.2017;'04 - 05;36,65;39,04;-2,39;0;0;0;2401;1560;-841
9317;23.01.2017;'05 - 06;44,84;43,92;0,92;0;0;0;2502;1504;-998
9318;23.01.2017;'06 - 07;69,97;72,39;-2,42;0;0;0;2656;1464;-1192
9319;23.01.2017;'07 - 08;98,45;100,68;-2,23;8;1;-7;2764;1671;-1093
9320;23.01.2017;'08 - 09;95,83;129,97;-34,14;545;435;-110;2907;1858;-1049
9321;23.01.2017;'09 - 10;99,99;135,87;-35,88;2409;2033;-376;3169;1899;-1270
9322;23.01.2017;'10 - 11;99,36;148,95;-49,59;4513;4004;-509;3326;1932;-1394
9323;23.01.2017;'11 - 12;87,42;193,5;-106,08;5963;5496;-467;3302;1678;-1624
9324;23.01.2017;'12 - 13;83,43;167,57;-84,14;6446;6164;-282;3235;1674;-1561
9325;23.01.2017;'13 - 14;81,81;159,48;-77,67;5973;5762;-211;3270;1696;-1574
9326;23.01.2017;'14 - 15;85,1;147,52;-62,42;4478;4357;-121;3346;1532;-1814
9327;23.01.2017;'15 - 16;82,84;154,46;-71,62;2325;2230;-95;3485;1545;-1940
9328;23.01.2017;'16 - 17;91,14;156,53;-65,39;515;444;-71;3724;1593;-2131
9329;23.01.2017;'17 - 18;109,98;186,6;-76,62;8;13;5;3997;1728;-2269
9330;23.01.2017;'18 - 19;128,4;189,45;-61,05;0;0;0;4302;1902;-2400
9331;23.01.2017;'19 - 20;103,87;170,9;-67,03;0;0;0;4445;2135;-2310
9332;23.01.2017;'20 - 21;84,55;104,8;-20,25;0;0;0;4410;2097;-2313
9333;23.01.2017;'21 - 22;69,4;88,92;-19,52;0;0;0;4401;1971;-2430
9334;23.01.2017;'22 - 23;65,06;89,21;-24,15;0;0;0;4366;1702;-2664
9335;23.01.2017;'23 - 24;43,08;78,51;-35,43;0;0;0;4329;1490;-2839
9336;24.01.2017;'00 - 01;57,01;50,84;6,17;0;0;0;2014;1279;-735
9337;24.01.2017;'01 - 02;51,04;49,36;1,68;0;0;0;1821;1086;-735
9338;24.01.2017;'02 - 03;53,05;48,01;5,04;0;0;0;1646;945;-701
9339;24.01.2017;'03 - 04;48,82;44,48;4,34;0;0;0;1451;975;-476
9340;24.01.2017;'04 - 05;51,52;44,94;6,58;0;0;0;1322;912;-410
9341;24.01.2017;'05 - 06;56,06;49,38;6,68;0;0;0;1277;898;-379
9342;24.01.2017;'06 - 07;91,21;76,39;14,82;0;0;0;1269;858;-411
9343;24.01.2017;'07 - 08;163,52;138,34;25,18;4;0;-4;1259;778;-481
9344;24.01.2017;'08 - 09;153,67;128,47;25,2;331;157;-174;1251;671;-580
9345;24.01.2017;'09 - 10;150,1;125,45;24,65;1453;724;-729;1240;718;-522
9346;24.01.2017;'10 - 11;151,07;139,51;11,56;2764;1436;-1328;1180;798;-382
9347;24.01.2017;'11 - 12;135;152,95;-17,95;3767;2002;-1765;1084;953;-131
9348;24.01.2017;'12 - 13;121,58;141,74;-20,16;4198;2067;-2131;1052;1024;-28
9349;24.01.2017;'13 - 14;117,68;136,47;-18,79;3948;1834;-2114;1117;1202;85
9350;24.01.2017;'14 - 15;112,21;134,15;-21,94;3035;1323;-1712;1264;1277;13
9351;24.01.2017;'15 - 16;117,18;140,28;-23,1;1645;636;-1009;1430;1442;12
9352;24.01.2017;'16 - 17;120;137,11;-17,11;353;113;-240;1607;1547;-60
9353;24.01.2017;'17 - 18;131,01;153,83;-22,82;9;8;-1;1814;1476;-338
9354;24.01.2017;'18 - 19;138,91;161,49;-22,58;0;0;0;2032;1526;-506
9355;24.01.2017;'19 - 20;113,8;161,97;-48,17;0;0;0;2204;1688;-516
9356;24.01.2017;'20 - 21;109,92;110,12;-0,2;0;0;0;2317;1813;-504
9357;24.01.2017;'21 - 22;78,98;72,63;6,35;0;0;0;2468;1929;-539
9358;24.01.2017;'22 - 23;66,17;67,66;-1,49;0;0;0;2601;2100;-501
9359;24.01.2017;'23 - 24;56,61;56,69;-0,08;0;0;0;2715;2330;-385
9360;25.01.2017;'00 - 01;54,69;58,3;-3,61;0;0;0;2688;2429;-259
9361;25.01.2017;'01 - 02;46,58;49,17;-2,59;0;0;0;2720;2464;-256
9362;25.01.2017;'02 - 03;42,39;47,67;-5,28;0;0;0;2779;2252;-527
9363;25.01.2017;'03 - 04;40,94;44,46;-3,52;0;0;0;2774;1954;-820
9364;25.01.2017;'04 - 05;43,25;45,64;-2,39;0;0;0;2733;1812;-921
9365;25.01.2017;'05 - 06;48,03;59,84;-11,81;0;0;0;2640;1626;-1014
9366;25.01.2017;'06 - 07;67,35;74,49;-7,14;0;0;0;2542;1530;-1012
9367;25.01.2017;'07 - 08;100,24;126,12;-25,88;7;1;-6;2457;1510;-947
9368;25.01.2017;'08 - 09;105,04;147,68;-42,64;380;174;-206;2410;1692;-718
9369;25.01.2017;'09 - 10;109,63;145,67;-36,04;1738;942;-796;2434;1971;-463
9370;25.01.2017;'10 - 11;109,93;143,64;-33,71;3405;1966;-1439;2470;2242;-228
9371;25.01.2017;'11 - 12;119,98;138,09;-18,11;4680;2908;-1772;2443;2495;52
9372;25.01.2017;'12 - 13;114,1;130,59;-16,49;5250;3469;-1781;2351;2688;337
9373;25.01.2017;'13 - 14;101,63;122,66;-21,03;4996;3517;-1479;2278;2741;463
9374;25.01.2017;'14 - 15;107,75;119,98;-12,23;3882;2837;-1045;2252;2661;409
9375;25.01.2017;'15 - 16;111,65;129,14;-17,49;2143;1556;-587;2238;2537;299
9376;25.01.2017;'16 - 17;119,63;138,6;-18,97;509;337;-172;2429;2582;153
9377;25.01.2017;'17 - 18;122,9;161,01;-38,11;9;13;4;2923;2828;-95
9378;25.01.2017;'18 - 19;133,18;156,73;-23,55;0;0;0;3548;3171;-377
9379;25.01.2017;'19 - 20;109,96;158,1;-48,14;0;0;0;4077;3679;-398
9380;25.01.2017;'20 - 21;89,96;96,19;-6,23;0;0;0;4486;4250;-236
9381;25.01.2017;'21 - 22;62,34;61,75;0,59;0;0;0;4843;4866;23
9382;25.01.2017;'22 - 23;57,8;55,48;2,32;0;0;0;5188;5243;55
9383;25.01.2017;'23 - 24;45,23;46,03;-0,8;0;0;0;5523;5824;301
9384;26.01.2017;'00 - 01;43,85;43,13;0,72;0;0;0;6438;6154;-284
9385;26.01.2017;'01 - 02;42,06;45,41;-3,35;0;0;0;6731;6468;-263
9386;26.01.2017;'02 - 03;40,02;44,79;-4,77;0;0;0;7051;6741;-310
9387;26.01.2017;'03 - 04;37,85;41,36;-3,51;0;0;0;7346;6966;-380
9388;26.01.2017;'04 - 05;38,23;38,42;-0,19;0;0;0;7675;7094;-581
9389;26.01.2017;'05 - 06;41,1;41,93;-0,83;0;0;0;8093;7082;-1011
9390;26.01.2017;'06 - 07;44,28;45,52;-1,24;0;0;0;8484;7152;-1332
9391;26.01.2017;'07 - 08;58,51;61,02;-2,51;6;2;-4;8884;7512;-1372
9392;26.01.2017;'08 - 09;65,05;63,31;1,74;515;463;-52;9188;7916;-1272
9393;26.01.2017;'09 - 10;60,94;63,05;-2,11;2344;2854;510;9409;8001;-1408
9394;26.01.2017;'10 - 11;58,13;60,4;-2,27;4549;6392;1843;9400;7941;-1459
9395;26.01.2017;'11 - 12;59,61;52,16;7,45;6346;9568;3222;8870;8436;-434
9396;26.01.2017;'12 - 13;59,45;44,35;15,1;7318;11205;3887;8299;9202;903
9397;26.01.2017;'13 - 14;53,51;40,18;13,33;7142;10967;3825;8102;9436;1334
9398;26.01.2017;'14 - 15;57,5;40,13;17,37;5718;8876;3158;8177;9362;1185
9399;26.01.2017;'15 - 16;54,97;41,43;13,54;3242;4990;1748;8917;9186;269
9400;26.01.2017;'16 - 17;55,72;51,66;4,06;767;1148;381;10410;9983;-427
9401;26.01.2017;'17 - 18;54,01;56,27;-2,26;7;22;15;12466;12211;-255
9402;26.01.2017;'18 - 19;53,35;53,61;-0,26;0;0;0;14348;13694;-654
9403;26.01.2017;'19 - 20;44,98;47,14;-2,16;0;0;0;15287;14104;-1183
9404;26.01.2017;'20 - 21;36,08;41,89;-5,81;0;0;0;15282;14035;-1247
9405;26.01.2017;'21 - 22;37,87;42,52;-4,65;0;0;0;14942;13528;-1414
9406;26.01.2017;'22 - 23;41,4;45,47;-4,07;0;0;0;14550;12944;-1606
9407;26.01.2017;'23 - 24;36,7;40,18;-3,48;0;0;0;14297;13082;-1215
9408;27.01.2017;'00 - 01;35,08;40,05;-4,97;0;0;0;12990;13052;62
9409;27.01.2017;'01 - 02;34,31;39,85;-5,54;0;0;0;13019;12831;-188
9410;27.01.2017;'02 - 03;34,05;39,66;-5,61;0;0;0;13276;13059;-217
9411;27.01.2017;'03 - 04;33,97;37,76;-3,79;0;0;0;13540;13584;44
9412;27.01.2017;'04 - 05;34,03;33,13;0,9;0;0;0;13720;14277;557
9413;27.01.2017;'05 - 06;34,06;30,38;3,68;0;0;0;13941;15187;1246
9414;27.01.2017;'06 - 07;35,8;29,33;6,47;0;0;0;14173;15672;1499
9415;27.01.2017;'07 - 08;46,39;42,84;3,55;10;3;-7;14229;16000;1771
9416;27.01.2017;'08 - 09;47,4;50,41;-3,01;836;1106;270;13935;15222;1287
9417;27.01.2017;'09 - 10;45,04;42,82;2,22;3531;4775;1244;13073;13977;904
9418;27.01.2017;'10 - 11;43,47;39,5;3,97;6339;9120;2781;11435;11712;277
9419;27.01.2017;'11 - 12;44,14;37,11;7,03;8350;12169;3819;9334;9381;47
9420;27.01.2017;'12 - 13;44,36;35,34;9,02;9196;13292;4096;7437;7904;467
9421;27.01.2017;'13 - 14;45,18;35,29;9,89;8677;12349;3672;6303;6932;629
9422;27.01.2017;'14 - 15;48,46;37,36;11,1;6785;9464;2679;6082;6458;376
9423;27.01.2017;'15 - 16;52,92;42,37;10,55;3852;5212;1360;6569;6402;-167
9424;27.01.2017;'16 - 17;55,25;44,8;10,45;936;1111;175;7768;7044;-724
9425;27.01.2017;'17 - 18;60,36;53,98;6,38;10;24;14;9300;8114;-1186
9426;27.01.2017;'18 - 19;56,59;52,98;3,61;0;0;0;10344;8781;-1563
9427;27.01.2017;'19 - 20;54,61;54,74;-0,13;0;0;0;10704;8829;-1875
9428;27.01.2017;'20 - 21;47,65;53,38;-5,73;0;0;0;10526;9139;-1387
9429;27.01.2017;'21 - 22;39,9;42,81;-2,91;0;0;0;10098;8774;-1324
9430;27.01.2017;'22 - 23;39,9;42,29;-2,39;0;0;0;9656;8372;-1284
9431;27.01.2017;'23 - 24;38,03;42,38;-4,35;0;0;0;9324;8281;-1043
9432;28.01.2017;'00 - 01;39,67;44,65;-4,98;0;0;0;10284;8338;-1946
9433;28.01.2017;'01 - 02;40;45,24;-5,24;0;0;0;10067;7690;-2377
9434;28.01.2017;'02 - 03;36;42,98;-6,98;0;0;0;10035;7684;-2351
9435;28.01.2017;'03 - 04;39;42,31;-3,31;0;0;0;10069;8064;-2005
9436;28.01.2017;'04 - 05;37,39;40,96;-3,57;0;0;0;10235;8533;-1702
9437;28.01.2017;'05 - 06;37,78;40,13;-2,35;0;0;0;10569;8978;-1591
9438;28.01.2017;'06 - 07;37,38;48,88;-11,5;0;0;0;10904;9534;-1370
9439;28.01.2017;'07 - 08;39,65;50,32;-10,67;12;4;-8;10996;9648;-1348
9440;28.01.2017;'08 - 09;47,34;55,92;-8,58;1138;905;-233;10793;9329;-1464
9441;28.01.2017;'09 - 10;44,9;58,94;-14,04;4466;4236;-230;10215;8627;-1588
9442;28.01.2017;'10 - 11;40,09;57,07;-16,98;7840;8391;551;8776;7092;-1684
9443;28.01.2017;'11 - 12;43,6;50,3;-6,7;10219;11621;1402;6773;5701;-1072
9444;28.01.2017;'12 - 13;38,4;42,89;-4,49;11048;12875;1827;5426;4967;-459
9445;28.01.2017;'13 - 14;37,74;41,24;-3,5;10276;12275;1999;4909;4730;-179
9446;28.01.2017;'14 - 15;41,01;40,31;0,7;7895;9407;1512;5071;4806;-265
9447;28.01.2017;'15 - 16;49,92;46,06;3,86;4373;5070;697;5762;5141;-621
9448;28.01.2017;'16 - 17;54,15;52,15;2;1049;1152;103;7113;6228;-885
9449;28.01.2017;'17 - 18;60,59;63,13;-2,54;11;28;17;8857;8458;-399
9450;28.01.2017;'18 - 19;55,2;59,58;-4,38;0;0;0;10578;10245;-333
9451;28.01.2017;'19 - 20;48,08;52,67;-4,59;0;0;0;11787;10858;-929
9452;28.01.2017;'20 - 21;40,57;47,66;-7,09;0;0;0;12454;11538;-916
9453;28.01.2017;'21 - 22;38;42,29;-4,29;0;0;0;13098;12182;-916
9454;28.01.2017;'22 - 23;37,2;42,14;-4,94;0;0;0;13703;12616;-1087
9455;28.01.2017;'23 - 24;33,74;41,05;-7,31;0;0;0;14020;13046;-974
9456;29.01.2017;'00 - 01;36,04;44,42;-8,38;0;0;0;12806;13132;326
9457;29.01.2017;'01 - 02;32,95;38,89;-5,94;0;0;0;13122;13424;302
9458;29.01.2017;'02 - 03;32,94;37,08;-4,14;0;0;0;13264;13890;626
9459;29.01.2017;'03 - 04;31,75;35,06;-3,31;0;0;0;13412;14306;894
9460;29.01.2017;'04 - 05;34,65;38,84;-4,19;0;0;0;13633;14021;388
9461;29.01.2017;'05 - 06;32,89;37,68;-4,79;0;0;0;13875;14363;488
9462;29.01.2017;'06 - 07;32,96;36,29;-3,33;0;0;0;14167;14139;-28
9463;29.01.2017;'07 - 08;35,01;40,56;-5,55;13;2;-11;14421;13784;-637
9464;29.01.2017;'08 - 09;35;40,47;-5,47;806;859;53;14499;13732;-767
9465;29.01.2017;'09 - 10;33,05;38,37;-5,32;2917;3789;872;14343;13642;-701
9466;29.01.2017;'10 - 11;33,07;34,55;-1,48;5257;7206;1949;13928;13592;-336
9467;29.01.2017;'11 - 12;33,07;32,03;1,04;7251;9464;2213;13547;13386;-161
9468;29.01.2017;'12 - 13;33,04;32,9;0,14;8139;10321;2182;13296;13370;74
9469;29.01.2017;'13 - 14;32,91;29,75;3,16;7864;9576;1712;12953;13022;69
9470;29.01.2017;'14 - 15;34,64;30,85;3,79;6196;7401;1205;12460;12552;92
9471;29.01.2017;'15 - 16;37,05;34,01;3,04;3449;4173;724;12060;12163;103
9472;29.01.2017;'16 - 17;45,58;38,36;7,22;862;1037;175;12004;11868;-136
9473;29.01.2017;'17 - 18;53,93;49,99;3,94;11;26;15;12437;11571;-866
9474;29.01.2017;'18 - 19;55,25;56,1;-0,85;0;0;0;13037;11604;-1433
9475;29.01.2017;'19 - 20;50,58;56,37;-5,79;0;0;0;13418;11922;-1496
9476;29.01.2017;'20 - 21;39,84;45,97;-6,13;0;0;0;13359;11576;-1783
9477;29.01.2017;'21 - 22;37,08;43,3;-6,22;0;0;0;13102;11682;-1420
9478;29.01.2017;'22 - 23;44,21;44,77;-0,56;0;0;0;12700;10988;-1712
9479;29.01.2017;'23 - 24;36,09;41,6;-5,51;0;0;0;12116;10362;-1754
9480;30.01.2017;'00 - 01;36,51;40,67;-4,16;0;0;0;10949;9993;-956
9481;30.01.2017;'01 - 02;36,49;38,3;-1,81;0;0;0;10486;10057;-429
9482;30.01.2017;'02 - 03;36,62;38,7;-2,08;0;0;0;10309;10242;-67
9483;30.01.2017;'03 - 04;36,05;37,62;-1,57;0;0;0;10265;10290;25
9484;30.01.2017;'04 - 05;35,11;35,19;-0,08;0;0;0;10352;10494;142
9485;30.01.2017;'05 - 06;36,68;37,13;-0,45;0;0;0;10667;11138;471
9486;30.01.2017;'06 - 07;47,14;43,16;3,98;0;0;0;11158;12628;1470
9487;30.01.2017;'07 - 08;59,13;47,05;12,08;9;2;-7;11662;13835;2173
9488;30.01.2017;'08 - 09;65,06;49,07;15,99;450;570;120;12016;14174;2158
9489;30.01.2017;'09 - 10;65,02;48,41;16,61;1478;1856;378;12291;14410;2119
9490;30.01.2017;'10 - 11;68,77;51,02;17,75;2467;3149;682;12315;13801;1486
9491;30.01.2017;'11 - 12;69,91;52,58;17,33;3040;3685;645;12075;13862;1787
9492;30.01.2017;'12 - 13;60,16;52,89;7,27;3002;3355;353;11835;14678;2843
9493;30.01.2017;'13 - 14;63,72;53,22;10,5;2538;2675;137;11669;15283;3614
9494;30.01.2017;'14 - 15;61,32;49,14;12,18;1782;1973;191;11762;15745;3983
9495;30.01.2017;'15 - 16;55,98;48,23;7,75;906;1062;156;12015;16234;4219
9496;30.01.2017;'16 - 17;55,94;51,44;4,5;236;240;4;12307;16566;4259
9497;30.01.2017;'17 - 18;68,48;55,23;13,25;3;10;7;12539;17172;4633
9498;30.01.2017;'18 - 19;59,98;54,36;5,62;0;0;0;12740;17186;4446
9499;30.01.2017;'19 - 20;56;47,85;8,15;0;0;0;12747;17143;4396
9500;30.01.2017;'20 - 21;47,87;39,35;8,52;0;0;0;12464;16601;4137
9501;30.01.2017;'21 - 22;41,93;36,31;5,62;0;0;0;12100;15840;3740
9502;30.01.2017;'22 - 23;45,6;37,79;7,81;0;0;0;11637;14722;3085
9503;30.01.2017;'23 - 24;36,59;35,18;1,41;0;0;0;11036;13605;2569
9504;31.01.2017;'00 - 01;33,06;41,72;-8,66;0;0;0;13333;12586;-747
9505;31.01.2017;'01 - 02;34,38;36,84;-2,46;0;0;0;12270;11589;-681
9506;31.01.2017;'02 - 03;34,38;41,04;-6,66;0;0;0;11324;10843;-481
9507;31.01.2017;'03 - 04;35,57;39,4;-3,83;0;0;0;10337;10022;-315
9508;31.01.2017;'04 - 05;37,33;36,43;0,9;0;0;0;9315;9071;-244
9509;31.01.2017;'05 - 06;38,95;41,47;-2,52;0;0;0;8283;8410;127
9510;31.01.2017;'06 - 07;56,95;54,54;2,41;0;0;0;7370;7979;609
9511;31.01.2017;'07 - 08;81,62;78,32;3,3;5;1;-4;6583;7507;924
9512;31.01.2017;'08 - 09;81,82;93,7;-11,88;222;160;-62;5873;6872;999
9513;31.01.2017;'09 - 10;82,02;98,53;-16,51;907;666;-241;5233;5940;707
9514;31.01.2017;'10 - 11;89,8;102,21;-12,41;1705;1366;-339;4651;5290;639
9515;31.01.2017;'11 - 12;89,82;108,57;-18,75;2341;2036;-305;4124;4474;350
9516;31.01.2017;'12 - 13;82,36;105,8;-23,44;2627;2388;-239;3635;3628;-7
9517;31.01.2017;'13 - 14;82,02;114,54;-32,52;2532;2296;-236;3140;3047;-93
9518;31.01.2017;'14 - 15;90,36;124,58;-34,22;2050;1836;-214;2676;2655;-21
9519;31.01.2017;'15 - 16;89,75;148,7;-58,95;1209;1035;-174;2342;2566;224
9520;31.01.2017;'16 - 17;90,2;172,1;-81,9;342;264;-78;2218;2499;281
9521;31.01.2017;'17 - 18;95;200,43;-105,43;7;16;9;2300;2618;318
9522;31.01.2017;'18 - 19;104,33;174,54;-70,21;0;0;0;2464;2709;245
9523;31.01.2017;'19 - 20;90;131,55;-41,55;0;0;0;2560;2663;103
9524;31.01.2017;'20 - 21;84,15;92,88;-8,73;0;0;0;2611;2627;16
9525;31.01.2017;'21 - 22;60,92;63,04;-2,12;0;0;0;2692;2636;-56
9526;31.01.2017;'22 - 23;54,9;56,25;-1,35;0;0;0;2766;2850;84
9527;31.01.2017;'23 - 24;40,69;45,62;-4,93;0;0;0;2908;3221;313
9528;01.02.2017;'00 - 01;44,91;43,2;1,71;0;0;0;2633;3068;435
9529;01.02.2017;'01 - 02;42,25;41,8;0,45;0;0;0;2820;3160;340
9530;01.02.2017;'02 - 03;39,8;39,36;0,44;0;0;0;3076;3264;188
9531;01.02.2017;'03 - 04;38,15;38,18;-0,03;0;0;0;3374;3604;230
9532;01.02.2017;'04 - 05;38,38;38,99;-0,61;0;0;0;3734;3798;64
9533;01.02.2017;'05 - 06;41,09;41,46;-0,37;0;0;0;4231;4235;4
9534;01.02.2017;'06 - 07;47,86;48,46;-0,6;0;0;0;4916;5109;193
9535;01.02.2017;'07 - 08;65,96;62,39;3,57;11;2;-9;5788;6040;252
9536;01.02.2017;'08 - 09;72,93;60,41;12,52;472;266;-206;6734;7309;575
9537;01.02.2017;'09 - 10;65,91;57,68;8,23;2025;1256;-769;7587;8166;579
9538;01.02.2017;'10 - 11;65,02;57,41;7,61;3898;2637;-1261;8180;8892;712
9539;01.02.2017;'11 - 12;62,91;53,59;9,32;5419;3956;-1463;8462;9112;650
9540;01.02.2017;'12 - 13;56,99;53,69;3,3;6084;4805;-1279;8686;9081;395
9541;01.02.2017;'13 - 14;54,18;47,17;7,01;5731;4616;-1115;8945;8742;-203
9542;01.02.2017;'14 - 15;50,49;41,79;8,7;4539;3676;-863;9393;9065;-328
9543;01.02.2017;'15 - 16;52,35;42,67;9,68;2680;2070;-610;9967;9809;-158
9544;01.02.2017;'16 - 17;57;41,69;15,31;750;507;-243;10866;10970;104
9545;01.02.2017;'17 - 18;62,58;50,59;11,99;12;26;14;12223;12494;271
9546;01.02.2017;'18 - 19;56,99;48,94;8,05;0;0;0;13587;13696;109
9547;01.02.2017;'19 - 20;49,74;40,38;9,36;0;0;0;14361;14638;277
9548;01.02.2017;'20 - 21;41,04;36,8;4,24;0;0;0;14348;14778;430
9549;01.02.2017;'21 - 22;44,2;34,24;9,96;0;0;0;14053;14818;765
9550;01.02.2017;'22 - 23;42,38;36,52;5,86;0;0;0;13585;14113;528
9551;01.02.2017;'23 - 24;38,06;35,73;2,33;0;0;0;12984;13638;654
9552;02.02.2017;'00 - 01;31,05;38,63;-7,58;0;0;0;13493;12765;-728
9553;02.02.2017;'01 - 02;29,8;36,44;-6,64;0;0;0;12926;12215;-711
9554;02.02.2017;'02 - 03;32,66;41,17;-8,51;0;0;0;12449;11960;-489
9555;02.02.2017;'03 - 04;32,3;32,01;0,29;0;0;0;12089;11425;-664
9556;02.02.2017;'04 - 05;31,05;30,39;0,66;0;0;0;11784;11246;-538
9557;02.02.2017;'05 - 06;32,66;31,46;1,2;0;0;0;11521;11236;-285
9558;02.02.2017;'06 - 07;39,91;36,77;3,14;0;0;0;11229;10991;-238
9559;02.02.2017;'07 - 08;55,58;49,74;5,84;19;6;-13;10893;10814;-79
9560;02.02.2017;'08 - 09;57,19;51,53;5,66;740;560;-180;10441;10441;0
9561;02.02.2017;'09 - 10;59,1;48,44;10,66;2737;2364;-373;9784;9678;-106
9562;02.02.2017;'10 - 11;58,55;45,76;12,79;4970;4958;-12;8936;8437;-499
9563;02.02.2017;'11 - 12;57,66;43,87;13,79;6817;7616;799;7982;7572;-410
9564;02.02.2017;'12 - 13;57,66;43,03;14,63;7714;8858;1144;7231;6536;-695
9565;02.02.2017;'13 - 14;54,44;42,96;11,48;7406;8063;657;7016;6200;-816
9566;02.02.2017;'14 - 15;50,9;43,62;7,28;6002;5716;-286;7599;6610;-989
9567;02.02.2017;'15 - 16;47,1;45,3;1,8;3708;3133;-575;8750;7802;-948
9568;02.02.2017;'16 - 17;45,98;48,77;-2,79;1136;902;-234;10488;9616;-872
9569;02.02.2017;'17 - 18;48,8;51,7;-2,9;25;43;18;12433;11981;-452
9570;02.02.2017;'18 - 19;53,3;54,04;-0,74;0;0;0;14121;13535;-586
9571;02.02.2017;'19 - 20;48,84;53,54;-4,7;0;0;0;15092;13944;-1148
9572;02.02.2017;'20 - 21;39,97;51,27;-11,3;0;0;0;15194;13691;-1503
9573;02.02.2017;'21 - 22;39,04;50,83;-11,79;0;0;0;15030;13267;-1763
9574;02.02.2017;'22 - 23;38,78;49,81;-11,03;0;0;0;14867;12350;-2517
9575;02.02.2017;'23 - 24;34,82;45,22;-10,4;0;0;0;14810;11812;-2998
9576;03.02.2017;'00 - 01;39,5;46,56;-7,06;0;0;0;13315;11032;-2283
9577;03.02.2017;'01 - 02;34,92;41,3;-6,38;0;0;0;12962;10496;-2466
9578;03.02.2017;'02 - 03;34,26;42,05;-7,79;0;0;0;12604;10128;-2476
9579;03.02.2017;'03 - 04;32,55;36;-3,45;0;0;0;12232;10015;-2217
9580;03.02.2017;'04 - 05;32,49;33,6;-1,11;0;0;0;11840;9824;-2016
9581;03.02.2017;'05 - 06;35,85;36,27;-0,42;0;0;0;11451;9200;-2251
9582;03.02.2017;'06 - 07;43,02;44,26;-1,24;0;0;0;11051;8469;-2582
9583;03.02.2017;'07 - 08;56,32;58,23;-1,91;19;10;-9;10559;8308;-2251
9584;03.02.2017;'08 - 09;60;62,02;-2,02;624;456;-168;9942;7879;-2063
9585;03.02.2017;'09 - 10;58;61,27;-3,27;2018;1605;-413;9218;7487;-1731
9586;03.02.2017;'10 - 11;56,67;60,41;-3,74;3341;2791;-550;8113;6668;-1445
9587;03.02.2017;'11 - 12;55,97;60,77;-4,8;4205;3785;-420;6739;5379;-1360
9588;03.02.2017;'12 - 13;54,37;60,89;-6,52;4443;4488;45;5610;4596;-1014
9589;03.02.2017;'13 - 14;53,67;58,66;-4,99;4097;4548;451;4814;4566;-248
9590;03.02.2017;'14 - 15;51,96;51,66;0,3;3209;3494;285;4433;4444;11
9591;03.02.2017;'15 - 16;48,47;46,27;2,2;1964;2152;188;4358;4135;-223
9592;03.02.2017;'16 - 17;53,33;48,73;4,6;613;844;231;4638;3944;-694
9593;03.02.2017;'17 - 18;60,36;57,43;2,93;19;50;31;5369;4408;-961
9594;03.02.2017;'18 - 19;55,79;53,66;2,13;0;0;0;6283;5647;-636
9595;03.02.2017;'19 - 20;59,29;50,17;9,12;0;0;0;7185;7240;55
9596;03.02.2017;'20 - 21;53,68;44,73;8,95;0;0;0;8038;8536;498
9597;03.02.2017;'21 - 22;44,9;41,07;3,83;0;0;0;8909;10015;1106
9598;03.02.2017;'22 - 23;44,25;40,06;4,19;0;0;0;9661;11293;1632
9599;03.02.2017;'23 - 24;36,08;34,04;2,04;0;0;0;10223;12460;2237
9600;04.02.2017;'00 - 01;37,04;40,33;-3,29;0;0;0;12570;12901;331
9601;04.02.2017;'01 - 02;34,96;33,99;0,97;0;0;0;13152;13401;249
9602;04.02.2017;'02 - 03;34,01;33,17;0,84;0;0;0;13505;14283;778
9603;04.02.2017;'03 - 04;31,93;28,98;2,95;0;0;0;13725;14553;828
9604;04.02.2017;'04 - 05;31,89;27,63;4,26;0;0;0;13595;14119;524
9605;04.02.2017;'05 - 06;32,09;30,37;1,72;0;0;0;13054;12866;-188
9606;04.02.2017;'06 - 07;33,82;33,22;0,6;0;0;0;12360;11191;-1169
9607;04.02.2017;'07 - 08;37,04;40,66;-3,62;27;18;-9;11582;10189;-1393
9608;04.02.2017;'08 - 09;42,32;48,64;-6,32;1022;1236;214;10706;10203;-503
9609;04.02.2017;'09 - 10;49,58;52,34;-2,76;4106;4531;425;9746;9519;-227
9610;04.02.2017;'10 - 11;51,97;49,24;2,73;7348;7667;319;8433;8104;-329
9611;04.02.2017;'11 - 12;50;44,39;5,61;9355;9496;141;6940;6193;-747
9612;04.02.2017;'12 - 13;50;45,65;4,35;9593;9182;-411;5788;5194;-594
9613;04.02.2017;'13 - 14;49,12;47,17;1,95;8402;7788;-614;5108;4363;-745
9614;04.02.2017;'14 - 15;47,22;48,04;-0,82;6282;5473;-809;5126;4032;-1094
9615;04.02.2017;'15 - 16;45,22;50,2;-4,98;3684;3009;-675;5595;4020;-1575
9616;04.02.2017;'16 - 17;46,26;51,36;-5,1;1083;821;-262;6699;4369;-2330
9617;04.02.2017;'17 - 18;56,37;60,85;-4,48;22;36;14;8483;5291;-3192
9618;04.02.2017;'18 - 19;66,18;68,74;-2,56;0;0;0;10170;5994;-4176
9619;04.02.2017;'19 - 20;61,61;62,84;-1,23;0;0;0;11088;7152;-3936
9620;04.02.2017;'20 - 21;55,49;55,13;0,36;0;0;0;11168;8309;-2859
9621;04.02.2017;'21 - 22;50;47,94;2,06;0;0;0;11125;9279;-1846
9622;04.02.2017;'22 - 23;50;48,3;1,7;0;0;0;11065;9631;-1434
9623;04.02.2017;'23 - 24;43,06;44,43;-1,37;0;0;0;11075;9833;-1242
9624;05.02.2017;'00 - 01;35,81;42,6;-6,79;0;0;0;11679;9365;-2314
9625;05.02.2017;'01 - 02;37,3;41,64;-4,34;0;0;0;11334;8666;-2668
9626;05.02.2017;'02 - 03;37,73;38,62;-0,89;0;0;0;10819;7798;-3021
9627;05.02.2017;'03 - 04;36,65;40,77;-4,12;0;0;0;10252;6889;-3363
9628;05.02.2017;'04 - 05;33,15;37;-3,85;0;0;0;9660;6206;-3454
9629;05.02.2017;'05 - 06;34,55;37,91;-3,36;0;0;0;9111;5433;-3678
9630;05.02.2017;'06 - 07;31,66;36,22;-4,56;0;0;0;8675;5484;-3191
9631;05.02.2017;'07 - 08;36,93;40,73;-3,8;46;30;-16;8143;5540;-2603
9632;05.02.2017;'08 - 09;37,52;38,97;-1,45;1347;1304;-43;7515;5784;-1731
9633;05.02.2017;'09 - 10;40,81;45,67;-4,86;3817;3940;123;6908;5619;-1289
9634;05.02.2017;'10 - 11;44,02;42,79;1,23;6138;6287;149;6155;5319;-836
9635;05.02.2017;'11 - 12;50,06;44,46;5,6;7735;7802;67;5323;4746;-577
9636;05.02.2017;'12 - 13;46,05;42,91;3,14;8141;8010;-131;4595;4393;-202
9637;05.02.2017;'13 - 14;41,45;39,86;1,59;7384;7659;275;3982;3847;-135
9638;05.02.2017;'14 - 15;40,88;38,45;2,43;5733;6503;770;3556;3348;-208
9639;05.02.2017;'15 - 16;39,97;36,25;3,72;3459;3681;222;3344;2983;-361
9640;05.02.2017;'16 - 17;40,81;39,13;1,68;1104;964;-140;3425;2957;-468
9641;05.02.2017;'17 - 18;48,24;50,15;-1,91;30;36;6;3736;3621;-115
9642;05.02.2017;'18 - 19;65,07;66,1;-1,03;0;0;0;4150;4023;-127
9643;05.02.2017;'19 - 20;60,86;59,89;0,97;0;0;0;4477;4092;-385
9644;05.02.2017;'20 - 21;57,91;54,84;3,07;0;0;0;4551;4244;-307
9645;05.02.2017;'21 - 22;47,88;48,57;-0,69;0;0;0;4551;4291;-260
9646;05.02.2017;'22 - 23;51;49,63;1,37;0;0;0;4498;4349;-149
9647;05.02.2017;'23 - 24;48;44,1;3,9;0;0;0;4413;4366;-47
9648;06.02.2017;'00 - 01;43,31;42;1,31;0;0;0;4412;4334;-78
9649;06.02.2017;'01 - 02;41,4;37,3;4,1;0;0;0;4586;4508;-78
9650;06.02.2017;'02 - 03;38,27;34,86;3,41;0;0;0;4959;4876;-83
9651;06.02.2017;'03 - 04;35,1;32,46;2,64;0;0;0;5295;5628;333
9652;06.02.2017;'04 - 05;36,3;32,92;3,38;0;0;0;5579;6365;786
9653;06.02.2017;'05 - 06;39,5;36,09;3,41;0;0;0;5789;6192;403
9654;06.02.2017;'06 - 07;55,21;59,71;-4,5;0;0;0;5936;6202;266
9655;06.02.2017;'07 - 08;74,95;74,29;0,66;23;11;-12;5904;6252;348
9656;06.02.2017;'08 - 09;82,06;85,57;-3,51;582;542;-40;5705;6062;357
9657;06.02.2017;'09 - 10;84,01;83,98;0,03;1952;1791;-161;5496;5576;80
9658;06.02.2017;'10 - 11;80,44;82,11;-1,67;3414;3181;-233;5303;5518;215
9659;06.02.2017;'11 - 12;79,61;80,45;-0,84;4511;4443;-68;5213;5752;539
9660;06.02.2017;'12 - 13;80,37;75,45;4,92;4847;5155;308;5212;6093;881
9661;06.02.2017;'13 - 14;77,75;70,75;7;4498;5307;809;5329;6337;1008
9662;06.02.2017;'14 - 15;72,93;66,58;6,35;3532;4470;938;5555;6073;518
9663;06.02.2017;'15 - 16;69,5;65,9;3,6;2152;2715;563;5868;6244;376
9664;06.02.2017;'16 - 17;67,04;67,46;-0,42;719;900;181;6317;6458;141
9665;06.02.2017;'17 - 18;69,94;71,4;-1,46;37;61;24;6938;6715;-223
9666;06.02.2017;'18 - 19;86,37;81,54;4,83;1;0;-1;7581;6748;-833
9667;06.02.2017;'19 - 20;77,29;75,32;1,97;0;0;0;7960;6545;-1415
9668;06.02.2017;'20 - 21;64,69;68,82;-4,13;0;0;0;8036;6712;-1324
9669;06.02.2017;'21 - 22;44,63;54,19;-9,56;0;0;0;8051;7431;-620
9670;06.02.2017;'22 - 23;43,27;54,68;-11,41;0;0;0;8022;7646;-376
9671;06.02.2017;'23 - 24;38,93;47,16;-8,23;0;0;0;8072;8015;-57
9672;07.02.2017;'00 - 01;42,01;44,25;-2,24;0;0;0;8156;8171;15
9673;07.02.2017;'01 - 02;40,4;42,27;-1,87;0;0;0;8372;8337;-35
9674;07.02.2017;'02 - 03;39,01;41,49;-2,48;0;0;0;8718;8554;-164
9675;07.02.2017;'03 - 04;37,78;37,6;0,18;0;0;0;9051;8280;-771
9676;07.02.2017;'04 - 05;38,03;37,64;0,39;0;0;0;9407;8844;-563
9677;07.02.2017;'05 - 06;38,09;42,09;-4;0;0;0;9755;9646;-109
9678;07.02.2017;'06 - 07;46,82;44,47;2,35;0;0;0;10058;10060;2
9679;07.02.2017;'07 - 08;64,9;53,38;11,52;33;16;-17;10260;10586;326
9680;07.02.2017;'08 - 09;63;49,95;13,05;762;558;-204;10342;10940;598
9681;07.02.2017;'09 - 10;62,92;52,48;10,44;2472;1974;-498;10418;11138;720
9682;07.02.2017;'10 - 11;64,55;53,9;10,65;4231;3608;-623;10510;11077;567
9683;07.02.2017;'11 - 12;65,91;55,98;9,93;5409;5085;-324;10630;11567;937
9684;07.02.2017;'12 - 13;63,39;51,59;11,8;5667;5776;109;10718;11465;747
9685;07.02.2017;'13 - 14;61,3;52,46;8,84;5125;5358;233;10810;11247;437
9686;07.02.2017;'14 - 15;60,49;53,37;7,12;3947;4062;115;11004;11264;260
9687;07.02.2017;'15 - 16;59,79;57,91;1,88;2373;2190;-183;11282;11498;216
9688;07.02.2017;'16 - 17;62,41;60,76;1,65;774;608;-166;11653;11467;-186
9689;07.02.2017;'17 - 18;67,14;64,38;2,76;31;36;5;12133;11673;-460
9690;07.02.2017;'18 - 19;66,97;72,37;-5,4;0;0;0;12636;12094;-542
9691;07.02.2017;'19 - 20;64,01;68,74;-4,73;0;0;0;12894;12482;-412
9692;07.02.2017;'20 - 21;45,07;51,02;-5,95;0;0;0;12789;12932;143
9693;07.02.2017;'21 - 22;43,1;46,5;-3,4;0;0;0;12565;12874;309
9694;07.02.2017;'22 - 23;45,02;51,45;-6,43;0;0;0;12252;12400;148
9695;07.02.2017;'23 - 24;39,89;41,69;-1,8;0;0;0;11916;12034;118
9696;08.02.2017;'00 - 01;34,51;37,28;-2,77;0;0;0;11931;12054;123
9697;08.02.2017;'01 - 02;34,59;37,13;-2,54;0;0;0;11683;12288;605
9698;08.02.2017;'02 - 03;34,35;34,95;-0,6;0;0;0;11637;12108;471
9699;08.02.2017;'03 - 04;33,73;31,55;2,18;0;0;0;11570;12064;494
9700;08.02.2017;'04 - 05;35,06;33,15;1,91;0;0;0;11463;11960;497
9701;08.02.2017;'05 - 06;35,9;34,28;1,62;0;0;0;11218;12003;785
9702;08.02.2017;'06 - 07;50,07;43,01;7,06;0;0;0;10893;12300;1407
9703;08.02.2017;'07 - 08;69,92;57,16;12,76;37;14;-23;10508;12420;1912
9704;08.02.2017;'08 - 09;71,1;54,85;16,25;753;481;-272;10047;11723;1676
9705;08.02.2017;'09 - 10;70,9;52,93;17,97;2824;1672;-1152;9552;10802;1250
9706;08.02.2017;'10 - 11;72,5;57,23;15,27;5192;3222;-1970;8867;9685;818
9707;08.02.2017;'11 - 12;71,49;65,16;6,33;7003;4787;-2216;8042;8924;882
9708;08.02.2017;'12 - 13;70,34;69,91;0,43;7814;5867;-1947;7297;7981;684
9709;08.02.2017;'13 - 14;66,94;69,53;-2,59;7454;5994;-1460;6800;7561;761
9710;08.02.2017;'14 - 15;67,43;66,35;1,08;6026;4926;-1100;6735;7307;572
9711;08.02.2017;'15 - 16;68,96;65,01;3,95;3785;2969;-816;6863;7308;445
9712;08.02.2017;'16 - 17;69,13;65,18;3,95;1355;1002;-353;7186;7468;282
9713;08.02.2017;'17 - 18;73,85;74,26;-0,41;61;62;1;7659;7678;19
9714;08.02.2017;'18 - 19;88,18;82,85;5,33;0;0;0;8082;7989;-93
9715;08.02.2017;'19 - 20;84,04;70,67;13,37;0;0;0;8091;7710;-381
9716;08.02.2017;'20 - 21;72,6;57,92;14,68;0;0;0;7533;7207;-326
9717;08.02.2017;'21 - 22;62,5;53,95;8,55;0;0;0;6847;6851;4
9718;08.02.2017;'22 - 23;47,98;50,62;-2,64;0;0;0;6195;6493;298
9719;08.02.2017;'23 - 24;45,82;44,96;0,86;0;0;0;5703;6099;396
9720;09.02.2017;'00 - 01;48,1;48,99;-0,89;0;0;0;5236;5754;518
9721;09.02.2017;'01 - 02;48,05;49,83;-1,78;0;0;0;4954;5679;725
9722;09.02.2017;'02 - 03;44,96;44,85;0,11;0;0;0;4907;5884;977
9723;09.02.2017;'03 - 04;42,5;41,49;1,01;0;0;0;4873;6140;1267
9724;09.02.2017;'04 - 05;41,66;42,11;-0,45;0;0;0;4924;6157;1233
9725;09.02.2017;'05 - 06;47,2;47,45;-0,25;0;0;0;5038;6248;1210
9726;09.02.2017;'06 - 07;54,58;49,41;5,17;0;0;0;5158;6064;906
9727;09.02.2017;'07 - 08;74,14;68,59;5,55;67;34;-33;5239;6220;981
9728;09.02.2017;'08 - 09;70;70,96;-0,96;1402;1077;-325;5182;6332;1150
9729;09.02.2017;'09 - 10;72,79;76,24;-3,45;4313;3440;-873;5080;6162;1082
9730;09.02.2017;'10 - 11;70,97;72,49;-1,52;7057;5824;-1233;4947;6224;1277
9731;09.02.2017;'11 - 12;68,97;70,93;-1,96;8734;7378;-1356;4853;6286;1433
9732;09.02.2017;'12 - 13;66,91;73,33;-6,42;9207;8211;-996;4843;6494;1651
9733;09.02.2017;'13 - 14;65,64;72,06;-6,42;8531;8173;-358;5137;7296;2159
9734;09.02.2017;'14 - 15;65;69,75;-4,75;6797;6463;-334;5869;8153;2284
9735;09.02.2017;'15 - 16;65;70,14;-5,14;4257;3566;-691;6817;9321;2504
9736;09.02.2017;'16 - 17;65,76;69,9;-4,14;1583;1048;-535;7939;10298;2359
9737;09.02.2017;'17 - 18;70,43;74,03;-3,6;84;64;-20;9195;10738;1543
9738;09.02.2017;'18 - 19;72,91;73,93;-1,02;0;0;0;10363;11574;1211
9739;09.02.2017;'19 - 20;64,54;69,45;-4,91;0;0;0;11025;12412;1387
9740;09.02.2017;'20 - 21;50,09;57,32;-7,23;0;0;0;11055;13065;2010
9741;09.02.2017;'21 - 22;39,48;49,69;-10,21;0;0;0;10796;13260;2464
9742;09.02.2017;'22 - 23;42,1;53,06;-10,96;0;0;0;10400;12771;2371
9743;09.02.2017;'23 - 24;38,35;42,96;-4,61;0;0;0;10072;12620;2548
9744;10.02.2017;'00 - 01;36,67;40,63;-3,96;0;0;0;10994;12140;1146
9745;10.02.2017;'01 - 02;34,31;38,35;-4,04;0;0;0;10909;11920;1011
9746;10.02.2017;'02 - 03;33,46;38,26;-4,8;0;0;0;11237;12302;1065
9747;10.02.2017;'03 - 04;33,1;35,27;-2,17;0;0;0;11573;12479;906
9748;10.02.2017;'04 - 05;32,55;36,06;-3,51;0;0;0;12015;12564;549
9749;10.02.2017;'05 - 06;34,74;42,36;-7,62;0;0;0;12519;12843;324
9750;10.02.2017;'06 - 07;39,17;38,94;0,23;0;0;0;12938;13134;196
9751;10.02.2017;'07 - 08;57;55,29;1,71;82;48;-34;13010;12904;-106
9752;10.02.2017;'08 - 09;63,08;58,29;4,79;1170;774;-396;12700;12379;-321
9753;10.02.2017;'09 - 10;63,09;63,18;-0,09;3514;2380;-1134;12341;12137;-204
9754;10.02.2017;'10 - 11;61,93;65,18;-3,25;5962;4039;-1923;11944;11742;-202
9755;10.02.2017;'11 - 12;59,04;64,1;-5,06;7741;5466;-2275;11654;10931;-723
9756;10.02.2017;'12 - 13;54,91;58,89;-3,98;8310;6184;-2126;11493;10793;-700
9757;10.02.2017;'13 - 14;45,08;51,35;-6,27;7780;6023;-1757;11637;10761;-876
9758;10.02.2017;'14 - 15;42,02;50,13;-8,11;6236;5010;-1226;12217;10912;-1305
9759;10.02.2017;'15 - 16;44,97;50,73;-5,76;3936;3006;-930;12907;11470;-1437
9760;10.02.2017;'16 - 17;49,07;55,91;-6,84;1468;910;-558;13708;11778;-1930
9761;10.02.2017;'17 - 18;52,73;62,2;-9,47;78;60;-18;14619;12561;-2058
9762;10.02.2017;'18 - 19;45,06;60,15;-15,09;0;0;0;15453;13043;-2410
9763;10.02.2017;'19 - 20;46,2;56,9;-10,7;0;0;0;15638;13483;-2155
9764;10.02.2017;'20 - 21;39,11;47,68;-8,57;0;0;0;14962;13077;-1885
9765;10.02.2017;'21 - 22;37,08;45,03;-7,95;0;0;0;14071;12185;-1886
9766;10.02.2017;'22 - 23;38,04;46,78;-8,74;0;0;0;13281;11998;-1283
9767;10.02.2017;'23 - 24;34,21;42,27;-8,06;0;0;0;12729;11816;-913
9768;11.02.2017;'00 - 01;39;47,85;-8,85;0;0;0;11906;11745;-161
9769;11.02.2017;'01 - 02;36,69;43,47;-6,78;0;0;0;11862;11846;-16
9770;11.02.2017;'02 - 03;35,05;40,69;-5,64;0;0;0;11981;11707;-274
9771;11.02.2017;'03 - 04;36,61;40,95;-4,34;0;0;0;12036;11558;-478
9772;11.02.2017;'04 - 05;32,9;41,47;-8,57;0;0;0;12125;12030;-95
9773;11.02.2017;'05 - 06;37,5;45,15;-7,65;0;0;0;12201;12174;-27
9774;11.02.2017;'06 - 07;33;41,75;-8,75;0;0;0;12234;12251;17
9775;11.02.2017;'07 - 08;44,15;52,79;-8,64;89;49;-40;12073;12396;323
9776;11.02.2017;'08 - 09;48,48;53,18;-4,7;1460;1276;-184;11685;12718;1033
9777;11.02.2017;'09 - 10;50,78;55,26;-4,48;3969;3929;-40;11267;12872;1605
9778;11.02.2017;'10 - 11;49,57;51,55;-1,98;6415;6889;474;10986;12874;1888
9779;11.02.2017;'11 - 12;44;45,41;-1,41;8290;9086;796;10934;12623;1689
9780;11.02.2017;'12 - 13;37,93;38,14;-0,21;9141;10200;1059;10993;12314;1321
9781;11.02.2017;'13 - 14;35,08;39,23;-4,15;8704;9898;1194;11278;12590;1312
9782;11.02.2017;'14 - 15;34;41,15;-7,15;7007;8218;1211;11918;13089;1171
9783;11.02.2017;'15 - 16;34,1;41,48;-7,38;4430;5080;650;12692;13912;1220
9784;11.02.2017;'16 - 17;35,09;42,68;-7,59;1706;1687;-19;13770;14791;1021
9785;11.02.2017;'17 - 18;41,56;56,43;-14,87;103;81;-22;15069;15667;598
9786;11.02.2017;'18 - 19;43,01;63,15;-20,14;0;0;0;16190;16667;477
9787;11.02.2017;'19 - 20;40,86;63,21;-22,35;0;0;0;16628;16835;207
9788;11.02.2017;'20 - 21;36,09;48,69;-12,6;0;0;0;16235;16503;268
9789;11.02.2017;'21 - 22;33,93;48,22;-14,29;0;0;0;15618;16445;827
9790;11.02.2017;'22 - 23;33,92;44;-10,08;0;0;0;15023;15517;494
9791;11.02.2017;'23 - 24;31,86;35,55;-3,69;0;0;0;14536;15068;532
9792;12.02.2017;'00 - 01;31,43;39,32;-7,89;0;0;0;15308;15204;-104
9793;12.02.2017;'01 - 02;31,06;36,51;-5,45;0;0;0;15241;15608;367
9794;12.02.2017;'02 - 03;31,15;37;-5,85;0;0;0;15392;15586;194
9795;12.02.2017;'03 - 04;31,08;36,97;-5,89;0;0;0;15445;15523;78
9796;12.02.2017;'04 - 05;29,78;33,38;-3,6;0;0;0;15505;15261;-244
9797;12.02.2017;'05 - 06;29,88;33,1;-3,22;0;0;0;15591;14712;-879
9798;12.02.2017;'06 - 07;30,36;33,08;-2,72;0;0;0;15614;14569;-1045
9799;12.02.2017;'07 - 08;30,36;35,48;-5,12;87;31;-56;15397;14348;-1049
9800;12.02.2017;'08 - 09;32,33;40,66;-8,33;1180;687;-493;14854;14112;-742
9801;12.02.2017;'09 - 10;33,21;46,45;-13,24;3670;2198;-1472;14288;13882;-406
9802;12.02.2017;'10 - 11;34,26;54,95;-20,69;6417;3967;-2450;13683;13434;-249
9803;12.02.2017;'11 - 12;35,03;54,26;-19,23;8682;5654;-3028;13090;13062;-28
9804;12.02.2017;'12 - 13;31,4;40,65;-9,25;9881;6672;-3209;12669;12839;170
9805;12.02.2017;'13 - 14;30,89;37,93;-7,04;9751;6898;-2853;12567;12964;397
9806;12.02.2017;'14 - 15;30,02;35,97;-5,95;8243;6024;-2219;12977;13270;293
9807;12.02.2017;'15 - 16;30,81;35,65;-4,84;5477;3940;-1537;13606;14040;434
9808;12.02.2017;'16 - 17;32,19;35,1;-2,91;2217;1465;-752;14655;14365;-290
9809;12.02.2017;'17 - 18;36;41,68;-5,68;147;131;-16;16149;15025;-1124
9810;12.02.2017;'18 - 19;42,59;50,3;-7,71;0;0;0;17452;15870;-1582
9811;12.02.2017;'19 - 20;41,1;47,61;-6,51;0;0;0;17808;16247;-1561
9812;12.02.2017;'20 - 21;40,44;47,82;-7,38;0;0;0;16911;16145;-766
9813;12.02.2017;'21 - 22;32,63;38,43;-5,8;0;0;0;15773;15960;187
9814;12.02.2017;'22 - 23;34,9;38,63;-3,73;0;0;0;14726;15073;347
9815;12.02.2017;'23 - 24;32,12;35,25;-3,13;0;0;0;14007;14440;433
9816;13.02.2017;'00 - 01;28,83;31,73;-2,9;0;0;0;13746;13936;190
9817;13.02.2017;'01 - 02;29,68;31,91;-2,23;0;0;0;13300;13608;308
9818;13.02.2017;'02 - 03;31,12;30,64;0,48;0;0;0;13141;13623;482
9819;13.02.2017;'03 - 04;29,85;28,98;0,87;0;0;0;13040;13944;904
9820;13.02.2017;'04 - 05;30,76;26,6;4,16;0;0;0;13078;14168;1090
9821;13.02.2017;'05 - 06;33,01;28,97;4,04;0;0;0;13213;14222;1009
9822;13.02.2017;'06 - 07;39,77;34,7;5,07;0;0;0;13263;14292;1029
9823;13.02.2017;'07 - 08;56,98;44,76;12,22;132;96;-36;13042;14393;1351
9824;13.02.2017;'08 - 09;59,13;51,96;7,17;2021;1886;-135;12488;14218;1730
9825;13.02.2017;'09 - 10;57,9;47;10,9;5624;5670;46;11862;13057;1195
9826;13.02.2017;'10 - 11;53,97;43,22;10,75;9508;10232;724;11335;12166;831
9827;13.02.2017;'11 - 12;45,2;37,51;7,69;12679;13882;1203;11081;11606;525
9828;13.02.2017;'12 - 13;37,24;34,06;3,18;14430;15764;1334;10948;11002;54
9829;13.02.2017;'13 - 14;35,06;33,31;1,75;14373;15820;1447;10965;10890;-75
9830;13.02.2017;'14 - 15;38,23;37,01;1,22;12302;13440;1138;11325;10955;-370
9831;13.02.2017;'15 - 16;43,52;42,27;1,25;8283;9052;769;11868;11155;-713
9832;13.02.2017;'16 - 17;49,17;45,67;3,5;3470;3494;24;12927;12318;-609
9833;13.02.2017;'17 - 18;53,84;49,95;3,89;237;246;9;14695;15682;987
9834;13.02.2017;'18 - 19;56,25;49,52;6,73;0;0;0;16458;18176;1718
9835;13.02.2017;'19 - 20;50,08;40,11;9,97;0;0;0;17168;18605;1437
9836;13.02.2017;'20 - 21;44,94;38,57;6,37;0;0;0;16610;17772;1162
9837;13.02.2017;'21 - 22;38,14;37,51;0,63;0;0;0;15707;17250;1543
9838;13.02.2017;'22 - 23;39,77;34,66;5,11;0;0;0;14728;15987;1259
9839;13.02.2017;'23 - 24;33,57;30,68;2,89;0;0;0;13722;14765;1043
9840;14.02.2017;'00 - 01;32,35;27,2;5,15;0;0;0;13147;14332;1185
9841;14.02.2017;'01 - 02;31,68;23,65;8,03;0;0;0;12474;13296;822
9842;14.02.2017;'02 - 03;32,11;26,22;5,89;0;0;0;11991;12374;383
9843;14.02.2017;'03 - 04;32,56;30,01;2,55;0;0;0;11555;12030;475
9844;14.02.2017;'04 - 05;33,34;34,04;-0,7;0;0;0;11340;11858;518
9845;14.02.2017;'05 - 06;32,84;33,49;-0,65;0;0;0;11347;11807;460
9846;14.02.2017;'06 - 07;42,09;36,16;5,93;0;0;0;11307;11867;560
9847;14.02.2017;'07 - 08;47,98;49,12;-1,14;284;197;-87;10950;11859;909
9848;14.02.2017;'08 - 09;50,63;52,79;-2,16;3460;3062;-398;10111;11042;931
9849;14.02.2017;'09 - 10;46,89;43,3;3,59;8681;8282;-399;9033;9108;75
9850;14.02.2017;'10 - 11;38,39;40,32;-1,93;13323;13672;349;7889;7272;-617
9851;14.02.2017;'11 - 12;36,64;36,42;0,22;16402;17406;1004;6883;6214;-669
9852;14.02.2017;'12 - 13;35,86;35,01;0,85;17495;19114;1619;6042;5138;-904
9853;14.02.2017;'13 - 14;38,33;37,25;1,08;16656;18356;1700;5559;4835;-724
9854;14.02.2017;'14 - 15;37,31;36,54;0,77;13904;15462;1558;5555;4744;-811
9855;14.02.2017;'15 - 16;41,88;37,2;4,68;9456;10362;906;5926;4678;-1248
9856;14.02.2017;'16 - 17;54,4;43,14;11,26;4122;4061;-61;6864;4868;-1996
9857;14.02.2017;'17 - 18;61,03;53,24;7,79;312;314;2;8472;6152;-2320
9858;14.02.2017;'18 - 19;66,22;56,82;9,4;0;0;0;10005;7844;-2161
9859;14.02.2017;'19 - 20;57,97;52,86;5,11;0;0;0;10501;9095;-1406
9860;14.02.2017;'20 - 21;54,68;41,14;13,54;0;0;0;9823;9246;-577
9861;14.02.2017;'21 - 22;42,26;39,13;3,13;0;0;0;8939;8800;-139
9862;14.02.2017;'22 - 23;43,47;38;5,47;0;0;0;7952;7902;-50
9863;14.02.2017;'23 - 24;40,64;35,27;5,37;0;0;0;6963;6837;-126
9864;15.02.2017;'00 - 01;37,39;34,68;2,71;0;0;0;5749;6223;474
9865;15.02.2017;'01 - 02;38,18;32,12;6,06;0;0;0;4993;5354;361
9866;15.02.2017;'02 - 03;37,13;31,4;5,73;0;0;0;4374;4715;341
9867;15.02.2017;'03 - 04;35,72;34,5;1,22;0;0;0;3837;4079;242
9868;15.02.2017;'04 - 05;36,51;39,15;-2,64;0;0;0;3523;3500;-23
9869;15.02.2017;'05 - 06;37,87;42,84;-4,97;0;0;0;3434;3083;-351
9870;15.02.2017;'06 - 07;48,2;42,48;5,72;0;0;0;3378;2923;-455
9871;15.02.2017;'07 - 08;61,48;59,24;2,24;283;216;-67;3178;3048;-130
9872;15.02.2017;'08 - 09;63,32;59,62;3,7;3455;3441;-14;2816;2999;183
9873;15.02.2017;'09 - 10;60,76;52,7;8,06;8609;9482;873;2406;2564;158
9874;15.02.2017;'10 - 11;55,69;42;13,69;13306;15047;1741;1871;1732;-139
9875;15.02.2017;'11 - 12;39,66;34,22;5,44;16470;18361;1891;1348;1137;-211
9876;15.02.2017;'12 - 13;37,35;34,4;2,95;17615;19457;1842;978;822;-156
9877;15.02.2017;'13 - 14;38,08;35,41;2,67;16755;18388;1633;824;857;33
9878;15.02.2017;'14 - 15;45,22;38,04;7,18;13896;15227;1331;875;834;-41
9879;15.02.2017;'15 - 16;50,85;41,32;9,53;9400;10070;670;1065;1035;-30
9880;15.02.2017;'16 - 17;54,43;47,23;7,2;4094;3894;-200;1589;1544;-45
9881;15.02.2017;'17 - 18;59,16;49,9;9,26;343;322;-21;2630;2590;-40
9882;15.02.2017;'18 - 19;64,48;52,91;11,57;0;0;0;3950;4090;140
9883;15.02.2017;'19 - 20;63,07;51,13;11,94;0;0;0;5269;5536;267
9884;15.02.2017;'20 - 21;54,77;46,08;8,69;0;0;0;6359;6962;603
9885;15.02.2017;'21 - 22;44,92;40,84;4,08;0;0;0;7458;8384;926
9886;15.02.2017;'22 - 23;37,98;44,95;-6,97;0;0;0;8417;9670;1253
9887;15.02.2017;'23 - 24;33,47;34,98;-1,51;0;0;0;9100;10483;1383
9888;16.02.2017;'00 - 01;33,27;33,1;0,17;0;0;0;11434;10938;-496
9889;16.02.2017;'01 - 02;34,93;35,5;-0,57;0;0;0;11616;11499;-117
9890;16.02.2017;'02 - 03;32,09;29,91;2,18;0;0;0;11856;11973;117
9891;16.02.2017;'03 - 04;32;31,05;0,95;0;0;0;12013;12348;335
9892;16.02.2017;'04 - 05;32,06;33,16;-1,1;0;0;0;12071;12253;182
9893;16.02.2017;'05 - 06;33,28;33,11;0,17;0;0;0;12056;12303;247
9894;16.02.2017;'06 - 07;38,01;36,01;2;0;0;0;12035;13048;1013
9895;16.02.2017;'07 - 08;50,99;47,94;3,05;271;254;-17;11919;13588;1669
9896;16.02.2017;'08 - 09;50,31;45,66;4,65;2935;3322;387;11695;13106;1411
9897;16.02.2017;'09 - 10;43,72;35,09;8,63;6866;8278;1412;11434;12530;1096
9898;16.02.2017;'10 - 11;38;31,98;6,02;10158;12595;2437;11042;10755;-287
9899;16.02.2017;'11 - 12;37,09;32,72;4,37;12124;15050;2926;10503;9468;-1035
9900;16.02.2017;'12 - 13;37,91;32,94;4,97;12419;15786;3367;10186;9474;-712
9901;16.02.2017;'13 - 14;37,19;33,04;4,15;11424;14567;3143;9929;9676;-253
9902;16.02.2017;'14 - 15;38,05;33,69;4,36;9328;11592;2264;9713;9900;187
9903;16.02.2017;'15 - 16;43,79;39,83;3,96;6209;7699;1490;9609;10054;445
9904;16.02.2017;'16 - 17;50,82;43,01;7,81;2666;3051;385;9815;10022;207
9905;16.02.2017;'17 - 18;53,3;49,68;3,62;248;234;-14;10453;10413;-40
9906;16.02.2017;'18 - 19;54,98;51,4;3,58;0;0;0;11332;11184;-148
9907;16.02.2017;'19 - 20;50,92;51,13;-0,21;0;0;0;12160;12118;-42
9908;16.02.2017;'20 - 21;42,06;44,35;-2,29;0;0;0;12802;12966;164
9909;16.02.2017;'21 - 22;38,95;43,08;-4,13;0;0;0;13400;13098;-302
9910;16.02.2017;'22 - 23;37,98;43,16;-5,18;0;0;0;13818;13486;-332
9911;16.02.2017;'23 - 24;33,3;38,82;-5,52;0;0;0;14050;13640;-410
9912;17.02.2017;'00 - 01;32,52;34,86;-2,34;0;0;0;13477;13502;25
9913;17.02.2017;'01 - 02;31,69;32,35;-0,66;0;0;0;13640;13671;31
9914;17.02.2017;'02 - 03;31,13;32,48;-1,35;0;0;0;13910;13819;-91
9915;17.02.2017;'03 - 04;31,35;30,16;1,19;0;0;0;14192;14398;206
9916;17.02.2017;'04 - 05;31,69;30,49;1,2;0;0;0;14403;13933;-470
9917;17.02.2017;'05 - 06;32,5;32,22;0,28;0;0;0;14467;13696;-771
9918;17.02.2017;'06 - 07;36,96;43,46;-6,5;0;0;0;14449;13265;-1184
9919;17.02.2017;'07 - 08;47,95;49,02;-1,07;87;69;-18;14197;12728;-1469
9920;17.02.2017;'08 - 09;45,01;49,85;-4,84;852;967;115;13702;11982;-1720
9921;17.02.2017;'09 - 10;44,05;50,12;-6,07;2032;2880;848;13308;11165;-2143
9922;17.02.2017;'10 - 11;48,98;50,67;-1,69;3145;4519;1374;13064;10449;-2615
9923;17.02.2017;'11 - 12;49,9;49,69;0,21;3915;5474;1559;12982;10175;-2807
9924;17.02.2017;'12 - 13;48,98;50,29;-1,31;4181;5405;1224;12915;9974;-2941
9925;17.02.2017;'13 - 14;40;48,27;-8,27;4048;4703;655;12556;9802;-2754
9926;17.02.2017;'14 - 15;42,92;52,77;-9,85;3561;3710;149;11793;9592;-2201
9927;17.02.2017;'15 - 16;48,53;50;-1,47;2483;2510;27;10946;9546;-1400
9928;17.02.2017;'16 - 17;48,81;49,7;-0,89;1125;1096;-29;10143;9460;-683
9929;17.02.2017;'17 - 18;50,92;51,71;-0,79;129;116;-13;9432;9286;-146
9930;17.02.2017;'18 - 19;53,04;51,98;1,06;0;0;0;8855;9132;277
9931;17.02.2017;'19 - 20;51,14;50,28;0,86;0;0;0;8145;8708;563
9932;17.02.2017;'20 - 21;49,77;42,71;7,06;0;0;0;7306;8605;1299
9933;17.02.2017;'21 - 22;49,52;42,43;7,09;0;0;0;6578;8724;2146
9934;17.02.2017;'22 - 23;46,34;41,2;5,14;0;0;0;5952;8056;2104
9935;17.02.2017;'23 - 24;38,82;36,49;2,33;0;0;0;5450;7862;2412
9936;18.02.2017;'00 - 01;35,1;33,1;2;0;0;0;6302;7260;958
9937;18.02.2017;'01 - 02;33,09;32,18;0,91;0;0;0;5957;6596;639
9938;18.02.2017;'02 - 03;35,08;31,5;3,58;0;0;0;5798;6195;397
9939;18.02.2017;'03 - 04;34,3;31,99;2,31;0;0;0;5582;6106;524
9940;18.02.2017;'04 - 05;34,3;31,98;2,32;0;0;0;5217;5909;692
9941;18.02.2017;'05 - 06;35,36;31,58;3,78;0;0;0;4699;5404;705
9942;18.02.2017;'06 - 07;38,81;29,84;8,97;0;0;0;4195;4745;550
9943;18.02.2017;'07 - 08;42,08;33,53;8,55;104;64;-40;3692;4187;495
9944;18.02.2017;'08 - 09;46,81;37,8;9,01;1078;738;-340;3283;3776;493
9945;18.02.2017;'09 - 10;50;41,53;8,47;2792;2064;-728;3043;3616;573
9946;18.02.2017;'10 - 11;49,85;44,38;5,47;4694;3838;-856;3023;3792;769
9947;18.02.2017;'11 - 12;48,24;43,74;4,5;6135;5588;-547;3436;4354;918
9948;18.02.2017;'12 - 13;42,25;39,24;3,01;6799;6360;-439;4053;5087;1034
9949;18.02.2017;'13 - 14;36,64;35,97;0,67;6675;6020;-655;4666;5544;878
9950;18.02.2017;'14 - 15;35,64;33,56;2,08;5810;4806;-1004;5116;5460;344
9951;18.02.2017;'15 - 16;37,35;36,05;1,3;4284;3316;-968;5448;5480;32
9952;18.02.2017;'16 - 17;42,04;37,83;4,21;2103;1530;-573;5764;5488;-276
9953;18.02.2017;'17 - 18;47,94;41,78;6,16;252;192;-60;6227;5719;-508
9954;18.02.2017;'18 - 19;53,94;43,37;10,57;1;0;-1;6854;6424;-430
9955;18.02.2017;'19 - 20;48,46;35,62;12,84;0;0;0;7635;7768;133
9956;18.02.2017;'20 - 21;39,01;33,18;5,83;0;0;0;8450;9173;723
9957;18.02.2017;'21 - 22;35;30,71;4,29;0;0;0;9258;10504;1246
9958;18.02.2017;'22 - 23;33,03;29,07;3,96;0;0;0;9988;11892;1904
9959;18.02.2017;'23 - 24;30,29;24,15;6,14;0;0;0;10664;12986;2322
9960;19.02.2017;'00 - 01;30,81;19,69;11,12;0;0;0;12298;13958;1660
9961;19.02.2017;'01 - 02;21,68;12,14;9,54;0;0;0;13079;14584;1505
9962;19.02.2017;'02 - 03;12,44;9,26;3,18;0;0;0;13872;15469;1597
9963;19.02.2017;'03 - 04;9,93;8,7;1,23;0;0;0;14633;16560;1927
9964;19.02.2017;'04 - 05;9,53;9,27;0,26;0;0;0;15247;17038;1791
9965;19.02.2017;'05 - 06;10,13;8,59;1,54;0;0;0;15673;17234;1561
9966;19.02.2017;'06 - 07;10,3;8,27;2,03;1;0;-1;16015;18244;2229
9967;19.02.2017;'07 - 08;18,12;10,51;7,61;221;245;24;15991;18641;2650
9968;19.02.2017;'08 - 09;25,47;5,92;19,55;2090;2604;514;15453;18110;2657
9969;19.02.2017;'09 - 10;29,59;11,86;17,73;5006;6257;1251;14855;16768;1913
9970;19.02.2017;'10 - 11;29,82;10,49;19,33;7667;8833;1166;14428;15583;1155
9971;19.02.2017;'11 - 12;32,09;18,89;13,2;9338;10168;830;14037;14058;21
9972;19.02.2017;'12 - 13;30,17;22,1;8,07;9677;9794;117;13540;13056;-484
9973;19.02.2017;'13 - 14;31,07;27,03;4,04;8882;8661;-221;13013;12617;-396
9974;19.02.2017;'14 - 15;31,41;26,74;4,67;7110;6332;-778;12562;12492;-70
9975;19.02.2017;'15 - 16;30,34;27,18;3,16;4650;3754;-896;12252;12734;482
9976;19.02.2017;'16 - 17;31,99;28,6;3,39;2030;1578;-452;12208;12771;563
9977;19.02.2017;'17 - 18;41,37;31,1;10,27;241;192;-49;12441;12471;30
9978;19.02.2017;'18 - 19;53,65;38,01;15,64;0;2;2;12751;12448;-303
9979;19.02.2017;'19 - 20;52,8;43,55;9,25;0;0;0;12997;12531;-466
9980;19.02.2017;'20 - 21;39,28;33,02;6,26;0;0;0;13256;12834;-422
9981;19.02.2017;'21 - 22;33,95;32,75;1,2;0;0;0;13453;12440;-1013
9982;19.02.2017;'22 - 23;35,05;34,74;0,31;0;0;0;13738;12530;-1208
9983;19.02.2017;'23 - 24;31,01;31,83;-0,82;0;0;0;14344;13201;-1143
9984;20.02.2017;'00 - 01;30,75;33,11;-2,36;0;0;0;14479;14101;-378
9985;20.02.2017;'01 - 02;27,22;31,87;-4,65;0;0;0;15302;15141;-161
9986;20.02.2017;'02 - 03;26,5;27,36;-0,86;0;0;0;16321;16066;-255
9987;20.02.2017;'03 - 04;25,04;23,32;1,72;0;0;0;17332;16804;-528
9988;20.02.2017;'04 - 05;20,95;23,07;-2,12;0;0;0;18510;16956;-1554
9989;20.02.2017;'05 - 06;21,93;28,29;-6,36;0;0;0;19971;18294;-1677
9990;20.02.2017;'06 - 07;38,49;37,55;0,94;0;0;0;21554;20083;-1471
9991;20.02.2017;'07 - 08;48,35;41,04;7,31;111;87;-24;22981;21829;-1152
9992;20.02.2017;'08 - 09;45,82;40,16;5,66;894;966;72;24249;23448;-801
9993;20.02.2017;'09 - 10;38,92;37,99;0,93;2082;2709;627;25492;25095;-397
9994;20.02.2017;'10 - 11;37,92;36,21;1,71;3147;4604;1457;26634;27010;376
9995;20.02.2017;'11 - 12;39,38;32,58;6,8;3856;6043;2187;27685;29076;1391
9996;20.02.2017;'12 - 13;39,18;28,86;10,32;3943;6179;2236;28560;30490;1930
9997;20.02.2017;'13 - 14;36,08;27,34;8,74;3511;4988;1477;29240;31368;2128
9998;20.02.2017;'14 - 15;33,03;27,87;5,16;2686;3302;616;29669;31846;2177
9999;20.02.2017;'15 - 16;31,87;30,76;1,11;1697;2014;317;30088;32439;2351
10000;20.02.2017;'16 - 17;31,63;31,18;0,45;712;783;71;30521;32871;2350
10001;20.02.2017;'17 - 18;34,92;34,69;0,23;96;91;-5;30933;33285;2352
10002;20.02.2017;'18 - 19;37,94;35,48;2,46;0;2;2;31341;33672;2331
10003;20.02.2017;'19 - 20;34,27;33,82;0,45;0;0;0;31591;33964;2373
10004;20.02.2017;'20 - 21;29,92;27,28;2,64;0;0;0;31603;33866;2263
10005;20.02.2017;'21 - 22;19,22;19,99;-0,77;0;0;0;31453;32998;1545
10006;20.02.2017;'22 - 23;9,94;16,09;-6,15;0;0;0;30997;31830;833
10007;20.02.2017;'23 - 24;9,48;15,16;-5,68;0;0;0;30237;30714;477
10008;21.02.2017;'00 - 01;12,54;11,55;0,99;0;0;0;28575;29662;1087
10009;21.02.2017;'01 - 02;10,19;8,44;1,75;0;0;0;27726;28559;833
10010;21.02.2017;'02 - 03;10,06;5,62;4,44;0;0;0;27056;27471;415
10011;21.02.2017;'03 - 04;11,12;5,57;5,55;0;0;0;26373;26747;374
10012;21.02.2017;'04 - 05;12,56;8,23;4,33;0;0;0;25799;26271;472
10013;21.02.2017;'05 - 06;25,16;13,41;11,75;0;0;0;25384;25799;415
10014;21.02.2017;'06 - 07;33;30,98;2,02;1;0;-1;25094;26214;1120
10015;21.02.2017;'07 - 08;38,96;30,02;8,94;82;55;-27;24925;26034;1109
10016;21.02.2017;'08 - 09;38,94;35,63;3,31;702;631;-71;24917;26127;1210
10017;21.02.2017;'09 - 10;38,94;35,24;3,7;1750;2018;268;25089;26944;1855
10018;21.02.2017;'10 - 11;38,95;33,91;5,04;2870;3532;662;25546;27446;1900
10019;21.02.2017;'11 - 12;38,95;33,03;5,92;3842;4854;1012;26180;27764;1584
10020;21.02.2017;'12 - 13;36,63;31,75;4,88;4367;6376;2009;26541;27250;709
10021;21.02.2017;'13 - 14;36,65;32,85;3,8;4393;6517;2124;26060;26460;400
10022;21.02.2017;'14 - 15;36,41;34,69;1,72;3914;5674;1760;24443;25323;880
10023;21.02.2017;'15 - 16;36,68;35,7;0,98;2785;3886;1101;22550;23403;853
10024;21.02.2017;'16 - 17;34,98;39,54;-4,56;1289;1926;637;20678;20930;252
10025;21.02.2017;'17 - 18;39,9;49,49;-9,59;158;274;116;19272;18836;-436
10026;21.02.2017;'18 - 19;57,42;56,87;0,55;0;3;3;18244;18139;-105
10027;21.02.2017;'19 - 20;45,8;47;-1,2;0;0;0;17674;18227;553
10028;21.02.2017;'20 - 21;46,14;41,01;5,13;0;0;0;17722;19100;1378
10029;21.02.2017;'21 - 22;40;31,2;8,8;0;0;0;18096;20200;2104
10030;21.02.2017;'22 - 23;34,25;28,73;5,52;0;0;0;19035;21023;1988
10031;21.02.2017;'23 - 24;30,03;25,01;5,02;0;0;0;20503;22387;1884
10032;22.02.2017;'00 - 01;22,92;14,86;8,06;0;0;0;24376;24268;-108
10033;22.02.2017;'01 - 02;10,26;6,72;3,54;0;0;0;26565;26394;-171
10034;22.02.2017;'02 - 03;9,5;2,21;7,29;0;0;0;29094;28930;-164
10035;22.02.2017;'03 - 04;7,66;-1,42;9,08;0;0;0;31649;31704;55
10036;22.02.2017;'04 - 05;5,03;-1,32;6,35;0;0;0;33482;33588;106
10037;22.02.2017;'05 - 06;7,68;-4,37;12,05;0;0;0;34575;35349;774
10038;22.02.2017;'06 - 07;21,52;4,63;16,89;0;0;0;35400;36981;1581
10039;22.02.2017;'07 - 08;31,86;18,36;13,5;94;89;-5;35996;37503;1507
10040;22.02.2017;'08 - 09;32,51;23,26;9,25;628;876;248;36175;37087;912
10041;22.02.2017;'09 - 10;32,51;25,04;7,47;1449;2229;780;36172;37116;944
10042;22.02.2017;'10 - 11;32,29;27,3;4,99;2302;3405;1103;36027;37134;1107
10043;22.02.2017;'11 - 12;32,96;27,16;5,8;2956;3821;865;35855;37044;1189
10044;22.02.2017;'12 - 13;32,01;27,08;4,93;3289;4040;751;35716;36966;1250
10045;22.02.2017;'13 - 14;30,94;28,2;2,74;3299;3950;651;35494;36496;1002
10046;22.02.2017;'14 - 15;29,94;28,17;1,77;2999;3279;280;35005;35744;739
10047;22.02.2017;'15 - 16;31,28;31,51;-0,23;2215;2290;75;34479;35404;925
10048;22.02.2017;'16 - 17;31,24;28,67;2,57;1081;1135;54;33901;35508;1607
10049;22.02.2017;'17 - 18;32,48;26,56;5,92;156;161;5;33360;35255;1895
10050;22.02.2017;'18 - 19;35,93;24,34;11,59;0;3;3;32900;34996;2096
10051;22.02.2017;'19 - 20;34,05;22,63;11,42;0;0;0;32571;34780;2209
10052;22.02.2017;'20 - 21;31,65;16,85;14,8;0;0;0;32436;34260;1824
10053;22.02.2017;'21 - 22;23,45;10,03;13,42;0;0;0;32284;33023;739
10054;22.02.2017;'22 - 23;10,26;6,55;3,71;0;0;0;31954;32013;59
10055;22.02.2017;'23 - 24;9,47;4,69;4,78;0;0;0;31402;31781;379
10056;23.02.2017;'00 - 01;-6,58;6,5;-13,08;0;0;0;33961;31222;-2739
10057;23.02.2017;'01 - 02;-5,03;4,45;-9,48;0;0;0;33251;30408;-2843
10058;23.02.2017;'02 - 03;0,01;8,73;-8,72;0;0;0;31897;29069;-2828
10059;23.02.2017;'03 - 04;7,03;13,25;-6,22;0;0;0;30142;27152;-2990
10060;23.02.2017;'04 - 05;9,44;14,92;-5,48;0;0;0;27620;24663;-2957
10061;23.02.2017;'05 - 06;25,53;26,15;-0,62;0;0;0;24252;23451;-801
10062;23.02.2017;'06 - 07;35;37,18;-2,18;0;0;0;20862;22237;1375
10063;23.02.2017;'07 - 08;46,01;50,05;-4,04;233;213;-20;17802;20624;2822
10064;23.02.2017;'08 - 09;48,5;43,51;4,99;1718;1838;120;15979;19605;3626
10065;23.02.2017;'09 - 10;46,41;43,05;3,36;3929;4656;727;15077;19785;4708
10066;23.02.2017;'10 - 11;43,36;34,36;9;6139;6718;579;14966;21376;6410
10067;23.02.2017;'11 - 12;40,61;28,68;11,93;7725;7930;205;16458;23483;7025
10068;23.02.2017;'12 - 13;32,91;24,24;8,67;8382;8223;-159;18920;26362;7442
10069;23.02.2017;'13 - 14;32,4;23,35;9,05;8061;7505;-556;21227;28955;7728
10070;23.02.2017;'14 - 15;31,24;21;10,24;6859;6215;-644;23273;30929;7656
10071;23.02.2017;'15 - 16;27,68;17,61;10,07;4885;4701;-184;25379;32368;6989
10072;23.02.2017;'16 - 17;27,64;15,51;12,13;2442;2318;-124;27004;33792;6788
10073;23.02.2017;'17 - 18;32,03;22,03;10;400;400;0;27981;35235;7254
10074;23.02.2017;'18 - 19;32,93;26,15;6,78;1;4;3;28872;35822;6950
10075;23.02.2017;'19 - 20;32,09;24,3;7,79;0;0;0;29195;36294;7099
10076;23.02.2017;'20 - 21;29,79;18,03;11,76;0;0;0;29078;36823;7745
10077;23.02.2017;'21 - 22;24,07;13,19;10,88;0;0;0;29287;37275;7988
10078;23.02.2017;'22 - 23;12,03;7,26;4,77;0;0;0;29356;36846;7490
10079;23.02.2017;'23 - 24;9,27;1,86;7,41;0;0;0;29437;36397;6960
10080;24.02.2017;'00 - 01;6,93;6,14;0,79;0;0;0;36467;36452;-15
10081;24.02.2017;'01 - 02;-4,99;1,81;-6,8;0;0;0;36295;36655;360
10082;24.02.2017;'02 - 03;-27,08;-3,12;-23,96;0;0;0;35797;35752;-45
10083;24.02.2017;'03 - 04;-0,9;1,71;-2,61;0;0;0;35018;35000;-18
10084;24.02.2017;'04 - 05;7;4,51;2,49;0;0;0;33686;33656;-30
10085;24.02.2017;'05 - 06;9,49;15,53;-6,04;0;0;0;32043;32615;572
10086;24.02.2017;'06 - 07;30,04;34,87;-4,83;1;0;-1;30182;31908;1726
10087;24.02.2017;'07 - 08;33,44;36,26;-2,82;366;238;-128;27685;29887;2202
10088;24.02.2017;'08 - 09;34,3;35,03;-0,73;2620;1978;-642;24702;25965;1263
10089;24.02.2017;'09 - 10;33,91;36,51;-2,6;5792;4848;-944;21934;22794;860
10090;24.02.2017;'10 - 11;33,48;42,01;-8,53;8912;7851;-1061;19866;20790;924
10091;24.02.2017;'11 - 12;33,18;38,61;-5,43;10988;9802;-1186;18523;20014;1491
10092;24.02.2017;'12 - 13;32,49;36,62;-4,13;11766;11338;-428;17190;19364;2174
10093;24.02.2017;'13 - 14;32,41;34,23;-1,82;11396;11501;105;15994;18532;2538
10094;24.02.2017;'14 - 15;32,24;31,23;1,01;9842;10554;712;15021;17462;2441
10095;24.02.2017;'15 - 16;34,9;30,41;4,49;7107;7760;653;13954;16123;2169
10096;24.02.2017;'16 - 17;44,92;35,23;9,69;3595;4017;422;12795;14347;1552
10097;24.02.2017;'17 - 18;50,1;43,94;6,16;561;648;87;11862;12273;411
10098;24.02.2017;'18 - 19;57,52;53,88;3,64;1;5;4;11490;12688;1198
10099;24.02.2017;'19 - 20;58,19;49,39;8,8;0;0;0;11606;14256;2650
10100;24.02.2017;'20 - 21;43,94;38,22;5,72;0;0;0;11993;14507;2514
10101;24.02.2017;'21 - 22;38,06;34,16;3,9;0;0;0;12388;14530;2142
10102;24.02.2017;'22 - 23;39,68;31,48;8,2;0;0;0;12538;14690;2152
10103;24.02.2017;'23 - 24;36,66;28,33;8,33;0;0;0;12366;14337;1971
10104;25.02.2017;'00 - 01;29,28;30,04;-0,76;0;0;0;12568;13964;1396
10105;25.02.2017;'01 - 02;29,09;28,89;0,2;0;0;0;12116;13840;1724
10106;25.02.2017;'02 - 03;28,94;27,41;1,53;0;0;0;11651;13328;1677
10107;25.02.2017;'03 - 04;29,45;27,52;1,93;0;0;0;11125;12525;1400
10108;25.02.2017;'04 - 05;29,93;27,19;2,74;0;0;0;10684;12185;1501
10109;25.02.2017;'05 - 06;29,53;26,87;2,66;0;0;0;10355;11572;1217
10110;25.02.2017;'06 - 07;32,87;29,56;3,31;2;0;-2;10048;11441;1393
10111;25.02.2017;'07 - 08;41,48;34,95;6,53;646;600;-46;9656;11586;1930
10112;25.02.2017;'08 - 09;41,99;32,26;9,73;3817;4174;357;9334;11551;2217
10113;25.02.2017;'09 - 10;40,44;29,85;10,59;7922;9016;1094;9406;11324;1918
10114;25.02.2017;'10 - 11;37,13;25,84;11,29;11537;13366;1829;10215;11364;1149
10115;25.02.2017;'11 - 12;32,04;21,68;10,36;13914;15972;2058;11736;13003;1267
10116;25.02.2017;'12 - 13;29,46;17,85;11,61;14500;15982;1482;13463;15358;1895
10117;25.02.2017;'13 - 14;28,01;10,96;17,05;13266;14674;1408;15099;16958;1859
10118;25.02.2017;'14 - 15;22,86;7,76;15,1;10719;11645;926;16337;18204;1867
10119;25.02.2017;'15 - 16;28,88;9,82;19,06;7425;7821;396;17168;19036;1868
10120;25.02.2017;'16 - 17;30,16;19,51;10,65;3637;3744;107;17994;18724;730
10121;25.02.2017;'17 - 18;38;28,33;9,67;593;581;-12;19061;19117;56
10122;25.02.2017;'18 - 19;39,57;34,65;4,92;0;4;4;20566;21164;598
10123;25.02.2017;'19 - 20;34,65;31,34;3,31;0;0;0;22042;23268;1226
10124;25.02.2017;'20 - 21;26,01;18,03;7,98;0;0;0;23088;24468;1380
10125;25.02.2017;'21 - 22;12,94;10,06;2,88;0;0;0;24068;25673;1605
10126;25.02.2017;'22 - 23;11,91;12,86;-0,95;0;0;0;24766;26012;1246
10127;25.02.2017;'23 - 24;8,8;7,73;1,07;0;0;0;25111;26037;926
10128;26.02.2017;'00 - 01;7,83;10,42;-2,59;0;0;0;26968;26033;-935
10129;26.02.2017;'01 - 02;3;8,1;-5,1;0;0;0;26670;26204;-466
10130;26.02.2017;'02 - 03;4,65;9,01;-4,36;0;0;0;26243;26186;-57
10131;26.02.2017;'03 - 04;7,74;5,7;2,04;0;0;0;25726;25910;184
10132;26.02.2017;'04 - 05;8,02;0,89;7,13;0;0;0;25238;25350;112
10133;26.02.2017;'05 - 06;8,95;-1,33;10,28;0;0;0;24836;24508;-328
10134;26.02.2017;'06 - 07;7,83;1,7;6,13;0;0;0;24484;24284;-200
10135;26.02.2017;'07 - 08;7,84;4,11;3,73;292;270;-22;24191;23873;-318
10136;26.02.2017;'08 - 09;9,63;10,2;-0,57;1655;1880;225;23963;24420;457
10137;26.02.2017;'09 - 10;10,36;11,21;-0,85;3378;3983;605;23795;24337;542
10138;26.02.2017;'10 - 11;12,91;11,14;1,77;4878;6381;1503;23583;24288;705
10139;26.02.2017;'11 - 12;12,98;10,21;2,77;5960;8716;2756;23309;24138;829
10140;26.02.2017;'12 - 13;9,92;5,04;4,88;6545;9908;3363;22945;24553;1608
10141;26.02.2017;'13 - 14;9,75;-12,86;22,61;6422;9847;3425;22323;23604;1281
10142;26.02.2017;'14 - 15;9,98;-10,89;20,87;5569;8540;2971;21419;24017;2598
10143;26.02.2017;'15 - 16;10,4;-5,51;15,91;4084;6107;2023;20564;22522;1958
10144;26.02.2017;'16 - 17;12,78;8,52;4,26;2120;3190;1070;20006;20577;571
10145;26.02.2017;'17 - 18;28;29,35;-1,35;397;634;237;20022;19006;-1016
10146;26.02.2017;'18 - 19;31,76;32,63;-0,87;0;4;4;20359;18836;-1523
10147;26.02.2017;'19 - 20;30,96;32,19;-1,23;0;0;0;20923;19529;-1394
10148;26.02.2017;'20 - 21;25,34;32,17;-6,83;0;0;0;21467;20213;-1254
10149;26.02.2017;'21 - 22;23,86;27,74;-3,88;0;0;0;21847;20638;-1209
10150;26.02.2017;'22 - 23;20,86;30,47;-9,61;0;0;0;21968;19626;-2342
10151;26.02.2017;'23 - 24;10,35;24,91;-14,56;0;0;0;21815;19394;-2421
10152;27.02.2017;'00 - 01;22,01;28,18;-6,17;0;0;0;22040;19128;-2912
10153;27.02.2017;'01 - 02;15,48;27,06;-11,58;0;0;0;21764;18887;-2877
10154;27.02.2017;'02 - 03;12,54;25,76;-13,22;0;0;0;21481;19232;-2249
10155;27.02.2017;'03 - 04;15,59;21,19;-5,6;0;0;0;21032;19042;-1990
10156;27.02.2017;'04 - 05;18,84;21,22;-2,38;0;0;0;20632;18674;-1958
10157;27.02.2017;'05 - 06;30,11;29,24;0,87;0;0;0;20380;18676;-1704
10158;27.02.2017;'06 - 07;38,66;42,28;-3,62;1;0;-1;20073;19593;-480
10159;27.02.2017;'07 - 08;47,29;46,94;0,35;537;550;13;19816;19578;-238
10160;27.02.2017;'08 - 09;47,52;43,06;4,46;3015;3026;11;19687;19860;173
10161;27.02.2017;'09 - 10;39,94;39,1;0,84;6111;6483;372;19700;19660;-40
10162;27.02.2017;'10 - 11;36,87;37,76;-0,89;8741;9654;913;20412;19750;-662
10163;27.02.2017;'11 - 12;36,6;34,61;1,99;10457;12284;1827;21790;21716;-74
10164;27.02.2017;'12 - 13;30,91;25,96;4,95;11035;14033;2998;23282;23704;422
10165;27.02.2017;'13 - 14;30,58;20,58;10;10440;13748;3308;24334;23784;-550
10166;27.02.2017;'14 - 15;30,59;18,14;12,45;8880;12219;3339;24301;23557;-744
10167;27.02.2017;'15 - 16;30,83;22,49;8,34;6291;9058;2767;24127;24159;32
10168;27.02.2017;'16 - 17;32,15;25,1;7,05;3042;4591;1549;24242;24222;-20
10169;27.02.2017;'17 - 18;32,89;31,05;1,84;517;739;222;24974;23879;-1095
10170;27.02.2017;'18 - 19;34,44;41,23;-6,79;0;5;5;26174;24944;-1230
10171;27.02.2017;'19 - 20;32,46;38,33;-5,87;0;0;0;27618;27906;288
10172;27.02.2017;'20 - 21;30,62;33,84;-3,22;0;0;0;28793;29175;382
10173;27.02.2017;'21 - 22;27,05;30,59;-3,54;0;0;0;29670;30014;344
10174;27.02.2017;'22 - 23;12,96;24,42;-11,46;0;0;0;30204;29549;-655
10175;27.02.2017;'23 - 24;7,95;20,14;-12,19;0;0;0;30273;29643;-630
10176;28.02.2017;'00 - 01;7,81;18,6;-10,79;0;0;0;31193;29201;-1992
10177;28.02.2017;'01 - 02;7,89;18,55;-10,66;0;0;0;30595;28028;-2567
10178;28.02.2017;'02 - 03;7,86;19,79;-11,93;0;0;0;29699;27440;-2259
10179;28.02.2017;'03 - 04;8,56;17,27;-8,71;0;0;0;29101;27099;-2002
10180;28.02.2017;'04 - 05;9,79;17,68;-7,89;0;0;0;28694;27210;-1484
10181;28.02.2017;'05 - 06;10,34;19,16;-8,82;0;0;0;28481;28665;184
10182;28.02.2017;'06 - 07;28,99;31,17;-2,18;1;0;-1;28393;30790;2397
10183;28.02.2017;'07 - 08;32,86;31,09;1,77;454;266;-188;28250;30239;1989
10184;28.02.2017;'08 - 09;33,2;36,12;-2,92;2659;1564;-1095;28069;30229;2160
10185;28.02.2017;'09 - 10;31,02;38,14;-7,12;5779;3630;-2149;27972;30624;2652
10186;28.02.2017;'10 - 11;30,76;35,62;-4,86;8829;6359;-2470;27559;31574;4015
10187;28.02.2017;'11 - 12;30,57;32,43;-1,86;10389;8362;-2027;26328;31755;5427
10188;28.02.2017;'12 - 13;32,42;31,88;0,54;9728;8822;-906;24652;30290;5638
10189;28.02.2017;'13 - 14;39,8;37,3;2,5;8047;7887;-160;22526;27656;5130
10190;28.02.2017;'14 - 15;39,86;41,99;-2,13;5983;6419;436;20381;24243;3862
10191;28.02.2017;'15 - 16;39,17;46,78;-7,61;3886;3975;89;18648;21219;2571
10192;28.02.2017;'16 - 17;39,52;47,1;-7,58;1880;1574;-306;17441;18656;1215
10193;28.02.2017;'17 - 18;40,13;50,46;-10,33;350;244;-106;17228;17438;210
10194;28.02.2017;'18 - 19;49,2;59,99;-10,79;1;6;5;17635;17874;239
10195;28.02.2017;'19 - 20;53,12;57,99;-4,87;0;0;0;18315;17651;-664
10196;28.02.2017;'20 - 21;39,11;50,58;-11,47;0;0;0;19473;18565;-908
10197;28.02.2017;'21 - 22;38,78;45,5;-6,72;0;0;0;20887;19960;-927
10198;28.02.2017;'22 - 23;31,4;36,61;-5,21;0;0;0;21888;20272;-1616
10199;28.02.2017;'23 - 24;30,06;34,15;-4,09;0;0;0;22367;21614;-753
10200;01.03.2017;'00 - 01;31,05;24,79;6,26;0;0;0;19996;23133;3137
10201;01.03.2017;'01 - 02;29,57;22,05;7,52;0;0;0;20693;23311;2618
10202;01.03.2017;'02 - 03;28,61;24,7;3,91;0;0;0;21116;22889;1773
10203;01.03.2017;'03 - 04;25,52;24,06;1,46;0;0;0;21157;21722;565
10204;01.03.2017;'04 - 05;28,65;27,04;1,61;0;0;0;20806;20952;146
10205;01.03.2017;'05 - 06;29,98;33,88;-3,9;0;0;0;20190;20562;372
10206;01.03.2017;'06 - 07;32,4;36,78;-4,38;3;1;-2;19770;20950;1180
10207;01.03.2017;'07 - 08;41,96;50,33;-8,37;503;409;-94;19634;20343;709
10208;01.03.2017;'08 - 09;42,08;50,73;-8,65;2468;2397;-71;19902;19491;-411
10209;01.03.2017;'09 - 10;39,99;47,44;-7,45;4811;4912;101;20536;20004;-532
10210;01.03.2017;'10 - 11;39,9;44,15;-4,25;6757;6971;214;21378;21257;-121
10211;01.03.2017;'11 - 12;36,92;37,66;-0,74;8589;8420;-169;22395;21716;-679
10212;01.03.2017;'12 - 13;31,22;34,95;-3,73;10097;8852;-1245;23355;22106;-1249
10213;01.03.2017;'13 - 14;30,74;35,26;-4,52;10083;8159;-1924;23951;22471;-1480
10214;01.03.2017;'14 - 15;30,83;35,91;-5,08;8653;6982;-1671;23885;22040;-1845
10215;01.03.2017;'15 - 16;32,16;38,78;-6,62;6148;5094;-1054;23236;21319;-1917
10216;01.03.2017;'16 - 17;38,63;44,42;-5,79;3111;2460;-651;21859;19363;-2496
10217;01.03.2017;'17 - 18;46,82;53,12;-6,3;568;503;-65;20037;15742;-4295
10218;01.03.2017;'18 - 19;51,99;59,31;-7,32;2;12;10;18735;14711;-4024
10219;01.03.2017;'19 - 20;49,68;65,41;-15,73;0;0;0;18225;14443;-3782
10220;01.03.2017;'20 - 21;39,93;55,13;-15,2;0;0;0;18378;14526;-3852
10221;01.03.2017;'21 - 22;34,9;41,88;-6,98;0;0;0;18682;15178;-3504
10222;01.03.2017;'22 - 23;31,93;42,18;-10,25;0;0;0;19168;15781;-3387
10223;01.03.2017;'23 - 24;29,7;34,02;-4,32;0;0;0;19947;16180;-3767
10224;02.03.2017;'00 - 01;29,73;34;-4,27;0;0;0;17493;16484;-1009
10225;02.03.2017;'01 - 02;29,49;32,62;-3,13;0;0;0;18192;16758;-1434
10226;02.03.2017;'02 - 03;25,99;30,49;-4,5;0;0;0;19303;17646;-1657
10227;02.03.2017;'03 - 04;26;30,41;-4,41;0;0;0;20739;18626;-2113
10228;02.03.2017;'04 - 05;26,17;29,21;-3,04;0;0;0;22343;19739;-2604
10229;02.03.2017;'05 - 06;26,04;32,81;-6,77;0;0;0;24490;21166;-3324
10230;02.03.2017;'06 - 07;31,04;35,58;-4,54;2;1;-1;26595;23329;-3266
10231;02.03.2017;'07 - 08;33,57;44,94;-11,37;499;492;-7;28393;25980;-2413
10232;02.03.2017;'08 - 09;34,19;42,71;-8,52;2776;2933;157;30234;28177;-2057
10233;02.03.2017;'09 - 10;30,85;36,19;-5,34;5716;6718;1002;31911;29877;-2034
10234;02.03.2017;'10 - 11;26;29,27;-3,27;8705;10055;1350;33197;31628;-1569
10235;02.03.2017;'11 - 12;25,08;23,38;1,7;11300;12309;1009;33928;32819;-1109
10236;02.03.2017;'12 - 13;12,63;17,53;-4,9;12480;12936;456;34445;33580;-865
10237;02.03.2017;'13 - 14;10,45;20,86;-10,41;11993;11949;-44;34470;34714;244
10238;02.03.2017;'14 - 15;10,48;19,24;-8,76;10459;9859;-600;33921;34892;971
10239;02.03.2017;'15 - 16;25,01;25,61;-0,6;7815;7257;-558;33020;34402;1382
10240;02.03.2017;'16 - 17;25,92;27,76;-1,84;4187;3791;-396;31616;32626;1010
10241;02.03.2017;'17 - 18;32,17;33,83;-1,66;869;846;-23;29899;30352;453
10242;02.03.2017;'18 - 19;39,9;41,86;-1,96;6;13;7;28262;27818;-444
10243;02.03.2017;'19 - 20;38,91;41,87;-2,96;0;0;0;26960;26666;-294
10244;02.03.2017;'20 - 21;31,95;39,68;-7,73;0;0;0;26218;25963;-255
10245;02.03.2017;'21 - 22;30,47;32,82;-2,35;0;0;0;25577;25393;-184
10246;02.03.2017;'22 - 23;29,25;30,44;-1,19;0;0;0;24815;24428;-387
10247;02.03.2017;'23 - 24;25,07;25,44;-0,37;0;0;0;23867;22854;-1013
10248;03.03.2017;'00 - 01;27,02;27,23;-0,21;0;0;0;21233;21359;126
10249;03.03.2017;'01 - 02;26,47;28,43;-1,96;0;0;0;19798;19239;-559
10250;03.03.2017;'02 - 03;26,03;28,47;-2,44;0;0;0;18191;17259;-932
10251;03.03.2017;'03 - 04;28,99;28,52;0,47;0;0;0;16786;15915;-871
10252;03.03.2017;'04 - 05;30,91;28,71;2,2;0;0;0;15824;15106;-718
10253;03.03.2017;'05 - 06;32,36;30,39;1,97;0;0;0;15445;16103;658
10254;03.03.2017;'06 - 07;41,91;36,35;5,56;6;4;-2;15289;17804;2515
10255;03.03.2017;'07 - 08;48;40,66;7,34;1216;1284;68;14845;18240;3395
10256;03.03.2017;'08 - 09;47,57;38,49;9,08;5129;5738;609;13725;16994;3269
10257;03.03.2017;'09 - 10;46,5;35,76;10,74;9087;10260;1173;12351;13997;1646
10258;03.03.2017;'10 - 11;43,49;36,24;7,25;11983;13521;1538;11255;11985;730
10259;03.03.2017;'11 - 12;43,47;35,13;8,34;13473;15120;1647;10473;11612;1139
10260;03.03.2017;'12 - 13;41,02;33,33;7,69;13333;14907;1574;9720;11750;2030
10261;03.03.2017;'13 - 14;39,83;34,08;5,75;11774;13020;1246;8898;11153;2255
10262;03.03.2017;'14 - 15;39,1;35,82;3,28;9396;10112;716;8111;9460;1349
10263;03.03.2017;'15 - 16;38,6;37,62;0,98;6574;6939;365;7657;8663;1006
10264;03.03.2017;'16 - 17;40,97;40,15;0,82;3352;3164;-188;8205;8230;25
10265;03.03.2017;'17 - 18;41,91;40,68;1,23;683;584;-99;10131;8664;-1467
10266;03.03.2017;'18 - 19;42,18;43,67;-1,49;4;10;6;12444;10432;-2012
10267;03.03.2017;'19 - 20;44,95;46,47;-1,52;0;0;0;14179;11776;-2403
10268;03.03.2017;'20 - 21;41,01;43,43;-2,42;0;0;0;14932;12844;-2088
10269;03.03.2017;'21 - 22;35,29;38,6;-3,31;0;0;0;15263;13761;-1502
10270;03.03.2017;'22 - 23;36,25;39,52;-3,27;0;0;0;15209;14150;-1059
10271;03.03.2017;'23 - 24;34,56;36,26;-1,7;0;0;0;14849;14454;-395
10272;04.03.2017;'00 - 01;31,6;30,86;0,74;0;0;0;13013;14288;1275
10273;04.03.2017;'01 - 02;30,25;28,93;1,32;0;0;0;12904;14285;1381
10274;04.03.2017;'02 - 03;30,04;29,3;0,74;0;0;0;12809;13766;957
10275;04.03.2017;'03 - 04;28,44;30,19;-1,75;0;0;0;12740;12844;104
10276;04.03.2017;'04 - 05;28,26;30,14;-1,88;0;0;0;12755;12821;66
10277;04.03.2017;'05 - 06;29,22;32,39;-3,17;0;0;0;12833;12738;-95
10278;04.03.2017;'06 - 07;28,16;28,11;0,05;9;8;-1;12847;12373;-474
10279;04.03.2017;'07 - 08;30;34,11;-4,11;1542;1532;-10;12439;11973;-466
10280;04.03.2017;'08 - 09;33,96;39,7;-5,74;6244;5998;-246;11478;11198;-280
10281;04.03.2017;'09 - 10;39,34;40,56;-1,22;11261;11232;-29;10343;8594;-1749
10282;04.03.2017;'10 - 11;36,73;40,7;-3,97;15133;14607;-526;9086;6180;-2906
10283;04.03.2017;'11 - 12;36,69;42,39;-5,7;17094;15456;-1638;7963;5167;-2796
10284;04.03.2017;'12 - 13;33,76;42,68;-8,92;16948;15705;-1243;7193;4649;-2544
10285;04.03.2017;'13 - 14;31,44;42,21;-10,77;15044;13890;-1154;6918;4729;-2189
10286;04.03.2017;'14 - 15;31,81;42,02;-10,21;11882;10514;-1368;7323;4770;-2553
10287;04.03.2017;'15 - 16;33,67;41,02;-7,35;7929;6929;-1000;8127;5024;-3103
10288;04.03.2017;'16 - 17;34,9;40,34;-5,44;3909;3337;-572;9439;6308;-3131
10289;04.03.2017;'17 - 18;40,44;45,34;-4,9;790;730;-60;11583;8726;-2857
10290;04.03.2017;'18 - 19;44,69;49,7;-5,01;6;11;5;13602;11753;-1849
10291;04.03.2017;'19 - 20;47,25;50,49;-3,24;0;0;0;14796;13085;-1711
10292;04.03.2017;'20 - 21;42,01;47,86;-5,85;0;0;0;15763;13003;-2760
10293;04.03.2017;'21 - 22;35,07;40,55;-5,48;0;0;0;16714;13627;-3087
10294;04.03.2017;'22 - 23;31,87;39,63;-7,76;0;0;0;17457;13842;-3615
10295;04.03.2017;'23 - 24;22,68;33,35;-10,67;0;0;0;18357;14844;-3513
10296;05.03.2017;'00 - 01;21,11;29,77;-8,66;0;0;0;16385;16955;570
10297;05.03.2017;'01 - 02;15,44;22,97;-7,53;0;0;0;17804;19394;1590
10298;05.03.2017;'02 - 03;11,56;15,38;-3,82;0;0;0;18829;21624;2795
10299;05.03.2017;'03 - 04;10,6;4,44;6,16;0;0;0;19774;20732;958
10300;05.03.2017;'04 - 05;9,84;2,52;7,32;0;0;0;20214;20184;-30
10301;05.03.2017;'05 - 06;8,06;3,92;4,14;0;0;0;20052;19193;-859
10302;05.03.2017;'06 - 07;9,83;10,71;-0,88;8;6;-2;20022;18922;-1100
10303;05.03.2017;'07 - 08;9,13;15,98;-6,85;789;593;-196;20330;19652;-678
10304;05.03.2017;'08 - 09;9,88;16,72;-6,84;3207;2520;-687;20899;18862;-2037
10305;05.03.2017;'09 - 10;11,32;24,79;-13,47;6142;5420;-722;21556;18185;-3371
10306;05.03.2017;'10 - 11;9,97;30,51;-20,54;8976;8489;-487;21903;19028;-2875
10307;05.03.2017;'11 - 12;10;27,77;-17,77;11307;11353;46;21290;19358;-1932
10308;05.03.2017;'12 - 13;10,8;20,68;-9,88;12632;12430;-202;20187;19409;-778
10309;05.03.2017;'13 - 14;9,96;14,26;-4,3;12523;11781;-742;18527;17500;-1027
10310;05.03.2017;'14 - 15;9,4;17,59;-8,19;10774;10290;-484;16319;14735;-1584
10311;05.03.2017;'15 - 16;9,96;20,88;-10,92;7582;7583;1;14311;12188;-2123
10312;05.03.2017;'16 - 17;17,22;29,51;-12,29;3816;3840;24;13015;9570;-3445
10313;05.03.2017;'17 - 18;30,03;39,46;-9,43;790;723;-67;12965;8303;-4662
10314;05.03.2017;'18 - 19;33,69;47,41;-13,72;6;18;12;13902;9259;-4643
10315;05.03.2017;'19 - 20;37,95;49,61;-11,66;0;0;0;15076;10656;-4420
10316;05.03.2017;'20 - 21;35,02;47,45;-12,43;0;0;0;15769;11463;-4306
10317;05.03.2017;'21 - 22;32,85;39,68;-6,83;0;0;0;15997;12466;-3531
10318;05.03.2017;'22 - 23;32,92;40,67;-7,75;0;0;0;15633;12256;-3377
10319;05.03.2017;'23 - 24;31,67;38,73;-7,06;0;0;0;14814;11787;-3027
10320;06.03.2017;'00 - 01;31,24;29,3;1,94;0;0;0;11353;11059;-294
10321;06.03.2017;'01 - 02;29,04;29,21;-0,17;0;0;0;10718;10505;-213
10322;06.03.2017;'02 - 03;27,99;27,65;0,34;0;0;0;10352;9874;-478
10323;06.03.2017;'03 - 04;25,35;25,42;-0,07;0;0;0;10083;9949;-134
10324;06.03.2017;'04 - 05;27,3;26,5;0,8;0;0;0;9853;10048;195
10325;06.03.2017;'05 - 06;29,07;27,82;1,25;0;0;0;9630;10012;382
10326;06.03.2017;'06 - 07;34,98;35,26;-0,28;8;10;2;9547;10542;995
10327;06.03.2017;'07 - 08;42,4;45,13;-2,73;720;673;-47;9633;10443;810
10328;06.03.2017;'08 - 09;44,28;45,89;-1,61;2720;2572;-148;9782;10359;577
10329;06.03.2017;'09 - 10;47,03;45,64;1,39;4857;5155;298;9935;9922;-13
10330;06.03.2017;'10 - 11;46,58;45,36;1,22;6674;7026;352;9902;9891;-11
10331;06.03.2017;'11 - 12;46,36;44,7;1,66;8127;7532;-595;9540;9774;234
10332;06.03.2017;'12 - 13;43,92;46,87;-2,95;8896;7672;-1224;9158;9646;488
10333;06.03.2017;'13 - 14;39,9;46,54;-6,64;8771;7448;-1323;8753;9278;525
10334;06.03.2017;'14 - 15;36,07;42,9;-6,83;7651;6289;-1362;8401;8893;492
10335;06.03.2017;'15 - 16;39,9;43,41;-3,51;5639;4557;-1082;8176;9243;1067
10336;06.03.2017;'16 - 17;42,91;44,96;-2,05;3040;2549;-491;8118;9506;1388
10337;06.03.2017;'17 - 18;46,15;45,17;0,98;698;656;-42;8234;10148;1914
10338;06.03.2017;'18 - 19;49,59;47,32;2,27;8;18;10;8519;10564;2045
10339;06.03.2017;'19 - 20;51,66;47,61;4,05;0;0;0;8772;11362;2590
10340;06.03.2017;'20 - 21;46,05;39,3;6,75;0;0;0;8766;11781;3015
10341;06.03.2017;'21 - 22;37,4;32,2;5,2;0;0;0;8591;11751;3160
10342;06.03.2017;'22 - 23;35;31,57;3,43;0;0;0;8315;11106;2791
10343;06.03.2017;'23 - 24;31,93;29,82;2,11;0;0;0;7972;10423;2451
10344;07.03.2017;'00 - 01;31,07;31,35;-0,28;0;0;0;8693;9759;1066
10345;07.03.2017;'01 - 02;30,01;32,19;-2,18;0;0;0;8468;9292;824
10346;07.03.2017;'02 - 03;29,99;31,53;-1,54;0;0;0;8419;9153;734
10347;07.03.2017;'03 - 04;29,64;30,52;-0,88;0;0;0;8215;8576;361
10348;07.03.2017;'04 - 05;30,6;31,3;-0,7;0;0;0;7936;8165;229
10349;07.03.2017;'05 - 06;32,98;33,88;-0,9;0;0;0;7504;7714;210
10350;07.03.2017;'06 - 07;36;35,97;0,03;5;7;2;7016;7197;181
10351;07.03.2017;'07 - 08;50,19;49,19;1;384;311;-73;6431;6395;-36
10352;07.03.2017;'08 - 09;54,25;57,41;-3,16;1513;1409;-104;5768;5295;-473
10353;07.03.2017;'09 - 10;54,1;57,1;-3;2928;2866;-62;5120;4198;-922
10354;07.03.2017;'10 - 11;53,93;53,54;0,39;4218;4100;-118;4532;3279;-1253
10355;07.03.2017;'11 - 12;51,54;51,49;0,05;5251;5182;-69;4039;2730;-1309
10356;07.03.2017;'12 - 13;49,9;50,36;-0,46;5782;5984;202;3679;2466;-1213
10357;07.03.2017;'13 - 14;49,07;48,62;0,45;5732;6582;850;3496;2172;-1324
10358;07.03.2017;'14 - 15;48,69;48,43;0,26;5093;6324;1231;3397;2248;-1149
10359;07.03.2017;'15 - 16;47,75;48,65;-0,9;3958;4950;992;3285;2190;-1095
10360;07.03.2017;'16 - 17;48;48,86;-0,86;2286;2850;564;3001;1892;-1109
10361;07.03.2017;'17 - 18;50,31;54,6;-4,29;591;774;183;2563;1783;-780
10362;07.03.2017;'18 - 19;57,52;68,6;-11,08;10;20;10;2174;1414;-760
10363;07.03.2017;'19 - 20;61,05;65,73;-4,68;0;0;0;1920;1356;-564
10364;07.03.2017;'20 - 21;51,93;53,76;-1,83;0;0;0;1798;1580;-218
10365;07.03.2017;'21 - 22;43,93;43,83;0,1;0;0;0;1780;1887;107
10366;07.03.2017;'22 - 23;41,94;44,38;-2,44;0;0;0;1885;2224;339
10367;07.03.2017;'23 - 24;33,73;33,69;0,04;0;0;0;2112;2744;632
10368;08.03.2017;'00 - 01;33,98;34,76;-0,78;0;0;0;2411;3013;602
10369;08.03.2017;'01 - 02;32,76;33,29;-0,53;0;0;0;2698;3438;740
10370;08.03.2017;'02 - 03;32;32,02;-0,02;0;0;0;3214;4121;907
10371;08.03.2017;'03 - 04;31,38;29,62;1,76;0;0;0;3804;5172;1368
10372;08.03.2017;'04 - 05;31,2;29,66;1,54;0;0;0;4639;6519;1880
10373;08.03.2017;'05 - 06;32,06;29,56;2,5;0;0;0;5873;7665;1792
10374;08.03.2017;'06 - 07;41,04;35,32;5,72;15;16;1;7293;9412;2119
10375;08.03.2017;'07 - 08;49,61;42,36;7,25;886;958;72;8724;11041;2317
10376;08.03.2017;'08 - 09;49,93;45,05;4,88;3489;3526;37;10082;12800;2718
10377;08.03.2017;'09 - 10;43,44;39,97;3,47;6136;6396;260;11669;14164;2495
10378;08.03.2017;'10 - 11;41;31,26;9,74;7939;8325;386;13880;15752;1872
10379;08.03.2017;'11 - 12;38,1;30,43;7,67;8440;9462;1022;16739;18236;1497
10380;08.03.2017;'12 - 13;34,16;29,25;4,91;7712;8708;996;19727;20324;597
10381;08.03.2017;'13 - 14;33,65;30,89;2,76;6151;6707;556;21854;22813;959
10382;08.03.2017;'14 - 15;35,01;31,85;3,16;4224;4992;768;22491;24263;1772
10383;08.03.2017;'15 - 16;33,7;32,94;0,76;2587;3224;637;22816;24001;1185
10384;08.03.2017;'16 - 17;34,03;33,43;0,6;1241;1402;161;22767;22985;218
10385;08.03.2017;'17 - 18;35,74;38,98;-3,24;297;243;-54;22493;22294;-199
10386;08.03.2017;'18 - 19;42,05;46,31;-4,26;3;1;-2;22469;21456;-1013
10387;08.03.2017;'19 - 20;42;45,35;-3,35;0;0;0;21991;19614;-2377
10388;08.03.2017;'20 - 21;34,15;39,18;-5,03;0;0;0;21047;18321;-2726
10389;08.03.2017;'21 - 22;31,85;36,54;-4,69;0;0;0;20169;16692;-3477
10390;08.03.2017;'22 - 23;32,14;35,41;-3,27;0;0;0;19052;15187;-3865
10391;08.03.2017;'23 - 24;28,97;31,27;-2,3;0;0;0;17704;14130;-3574
10392;09.03.2017;'00 - 01;30,66;30,23;0,43;0;0;0;12502;12236;-266
10393;09.03.2017;'01 - 02;30,56;30,19;0,37;0;0;0;11265;10208;-1057
10394;09.03.2017;'02 - 03;29,78;31,14;-1,36;0;0;0;10452;9090;-1362
10395;09.03.2017;'03 - 04;29,3;31,51;-2,21;0;0;0;9845;8352;-1493
10396;09.03.2017;'04 - 05;29,28;30,58;-1,3;0;0;0;9346;7960;-1386
10397;09.03.2017;'05 - 06;31,12;32,52;-1,4;0;0;0;8788;7397;-1391
10398;09.03.2017;'06 - 07;41,59;39,84;1,75;12;10;-2;8220;6793;-1427
10399;09.03.2017;'07 - 08;48,67;48,84;-0,17;527;636;109;7699;6334;-1365
10400;09.03.2017;'08 - 09;50,02;50,99;-0,97;1902;2374;472;7336;6383;-953
10401;09.03.2017;'09 - 10;49,02;46,34;2,68;3738;4715;977;7181;6452;-729
10402;09.03.2017;'10 - 11;48,62;43,93;4,69;5641;6057;416;7445;7143;-302
10403;09.03.2017;'11 - 12;47,16;43,82;3,34;7285;6390;-895;8194;8096;-98
10404;09.03.2017;'12 - 13;43,82;42,13;1,69;8025;6774;-1251;9061;9163;102
10405;09.03.2017;'13 - 14;41,85;41,91;-0,06;7759;6884;-875;9967;10502;535
10406;09.03.2017;'14 - 15;38,09;39,07;-0,98;6476;6026;-450;10963;12770;1807
10407;09.03.2017;'15 - 16;36,69;35,13;1,56;4577;4816;239;11969;15945;3976
10408;09.03.2017;'16 - 17;35,3;31,43;3,87;2508;2807;299;12885;18118;5233
10409;09.03.2017;'17 - 18;41,47;32,34;9,13;649;917;268;13905;20004;6099
10410;09.03.2017;'18 - 19;44,82;34,18;10,64;10;20;10;15135;21940;6805
10411;09.03.2017;'19 - 20;42,84;31,95;10,89;0;0;0;16466;24498;8032
10412;09.03.2017;'20 - 21;33,34;28,06;5,28;0;0;0;17886;26524;8638
10413;09.03.2017;'21 - 22;33,02;21,91;11,11;0;0;0;19267;27336;8069
10414;09.03.2017;'22 - 23;31,51;23,59;7,92;0;0;0;20058;26691;6633
10415;09.03.2017;'23 - 24;28,82;21,9;6,92;0;0;0;20159;25754;5595
10416;10.03.2017;'00 - 01;20,82;18,27;2,55;0;0;0;23139;25142;2003
10417;10.03.2017;'01 - 02;18,18;14,98;3,2;0;0;0;22439;24283;1844
10418;10.03.2017;'02 - 03;12,01;13,75;-1,74;0;0;0;21796;23327;1531
10419;10.03.2017;'03 - 04;18,09;16,64;1,45;0;0;0;21006;22441;1435
10420;10.03.2017;'04 - 05;26,96;21,28;5,68;0;0;0;19934;21304;1370
10421;10.03.2017;'05 - 06;28,59;29,12;-0,53;0;0;0;18761;19378;617
10422;10.03.2017;'06 - 07;31,9;36,38;-4,48;21;19;-2;17708;18373;665
10423;10.03.2017;'07 - 08;41,98;44,53;-2,55;1006;1057;51;17048;16938;-110
10424;10.03.2017;'08 - 09;41,93;42,37;-0,44;3745;4213;468;16849;15601;-1248
10425;10.03.2017;'09 - 10;36,96;38,41;-1,45;7033;8058;1025;16837;14821;-2016
10426;10.03.2017;'10 - 11;33,02;34,02;-1;9933;11109;1176;16718;14833;-1885
10427;10.03.2017;'11 - 12;32,09;34,13;-2,04;12152;13840;1688;16283;14543;-1740
10428;10.03.2017;'12 - 13;31,51;32,34;-0,83;13588;15813;2225;15626;14194;-1432
10429;10.03.2017;'13 - 14;31,31;31,02;0,29;13799;16071;2272;14829;13644;-1185
10430;10.03.2017;'14 - 15;31,26;29,91;1,35;12693;14348;1655;13713;12908;-805
10431;10.03.2017;'15 - 16;32,11;30,81;1,3;9702;10864;1162;12308;11336;-972
10432;10.03.2017;'16 - 17;36,07;35,04;1,03;5559;6312;753;10586;9479;-1107
10433;10.03.2017;'17 - 18;40,37;42,75;-2,38;1513;1812;299;8655;6518;-2137
10434;10.03.2017;'18 - 19;49,17;53,84;-4,67;30;30;0;7014;4634;-2380
10435;10.03.2017;'19 - 20;53,56;59,66;-6,1;0;0;0;5978;4242;-1736
10436;10.03.2017;'20 - 21;45,88;48,5;-2,62;0;0;0;5479;3939;-1540
10437;10.03.2017;'21 - 22;39,67;41,55;-1,88;0;0;0;5022;3825;-1197
10438;10.03.2017;'22 - 23;37,71;37,42;0,29;0;0;0;4549;3744;-805
10439;10.03.2017;'23 - 24;34,25;32,27;1,98;0;0;0;4125;3780;-345
10440;11.03.2017;'00 - 01;33,02;33,34;-0,32;0;0;0;3440;3844;404
10441;11.03.2017;'01 - 02;31,24;30,68;0,56;0;0;0;3332;3812;480
10442;11.03.2017;'02 - 03;30,13;30,4;-0,27;0;0;0;3245;3935;690
10443;11.03.2017;'03 - 04;29,64;28,13;1,51;0;0;0;3180;3767;587
10444;11.03.2017;'04 - 05;29,07;27,76;1,31;0;0;0;3119;3826;707
10445;11.03.2017;'05 - 06;30;29,15;0,85;0;0;0;3036;3871;835
10446;11.03.2017;'06 - 07;31,77;30,78;0,99;59;52;-7;2943;3885;942
10447;11.03.2017;'07 - 08;32,4;32,07;0,33;2125;1806;-319;2753;3840;1087
10448;11.03.2017;'08 - 09;35;32,8;2,2;6735;5856;-879;2446;3347;901
10449;11.03.2017;'09 - 10;35,05;36,45;-1,4;11322;11132;-190;2141;2535;394
10450;11.03.2017;'10 - 11;33;32,34;0,66;14875;15066;191;1947;2074;127
10451;11.03.2017;'11 - 12;31,41;29,14;2,27;16946;17694;748;1918;2231;313
10452;11.03.2017;'12 - 13;31,07;28,11;2,96;17628;18492;864;1963;2349;386
10453;11.03.2017;'13 - 14;30,19;26,85;3,34;16907;17269;362;2073;2384;311
10454;11.03.2017;'14 - 15;29,85;27,41;2,44;14725;14472;-253;2269;2688;419
10455;11.03.2017;'15 - 16;29,98;27,51;2,47;11008;10284;-724;2533;3491;958
10456;11.03.2017;'16 - 17;30,81;27,37;3,44;6168;5553;-615;3180;4361;1181
10457;11.03.2017;'17 - 18;34,66;31,62;3,04;1666;1562;-104;4556;5091;535
10458;11.03.2017;'18 - 19;43,97;37,43;6,54;32;32;0;6323;7361;1038
10459;11.03.2017;'19 - 20;45,91;37,62;8,29;0;0;0;8042;9719;1677
10460;11.03.2017;'20 - 21;38,1;31,73;6,37;0;0;0;9228;11622;2394
10461;11.03.2017;'21 - 22;32,26;24,4;7,86;0;0;0;10117;13499;3382
10462;11.03.2017;'22 - 23;32,11;22,67;9,44;0;0;0;10576;14338;3762
10463;11.03.2017;'23 - 24;30,05;20,15;9,9;0;0;0;10603;14570;3967
10464;12.03.2017;'00 - 01;27,9;13,49;14,41;0;0;0;12280;14373;2093
10465;12.03.2017;'01 - 02;25,4;11,96;13,44;0;0;0;12002;13631;1629
10466;12.03.2017;'02 - 03;20,36;14,07;6,29;0;0;0;11882;13864;1982
10467;12.03.2017;'03 - 04;13,92;11,7;2,22;0;0;0;11849;14361;2512
10468;12.03.2017;'04 - 05;10,88;9,7;1,18;0;0;0;12047;14731;2684
10469;12.03.2017;'05 - 06;11,95;9,36;2,59;0;0;0;12477;14833;2356
10470;12.03.2017;'06 - 07;13,92;9,56;4,36;85;85;0;12869;15235;2366
10471;12.03.2017;'07 - 08;11,21;9,39;1,82;2434;2786;352;12788;15197;2409
10472;12.03.2017;'08 - 09;10,97;8,86;2,11;7838;8495;657;11995;13721;1726
10473;12.03.2017;'09 - 10;13,28;9,8;3,48;13451;14407;956;11207;11505;298
10474;12.03.2017;'10 - 11;10,18;11;-0,82;17660;18596;936;10861;10743;-118
10475;12.03.2017;'11 - 12;15,63;10,66;4,97;20044;20784;740;11021;11990;969
10476;12.03.2017;'12 - 13;9,6;9,82;-0,22;20679;21356;677;11222;13048;1826
10477;12.03.2017;'13 - 14;12,21;9,34;2,87;19553;20152;599;11223;12821;1598
10478;12.03.2017;'14 - 15;9,55;7,66;1,89;16697;17332;635;10983;12443;1460
10479;12.03.2017;'15 - 16;11,93;8,13;3,8;12413;12680;267;10853;12274;1421
10480;12.03.2017;'16 - 17;11;8,29;2,71;7025;7061;36;11196;12101;905
10481;12.03.2017;'17 - 18;26,9;15,59;11,31;1973;1963;-10;12215;12138;-77
10482;12.03.2017;'18 - 19;31,15;30,41;0,74;42;44;2;13512;13672;160
10483;12.03.2017;'19 - 20;31,35;33,38;-2,03;0;0;0;14289;15471;1182
10484;12.03.2017;'20 - 21;30,69;31,61;-0,92;0;0;0;14172;15600;1428
10485;12.03.2017;'21 - 22;30,62;29,04;1,58;0;0;0;13736;15054;1318
10486;12.03.2017;'22 - 23;30,4;30,64;-0,24;0;0;0;12973;13869;896
10487;12.03.2017;'23 - 24;29,34;28,79;0,55;0;0;0;11856;12480;624
10488;13.03.2017;'00 - 01;27,04;25,52;1,52;0;0;0;11252;11350;98
10489;13.03.2017;'01 - 02;26,82;25,41;1,41;0;0;0;9840;10464;624
10490;13.03.2017;'02 - 03;26,9;24,55;2,35;0;0;0;8616;9507;891
10491;13.03.2017;'03 - 04;27,02;23,44;3,58;0;0;0;7499;8314;815
10492;13.03.2017;'04 - 05;27,77;22,23;5,54;0;0;0;6598;7522;924
10493;13.03.2017;'05 - 06;29,64;26,09;3,55;0;0;0;5948;6948;1000
10494;13.03.2017;'06 - 07;33,83;32,49;1,34;116;114;-2;5262;6660;1398
10495;13.03.2017;'07 - 08;41;38,53;2,47;2902;2856;-46;4345;6153;1808
10496;13.03.2017;'08 - 09;42,86;41,36;1,5;8559;8212;-347;3191;4706;1515
10497;13.03.2017;'09 - 10;40;36,79;3,21;14206;14030;-176;2120;2720;600
10498;13.03.2017;'10 - 11;34,57;34,64;-0,07;18472;18227;-245;1418;1795;377
10499;13.03.2017;'11 - 12;32,89;32,09;0,8;20706;20542;-164;1222;1450;228
10500;13.03.2017;'12 - 13;31,97;31,75;0,22;20730;21035;305;1131;1513;382
10501;13.03.2017;'13 - 14;32,2;31,99;0,21;18932;19134;202;1100;1472;372
10502;13.03.2017;'14 - 15;31,7;34,45;-2,75;15654;15073;-581;1188;1508;320
10503;13.03.2017;'15 - 16;32;34,68;-2,68;11191;9434;-1757;1348;1936;588
10504;13.03.2017;'16 - 17;36,61;36,51;0,1;6144;4848;-1296;1589;2099;510
10505;13.03.2017;'17 - 18;41,82;38,78;3,04;1784;1508;-276;1974;2480;506
10506;13.03.2017;'18 - 19;49,9;46,73;3,17;45;38;-7;2438;3090;652
10507;13.03.2017;'19 - 20;56,99;49,69;7,3;0;0;0;3003;3854;851
10508;13.03.2017;'20 - 21;49,51;42,55;6,96;0;0;0;3619;4376;757
10509;13.03.2017;'21 - 22;44,94;36,29;8,65;0;0;0;4149;4621;472
10510;13.03.2017;'22 - 23;39,96;33,38;6,58;0;0;0;4493;4604;111
10511;13.03.2017;'23 - 24;33,55;31,4;2,15;0;0;0;4693;5004;311
10512;14.03.2017;'00 - 01;29,58;30,36;-0,78;0;0;0;5846;5200;-646
10513;14.03.2017;'01 - 02;28,61;26,91;1,7;0;0;0;6407;5503;-904
10514;14.03.2017;'02 - 03;27,73;26,4;1,33;0;0;0;6987;6379;-608
10515;14.03.2017;'03 - 04;27,75;25,3;2,45;0;0;0;7325;7152;-173
10516;14.03.2017;'04 - 05;28,43;25,89;2,54;0;0;0;7551;7627;76
10517;14.03.2017;'05 - 06;29,49;27,05;2,44;0;0;0;7711;7989;278
10518;14.03.2017;'06 - 07;37,72;34,07;3,65;75;86;11;7854;8500;646
10519;14.03.2017;'07 - 08;44,92;42,28;2,64;1677;1755;78;7851;8797;946
10520;14.03.2017;'08 - 09;47,1;46,91;0,19;5044;5024;-20;7702;7918;216
10521;14.03.2017;'09 - 10;43,97;40,75;3,22;8718;9313;595;7686;7171;-515
10522;14.03.2017;'10 - 11;41,93;37,95;3,98;12087;13241;1154;8141;7812;-329
10523;14.03.2017;'11 - 12;37,19;30,81;6,38;14528;16255;1727;9181;9072;-109
10524;14.03.2017;'12 - 13;31,08;28,67;2,41;15644;17120;1476;10409;10660;251
10525;14.03.2017;'13 - 14;30,08;28,29;1,79;15420;16270;850;11598;11966;368
10526;14.03.2017;'14 - 15;30,08;28,77;1,31;13614;13868;254;12327;13196;869
10527;14.03.2017;'15 - 16;30,16;28,6;1,56;10197;9717;-480;12762;13984;1222
10528;14.03.2017;'16 - 17;35;31,86;3,14;5819;5239;-580;13065;13721;656
10529;14.03.2017;'17 - 18;41,15;36,29;4,86;1769;1590;-179;13435;13508;73
10530;14.03.2017;'18 - 19;45,58;41,2;4,38;47;42;-5;14096;14530;434
10531;14.03.2017;'19 - 20;45,46;38,7;6,76;0;0;0;15127;16248;1121
10532;14.03.2017;'20 - 21;35,85;33,67;2,18;0;0;0;16342;17536;1194
10533;14.03.2017;'21 - 22;28,99;29,09;-0,1;0;0;0;17407;18390;983
10534;14.03.2017;'22 - 23;28,08;27,9;0,18;0;0;0;17963;18474;511
10535;14.03.2017;'23 - 24;23,44;24,17;-0,73;0;0;0;18043;18185;142
10536;15.03.2017;'00 - 01;22,21;21,98;0,23;0;0;0;17384;17846;462
10537;15.03.2017;'01 - 02;21,14;19,02;2,12;0;0;0;16915;17373;458
10538;15.03.2017;'02 - 03;18,65;17,34;1,31;0;0;0;16283;17212;929
10539;15.03.2017;'03 - 04;20,16;18,14;2,02;0;0;0;15625;17028;1403
10540;15.03.2017;'04 - 05;24,03;20,91;3,12;0;0;0;14819;16626;1807
10541;15.03.2017;'05 - 06;28,05;21,67;6,38;0;0;0;13768;15354;1586
10542;15.03.2017;'06 - 07;34,96;27,3;7,66;92;104;12;12778;14066;1288
10543;15.03.2017;'07 - 08;40,98;31,76;9,22;1701;1912;211;12064;12033;-31
10544;15.03.2017;'08 - 09;40,97;36,99;3,98;4811;5118;307;11774;11106;-668
10545;15.03.2017;'09 - 10;38,99;39,07;-0,08;8015;8923;908;11884;10814;-1070
10546;15.03.2017;'10 - 11;34,94;34,11;0,83;10672;12763;2091;12495;10756;-1739
10547;15.03.2017;'11 - 12;33,07;32,32;0,75;12467;15690;3223;13572;11368;-2204
10548;15.03.2017;'12 - 13;32,14;30,47;1,67;13069;16950;3881;14724;12772;-1952
10549;15.03.2017;'13 - 14;31,5;28,08;3,42;12562;16896;4334;15393;14075;-1318
10550;15.03.2017;'14 - 15;31,42;26,86;4,56;10901;15033;4132;15299;14756;-543
10551;15.03.2017;'15 - 16;32,4;27,6;4,8;8191;11318;3127;14766;14464;-302
10552;15.03.2017;'16 - 17;33,06;29,67;3,39;4864;6752;1888;13767;13337;-430
10553;15.03.2017;'17 - 18;41;37,16;3,84;1582;2124;542;12400;11162;-1238
10554;15.03.2017;'18 - 19;47,97;41,9;6,07;53;78;25;11325;9978;-1347
10555;15.03.2017;'19 - 20;52,09;46,88;5,21;0;0;0;10840;10376;-464
10556;15.03.2017;'20 - 21;43,9;38,77;5,13;0;0;0;10689;11258;569
10557;15.03.2017;'21 - 22;38,1;33,23;4,87;0;0;0;10588;11433;845
10558;15.03.2017;'22 - 23;34,82;31,02;3,8;0;0;0;10517;11217;700
10559;15.03.2017;'23 - 24;31,59;29,92;1,67;0;0;0;10464;11208;744
10560;16.03.2017;'00 - 01;29,99;30,2;-0,21;0;0;0;9371;10353;982
10561;16.03.2017;'01 - 02;29,84;28,82;1,02;0;0;0;9252;9785;533
10562;16.03.2017;'02 - 03;28,14;27,96;0,18;0;0;0;9226;10052;826
10563;16.03.2017;'03 - 04;28,29;25,81;2,48;0;0;0;9183;10031;848
10564;16.03.2017;'04 - 05;29,37;25,79;3,58;0;0;0;9210;9742;532
10565;16.03.2017;'05 - 06;30;28,18;1,82;0;0;0;9255;9686;431
10566;16.03.2017;'06 - 07;38,48;34,61;3,87;166;121;-45;9089;9246;157
10567;16.03.2017;'07 - 08;45,18;40,83;4,35;2889;2620;-269;8551;8220;-331
10568;16.03.2017;'08 - 09;40,95;39,89;1,06;7888;8086;198;7594;6846;-748
10569;16.03.2017;'09 - 10;36,15;40,63;-4,48;13140;14411;1271;6625;5730;-895
10570;16.03.2017;'10 - 11;32,94;32,07;0,87;17541;19408;1867;6328;5737;-591
10571;16.03.2017;'11 - 12;31,87;28,14;3,73;20407;21900;1493;6739;6336;-403
10572;16.03.2017;'12 - 13;30,49;28,05;2,44;21338;22409;1071;7416;7378;-38
10573;16.03.2017;'13 - 14;30,45;27,09;3,36;20415;21348;933;8086;8224;138
10574;16.03.2017;'14 - 15;30,19;26,93;3,26;17761;18460;699;8623;8717;94
10575;16.03.2017;'15 - 16;30,28;26,58;3,7;13438;13910;472;8879;8687;-192
10576;16.03.2017;'16 - 17;33,5;27,92;5,58;7825;8093;268;8663;8049;-614
10577;16.03.2017;'17 - 18;39,9;32,07;7,83;2459;2573;114;8527;7042;-1485
10578;16.03.2017;'18 - 19;45,59;39,6;5,99;87;113;26;9015;7704;-1311
10579;16.03.2017;'19 - 20;50,1;45,44;4,66;0;0;0;10139;9324;-815
10580;16.03.2017;'20 - 21;42,92;35,72;7,2;0;0;0;11915;11726;-189
10581;16.03.2017;'21 - 22;34,81;32,48;2,33;0;0;0;13896;14550;654
10582;16.03.2017;'22 - 23;30,19;29,26;0,93;0;0;0;15571;16592;1021
10583;16.03.2017;'23 - 24;26,36;25,89;0,47;0;0;0;16707;17821;1114
10584;17.03.2017;'00 - 01;21,63;28,98;-7,35;0;0;0;18685;18635;-50
10585;17.03.2017;'01 - 02;18,76;26,52;-7,76;0;0;0;19116;19977;861
10586;17.03.2017;'02 - 03;18,53;23,98;-5,45;0;0;0;19035;20646;1611
10587;17.03.2017;'03 - 04;20,93;21,07;-0,14;0;0;0;18823;20526;1703
10588;17.03.2017;'04 - 05;24,11;21,61;2,5;0;0;0;18507;19644;1137
10589;17.03.2017;'05 - 06;28;28,55;-0,55;0;0;0;18089;19081;992
10590;17.03.2017;'06 - 07;39,97;39,01;0,96;161;168;7;17616;19249;1633
10591;17.03.2017;'07 - 08;40,91;36,5;4,41;2388;2633;245;17222;17995;773
10592;17.03.2017;'08 - 09;40,45;31;9,45;5990;6888;898;17161;17976;815
10593;17.03.2017;'09 - 10;33,97;29,02;4,95;9243;10692;1449;17523;17609;86
10594;17.03.2017;'10 - 11;32,17;26,73;5,44;11601;13660;2059;18481;19058;577
10595;17.03.2017;'11 - 12;29,71;25,63;4,08;12861;14099;1238;20030;20672;642
10596;17.03.2017;'12 - 13;27,83;22,72;5,11;12699;12966;267;21675;22820;1145
10597;17.03.2017;'13 - 14;25,44;23,89;1,55;11470;11522;52;23212;24860;1648
10598;17.03.2017;'14 - 15;22,1;23,53;-1,43;9573;9762;189;24154;25597;1443
10599;17.03.2017;'15 - 16;22,78;24,34;-1,56;7120;6970;-150;24680;26350;1670
10600;17.03.2017;'16 - 17;26,48;25,18;1,3;4081;3500;-581;24305;25806;1501
10601;17.03.2017;'17 - 18;30,96;31,22;-0,26;1318;1071;-247;22878;23996;1118
10602;17.03.2017;'18 - 19;38,1;35,79;2,31;59;32;-27;21532;22000;468
10603;17.03.2017;'19 - 20;40,45;40,93;-0,48;0;0;0;21142;20876;-266
10604;17.03.2017;'20 - 21;32,99;34,4;-1,41;0;0;0;21980;20669;-1311
10605;17.03.2017;'21 - 22;27,91;31,29;-3,38;0;0;0;23169;21554;-1615
10606;17.03.2017;'22 - 23;24,5;30,36;-5,86;0;0;0;24472;22806;-1666
10607;17.03.2017;'23 - 24;14,96;21,9;-6,94;0;0;0;25616;24462;-1154
10608;18.03.2017;'00 - 01;11,73;14,01;-2,28;0;0;0;27610;26562;-1048
10609;18.03.2017;'01 - 02;9,42;11,95;-2,53;0;0;0;28949;28068;-881
10610;18.03.2017;'02 - 03;9,39;4,82;4,57;0;0;0;29824;29313;-511
10611;18.03.2017;'03 - 04;8,46;3,1;5,36;0;0;0;30620;30353;-267
10612;18.03.2017;'04 - 05;8,3;5,12;3,18;0;0;0;30832;31871;1039
10613;18.03.2017;'05 - 06;9,37;1,73;7,64;0;0;0;30336;33328;2992
10614;18.03.2017;'06 - 07;10,35;-0,63;10,98;39;22;-17;29898;35255;5357
10615;18.03.2017;'07 - 08;11,25;-0,15;11,4;402;372;-30;29290;36614;7324
10616;18.03.2017;'08 - 09;16,93;-0,26;17,19;981;1231;250;28408;37982;9574
10617;18.03.2017;'09 - 10;28,18;2,52;25,66;1676;2582;906;27688;38008;10320
10618;18.03.2017;'10 - 11;25,6;0,41;25,19;2473;4011;1538;27174;36682;9508
10619;18.03.2017;'11 - 12;26,83;2,96;23,87;3316;5396;2080;26759;35304;8545
10620;18.03.2017;'12 - 13;25,69;3,22;22,47;4101;6498;2397;26459;34070;7611
10621;18.03.2017;'13 - 14;17,01;2,73;14,28;4508;6713;2205;26230;33086;6856
10622;18.03.2017;'14 - 15;9,75;3,39;6,36;4254;5730;1476;25638;32186;6548
10623;18.03.2017;'15 - 16;14,36;4,18;10,18;3271;4142;871;24789;30812;6023
10624;18.03.2017;'16 - 17;9,99;6,02;3,97;1947;2299;352;23134;28360;5226
10625;18.03.2017;'17 - 18;27,44;20,71;6,73;653;672;19;20483;25254;4771
10626;18.03.2017;'18 - 19;32,31;31,76;0,55;32;22;-10;17684;21419;3735
10627;18.03.2017;'19 - 20;37,94;35,29;2,65;0;0;0;15554;19099;3545
10628;18.03.2017;'20 - 21;31,27;31,74;-0,47;0;0;0;14443;17348;2905
10629;18.03.2017;'21 - 22;30,74;29,41;1,33;0;0;0;13416;15679;2263
10630;18.03.2017;'22 - 23;30,75;27,84;2,91;0;0;0;12348;13560;1212
10631;18.03.2017;'23 - 24;29,06;26,47;2,59;0;0;0;11296;12128;832
10632;19.03.2017;'00 - 01;16,62;24,21;-7,59;0;0;0;11729;10880;-849
10633;19.03.2017;'01 - 02;15,79;24,11;-8,32;0;0;0;10428;10042;-386
10634;19.03.2017;'02 - 03;16,12;19,41;-3,29;0;0;0;9452;9379;-73
10635;19.03.2017;'03 - 04;12,67;18,3;-5,63;0;0;0;8559;9024;465
10636;19.03.2017;'04 - 05;13,43;19,96;-6,53;0;0;0;8173;8826;653
10637;19.03.2017;'05 - 06;12,47;17,47;-5;0;0;0;8667;9716;1049
10638;19.03.2017;'06 - 07;11,62;13,39;-1,77;102;94;-8;9571;12148;2577
10639;19.03.2017;'07 - 08;9,64;11,69;-2,05;880;1053;173;11111;14534;3423
10640;19.03.2017;'08 - 09;13,73;6,28;7,45;1908;2238;330;13087;17188;4101
10641;19.03.2017;'09 - 10;18,44;10,08;8,36;2759;3379;620;15179;20053;4874
10642;19.03.2017;'10 - 11;21,06;9,9;11,16;3436;4280;844;17292;21878;4586
10643;19.03.2017;'11 - 12;17,63;11,41;6,22;3842;4945;1103;19541;22874;3333
10644;19.03.2017;'12 - 13;18,05;11,91;6,14;3923;4920;997;21796;23604;1808
10645;19.03.2017;'13 - 14;11,35;12,55;-1,2;3785;4764;979;23528;25120;1592
10646;19.03.2017;'14 - 15;10,12;13,32;-3,2;3347;4220;873;24801;26797;1996
10647;19.03.2017;'15 - 16;9,44;10,67;-1,23;2511;3414;903;26304;27608;1304
10648;19.03.2017;'16 - 17;9,42;11,98;-2,56;1506;2149;643;27170;28889;1719
10649;19.03.2017;'17 - 18;10,15;13,03;-2,88;559;774;215;27198;30065;2867
10650;19.03.2017;'18 - 19;17,09;18,17;-1,08;33;30;-3;27386;30809;3423
10651;19.03.2017;'19 - 20;16,72;17,14;-0,42;0;0;0;27403;30962;3559
10652;19.03.2017;'20 - 21;11,96;11,43;0,53;0;0;0;27110;31163;4053
10653;19.03.2017;'21 - 22;9,47;8,33;1,14;0;0;0;26675;31304;4629
10654;19.03.2017;'22 - 23;12,51;10,5;2,01;0;0;0;25868;29889;4021
10655;19.03.2017;'23 - 24;10,12;7,66;2,46;0;0;0;24705;28720;4015
10656;20.03.2017;'00 - 01;10,59;5,37;5,22;0;0;0;23058;26538;3480
10657;20.03.2017;'01 - 02;13,87;6,41;7,46;0;0;0;21349;24436;3087
10658;20.03.2017;'02 - 03;10,07;5,89;4,18;0;0;0;19780;22628;2848
10659;20.03.2017;'03 - 04;16,36;9,02;7,34;0;0;0;18319;19667;1348
10660;20.03.2017;'04 - 05;22,06;14,85;7,21;0;0;0;16945;17473;528
10661;20.03.2017;'05 - 06;26,08;28,3;-2,22;0;0;0;16165;16170;5
10662;20.03.2017;'06 - 07;36,3;41,64;-5,34;88;67;-21;15789;15457;-332
10663;20.03.2017;'07 - 08;40,98;46,29;-5,31;988;968;-20;16132;15548;-584
10664;20.03.2017;'08 - 09;42,31;48,19;-5,88;2552;2704;152;17149;16564;-585
10665;20.03.2017;'09 - 10;39,34;43,38;-4,04;4386;4748;362;18225;17738;-487
10666;20.03.2017;'10 - 11;38,96;39,62;-0,66;6013;6774;761;19375;19826;451
10667;20.03.2017;'11 - 12;36,94;38,52;-1,58;7225;8396;1171;20471;21361;890
10668;20.03.2017;'12 - 13;35;34,39;0,61;7868;9052;1184;21377;22072;695
10669;20.03.2017;'13 - 14;32,74;31,72;1,02;7796;8864;1068;21993;23056;1063
10670;20.03.2017;'14 - 15;31,16;31,3;-0,14;7028;7920;892;22212;23568;1356
10671;20.03.2017;'15 - 16;30,82;29,6;1,22;5433;6504;1071;22425;23835;1410
10672;20.03.2017;'16 - 17;30,56;30,02;0,54;3256;4250;994;22696;24211;1515
10673;20.03.2017;'17 - 18;32;30,09;1,91;1128;1496;368;23037;25072;2035
10674;20.03.2017;'18 - 19;38,38;32,48;5,9;59;58;-1;23472;25614;2142
10675;20.03.2017;'19 - 20;36,94;33,16;3,78;0;0;0;24099;26685;2586
10676;20.03.2017;'20 - 21;32,42;30,72;1,7;0;0;0;24758;28165;3407
10677;20.03.2017;'21 - 22;27,6;25,06;2,54;0;0;0;25174;28671;3497
10678;20.03.2017;'22 - 23;25,2;20,87;4,33;0;0;0;25034;27996;2962
10679;20.03.2017;'23 - 24;10,75;12,98;-2,23;0;0;0;24316;27788;3472
10680;21.03.2017;'00 - 01;18,76;19,09;-0,33;0;0;0;26034;26777;743
10681;21.03.2017;'01 - 02;17,48;15,32;2,16;0;0;0;24849;25026;177
10682;21.03.2017;'02 - 03;15,92;14,49;1,43;0;0;0;23522;22584;-938
10683;21.03.2017;'03 - 04;18,02;21,29;-3,27;0;0;0;22126;20794;-1332
10684;21.03.2017;'04 - 05;22,6;26,35;-3,75;0;0;0;20783;19556;-1227
10685;21.03.2017;'05 - 06;23,99;28,12;-4,13;0;0;0;19904;18490;-1414
10686;21.03.2017;'06 - 07;31,01;42,42;-11,41;187;134;-53;19428;18352;-1076
10687;21.03.2017;'07 - 08;35,96;43,32;-7,36;1867;1569;-298;19385;17740;-1645
10688;21.03.2017;'08 - 09;35,31;43,42;-8,11;4508;4258;-250;19962;17448;-2514
10689;21.03.2017;'09 - 10;30,84;40,82;-9,98;7230;7283;53;21201;17782;-3419
10690;21.03.2017;'10 - 11;29,97;37,7;-7,73;9371;8978;-393;21962;18822;-3140
10691;21.03.2017;'11 - 12;29,69;34,85;-5,16;10619;9807;-812;22778;18444;-4334
10692;21.03.2017;'12 - 13;29,08;35,18;-6,1;10615;10000;-615;23239;18750;-4489
10693;21.03.2017;'13 - 14;28,86;35,08;-6,22;9710;9655;-55;23296;18425;-4871
10694;21.03.2017;'14 - 15;28,94;35,57;-6,63;8173;8136;-37;22783;18034;-4749
10695;21.03.2017;'15 - 16;29,37;38,86;-9,49;6094;5828;-266;21978;18098;-3880
10696;21.03.2017;'16 - 17;30,1;41,17;-11,07;3678;3324;-354;20378;17952;-2426
10697;21.03.2017;'17 - 18;36,65;40,95;-4,3;1364;1214;-150;18056;16385;-1671
10698;21.03.2017;'18 - 19;42,98;45,97;-2,99;95;108;13;15730;13816;-1914
10699;21.03.2017;'19 - 20;47,25;48,26;-1,01;0;0;0;14089;12890;-1199
10700;21.03.2017;'20 - 21;41,77;44,47;-2,7;0;0;0;13160;12132;-1028
10701;21.03.2017;'21 - 22;37,75;41,19;-3,44;0;0;0;12508;11592;-916
10702;21.03.2017;'22 - 23;34,99;32,08;2,91;0;0;0;11910;10812;-1098
10703;21.03.2017;'23 - 24;33,96;30,52;3,44;0;0;0;11341;10745;-596
10704;22.03.2017;'00 - 01;30,45;31,58;-1,13;0;0;0;11567;10647;-920
10705;22.03.2017;'01 - 02;29,98;31,5;-1,52;0;0;0;11051;10146;-905
10706;22.03.2017;'02 - 03;29,2;29,22;-0,02;0;0;0;10560;9481;-1079
10707;22.03.2017;'03 - 04;29,05;29,78;-0,73;0;0;0;9982;9460;-522
10708;22.03.2017;'04 - 05;29,05;29,5;-0,45;0;0;0;9528;9064;-464
10709;22.03.2017;'05 - 06;30,41;32,54;-2,13;0;0;0;9126;9068;-58
10710;22.03.2017;'06 - 07;35,19;37,99;-2,8;290;242;-48;8731;8849;118
10711;22.03.2017;'07 - 08;40,19;41,94;-1,75;2646;2228;-418;7926;7758;-168
10712;22.03.2017;'08 - 09;43,02;47,04;-4,02;6385;5602;-783;6411;5805;-606
10713;22.03.2017;'09 - 10;41,74;49,17;-7,43;10007;9263;-744;5081;4989;-92
10714;22.03.2017;'10 - 11;37,54;44,11;-6,57;12506;11939;-567;4756;5386;630
10715;22.03.2017;'11 - 12;36,69;40,62;-3,93;13698;12910;-788;4781;5701;920
10716;22.03.2017;'12 - 13;36,25;38,99;-2,74;13526;12776;-750;4469;5095;626
10717;22.03.2017;'13 - 14;35,95;39,05;-3,1;12288;11712;-576;4113;3891;-222
10718;22.03.2017;'14 - 15;35,02;40,16;-5,14;10255;9426;-829;4043;3456;-587
10719;22.03.2017;'15 - 16;36,35;41,46;-5,11;7731;6587;-1144;4248;3608;-640
10720;22.03.2017;'16 - 17;36,9;42,98;-6,08;4753;3610;-1143;4713;3844;-869
10721;22.03.2017;'17 - 18;39,6;44,44;-4,84;1759;1225;-534;5394;4212;-1182
10722;22.03.2017;'18 - 19;42,4;48,08;-5,68;128;85;-43;6611;4840;-1771
10723;22.03.2017;'19 - 20;45;52,71;-7,71;0;0;0;8491;6411;-2080
10724;22.03.2017;'20 - 21;38,98;46,51;-7,53;0;0;0;10073;8036;-2037
10725;22.03.2017;'21 - 22;32,18;41,42;-9,24;0;0;0;10800;9176;-1624
10726;22.03.2017;'22 - 23;31,65;33,65;-2;0;0;0;10811;9926;-885
10727;22.03.2017;'23 - 24;29,17;28,9;0,27;0;0;0;10457;10236;-221
10728;23.03.2017;'00 - 01;29,45;30,85;-1,4;0;0;0;10896;9941;-955
10729;23.03.2017;'01 - 02;29,1;30,44;-1,34;0;0;0;10649;9438;-1211
10730;23.03.2017;'02 - 03;28,91;31,05;-2,14;0;0;0;10298;9224;-1074
10731;23.03.2017;'03 - 04;28,65;30,25;-1,6;0;0;0;9929;9060;-869
10732;23.03.2017;'04 - 05;28,53;30,61;-2,08;0;0;0;9767;8928;-839
10733;23.03.2017;'05 - 06;30,72;32,73;-2,01;0;0;0;9810;8711;-1099
10734;23.03.2017;'06 - 07;32,38;37,63;-5,25;217;132;-85;9830;9082;-748
10735;23.03.2017;'07 - 08;39,61;47,03;-7,42;2062;1552;-510;9787;8562;-1225
10736;23.03.2017;'08 - 09;40,5;45,46;-4,96;5138;4296;-842;9393;7693;-1700
10737;23.03.2017;'09 - 10;38,91;44,08;-5,17;8424;7964;-460;8822;7254;-1568
10738;23.03.2017;'10 - 11;37,1;41,54;-4,44;11244;11145;-99;8545;7251;-1294
10739;23.03.2017;'11 - 12;36,44;38,36;-1,92;13101;13292;191;8471;7626;-845
10740;23.03.2017;'12 - 13;31,54;32,97;-1,43;13878;14387;509;8417;8119;-298
10741;23.03.2017;'13 - 14;32,03;31,95;0,08;13589;13906;317;8311;8186;-125
10742;23.03.2017;'14 - 15;32,05;31,74;0,31;12288;12152;-136;8074;8848;774
10743;23.03.2017;'15 - 16;32,72;33,22;-0,5;9755;9300;-455;7942;9332;1390
10744;23.03.2017;'16 - 17;33,24;33,5;-0,26;6158;5682;-476;8151;9126;975
10745;23.03.2017;'17 - 18;37,92;38,74;-0,82;2357;2039;-318;8692;9141;449
10746;23.03.2017;'18 - 19;40;43,77;-3,77;174;150;-24;9473;9341;-132
10747;23.03.2017;'19 - 20;42,77;48,15;-5,38;0;0;0;10186;9947;-239
10748;23.03.2017;'20 - 21;38,9;41,61;-2,71;0;0;0;10295;10005;-290
10749;23.03.2017;'21 - 22;34,97;36,02;-1,05;0;0;0;9912;9782;-130
10750;23.03.2017;'22 - 23;32,89;32,75;0,14;0;0;0;9193;9497;304
10751;23.03.2017;'23 - 24;30,63;30,06;0,57;0;0;0;8235;8911;676
10752;24.03.2017;'00 - 01;29,04;27,68;1,36;0;0;0;8011;8065;54
10753;24.03.2017;'01 - 02;28,99;27,72;1,27;0;0;0;7430;7380;-50
10754;24.03.2017;'02 - 03;29,21;27,9;1,31;0;0;0;7182;6962;-220
10755;24.03.2017;'03 - 04;28,87;28,74;0,13;0;0;0;6957;6940;-17
10756;24.03.2017;'04 - 05;29;28,27;0,73;0;0;0;7004;7131;127
10757;24.03.2017;'05 - 06;30,14;27,96;2,18;0;0;0;7116;7112;-4
10758;24.03.2017;'06 - 07;37,91;35,31;2,6;427;369;-58;6950;7493;543
10759;24.03.2017;'07 - 08;41,69;39,68;2,01;3459;2818;-641;6505;7702;1197
10760;24.03.2017;'08 - 09;43,79;38,45;5,34;8023;6651;-1372;5691;6404;713
10761;24.03.2017;'09 - 10;41,09;40,5;0,59;12884;10461;-2423;4680;5578;898
10762;24.03.2017;'10 - 11;35,71;39,66;-3,95;16977;13468;-3509;4175;5518;1343
10763;24.03.2017;'11 - 12;33,07;38,24;-5,17;19725;15608;-4117;4467;5252;785
10764;24.03.2017;'12 - 13;32,09;38,41;-6,32;20690;16750;-3940;4762;4470;-292
10765;24.03.2017;'13 - 14;30,29;34,17;-3,88;20013;16631;-3382;4938;3963;-975
10766;24.03.2017;'14 - 15;29,9;33,75;-3,85;17632;15202;-2430;5106;4095;-1011
10767;24.03.2017;'15 - 16;30,07;33,2;-3,13;13521;12154;-1367;5385;4662;-723
10768;24.03.2017;'16 - 17;31,2;34,39;-3,19;8178;7421;-757;5851;5266;-585
10769;24.03.2017;'17 - 18;36,63;41,2;-4,57;2990;2682;-308;6418;5471;-947
10770;24.03.2017;'18 - 19;40,59;44,44;-3,85;223;212;-11;7006;6048;-958
10771;24.03.2017;'19 - 20;42,96;47,42;-4,46;0;0;0;7651;7618;-33
10772;24.03.2017;'20 - 21;38,92;44,11;-5,19;0;0;0;8262;8123;-139
10773;24.03.2017;'21 - 22;34,85;39,21;-4,36;0;0;0;8360;7820;-540
10774;24.03.2017;'22 - 23;34,37;37,66;-3,29;0;0;0;7921;7368;-553
10775;24.03.2017;'23 - 24;32,48;33,17;-0,69;0;0;0;7188;7113;-75
10776;25.03.2017;'00 - 01;32,64;30,77;1,87;0;0;0;6090;6881;791
10777;25.03.2017;'01 - 02;29,14;29,91;-0,77;0;0;0;5886;6799;913
10778;25.03.2017;'02 - 03;28,32;28,45;-0,13;0;0;0;6028;6702;674
10779;25.03.2017;'03 - 04;27,13;28;-0,87;0;0;0;6306;7094;788
10780;25.03.2017;'04 - 05;27,02;26,27;0,75;0;0;0;6614;7452;838
10781;25.03.2017;'05 - 06;27,56;27,48;0,08;0;0;0;6862;7640;778
10782;25.03.2017;'06 - 07;28,55;28,65;-0,1;524;550;26;7015;7860;845
10783;25.03.2017;'07 - 08;29,92;29,23;0,69;4235;4118;-117;6847;7366;519
10784;25.03.2017;'08 - 09;30,21;28,48;1,73;10040;9551;-489;6125;6210;85
10785;25.03.2017;'09 - 10;29;28,85;0,15;15918;15478;-440;5294;5542;248
10786;25.03.2017;'10 - 11;28,19;27,05;1,14;20438;20143;-295;5280;6858;1578
10787;25.03.2017;'11 - 12;25,39;22,58;2,81;22872;22659;-213;6095;8386;2291
10788;25.03.2017;'12 - 13;22,91;15,18;7,73;23270;23570;300;6941;9414;2473
10789;25.03.2017;'13 - 14;21,09;13,6;7,49;22118;22967;849;7588;10034;2446
10790;25.03.2017;'14 - 15;15,97;11,68;4,29;19419;20352;933;8077;10474;2397
10791;25.03.2017;'15 - 16;20,07;13,93;6,14;15113;15606;493;8511;10337;1826
10792;25.03.2017;'16 - 17;23,47;18,57;4,9;9238;9536;298;8832;9732;900
10793;25.03.2017;'17 - 18;28,04;28,01;0,03;3411;3534;123;9032;8850;-182
10794;25.03.2017;'18 - 19;33,85;34,97;-1,12;274;296;22;9292;8554;-738
10795;25.03.2017;'19 - 20;39,17;39,61;-0,44;0;0;0;9857;9690;-167
10796;25.03.2017;'20 - 21;37,6;37,04;0,56;0;0;0;10064;10590;526
10797;25.03.2017;'21 - 22;33,31;32,4;0,91;0;0;0;9895;10298;403
10798;25.03.2017;'22 - 23;32,94;31,13;1,81;0;0;0;9362;9423;61
10799;25.03.2017;'23 - 24;29;28,36;0,64;0;0;0;8524;9225;701
10800;26.03.2017;'00 - 01;28,74;24,77;3,97;0;0;0;7084;8505;1421
10801;26.03.2017;'01 - 02;27,94;19,57;8,37;0;0;0;6516;7559;1043
10802;26.03.2017;'02 - 03;0;0;0;0;0;0;0;0;0
10803;26.03.2017;'03 - 04;26,97;22,27;4,7;0;0;0;5880;6547;667
10804;26.03.2017;'04 - 05;26,62;23,81;2,81;0;0;0;5199;5877;678
10805;26.03.2017;'05 - 06;24,65;23,79;0,86;0;0;0;4481;5222;741
10806;26.03.2017;'06 - 07;26,87;23,9;2,97;0;0;0;3725;4294;569
10807;26.03.2017;'07 - 08;27,67;24,99;2,68;671;678;7;3026;3430;404
10808;26.03.2017;'08 - 09;28,24;26,31;1,93;4440;4456;16;2401;2628;227
10809;26.03.2017;'09 - 10;28,58;27,58;1;9767;10204;437;1820;1633;-187
10810;26.03.2017;'10 - 11;26,06;25,07;0,99;14949;15644;695;1374;1120;-254
10811;26.03.2017;'11 - 12;24,93;23,16;1,77;18983;20197;1214;1131;892;-239
10812;26.03.2017;'12 - 13;25,82;23,69;2,13;21524;23112;1588;1147;743;-404
10813;26.03.2017;'13 - 14;22,06;14,19;7,87;22376;24096;1720;1227;867;-360
10814;26.03.2017;'14 - 15;18,46;10,08;8,38;21406;23259;1853;1348;1186;-162
10815;26.03.2017;'15 - 16;16,97;9,47;7,5;18676;20512;1836;1527;1615;88
10816;26.03.2017;'16 - 17;17,65;10,39;7,26;14285;15886;1601;1730;2094;364
10817;26.03.2017;'17 - 18;22,22;18,79;3,43;8677;9797;1120;2044;2368;324
10818;26.03.2017;'18 - 19;30,31;31,2;-0,89;3230;3649;419;2518;2559;41
10819;26.03.2017;'19 - 20;35,82;36,23;-0,41;290;316;26;3085;2723;-362
10820;26.03.2017;'20 - 21;40,07;36,92;3,15;0;0;0;3750;3646;-104
10821;26.03.2017;'21 - 22;39,64;37,78;1,86;0;0;0;4299;4356;57
10822;26.03.2017;'22 - 23;38,79;35,87;2,92;0;0;0;4781;4384;-397
10823;26.03.2017;'23 - 24;38,06;33,42;4,64;0;0;0;5086;4428;-658
10824;27.03.2017;'00 - 01;28,25;29,74;-1,49;0;0;0;4757;4648;-109
10825;27.03.2017;'01 - 02;28,27;29,57;-1,3;0;0;0;4798;4507;-291
10826;27.03.2017;'02 - 03;28,3;28,96;-0,66;0;0;0;4707;4183;-524
10827;27.03.2017;'03 - 04;26,88;28,04;-1,16;0;0;0;4557;3933;-624
10828;27.03.2017;'04 - 05;27,06;29,68;-2,62;0;0;0;4373;3820;-553
10829;27.03.2017;'05 - 06;30,1;34,73;-4,63;0;0;0;4227;3784;-443
10830;27.03.2017;'06 - 07;39,31;43,64;-4,33;1;1;0;4112;4086;-26
10831;27.03.2017;'07 - 08;48;51,25;-3,25;901;927;26;3999;4402;403
10832;27.03.2017;'08 - 09;48,16;54,46;-6,3;5660;5869;209;3649;4188;539
10833;27.03.2017;'09 - 10;40,91;41,73;-0,82;12246;12746;500;2938;2871;-67
10834;27.03.2017;'10 - 11;36,56;34,74;1,82;18325;18982;657;2272;1951;-321
10835;27.03.2017;'11 - 12;33,24;30,64;2,6;22648;23276;628;2006;2025;19
10836;27.03.2017;'12 - 13;30,48;28,42;2,06;25028;25567;539;2111;2069;-42
10837;27.03.2017;'13 - 14;29,67;27,58;2,09;25559;26099;540;2180;1858;-322
10838;27.03.2017;'14 - 15;29,11;27,56;1,55;24317;24828;511;2151;1673;-478
10839;27.03.2017;'15 - 16;28,92;29,9;-0,98;21311;21755;444;2072;1633;-439
10840;27.03.2017;'16 - 17;29,9;30,43;-0,53;16466;16972;506;1989;1554;-435
10841;27.03.2017;'17 - 18;32,35;33,36;-1,01;10119;10501;382;2023;1496;-527
10842;27.03.2017;'18 - 19;40;38,78;1,22;3830;3964;134;2306;1449;-857
10843;27.03.2017;'19 - 20;46,99;44,95;2,04;372;356;-16;2825;1718;-1107
10844;27.03.2017;'20 - 21;46,27;42,88;3,39;0;0;0;3429;2644;-785
10845;27.03.2017;'21 - 22;39,98;38,7;1,28;0;0;0;3936;3630;-306
10846;27.03.2017;'22 - 23;37,94;37,67;0,27;0;0;0;4294;4084;-210
10847;27.03.2017;'23 - 24;32,4;32,25;0,15;0;0;0;4402;4206;-196
10848;28.03.2017;'00 - 01;28,71;28,59;0,12;0;0;0;4109;4051;-58
10849;28.03.2017;'01 - 02;28,07;28,56;-0,49;0;0;0;3973;3908;-65
10850;28.03.2017;'02 - 03;27,43;28,76;-1,33;0;0;0;3818;3753;-65
10851;28.03.2017;'03 - 04;27,24;27,15;0,09;0;0;0;3714;3488;-226
10852;28.03.2017;'04 - 05;27,72;28,29;-0,57;0;0;0;3626;3233;-393
10853;28.03.2017;'05 - 06;29,06;29,94;-0,88;0;0;0;3538;3210;-328
10854;28.03.2017;'06 - 07;38,91;36,29;2,62;2;2;0;3486;3211;-275
10855;28.03.2017;'07 - 08;46,13;46,71;-0,58;963;993;30;3448;3252;-196
10856;28.03.2017;'08 - 09;50;50,74;-0,74;5655;5914;259;3169;3073;-96
10857;28.03.2017;'09 - 10;43,03;40,99;2,04;12107;12744;637;2459;2164;-295
10858;28.03.2017;'10 - 11;39,94;33,12;6,82;18065;18679;614;1558;926;-632
10859;28.03.2017;'11 - 12;37,4;32,52;4,88;22274;22829;555;1004;637;-367
10860;28.03.2017;'12 - 13;32,29;29,95;2,34;24550;24964;414;1270;855;-415
10861;28.03.2017;'13 - 14;30,71;28,89;1,82;24932;25286;354;1775;1748;-27
10862;28.03.2017;'14 - 15;29,98;28,12;1,86;23508;23976;468;2479;2980;501
10863;28.03.2017;'15 - 16;30;26,88;3,12;20320;20778;458;3315;4142;827
10864;28.03.2017;'16 - 17;30,05;27,11;2,94;15406;15714;308;3994;4927;933
10865;28.03.2017;'17 - 18;32,16;28,57;3,59;9228;9478;250;4468;5402;934
10866;28.03.2017;'18 - 19;37,46;31,59;5,87;3434;3525;91;4698;5485;787
10867;28.03.2017;'19 - 20;41,41;35,57;5,84;352;349;-3;5130;4870;-260
10868;28.03.2017;'20 - 21;41,01;38,67;2,34;0;0;0;6124;5840;-284
10869;28.03.2017;'21 - 22;36,4;33,32;3,08;0;0;0;7983;7216;-767
10870;28.03.2017;'22 - 23;33,56;30,61;2,95;0;0;0;10157;8419;-1738
10871;28.03.2017;'23 - 24;28,9;28,07;0,83;0;0;0;12111;9580;-2531
10872;29.03.2017;'00 - 01;28,06;30,91;-2,85;0;0;0;12219;10689;-1530
10873;29.03.2017;'01 - 02;26,71;27,94;-1,23;0;0;0;12974;12091;-883
10874;29.03.2017;'02 - 03;26,68;22,85;3,83;0;0;0;14017;12696;-1321
10875;29.03.2017;'03 - 04;26,07;19,21;6,86;0;0;0;15319;13438;-1881
10876;29.03.2017;'04 - 05;26,09;22,64;3,45;0;0;0;16470;15359;-1111
10877;29.03.2017;'05 - 06;26,95;26,75;0,2;0;0;0;17516;17720;204
10878;29.03.2017;'06 - 07;34,16;29,25;4,91;3;2;-1;18321;20311;1990
10879;29.03.2017;'07 - 08;39,56;29,48;10,08;884;751;-133;19047;21334;2287
10880;29.03.2017;'08 - 09;39,78;31,37;8,41;4780;4203;-577;19568;20712;1144
10881;29.03.2017;'09 - 10;30,88;28,57;2,31;9787;9074;-713;19974;19782;-192
10882;29.03.2017;'10 - 11;27,66;32,92;-5,26;13971;13347;-624;20551;20644;93
10883;29.03.2017;'11 - 12;26,55;29,4;-2,85;16566;15710;-856;21177;22494;1317
10884;29.03.2017;'12 - 13;27,25;27,73;-0,48;17566;15754;-1812;21627;23368;1741
10885;29.03.2017;'13 - 14;26,05;29,71;-3,66;16962;14622;-2340;21595;21338;-257
10886;29.03.2017;'14 - 15;26,09;31,8;-5,71;14629;13114;-1515;20813;18656;-2157
10887;29.03.2017;'15 - 16;28,05;36,15;-8,1;11679;11501;-178;19183;16270;-2913
10888;29.03.2017;'16 - 17;30,65;36,78;-6,13;8402;9023;621;17295;14046;-3249
10889;29.03.2017;'17 - 18;31,23;37,98;-6,75;5099;5546;447;15142;12320;-2822
10890;29.03.2017;'18 - 19;35,19;40,09;-4,9;2033;2173;140;12879;10216;-2663
10891;29.03.2017;'19 - 20;40,47;43,63;-3,16;246;236;-10;10864;8681;-2183
10892;29.03.2017;'20 - 21;41,81;44,08;-2,27;0;0;0;9249;7477;-1772
10893;29.03.2017;'21 - 22;37,66;39,14;-1,48;0;0;0;8265;7012;-1253
10894;29.03.2017;'22 - 23;35,07;36,43;-1,36;0;0;0;7540;6404;-1136
10895;29.03.2017;'23 - 24;30,72;29,94;0,78;0;0;0;6951;5910;-1041
10896;30.03.2017;'00 - 01;28,73;30,65;-1,92;0;0;0;6651;5829;-822
10897;30.03.2017;'01 - 02;28,02;28,88;-0,86;0;0;0;6344;5680;-664
10898;30.03.2017;'02 - 03;27,3;27,85;-0,55;0;0;0;6135;5584;-551
10899;30.03.2017;'03 - 04;26,38;28,12;-1,74;0;0;0;6147;5780;-367
10900;30.03.2017;'04 - 05;26,78;28,53;-1,75;0;0;0;6246;5918;-328
10901;30.03.2017;'05 - 06;28,53;29,44;-0,91;0;0;0;6445;6326;-119
10902;30.03.2017;'06 - 07;36;36,73;-0,73;2;1;-1;6766;7001;235
10903;30.03.2017;'07 - 08;43,06;39,35;3,71;490;523;33;7078;7766;688
10904;30.03.2017;'08 - 09;46,01;41,16;4,85;2761;3121;360;7242;8048;806
10905;30.03.2017;'09 - 10;42,86;38,27;4,59;6063;7396;1333;7248;7696;448
10906;30.03.2017;'10 - 11;39,93;34,48;5,45;9577;12344;2767;7242;7600;358
10907;30.03.2017;'11 - 12;38,42;33,26;5,16;12538;16687;4149;7418;8072;654
10908;30.03.2017;'12 - 13;33,01;27,17;5,84;14480;19126;4646;7852;8638;786
10909;30.03.2017;'13 - 14;30,98;26,5;4,48;15246;20040;4794;8337;9272;935
10910;30.03.2017;'14 - 15;29,58;24,5;5,08;14926;19404;4478;8517;10070;1553
10911;30.03.2017;'15 - 16;29,07;24,28;4,79;13496;17487;3991;8310;10412;2102
10912;30.03.2017;'16 - 17;28,93;25,95;2,98;10892;13646;2754;8052;10289;2237
10913;30.03.2017;'17 - 18;30,43;28,65;1,78;7161;8737;1576;8000;9333;1333
10914;30.03.2017;'18 - 19;35,93;32,26;3,67;2969;3496;527;8397;8318;-79
10915;30.03.2017;'19 - 20;40,46;37,11;3,35;354;395;41;9076;8321;-755
10916;30.03.2017;'20 - 21;40,07;37,27;2,8;0;0;0;10134;9510;-624
10917;30.03.2017;'21 - 22;35;33,67;1,33;0;0;0;11448;10635;-813
10918;30.03.2017;'22 - 23;32,47;32,79;-0,32;0;0;0;12564;11457;-1107
10919;30.03.2017;'23 - 24;28,94;26,75;2,19;0;0;0;13452;11893;-1559
10920;31.03.2017;'00 - 01;26,91;26,03;0,88;0;0;0;13913;12340;-1573
10921;31.03.2017;'01 - 02;24,77;25,35;-0,58;0;0;0;14051;12930;-1121
10922;31.03.2017;'02 - 03;24,45;24,94;-0,49;0;0;0;13924;13368;-556
10923;31.03.2017;'03 - 04;23,05;25,56;-2,51;0;0;0;13646;13612;-34
10924;31.03.2017;'04 - 05;23,45;20,07;3,38;0;0;0;13381;13582;201
10925;31.03.2017;'05 - 06;27,24;22,84;4,4;0;0;0;13215;14048;833
10926;31.03.2017;'06 - 07;33,09;28,84;4,25;9;6;-3;13146;14165;1019
10927;31.03.2017;'07 - 08;37,95;35,77;2,18;1141;1132;-9;13036;14047;1011
10928;31.03.2017;'08 - 09;38,99;36,31;2,68;5766;5826;60;12312;12975;663
10929;31.03.2017;'09 - 10;37,97;34,8;3,17;11767;12090;323;10489;10238;-251
10930;31.03.2017;'10 - 11;35,93;32,54;3,39;17303;17543;240;8828;7779;-1049
10931;31.03.2017;'11 - 12;33,32;31,29;2,03;21265;21171;-94;8387;7488;-899
10932;31.03.2017;'12 - 13;30,02;30,14;-0,12;23426;22856;-570;9090;8487;-603
10933;31.03.2017;'13 - 14;28,09;28,09;0;23827;23016;-811;9690;9860;170
10934;31.03.2017;'14 - 15;27,63;27,4;0,23;22621;21852;-769;9986;10946;960
10935;31.03.2017;'15 - 16;28,29;26,68;1,61;19764;18589;-1175;9825;11313;1488
10936;31.03.2017;'16 - 17;28,36;27,01;1,35;15308;13955;-1353;9349;11145;1796
10937;31.03.2017;'17 - 18;30,43;30,69;-0,26;9553;8292;-1261;8815;10939;2124
10938;31.03.2017;'18 - 19;34,67;33,41;1,26;3762;3166;-596;8825;10353;1528
10939;31.03.2017;'19 - 20;38,98;36,23;2,75;432;355;-77;9371;9964;593
10940;31.03.2017;'20 - 21;39,96;37,53;2,43;0;0;0;9889;10722;833
10941;31.03.2017;'21 - 22;37,91;34,85;3,06;0;0;0;9986;10866;880
10942;31.03.2017;'22 - 23;35,95;32,45;3,5;0;0;0;9757;10626;869
10943;31.03.2017;'23 - 24;32,02;32,48;-0,46;0;0;0;9095;9449;354
10944;01.04.2017;'00 - 01;27,08;30,04;-2,96;0;0;0;8469;8018;-451
10945;01.04.2017;'01 - 02;28,07;33,77;-5,7;0;0;0;7105;6818;-287
10946;01.04.2017;'02 - 03;28,08;32,32;-4,24;0;0;0;5973;5954;-19
10947;01.04.2017;'03 - 04;26,9;31,02;-4,12;0;0;0;5090;5231;141
10948;01.04.2017;'04 - 05;27;30,04;-3,04;0;0;0;4382;5272;890
10949;01.04.2017;'05 - 06;27,98;29,86;-1,88;0;0;0;3829;4852;1023
10950;01.04.2017;'06 - 07;29,87;28,34;1,53;12;8;-4;3467;4060;593
10951;01.04.2017;'07 - 08;32,09;30,69;1,4;1114;1176;62;3196;3170;-26
10952;01.04.2017;'08 - 09;34,42;33,11;1,31;5211;5499;288;2832;2468;-364
10953;01.04.2017;'09 - 10;35,1;36,17;-1,07;10620;10798;178;2227;1543;-684
10954;01.04.2017;'10 - 11;28,9;33,76;-4,86;15463;15410;-53;1662;929;-733
10955;01.04.2017;'11 - 12;27,09;31,13;-4,04;18995;18453;-542;1414;766;-648
10956;01.04.2017;'12 - 13;25,99;32,24;-6,25;20997;19886;-1111;1342;732;-610
10957;01.04.2017;'13 - 14;26,07;30,98;-4,91;21165;19784;-1381;1280;725;-555
10958;01.04.2017;'14 - 15;25,29;29,33;-4,04;19634;18204;-1430;1267;811;-456
10959;01.04.2017;'15 - 16;24,81;29,4;-4,59;16543;15152;-1391;1272;1086;-186
10960;01.04.2017;'16 - 17;25,65;30,33;-4,68;12383;10894;-1489;1353;1597;244
10961;01.04.2017;'17 - 18;27,99;32,43;-4,44;7497;6485;-1012;1561;2202;641
10962;01.04.2017;'18 - 19;33,66;34,28;-0,62;2880;2708;-172;1936;2973;1037
10963;01.04.2017;'19 - 20;38,7;36,38;2,32;376;344;-32;2361;4485;2124
10964;01.04.2017;'20 - 21;39,6;40,31;-0,71;0;0;0;2520;6038;3518
10965;01.04.2017;'21 - 22;38,98;35,51;3,47;0;0;0;2679;6776;4097
10966;01.04.2017;'22 - 23;37,96;32,73;5,23;0;0;0;2877;6061;3184
10967;01.04.2017;'23 - 24;31,86;29,6;2,26;0;0;0;3009;4968;1959
10968;02.04.2017;'00 - 01;32,92;28,9;4,02;0;0;0;4405;4640;235
10969;02.04.2017;'01 - 02;27,5;26,46;1,04;0;0;0;4488;5173;685
10970;02.04.2017;'02 - 03;26,77;25,51;1,26;0;0;0;4704;5476;772
10971;02.04.2017;'03 - 04;26,67;23,94;2,73;0;0;0;4939;5485;546
10972;02.04.2017;'04 - 05;26,49;24,3;2,19;0;0;0;5149;5313;164
10973;02.04.2017;'05 - 06;26,42;22,71;3,71;0;0;0;5356;4744;-612
10974;02.04.2017;'06 - 07;26,65;23,47;3,18;12;8;-4;5431;4370;-1061
10975;02.04.2017;'07 - 08;27,14;24,14;3;916;766;-150;5430;4442;-988
10976;02.04.2017;'08 - 09;29,06;25,92;3,14;4201;3662;-539;5256;3775;-1481
10977;02.04.2017;'09 - 10;29,56;28,29;1,27;8447;7874;-573;4946;3203;-1743
10978;02.04.2017;'10 - 11;28,54;30,72;-2,18;12579;12496;-83;4877;3060;-1817
10979;02.04.2017;'11 - 12;28,2;29,79;-1,59;15722;15863;141;5109;3231;-1878
10980;02.04.2017;'12 - 13;27,22;29,67;-2,45;17537;17690;153;5629;3914;-1715
10981;02.04.2017;'13 - 14;26,02;24,23;1,79;17781;18359;578;6183;4383;-1800
10982;02.04.2017;'14 - 15;21,05;13,57;7,48;16712;17914;1202;6653;4843;-1810
10983;02.04.2017;'15 - 16;20,57;11,07;9,5;14495;15975;1480;6906;4885;-2021
10984;02.04.2017;'16 - 17;23,31;17,71;5,6;11315;12354;1039;7011;5011;-2000
10985;02.04.2017;'17 - 18;26;24,37;1,63;7277;7897;620;6809;4820;-1989
10986;02.04.2017;'18 - 19;29,6;28,38;1,22;3060;3371;311;6330;4455;-1875
10987;02.04.2017;'19 - 20;39,1;38;1,1;416;445;29;5935;4449;-1486
10988;02.04.2017;'20 - 21;42,22;40,03;2,19;0;0;0;5777;4978;-799
10989;02.04.2017;'21 - 22;39,92;35,68;4,24;0;0;0;5705;5424;-281
10990;02.04.2017;'22 - 23;40,51;36,15;4,36;0;0;0;5693;5498;-195
10991;02.04.2017;'23 - 24;37,78;34,51;3,27;0;0;0;5628;5235;-393
10992;03.04.2017;'00 - 01;34,38;31,33;3,05;0;0;0;4201;4887;686
10993;03.04.2017;'01 - 02;31,95;29,04;2,91;0;0;0;4043;4630;587
10994;03.04.2017;'02 - 03;29,88;26,21;3,67;0;0;0;3893;4201;308
10995;03.04.2017;'03 - 04;28,75;25,84;2,91;0;0;0;3685;4099;414
10996;03.04.2017;'04 - 05;28,44;23,51;4,93;0;0;0;3438;3877;439
10997;03.04.2017;'05 - 06;31,64;29,61;2,03;0;0;0;3154;3533;379
10998;03.04.2017;'06 - 07;41,77;43,33;-1,56;12;9;-3;2809;3305;496
10999;03.04.2017;'07 - 08;49,28;76,05;-26,77;727;768;41;2446;2943;497
11000;03.04.2017;'08 - 09;54,02;72,55;-18,53;3200;3481;281;2013;2477;464
11001;03.04.2017;'09 - 10;50;56,87;-6,87;6376;7200;824;1542;1850;308
11002;03.04.2017;'10 - 11;48,43;44,41;4,02;9638;11282;1644;1177;1546;369
11003;03.04.2017;'11 - 12;44,95;41,04;3,91;12491;14256;1765;962;1330;368
11004;03.04.2017;'12 - 13;38,93;36,89;2,04;14573;15822;1249;903;1131;228
11005;03.04.2017;'13 - 14;36,68;37,44;-0,76;15527;16140;613;906;1043;137
11006;03.04.2017;'14 - 15;32,94;33,93;-0,99;15266;15513;247;979;1124;145
11007;03.04.2017;'15 - 16;30,91;33,81;-2,9;13709;14072;363;1110;1329;219
11008;03.04.2017;'16 - 17;31,72;34;-2,28;10869;10910;41;1278;1385;107
11009;03.04.2017;'17 - 18;32,19;36,6;-4,41;7127;6879;-248;1488;1392;-96
11010;03.04.2017;'18 - 19;37,46;40,59;-3,13;3129;2954;-175;1790;1458;-332
11011;03.04.2017;'19 - 20;41,78;43,93;-2,15;470;448;-22;2160;1819;-341
11012;03.04.2017;'20 - 21;43,59;45,44;-1,85;0;1;1;2487;2355;-132
11013;03.04.2017;'21 - 22;38,97;40,24;-1,27;0;0;0;2648;2907;259
11014;03.04.2017;'22 - 23;35,18;36,56;-1,38;0;0;0;2755;3272;517
11015;03.04.2017;'23 - 24;31,08;31,12;-0,04;0;0;0;2786;3360;574
11016;04.04.2017;'00 - 01;31,57;27,96;3,61;0;0;0;2964;3281;317
11017;04.04.2017;'01 - 02;30,13;27,24;2,89;0;0;0;2819;3190;371
11018;04.04.2017;'02 - 03;29,29;26,79;2,5;0;0;0;2633;2928;295
11019;04.04.2017;'03 - 04;29,47;26,96;2,51;0;0;0;2403;2816;413
11020;04.04.2017;'04 - 05;29,8;27,05;2,75;0;0;0;2174;2794;620
11021;04.04.2017;'05 - 06;31,83;29,25;2,58;0;0;0;2003;2636;633
11022;04.04.2017;'06 - 07;41,17;38,47;2,7;18;11;-7;1921;2566;645
11023;04.04.2017;'07 - 08;51,01;44,93;6,08;996;937;-59;1848;2514;666
11024;04.04.2017;'08 - 09;52,39;46,11;6,28;4445;4180;-265;1649;2103;454
11025;04.04.2017;'09 - 10;50,94;42,62;8,32;8839;8591;-248;1342;1292;-50
11026;04.04.2017;'10 - 11;43,3;39,94;3,36;13053;12734;-319;1100;1017;-83
11027;04.04.2017;'11 - 12;42,33;37,86;4,47;16326;15573;-753;983;938;-45
11028;04.04.2017;'12 - 13;39,16;36,29;2,87;18117;16203;-1914;945;888;-57
11029;04.04.2017;'13 - 14;37,72;36,09;1,63;18210;15634;-2576;924;832;-92
11030;04.04.2017;'14 - 15;34,6;36,09;-1,49;17015;14596;-2419;942;869;-73
11031;04.04.2017;'15 - 16;34,45;34,97;-0,52;14644;12818;-1826;1019;997;-22
11032;04.04.2017;'16 - 17;34,45;33,62;0,83;11348;10130;-1218;1092;1114;22
11033;04.04.2017;'17 - 18;37,49;33,78;3,71;7333;6614;-719;1225;1150;-75
11034;04.04.2017;'18 - 19;41,59;38,56;3,03;3181;2976;-205;1452;1224;-228
11035;04.04.2017;'19 - 20;45,26;40,52;4,74;467;488;21;1803;1318;-485
11036;04.04.2017;'20 - 21;47,57;41,27;6,3;2;1;-1;2158;1638;-520
11037;04.04.2017;'21 - 22;40,07;37,8;2,27;0;0;0;2349;1840;-509
11038;04.04.2017;'22 - 23;38,91;35,34;3,57;0;0;0;2452;1780;-672
11039;04.04.2017;'23 - 24;33,04;32,48;0,56;0;0;0;2575;1696;-879
11040;05.04.2017;'00 - 01;30;31,06;-1,06;0;0;0;2223;1799;-424
11041;05.04.2017;'01 - 02;29,64;29,02;0,62;0;0;0;2410;1920;-490
11042;05.04.2017;'02 - 03;28,39;27,83;0,56;0;0;0;2727;2225;-502
11043;05.04.2017;'03 - 04;27,94;27,04;0,9;0;0;0;3284;2583;-701
11044;05.04.2017;'04 - 05;27,49;27,34;0,15;0;0;0;4015;2994;-1021
11045;05.04.2017;'05 - 06;29,65;30,37;-0,72;0;0;0;4831;3960;-871
11046;05.04.2017;'06 - 07;37,1;40,63;-3,53;25;18;-7;5702;5078;-624
11047;05.04.2017;'07 - 08;44,2;42,86;1,34;1106;1078;-28;6702;5896;-806
11048;05.04.2017;'08 - 09;48,1;44,28;3,82;4608;4769;161;7410;6432;-978
11049;05.04.2017;'09 - 10;44,03;40,42;3,61;8905;9564;659;7764;6292;-1472
11050;05.04.2017;'10 - 11;39,02;34,99;4,03;12652;14040;1388;8395;7554;-841
11051;05.04.2017;'11 - 12;36,98;31,46;5,52;15039;16662;1623;9587;9357;-230
11052;05.04.2017;'12 - 13;34,03;29;5,03;15938;16982;1044;11294;10989;-305
11053;05.04.2017;'13 - 14;32,89;26,91;5,98;15089;15786;697;13384;13484;100
11054;05.04.2017;'14 - 15;30,06;26,62;3,44;13179;13865;686;15741;15648;-93
11055;05.04.2017;'15 - 16;29,53;24,49;5,04;10663;10920;257;18066;18182;116
11056;05.04.2017;'16 - 17;30,01;25,99;4,02;7802;7565;-237;20169;20035;-134
11057;05.04.2017;'17 - 18;30,06;27,44;2,62;4860;4414;-446;21791;22160;369
11058;05.04.2017;'18 - 19;29,9;28,77;1,13;2149;1932;-217;22388;23185;797
11059;05.04.2017;'19 - 20;32,69;31,26;1,43;348;318;-30;22686;22513;-173
11060;05.04.2017;'20 - 21;35;34,83;0,17;0;0;0;22973;22446;-527
11061;05.04.2017;'21 - 22;29,93;31,32;-1,39;0;0;0;23291;23006;-285
11062;05.04.2017;'22 - 23;27,87;26,42;1,45;0;0;0;23694;22993;-701
11063;05.04.2017;'23 - 24;20;21,2;-1,2;0;0;0;23878;22496;-1382
11064;06.04.2017;'00 - 01;12,48;18,02;-5,54;0;0;0;23277;22433;-844
11065;06.04.2017;'01 - 02;9,87;17,19;-7,32;0;0;0;22698;21584;-1114
11066;06.04.2017;'02 - 03;9,04;16,63;-7,59;0;0;0;22049;20149;-1900
11067;06.04.2017;'03 - 04;14,9;23,12;-8,22;0;0;0;21200;19407;-1793
11068;06.04.2017;'04 - 05;22;28,42;-6,42;0;0;0;20276;18638;-1638
11069;06.04.2017;'05 - 06;24,55;29,94;-5,39;0;0;0;19124;17424;-1700
11070;06.04.2017;'06 - 07;35,96;40,06;-4,1;39;36;-3;17899;15998;-1901
11071;06.04.2017;'07 - 08;40,97;45,21;-4,24;1261;1306;45;16734;14363;-2371
11072;06.04.2017;'08 - 09;40,81;49,34;-8,53;4762;4912;150;15984;13110;-2874
11073;06.04.2017;'09 - 10;38,26;47,18;-8,92;8913;9088;175;15911;14577;-1334
11074;06.04.2017;'10 - 11;37,59;43,87;-6,28;12347;11657;-690;15777;14072;-1705
11075;06.04.2017;'11 - 12;35,46;39,2;-3,74;14587;13718;-869;15612;13464;-2148
11076;06.04.2017;'12 - 13;31,07;39,14;-8,07;15668;14876;-792;15495;13609;-1886
11077;06.04.2017;'13 - 14;30,08;37,57;-7,49;15746;15876;130;15490;13989;-1501
11078;06.04.2017;'14 - 15;28,33;34,09;-5,76;14852;16051;1199;15776;14076;-1700
11079;06.04.2017;'15 - 16;28,19;30,63;-2,44;12974;14778;1804;16394;15547;-847
11080;06.04.2017;'16 - 17;28,08;29,72;-1,64;10131;12148;2017;17088;16890;-198
11081;06.04.2017;'17 - 18;32,12;31,12;1;6559;7986;1427;17294;17990;696
11082;06.04.2017;'18 - 19;38,05;33,9;4,15;2883;3740;857;16793;17982;1189
11083;06.04.2017;'19 - 20;40,98;35,33;5,65;452;684;232;16161;17061;900
11084;06.04.2017;'20 - 21;40,87;36,69;4,18;3;2;-1;16071;16892;821
11085;06.04.2017;'21 - 22;38,04;34,39;3,65;0;0;0;16676;17371;695
11086;06.04.2017;'22 - 23;34,27;34,38;-0,11;0;0;0;17606;17958;352
11087;06.04.2017;'23 - 24;27,79;30,75;-2,96;0;0;0;18685;18587;-98
11088;07.04.2017;'00 - 01;24,99;27,41;-2,42;0;0;0;19244;19363;119
11089;07.04.2017;'01 - 02;23,02;22,83;0,19;0;0;0;19980;19886;-94
11090;07.04.2017;'02 - 03;18,31;21,17;-2,86;0;0;0;20496;19675;-821
11091;07.04.2017;'03 - 04;19,17;23,92;-4,75;0;0;0;20623;19008;-1615
11092;07.04.2017;'04 - 05;20,87;27,72;-6,85;0;0;0;20693;18572;-2121
11093;07.04.2017;'05 - 06;27,07;33,17;-6,1;0;0;0;20511;19097;-1414
11094;07.04.2017;'06 - 07;32,05;37,32;-5,27;17;12;-5;20097;19652;-445
11095;07.04.2017;'07 - 08;39,97;43,69;-3,72;665;635;-30;19676;19673;-3
11096;07.04.2017;'08 - 09;41,57;42,49;-0,92;2774;2814;40;19244;19330;86
11097;07.04.2017;'09 - 10;40,94;36,74;4,2;5386;5768;382;18952;19126;174
11098;07.04.2017;'10 - 11;39,98;34,36;5,62;7603;8980;1377;18870;19272;402
11099;07.04.2017;'11 - 12;40,02;32,28;7,74;8985;11662;2677;18907;19233;326
11100;07.04.2017;'12 - 13;38,14;29,58;8,56;9617;13137;3520;18982;19411;429
11101;07.04.2017;'13 - 14;35,29;27,19;8,1;9535;13290;3755;19036;19990;954
11102;07.04.2017;'14 - 15;32,67;26,22;6,45;8837;12697;3860;19002;20082;1080
11103;07.04.2017;'15 - 16;32,97;27,06;5,91;7597;11334;3737;18745;19769;1024
11104;07.04.2017;'16 - 17;32,98;27,58;5,4;5909;8718;2809;18266;19147;881
11105;07.04.2017;'17 - 18;36,09;29,06;7,03;3892;5712;1820;17405;17794;389
11106;07.04.2017;'18 - 19;39,12;34,82;4,3;1812;2639;827;16141;16180;39
11107;07.04.2017;'19 - 20;39,91;36,51;3,4;310;480;170;14816;14512;-304
11108;07.04.2017;'20 - 21;39,96;38,03;1,93;1;1;0;13658;13430;-228
11109;07.04.2017;'21 - 22;39,31;36,7;2,61;0;0;0;12780;12109;-671
11110;07.04.2017;'22 - 23;39,61;36,7;2,91;0;0;0;12045;11179;-866
11111;07.04.2017;'23 - 24;37,93;36,69;1,24;0;0;0;11286;10560;-726
11112;08.04.2017;'00 - 01;32,71;36,51;-3,8;0;0;0;10189;9403;-786
11113;08.04.2017;'01 - 02;32,28;35,07;-2,79;0;0;0;8971;8529;-442
11114;08.04.2017;'02 - 03;32,81;33,88;-1,07;0;0;0;7794;7565;-229
11115;08.04.2017;'03 - 04;31,5;30,33;1,17;0;0;0;6756;6520;-236
11116;08.04.2017;'04 - 05;30,44;30,53;-0,09;0;0;0;5793;5534;-259
11117;08.04.2017;'05 - 06;31,7;32,21;-0,51;0;0;0;4993;4610;-383
11118;08.04.2017;'06 - 07;34,72;35,52;-0,8;33;25;-8;4372;3696;-676
11119;08.04.2017;'07 - 08;37,91;35,59;2,32;975;895;-80;3841;3281;-560
11120;08.04.2017;'08 - 09;39,43;35,06;4,37;3714;3482;-232;3365;2984;-381
11121;08.04.2017;'09 - 10;38,99;35,8;3,19;7231;6934;-297;2975;2810;-165
11122;08.04.2017;'10 - 11;36,5;34,48;2,02;10832;10718;-114;2689;2498;-191
11123;08.04.2017;'11 - 12;34,94;33,45;1,49;13695;14152;457;2575;2423;-152
11124;08.04.2017;'12 - 13;30,66;30,02;0,64;15414;16597;1183;2690;2569;-121
11125;08.04.2017;'13 - 14;29,5;27,34;2,16;15842;17553;1711;2896;2713;-183
11126;08.04.2017;'14 - 15;27,81;26,72;1,09;15310;16941;1631;3082;2681;-401
11127;08.04.2017;'15 - 16;27,53;26,33;1,2;13794;15125;1331;3133;2522;-611
11128;08.04.2017;'16 - 17;28,28;26,99;1,29;11186;12288;1102;3027;2194;-833
11129;08.04.2017;'17 - 18;30,02;28,2;1,82;7601;8287;686;2750;1700;-1050
11130;08.04.2017;'18 - 19;35,85;34,34;1,51;3482;3886;404;2362;1290;-1072
11131;08.04.2017;'19 - 20;39,3;37,67;1,63;571;728;157;2067;1133;-934
11132;08.04.2017;'20 - 21;41,88;38,75;3,13;6;4;-2;1944;1101;-843
11133;08.04.2017;'21 - 22;41,58;36,85;4,73;0;0;0;1926;1184;-742
11134;08.04.2017;'22 - 23;42,07;37,92;4,15;0;0;0;1981;1267;-714
11135;08.04.2017;'23 - 24;39,02;36,73;2,29;0;0;0;2043;1234;-809
11136;09.04.2017;'00 - 01;33,98;31,21;2,77;0;0;0;1325;1237;-88
11137;09.04.2017;'01 - 02;31,06;27,54;3,52;0;0;0;1315;1211;-104
11138;09.04.2017;'02 - 03;31,04;25,89;5,15;0;0;0;1283;1354;71
11139;09.04.2017;'03 - 04;27,54;24,16;3,38;0;0;0;1266;1505;239
11140;09.04.2017;'04 - 05;28,46;24,83;3,63;0;0;0;1270;1675;405
11141;09.04.2017;'05 - 06;27,79;23,37;4,42;0;0;0;1283;1934;651
11142;09.04.2017;'06 - 07;28,48;25,31;3,17;69;73;4;1334;2076;742
11143;09.04.2017;'07 - 08;30,52;25,44;5,08;1808;1981;173;1447;2262;815
11144;09.04.2017;'08 - 09;30,63;25,1;5,53;6761;7123;362;1565;2220;655
11145;09.04.2017;'09 - 10;29,44;28,27;1,17;12809;13674;865;1585;1930;345
11146;09.04.2017;'10 - 11;27,78;24,98;2,8;18272;19532;1260;1631;2116;485
11147;09.04.2017;'11 - 12;26,4;23,4;3;22262;23246;984;1850;2422;572
11148;09.04.2017;'12 - 13;24,04;22,21;1,83;24432;25270;838;2026;2358;332
11149;09.04.2017;'13 - 14;20,79;14,93;5,86;24913;25695;782;2127;2200;73
11150;09.04.2017;'14 - 15;12,98;8,61;4,37;23881;24711;830;2182;2102;-80
11151;09.04.2017;'15 - 16;15;12,15;2,85;21198;21917;719;2214;1985;-229
11152;09.04.2017;'16 - 17;20,07;15,09;4,98;16974;17478;504;2250;1787;-463
11153;09.04.2017;'17 - 18;24,44;22,8;1,64;11136;11410;274;2407;1690;-717
11154;09.04.2017;'18 - 19;32,4;31,57;0,83;4880;5058;178;2661;1579;-1082
11155;09.04.2017;'19 - 20;38,24;37,48;0,76;820;908;88;3389;1910;-1479
11156;09.04.2017;'20 - 21;39,53;39,12;0,41;7;6;-1;5159;3342;-1817
11157;09.04.2017;'21 - 22;37,57;38,58;-1,01;0;0;0;7868;6009;-1859
11158;09.04.2017;'22 - 23;35,2;37,31;-2,11;0;0;0;10353;9424;-929
11159;09.04.2017;'23 - 24;24,08;31,37;-7,29;0;0;0;12530;12059;-471
11160;10.04.2017;'00 - 01;26,03;23,72;2,31;0;0;0;14195;14242;47
11161;10.04.2017;'01 - 02;23,02;18,22;4,8;0;0;0;15564;15865;301
11162;10.04.2017;'02 - 03;20,36;16,26;4,1;0;0;0;16477;17731;1254
11163;10.04.2017;'03 - 04;12,26;10,38;1,88;0;0;0;16942;19280;2338
11164;10.04.2017;'04 - 05;19,95;13,25;6,7;0;0;0;17341;19892;2551
11165;10.04.2017;'05 - 06;26,08;18,58;7,5;0;0;0;17492;19864;2372
11166;10.04.2017;'06 - 07;38,93;31,96;6,97;93;96;3;17352;20024;2672
11167;10.04.2017;'07 - 08;38,93;34,31;4,62;2049;2258;209;16973;20381;3408
11168;10.04.2017;'08 - 09;38,09;29,69;8,4;7011;7316;305;16097;18700;2603
11169;10.04.2017;'09 - 10;35,25;28,31;6,94;12574;12714;140;14814;17122;2308
11170;10.04.2017;'10 - 11;30,89;28,44;2,45;17018;16825;-193;14678;17540;2862
11171;10.04.2017;'11 - 12;27,57;27,48;0,09;19770;19285;-485;15669;19138;3469
11172;10.04.2017;'12 - 13;24,01;25,54;-1,53;20769;20246;-523;17258;21545;4287
11173;10.04.2017;'13 - 14;17,91;22,06;-4,15;20423;19772;-651;19144;23708;4564
11174;10.04.2017;'14 - 15;9,37;16,62;-7,25;18855;18510;-345;20778;24392;3614
11175;10.04.2017;'15 - 16;17,92;18,9;-0,98;16070;15712;-358;22032;25457;3425
11176;10.04.2017;'16 - 17;21,63;21,15;0,48;12245;11854;-391;22964;26230;3266
11177;10.04.2017;'17 - 18;26,2;25,5;0,7;7796;7344;-452;23277;26712;3435
11178;10.04.2017;'18 - 19;32,26;29,69;2,57;3502;3255;-247;22727;25793;3066
11179;10.04.2017;'19 - 20;38,32;33,36;4,96;646;690;44;21820;23708;1888
11180;10.04.2017;'20 - 21;38,74;37,99;0,75;7;5;-2;21103;21478;375
11181;10.04.2017;'21 - 22;37,95;33,72;4,23;0;0;0;20452;19968;-484
11182;10.04.2017;'22 - 23;31,29;32,57;-1,28;0;0;0;19933;18942;-991
11183;10.04.2017;'23 - 24;24,02;27,25;-3,23;0;0;0;19593;18425;-1168
11184;11.04.2017;'00 - 01;24,83;29,43;-4,6;0;0;0;19060;18177;-883
11185;11.04.2017;'01 - 02;23,52;29,63;-6,11;0;0;0;18747;17466;-1281
11186;11.04.2017;'02 - 03;23,55;29,7;-6,15;0;0;0;18590;16823;-1767
11187;11.04.2017;'03 - 04;23,53;28,96;-5,43;0;0;0;18587;17159;-1428
11188;11.04.2017;'04 - 05;25,63;31,39;-5,76;0;0;0;18606;17727;-879
11189;11.04.2017;'05 - 06;28,12;31,7;-3,58;0;0;0;18416;17752;-664
11190;11.04.2017;'06 - 07;37,91;37,87;0,04;79;87;8;17927;16958;-969
11191;11.04.2017;'07 - 08;41,52;42,48;-0,96;1453;1669;216;17469;15446;-2023
11192;11.04.2017;'08 - 09;43,5;42,25;1,25;4722;5080;358;17330;15162;-2168
11193;11.04.2017;'09 - 10;40,93;38,3;2,63;8618;9490;872;17896;16598;-1298
11194;11.04.2017;'10 - 11;37,45;32,32;5,13;12307;13265;958;18586;16894;-1692
11195;11.04.2017;'11 - 12;34,16;32,99;1,17;15130;15730;600;18724;16484;-2240
11196;11.04.2017;'12 - 13;31;30,86;0,14;16694;17192;498;18311;15731;-2580
11197;11.04.2017;'13 - 14;29,66;30,79;-1,13;16994;17912;918;17894;14928;-2966
11198;11.04.2017;'14 - 15;29,98;31,3;-1,32;16155;16844;689;17702;14778;-2924
11199;11.04.2017;'15 - 16;31,9;32,34;-0,44;14142;14630;488;17660;14860;-2800
11200;11.04.2017;'16 - 17;31,83;31,4;0,43;11093;11596;503;17415;14258;-3157
11201;11.04.2017;'17 - 18;35,3;34,2;1,1;7362;7654;292;16554;13954;-2600
11202;11.04.2017;'18 - 19;37,95;37,35;0,6;3409;3528;119;14977;12724;-2253
11203;11.04.2017;'19 - 20;43,1;40,29;2,81;637;731;94;13389;11837;-1552
11204;11.04.2017;'20 - 21;43,27;41,03;2,24;8;6;-2;12730;11746;-984
11205;11.04.2017;'21 - 22;38,38;37,01;1,37;0;0;0;13257;11978;-1279
11206;11.04.2017;'22 - 23;37,08;37,73;-0,65;0;0;0;14345;13215;-1130
11207;11.04.2017;'23 - 24;30,17;33,18;-3,01;0;0;0;15762;14391;-1371
11208;12.04.2017;'00 - 01;25,99;29,78;-3,79;0;0;0;17265;15763;-1502
11209;12.04.2017;'01 - 02;24,42;28,96;-4,54;0;0;0;18775;16694;-2081
11210;12.04.2017;'02 - 03;23,02;25,13;-2,11;0;0;0;20058;17208;-2850
11211;12.04.2017;'03 - 04;20,5;24,27;-3,77;0;0;0;20847;18340;-2507
11212;12.04.2017;'04 - 05;23,01;23,11;-0,1;0;0;0;21530;19340;-2190
11213;12.04.2017;'05 - 06;23,09;28,14;-5,05;0;0;0;22010;20130;-1880
11214;12.04.2017;'06 - 07;31,02;33,75;-2,73;57;51;-6;22338;21443;-895
11215;12.04.2017;'07 - 08;36,44;38,53;-2,09;1170;1245;75;22698;21743;-955
11216;12.04.2017;'08 - 09;37,95;34,76;3,19;3945;3964;19;23346;22168;-1178
11217;12.04.2017;'09 - 10;34,02;32,29;1,73;7256;7235;-21;24489;22429;-2060
11218;12.04.2017;'10 - 11;29,29;32,72;-3,43;10433;10775;342;25790;23758;-2032
11219;12.04.2017;'11 - 12;27,35;30,85;-3,5;12895;13706;811;26862;25982;-880
11220;12.04.2017;'12 - 13;23,65;25,62;-1,97;14387;15578;1191;27509;27379;-130
11221;12.04.2017;'13 - 14;23,06;22,45;0,61;14587;15850;1263;27893;28136;243
11222;12.04.2017;'14 - 15;23,4;17,36;6,04;13731;15027;1296;28011;28403;392
11223;12.04.2017;'15 - 16;23,05;17,01;6,04;11745;12910;1165;27912;27925;13
11224;12.04.2017;'16 - 17;26,06;17,86;8,2;8776;9567;791;27536;27134;-402
11225;12.04.2017;'17 - 18;27,56;23,57;3,99;5435;5466;31;26657;26434;-223
11226;12.04.2017;'18 - 19;31,34;29,93;1,41;2410;2344;-66;25648;25719;71
11227;12.04.2017;'19 - 20;33,78;32,65;1,13;460;502;42;24863;24122;-741
11228;12.04.2017;'20 - 21;34,11;34,2;-0,09;5;3;-2;24218;23468;-750
11229;12.04.2017;'21 - 22;31,95;32,38;-0,43;0;0;0;23817;22923;-894
11230;12.04.2017;'22 - 23;27,32;31,19;-3,87;0;0;0;23651;22748;-903
11231;12.04.2017;'23 - 24;23,05;27,02;-3,97;0;0;0;23402;22159;-1243
11232;13.04.2017;'00 - 01;18,01;26,15;-8,14;0;0;0;22531;21354;-1177
11233;13.04.2017;'01 - 02;16,01;26,12;-10,11;0;0;0;22093;20684;-1409
11234;13.04.2017;'02 - 03;17,95;26,67;-8,72;0;0;0;21811;19947;-1864
11235;13.04.2017;'03 - 04;19,8;25,4;-5,6;0;0;0;21496;19153;-2343
11236;13.04.2017;'04 - 05;20,02;24,6;-4,58;0;0;0;21304;18375;-2929
11237;13.04.2017;'05 - 06;26,76;33,8;-7,04;0;0;0;21018;18218;-2800
11238;13.04.2017;'06 - 07;31,95;36,94;-4,99;99;80;-19;20759;18653;-2106
11239;13.04.2017;'07 - 08;35,95;40,96;-5,01;1382;1170;-212;20574;18297;-2277
11240;13.04.2017;'08 - 09;35,99;40,69;-4,7;4106;3641;-465;20787;18662;-2125
11241;13.04.2017;'09 - 10;33,48;39,02;-5,54;7289;6854;-435;21656;20319;-1337
11242;13.04.2017;'10 - 11;31,06;36,28;-5,22;10295;9420;-875;22642;22154;-488
11243;13.04.2017;'11 - 12;28,96;34,44;-5,48;12506;10985;-1521;23592;23475;-117
11244;13.04.2017;'12 - 13;27,01;33,35;-6,34;13773;12058;-1715;24500;24436;-64
11245;13.04.2017;'13 - 14;24,45;33,17;-8,72;13845;12657;-1188;25241;24436;-805
11246;13.04.2017;'14 - 15;24,02;31,06;-7,04;13016;12162;-854;25612;24222;-1390
11247;13.04.2017;'15 - 16;26,57;32,05;-5,48;11368;11338;-30;25399;23594;-1805
11248;13.04.2017;'16 - 17;27,59;31,09;-3,5;9016;9305;289;24860;22926;-1934
11249;13.04.2017;'17 - 18;30,03;33;-2,97;6239;6439;200;23637;22086;-1551
11250;13.04.2017;'18 - 19;35,93;37,71;-1,78;3121;3238;117;21544;20255;-1289
11251;13.04.2017;'19 - 20;40;38,35;1,65;642;854;212;19169;18493;-676
11252;13.04.2017;'20 - 21;42,24;41,7;0,54;9;16;7;17335;17089;-246
11253;13.04.2017;'21 - 22;38,91;37,95;0,96;0;0;0;16326;16197;-129
11254;13.04.2017;'22 - 23;36,82;37,19;-0,37;0;0;0;15868;15378;-490
11255;13.04.2017;'23 - 24;32,97;32,67;0,3;0;0;0;15756;14933;-823
11256;14.04.2017;'00 - 01;30,66;27,68;2,98;0;0;0;14249;14472;223
11257;14.04.2017;'01 - 02;26,78;26,66;0,12;0;0;0;14198;14457;259
11258;14.04.2017;'02 - 03;26,96;27,3;-0,34;0;0;0;14126;14230;104
11259;14.04.2017;'03 - 04;26,87;26,8;0,07;0;0;0;14089;13747;-342
11260;14.04.2017;'04 - 05;26,69;28,04;-1,35;0;0;0;13928;13262;-666
11261;14.04.2017;'05 - 06;26,76;28,8;-2,04;0;0;0;13565;13396;-169
11262;14.04.2017;'06 - 07;26,93;28,42;-1,49;131;121;-10;12927;13515;588
11263;14.04.2017;'07 - 08;27,7;25,26;2,44;1856;1785;-71;12215;11932;-283
11264;14.04.2017;'08 - 09;28,73;26,77;1,96;5582;5254;-328;11703;10891;-812
11265;14.04.2017;'09 - 10;28,23;29,88;-1,65;9762;9285;-477;11581;11278;-303
11266;14.04.2017;'10 - 11;27,82;30,11;-2,29;13011;12682;-329;11512;11486;-26
11267;14.04.2017;'11 - 12;27,88;27,21;0,67;14839;14742;-97;11421;11423;2
11268;14.04.2017;'12 - 13;25,95;24,82;1,13;15530;14914;-616;11313;11931;618
11269;14.04.2017;'13 - 14;27,69;24,41;3,28;15346;13832;-1514;11181;12204;1023
11270;14.04.2017;'14 - 15;27,65;24,87;2,78;14341;12691;-1650;11093;12320;1227
11271;14.04.2017;'15 - 16;27,79;24,49;3,3;12497;11002;-1495;10942;12236;1294
11272;14.04.2017;'16 - 17;28,34;24,99;3,35;9940;8488;-1452;10568;11370;802
11273;14.04.2017;'17 - 18;30,66;29,03;1,63;6762;5577;-1185;9870;10895;1025
11274;14.04.2017;'18 - 19;36,9;34,59;2,31;3224;2694;-530;8763;9641;878
11275;14.04.2017;'19 - 20;38,74;34,22;4,52;640;551;-89;7562;8054;492
11276;14.04.2017;'20 - 21;38,37;34,16;4,21;9;6;-3;6885;7518;633
11277;14.04.2017;'21 - 22;38,55;33,36;5,19;0;0;0;6972;7239;267
11278;14.04.2017;'22 - 23;37,45;33,33;4,12;0;0;0;7416;7183;-233
11279;14.04.2017;'23 - 24;36,95;30,99;5,96;0;0;0;8190;7692;-498
11280;15.04.2017;'00 - 01;33,88;29,47;4,41;0;0;0;8302;8522;220
11281;15.04.2017;'01 - 02;30,51;25,91;4,6;0;0;0;9372;9509;137
11282;15.04.2017;'02 - 03;28,82;23,97;4,85;0;0;0;10437;10623;186
11283;15.04.2017;'03 - 04;25,98;15,27;10,71;0;0;0;11631;11709;78
11284;15.04.2017;'04 - 05;20,04;11,82;8,22;0;0;0;12851;13458;607
11285;15.04.2017;'05 - 06;19,1;9,12;9,98;0;0;0;13949;14092;143
11286;15.04.2017;'06 - 07;17,67;7,03;10,64;85;94;9;15021;15166;145
11287;15.04.2017;'07 - 08;17,97;8,21;9,76;1067;1274;207;16386;17092;706
11288;15.04.2017;'08 - 09;20,1;11,94;8,16;3037;3749;712;18321;18214;-107
11289;15.04.2017;'09 - 10;19,08;9,15;9,93;5226;6693;1467;20922;20444;-478
11290;15.04.2017;'10 - 11;13,94;4,8;9,14;7086;9468;2382;23607;23404;-203
11291;15.04.2017;'11 - 12;9,43;-7;16,43;8558;10268;1710;25698;26088;390
11292;15.04.2017;'12 - 13;13,36;-10,86;24,22;9598;10294;696;27158;27530;372
11293;15.04.2017;'13 - 14;7,56;-5,67;13,23;10199;10184;-15;28231;28582;351
11294;15.04.2017;'14 - 15;0,25;-1,26;1,51;10245;9380;-865;28785;29337;552
11295;15.04.2017;'15 - 16;-1,08;6,31;-7,39;9470;8630;-840;28882;30212;1330
11296;15.04.2017;'16 - 17;-3,23;10,11;-13,34;7750;7083;-667;28858;30521;1663
11297;15.04.2017;'17 - 18;7,68;13,12;-5,44;5397;5006;-391;28170;29745;1575
11298;15.04.2017;'18 - 19;10,03;18,78;-8,75;2823;2609;-214;26683;28604;1921
11299;15.04.2017;'19 - 20;14,03;19,8;-5,77;670;694;24;25027;26179;1152
11300;15.04.2017;'20 - 21;13,03;18,49;-5,46;16;19;3;23646;23818;172
11301;15.04.2017;'21 - 22;12,04;16,34;-4,3;0;0;0;22880;22810;-70
11302;15.04.2017;'22 - 23;11,07;13,56;-2,49;0;0;0;22574;22312;-262
11303;15.04.2017;'23 - 24;9,23;13,48;-4,25;0;0;0;22512;22615;103
11304;16.04.2017;'00 - 01;3,94;9,95;-6,01;0;0;0;22734;22678;-56
11305;16.04.2017;'01 - 02;7,55;9,17;-1,62;0;0;0;23013;22325;-688
11306;16.04.2017;'02 - 03;5,14;11,65;-6,51;0;0;0;22965;21849;-1116
11307;16.04.2017;'03 - 04;1,91;9,29;-7,38;0;0;0;22193;20909;-1284
11308;16.04.2017;'04 - 05;7,55;9,65;-2,1;0;0;0;21085;19569;-1516
11309;16.04.2017;'05 - 06;14,03;13,22;0,81;0;0;0;19465;18045;-1420
11310;16.04.2017;'06 - 07;9,2;11,27;-2,07;152;144;-8;17389;16857;-532
11311;16.04.2017;'07 - 08;14,07;11,7;2,37;1733;1766;33;15292;14753;-539
11312;16.04.2017;'08 - 09;15,96;21,84;-5,88;4757;4553;-204;13683;13079;-604
11313;16.04.2017;'09 - 10;19,01;26,73;-7,72;8007;7624;-383;13007;12631;-376
11314;16.04.2017;'10 - 11;19,01;28,91;-9,9;10642;10060;-582;12653;12526;-127
11315;16.04.2017;'11 - 12;28,74;29,12;-0,38;12320;11938;-382;12332;11839;-493
11316;16.04.2017;'12 - 13;24,03;27,91;-3,88;13046;12605;-441;12015;12205;190
11317;16.04.2017;'13 - 14;15,03;18,16;-3,13;12655;12323;-332;11676;12499;823
11318;16.04.2017;'14 - 15;16;14,92;1,08;11556;11996;440;11672;12434;762
11319;16.04.2017;'15 - 16;15,31;16,37;-1,06;9826;10828;1002;11875;12235;360
11320;16.04.2017;'16 - 17;15,06;13,87;1,19;7554;8487;933;11981;12104;123
11321;16.04.2017;'17 - 18;23,03;18,61;4,42;5028;5432;404;11699;10950;-749
11322;16.04.2017;'18 - 19;31,07;25,12;5,95;2503;2901;398;10872;9713;-1159
11323;16.04.2017;'19 - 20;31,07;28,07;3;594;747;153;10071;8496;-1575
11324;16.04.2017;'20 - 21;33,95;28,27;5,68;16;15;-1;9519;7356;-2163
11325;16.04.2017;'21 - 22;32,55;26,5;6,05;0;0;0;9261;6708;-2553
11326;16.04.2017;'22 - 23;31,91;26,91;5;0;0;0;9148;6377;-2771
11327;16.04.2017;'23 - 24;30,46;24,89;5,57;0;0;0;9240;6426;-2814
11328;17.04.2017;'00 - 01;28,5;22,8;5,7;0;0;0;6766;6373;-393
11329;17.04.2017;'01 - 02;24,01;19;5,01;0;0;0;6982;6411;-571
11330;17.04.2017;'02 - 03;22,07;18,73;3,34;0;0;0;7170;6634;-536
11331;17.04.2017;'03 - 04;21,08;17,82;3,26;0;0;0;7427;6825;-602
11332;17.04.2017;'04 - 05;22;16,98;5,02;0;0;0;7571;6598;-973
11333;17.04.2017;'05 - 06;27,95;19,82;8,13;0;0;0;7532;6804;-728
11334;17.04.2017;'06 - 07;28,21;19,22;8,99;160;141;-19;7359;6902;-457
11335;17.04.2017;'07 - 08;27,44;17,23;10,21;1581;1413;-168;7206;6754;-452
11336;17.04.2017;'08 - 09;29,9;19,28;10,62;4226;3775;-451;7024;6150;-874
11337;17.04.2017;'09 - 10;30,17;21,44;8,73;7454;6474;-980;7061;6152;-909
11338;17.04.2017;'10 - 11;29,6;21,44;8,16;10541;8268;-2273;7398;6662;-736
11339;17.04.2017;'11 - 12;29;21,38;7,62;12869;9600;-3269;7823;7384;-439
11340;17.04.2017;'12 - 13;25,01;21,05;3,96;13916;10808;-3108;8494;8171;-323
11341;17.04.2017;'13 - 14;19,57;17,17;2,4;14148;11568;-2580;9385;9192;-193
11342;17.04.2017;'14 - 15;15,93;12,87;3,06;13813;11392;-2421;10392;10862;470
11343;17.04.2017;'15 - 16;9,28;11,68;-2,4;12590;10340;-2250;11491;11704;213
11344;17.04.2017;'16 - 17;9,36;11,33;-1,97;10497;8754;-1743;12384;12560;176
11345;17.04.2017;'17 - 18;17,8;16,69;1,11;7628;6211;-1417;12757;12707;-50
11346;17.04.2017;'18 - 19;25,36;24,46;0,9;3966;3320;-646;12307;11820;-487
11347;17.04.2017;'19 - 20;32,15;28,5;3,65;963;866;-97;11488;11067;-421
11348;17.04.2017;'20 - 21;33,91;30,09;3,82;30;23;-7;10488;10394;-94
11349;17.04.2017;'21 - 22;33,95;30,21;3,74;0;0;0;9685;9961;276
11350;17.04.2017;'22 - 23;33,93;28,96;4,97;0;0;0;9163;10000;837
11351;17.04.2017;'23 - 24;30,95;25,25;5,7;0;0;0;8740;9587;847
11352;18.04.2017;'00 - 01;29,54;26,93;2,61;0;0;0;9838;8765;-1073
11353;18.04.2017;'01 - 02;28,36;26,51;1,85;0;0;0;9386;7878;-1508
11354;18.04.2017;'02 - 03;27,77;25,31;2,46;0;0;0;9150;8014;-1136
11355;18.04.2017;'03 - 04;27,26;24,33;2,93;0;0;0;9255;8958;-297
11356;18.04.2017;'04 - 05;26,97;21,39;5,58;0;0;0;9386;10109;723
11357;18.04.2017;'05 - 06;30,91;23,27;7,64;0;0;0;9644;10250;606
11358;18.04.2017;'06 - 07;39,94;32,69;7,25;171;130;-41;10093;11122;1029
11359;18.04.2017;'07 - 08;43,35;37,86;5,49;1777;1363;-414;10830;11436;606
11360;18.04.2017;'08 - 09;45,39;40,02;5,37;4874;3584;-1290;11745;12529;784
11361;18.04.2017;'09 - 10;41,05;39,71;1,34;8502;6250;-2252;12668;13619;951
11362;18.04.2017;'10 - 11;39,88;39,42;0,46;11876;8242;-3634;13542;14365;823
11363;18.04.2017;'11 - 12;37,97;40,1;-2,13;14430;9799;-4631;14144;14425;281
11364;18.04.2017;'12 - 13;35,9;41;-5,1;15988;10993;-4995;14420;14336;-84
11365;18.04.2017;'13 - 14;33,83;40,6;-6,77;16452;12161;-4291;14777;13539;-1238
11366;18.04.2017;'14 - 15;31,04;38,83;-7,79;16044;12975;-3069;15366;13619;-1747
11367;18.04.2017;'15 - 16;30,43;36,78;-6,35;14362;12906;-1456;16361;14151;-2210
11368;18.04.2017;'16 - 17;30,1;35,3;-5,2;11511;10924;-587;17427;14419;-3008
11369;18.04.2017;'17 - 18;30,85;34,69;-3,84;7992;7714;-278;17874;14916;-2958
11370;18.04.2017;'18 - 19;33,92;36,64;-2,72;4105;4045;-60;17494;14738;-2756
11371;18.04.2017;'19 - 20;37,95;38,51;-0,56;1036;1093;57;16766;13437;-3329
11372;18.04.2017;'20 - 21;38;40,41;-2,41;36;36;0;15677;12150;-3527
11373;18.04.2017;'21 - 22;37,71;39,62;-1,91;0;0;0;14593;10925;-3668
11374;18.04.2017;'22 - 23;34,08;37,91;-3,83;0;0;0;13646;10294;-3352
11375;18.04.2017;'23 - 24;31,07;34,55;-3,48;0;0;0;12725;9610;-3115
11376;19.04.2017;'00 - 01;30,35;31,42;-1,07;0;0;0;9782;8954;-828
11377;19.04.2017;'01 - 02;30,02;31,9;-1,88;0;0;0;9071;8345;-726
11378;19.04.2017;'02 - 03;29,94;30,57;-0,63;0;0;0;8551;7794;-757
11379;19.04.2017;'03 - 04;30,25;31,17;-0,92;0;0;0;8383;7751;-632
11380;19.04.2017;'04 - 05;30,83;32,95;-2,12;0;0;0;8279;7608;-671
11381;19.04.2017;'05 - 06;31,81;33,19;-1,38;0;0;0;8078;7569;-509
11382;19.04.2017;'06 - 07;38,9;39,66;-0,76;269;241;-28;7772;7595;-177
11383;19.04.2017;'07 - 08;46,88;44,35;2,53;2597;2376;-221;7191;6834;-357
11384;19.04.2017;'08 - 09;48,38;45,42;2,96;7055;6514;-541;6457;5720;-737
11385;19.04.2017;'09 - 10;43,67;45,35;-1,68;11983;11072;-911;6853;6982;129
11386;19.04.2017;'10 - 11;38,97;39,3;-0,33;15672;13010;-2662;8484;8865;381
11387;19.04.2017;'11 - 12;37,4;38,1;-0,7;17443;13294;-4149;9364;8734;-630
11388;19.04.2017;'12 - 13;37,1;41,1;-4;17591;13528;-4063;9145;8514;-631
11389;19.04.2017;'13 - 14;36,61;38,6;-1,99;16799;14022;-2777;8803;8268;-535
11390;19.04.2017;'14 - 15;34,47;37,06;-2,59;15441;13953;-1488;8713;8103;-610
11391;19.04.2017;'15 - 16;33,07;35,58;-2,51;13354;12692;-662;8834;7989;-845
11392;19.04.2017;'16 - 17;33,73;35,95;-2,22;10770;10359;-411;8962;8021;-941
11393;19.04.2017;'17 - 18;36,89;37,47;-0,58;7418;7293;-125;8877;7966;-911
11394;19.04.2017;'18 - 19;38,92;40,45;-1,53;3885;3899;14;8362;7335;-1027
11395;19.04.2017;'19 - 20;41,19;43,89;-2,7;1027;1132;105;7500;6101;-1399
11396;19.04.2017;'20 - 21;44,01;45,16;-1,15;39;31;-8;6840;5180;-1660
11397;19.04.2017;'21 - 22;43,06;44,92;-1,86;0;0;0;6458;5055;-1403
11398;19.04.2017;'22 - 23;38,05;40,26;-2,21;0;0;0;6006;5046;-960
11399;19.04.2017;'23 - 24;34,16;35,14;-0,98;0;0;0;5428;4556;-872
11400;20.04.2017;'00 - 01;32,03;33,39;-1,36;0;0;0;3890;3887;-3
11401;20.04.2017;'01 - 02;32,95;34,04;-1,09;0;0;0;3292;3154;-138
11402;20.04.2017;'02 - 03;31,43;33,18;-1,75;0;0;0;2850;2725;-125
11403;20.04.2017;'03 - 04;31,62;33;-1,38;0;0;0;2660;2562;-98
11404;20.04.2017;'04 - 05;31,71;33,41;-1,7;0;0;0;2547;2696;149
11405;20.04.2017;'05 - 06;33,2;36,69;-3,49;0;0;0;2482;2824;342
11406;20.04.2017;'06 - 07;42,03;39,14;2,89;309;310;1;2461;3028;567
11407;20.04.2017;'07 - 08;48,41;45,55;2,86;2960;3136;176;2432;3046;614
11408;20.04.2017;'08 - 09;52;44,84;7,16;8106;8680;574;2410;2458;48
11409;20.04.2017;'09 - 10;43,87;38,52;5,35;13496;14405;909;2507;2503;-4
11410;20.04.2017;'10 - 11;38,47;37,34;1,13;17369;16847;-522;2876;3443;567
11411;20.04.2017;'11 - 12;36,32;37,85;-1,53;19524;18496;-1028;3259;3930;671
11412;20.04.2017;'12 - 13;33,86;38,27;-4,41;20425;20258;-167;3635;4110;475
11413;20.04.2017;'13 - 14;32,4;34,23;-1,83;20466;21493;1027;4075;4444;369
11414;20.04.2017;'14 - 15;31,07;30,87;0,2;19515;21382;1867;4612;4962;350
11415;20.04.2017;'15 - 16;31,09;29,68;1,41;17327;19346;2019;5199;5522;323
11416;20.04.2017;'16 - 17;33,01;29,55;3,46;13893;15456;1563;5751;6249;498
11417;20.04.2017;'17 - 18;36,89;34,6;2,29;9486;10464;978;6159;6793;634
11418;20.04.2017;'18 - 19;39,94;37,28;2,66;4689;5294;605;6340;6592;252
11419;20.04.2017;'19 - 20;45,01;42,31;2,7;1194;1420;226;6408;6227;-181
11420;20.04.2017;'20 - 21;46,61;44,08;2,53;52;45;-7;6757;5992;-765
11421;20.04.2017;'21 - 22;44,06;43,81;0,25;0;0;0;7506;6298;-1208
11422;20.04.2017;'22 - 23;35,23;42,58;-7,35;0;0;0;8488;7298;-1190
11423;20.04.2017;'23 - 24;29,22;34,99;-5,77;0;0;0;9428;8397;-1031
11424;21.04.2017;'00 - 01;29,3;31,97;-2,67;0;0;0;10361;9588;-773
11425;21.04.2017;'01 - 02;25,05;26,43;-1,38;0;0;0;11185;10435;-750
11426;21.04.2017;'02 - 03;26,52;26,6;-0,08;0;0;0;11788;11021;-767
11427;21.04.2017;'03 - 04;25,25;26,48;-1,23;0;0;0;12189;11202;-987
11428;21.04.2017;'04 - 05;24,05;27,07;-3,02;0;0;0;12452;11392;-1060
11429;21.04.2017;'05 - 06;28,25;30,63;-2,38;0;1;1;12666;11490;-1176
11430;21.04.2017;'06 - 07;40,02;39,81;0,21;259;242;-17;12831;11684;-1147
11431;21.04.2017;'07 - 08;42,5;43,24;-0,74;2327;2346;19;12985;11947;-1038
11432;21.04.2017;'08 - 09;42,61;42,2;0,41;6127;6272;145;13155;11712;-1443
11433;21.04.2017;'09 - 10;38,95;37,11;1,84;10141;10783;642;13844;11705;-2139
11434;21.04.2017;'10 - 11;34,47;32,08;2,39;13402;15237;1835;15038;12916;-2122
11435;21.04.2017;'11 - 12;31,97;25,21;6,76;15496;18706;3210;16303;14792;-1511
11436;21.04.2017;'12 - 13;28,08;15,18;12,9;16401;19832;3431;17796;17556;-240
11437;21.04.2017;'13 - 14;21,15;7,53;13,62;16026;19241;3215;19366;19612;246
11438;21.04.2017;'14 - 15;20,79;8,2;12,59;14601;18136;3535;20879;21507;628
11439;21.04.2017;'15 - 16;19,84;8,36;11,48;12355;15130;2775;22079;23314;1235
11440;21.04.2017;'16 - 17;24,04;10,02;14,02;9434;11315;1881;23008;23880;872
11441;21.04.2017;'17 - 18;27,08;17,18;9,9;6124;7176;1052;23582;24230;648
11442;21.04.2017;'18 - 19;29,14;26,36;2,78;2937;3369;432;23635;24630;995
11443;21.04.2017;'19 - 20;31,02;28,63;2,39;757;800;43;23659;24678;1019
11444;21.04.2017;'20 - 21;30,64;27,04;3,6;32;16;-16;23923;25036;1113
11445;21.04.2017;'21 - 22;24,01;21,03;2,98;0;0;0;24303;25486;1183
11446;21.04.2017;'22 - 23;16,26;12,69;3,57;0;0;0;24714;25355;641
11447;21.04.2017;'23 - 24;3,55;6,37;-2,82;0;0;0;24733;24933;200
11448;22.04.2017;'00 - 01;0,88;12,25;-11,37;0;0;0;23954;24159;205
11449;22.04.2017;'01 - 02;8;12,46;-4,46;0;0;0;23129;23490;361
11450;22.04.2017;'02 - 03;8,22;13,59;-5,37;0;0;0;22452;22671;219
11451;22.04.2017;'03 - 04;8,03;12,55;-4,52;0;0;0;21901;21990;89
11452;22.04.2017;'04 - 05;9,08;11,15;-2,07;0;0;0;21460;21436;-24
11453;22.04.2017;'05 - 06;9,18;11,88;-2,7;0;2;2;20970;20456;-514
11454;22.04.2017;'06 - 07;9,19;16,7;-7,51;262;239;-23;20587;19618;-969
11455;22.04.2017;'07 - 08;10,72;21,3;-10,58;1880;1840;-40;20610;18857;-1753
11456;22.04.2017;'08 - 09;13,09;26,68;-13,59;4608;4631;23;21592;20799;-793
11457;22.04.2017;'09 - 10;13,47;20,84;-7,37;7505;7339;-166;23453;23371;-82
11458;22.04.2017;'10 - 11;9,54;21,16;-11,62;9907;9190;-717;25147;24669;-478
11459;22.04.2017;'11 - 12;9,12;17,36;-8,24;11605;10570;-1035;26330;25511;-819
11460;22.04.2017;'12 - 13;9,04;18,37;-9,33;12539;11493;-1046;26899;26154;-745
11461;22.04.2017;'13 - 14;8,1;14,61;-6,51;12565;11933;-632;27370;26758;-612
11462;22.04.2017;'14 - 15;5,02;12,26;-7,24;11946;11267;-679;27695;26948;-747
11463;22.04.2017;'15 - 16;7,11;12,97;-5,86;10661;9763;-898;27902;27509;-393
11464;22.04.2017;'16 - 17;9,05;14,33;-5,28;8696;8056;-640;27890;27400;-490
11465;22.04.2017;'17 - 18;10,72;15,8;-5,08;6168;5549;-619;27291;26628;-663
11466;22.04.2017;'18 - 19;20,79;21,91;-1,12;3309;3096;-213;25898;24804;-1094
11467;22.04.2017;'19 - 20;23,01;24,52;-1,51;961;926;-35;24059;23470;-589
11468;22.04.2017;'20 - 21;24,5;25,58;-1,08;48;40;-8;22236;21666;-570
11469;22.04.2017;'21 - 22;24,2;23,76;0,44;0;0;0;21105;20227;-878
11470;22.04.2017;'22 - 23;24,15;23,73;0,42;0;0;0;20388;19170;-1218
11471;22.04.2017;'23 - 24;20,2;23,24;-3,04;0;0;0;20019;19169;-850
11472;23.04.2017;'00 - 01;9,04;14,95;-5,91;0;0;0;20055;18382;-1673
11473;23.04.2017;'01 - 02;8,97;10,5;-1,53;0;0;0;19785;18234;-1551
11474;23.04.2017;'02 - 03;8,31;12,47;-4,16;0;0;0;19595;18209;-1386
11475;23.04.2017;'03 - 04;8,94;12,86;-3,92;0;0;0;19302;17823;-1479
11476;23.04.2017;'04 - 05;10,05;12,42;-2,37;0;0;0;19015;16952;-2063
11477;23.04.2017;'05 - 06;9,04;17,02;-7,98;1;2;1;18890;16237;-2653
11478;23.04.2017;'06 - 07;9,02;15,24;-6,22;335;306;-29;19009;15844;-3165
11479;23.04.2017;'07 - 08;8,04;14,58;-6,54;2561;2454;-107;19167;14541;-4626
11480;23.04.2017;'08 - 09;8,89;20,97;-12,08;6505;6208;-297;19065;14676;-4389
11481;23.04.2017;'09 - 10;8,86;21,36;-12,5;10790;9712;-1078;19119;16341;-2778
11482;23.04.2017;'10 - 11;2,96;15,97;-13,01;14314;11794;-2520;19872;17811;-2061
11483;23.04.2017;'11 - 12;6,54;18,2;-11,66;16221;13120;-3101;20843;18959;-1884
11484;23.04.2017;'12 - 13;3,72;19,82;-16,1;16876;14752;-2124;21348;19665;-1683
11485;23.04.2017;'13 - 14;-7,65;11,73;-19,38;16948;15257;-1691;21792;20706;-1086
11486;23.04.2017;'14 - 15;-15,03;5,64;-20,67;16257;15369;-888;22049;21228;-821
11487;23.04.2017;'15 - 16;-9,18;1,01;-10,19;14532;14333;-199;21942;21654;-288
11488;23.04.2017;'16 - 17;-0,15;1,27;-1,42;11679;12004;325;21424;21747;323
11489;23.04.2017;'17 - 18;7,6;7,2;0,4;8058;8641;583;20068;20660;592
11490;23.04.2017;'18 - 19;21,08;22,26;-1,18;4174;4667;493;17758;18868;1110
11491;23.04.2017;'19 - 20;30,63;30,33;0,3;1169;1423;254;14916;15246;330
11492;23.04.2017;'20 - 21;34,54;37,54;-3;60;69;9;12411;12040;-371
11493;23.04.2017;'21 - 22;36,65;36,8;-0,15;0;0;0;11033;10575;-458
11494;23.04.2017;'22 - 23;37,1;40,09;-2,99;0;0;0;10373;10180;-193
11495;23.04.2017;'23 - 24;29,95;35,12;-5,17;0;0;0;10256;10585;329
11496;24.04.2017;'00 - 01;29,19;26,42;2,77;0;0;0;10421;11424;1003
11497;24.04.2017;'01 - 02;27,65;25,86;1,79;0;0;0;10977;11942;965
11498;24.04.2017;'02 - 03;27,42;24,9;2,52;0;0;0;11642;12470;828
11499;24.04.2017;'03 - 04;26,48;24,34;2,14;0;0;0;12448;12694;246
11500;24.04.2017;'04 - 05;27,46;24,68;2,78;0;0;0;13242;13696;454
11501;24.04.2017;'05 - 06;30,26;28,17;2,09;5;3;-2;14009;14740;731
11502;24.04.2017;'06 - 07;38,83;35,04;3,79;581;481;-100;14688;15696;1008
11503;24.04.2017;'07 - 08;40,89;41,24;-0,35;3466;3731;265;15336;16156;820
11504;24.04.2017;'08 - 09;40,86;37,46;3,4;8599;9294;695;15956;16047;91
11505;24.04.2017;'09 - 10;31,8;26,22;5,58;14192;15027;835;17136;17459;323
11506;24.04.2017;'10 - 11;24,06;19,63;4,43;18461;19857;1396;19094;20074;980
11507;24.04.2017;'11 - 12;12,82;9,78;3,04;20989;22941;1952;20699;21900;1201
11508;24.04.2017;'12 - 13;9,07;-4,8;13,87;22066;24237;2171;21805;22384;579
11509;24.04.2017;'13 - 14;20,01;-0,82;20,83;21851;23940;2089;22384;22436;52
11510;24.04.2017;'14 - 15;22,44;9,12;13,32;20361;22184;1823;22011;21212;-799
11511;24.04.2017;'15 - 16;24,9;17,16;7,74;17597;19213;1616;20522;19250;-1272
11512;24.04.2017;'16 - 17;27,71;23,36;4,35;13958;15214;1256;18543;17350;-1193
11513;24.04.2017;'17 - 18;32,19;29,99;2,2;9515;9961;446;15958;14527;-1431
11514;24.04.2017;'18 - 19;38,35;37,26;1,09;4866;4808;-58;12969;11700;-1269
11515;24.04.2017;'19 - 20;43,3;44,05;-0,75;1460;1319;-141;10167;8174;-1993
11516;24.04.2017;'20 - 21;43,59;44,31;-0,72;140;50;-90;8113;5957;-2156
11517;24.04.2017;'21 - 22;44,51;44,9;-0,39;0;0;0;6935;4954;-1981
11518;24.04.2017;'22 - 23;44,38;43,91;0,47;0;0;0;6149;4516;-1633
11519;24.04.2017;'23 - 24;38,55;39,78;-1,23;0;0;0;5706;4024;-1682
11520;25.04.2017;'00 - 01;34,01;30,78;3,23;0;0;0;4835;3706;-1129
11521;25.04.2017;'01 - 02;31,07;28,38;2,69;0;0;0;4931;3976;-955
11522;25.04.2017;'02 - 03;31,2;29,23;1,97;0;0;0;5156;4532;-624
11523;25.04.2017;'03 - 04;29,98;27,7;2,28;0;0;0;5514;5558;44
11524;25.04.2017;'04 - 05;29,97;27,14;2,83;0;0;0;5975;6932;957
11525;25.04.2017;'05 - 06;30,5;25,28;5,22;1;3;2;6380;8456;2076
11526;25.04.2017;'06 - 07;37,03;29,23;7,8;321;315;-6;6661;9839;3178
11527;25.04.2017;'07 - 08;41,17;34,8;6,37;2060;2041;-19;6894;9846;2952
11528;25.04.2017;'08 - 09;43;36,1;6,9;4893;4825;-68;7112;9817;2705
11529;25.04.2017;'09 - 10;41,94;35,35;6,59;7948;7409;-539;7499;11440;3941
11530;25.04.2017;'10 - 11;39,81;32,48;7,33;10427;9054;-1373;8306;13410;5104
11531;25.04.2017;'11 - 12;38,1;31,84;6,26;12122;10187;-1935;9238;14394;5156
11532;25.04.2017;'12 - 13;35,09;32,23;2,86;12975;11721;-1254;9937;14744;4807
11533;25.04.2017;'13 - 14;33,91;31,72;2,19;12806;12515;-291;10717;15263;4546
11534;25.04.2017;'14 - 15;31,72;29,58;2,14;11912;11790;-122;11437;15425;3988
11535;25.04.2017;'15 - 16;31,59;30,41;1,18;10328;10046;-282;11854;15512;3658
11536;25.04.2017;'16 - 17;32,46;31,36;1,1;7973;8425;452;11866;15250;3384
11537;25.04.2017;'17 - 18;36,55;32,92;3,63;5399;6139;740;11260;13896;2636
11538;25.04.2017;'18 - 19;39,93;35,94;3,99;2896;3536;640;9965;12149;2184
11539;25.04.2017;'19 - 20;42,95;38,75;4,2;890;1178;288;8406;9268;862
11540;25.04.2017;'20 - 21;42,94;41,71;1,23;61;87;26;6952;7471;519
11541;25.04.2017;'21 - 22;41,98;40,36;1,62;0;0;0;6230;6840;610
11542;25.04.2017;'22 - 23;38,42;35,08;3,34;0;0;0;6010;6167;157
11543;25.04.2017;'23 - 24;33,4;29,29;4,11;0;0;0;5869;5521;-348
11544;26.04.2017;'00 - 01;30,54;28,23;2,31;0;0;0;4219;5196;977
11545;26.04.2017;'01 - 02;30,99;28,38;2,61;0;0;0;3962;4721;759
11546;26.04.2017;'02 - 03;30,95;27,49;3,46;0;0;0;3734;4377;643
11547;26.04.2017;'03 - 04;30,54;27,59;2,95;0;0;0;3498;3829;331
11548;26.04.2017;'04 - 05;30,44;27,37;3,07;0;0;0;3204;3726;522
11549;26.04.2017;'05 - 06;33,1;28,14;4,96;3;5;2;2834;3397;563
11550;26.04.2017;'06 - 07;42,3;39,3;3;344;334;-10;2335;2828;493
11551;26.04.2017;'07 - 08;46,95;43,14;3,81;2060;2007;-53;1759;1985;226
11552;26.04.2017;'08 - 09;53,47;47,07;6,4;4983;4919;-64;1220;942;-278
11553;26.04.2017;'09 - 10;46,98;43,93;3,05;8394;8334;-60;952;630;-322
11554;26.04.2017;'10 - 11;45,61;43,1;2,51;11280;10537;-743;801;896;95
11555;26.04.2017;'11 - 12;44,75;42,37;2,38;13140;11799;-1341;715;1202;487
11556;26.04.2017;'12 - 13;44,01;43,3;0,71;13990;12316;-1674;709;1400;691
11557;26.04.2017;'13 - 14;42;43,54;-1,54;13918;12631;-1287;758;1382;624
11558;26.04.2017;'14 - 15;39,11;40,97;-1,86;13059;12229;-830;905;1670;765
11559;26.04.2017;'15 - 16;38,64;40,05;-1,41;11445;10441;-1004;1146;1795;649
11560;26.04.2017;'16 - 17;38,61;39,09;-0,48;9283;8286;-997;1406;2173;767
11561;26.04.2017;'17 - 18;41,92;41,16;0,76;6531;5982;-549;1618;2560;942
11562;26.04.2017;'18 - 19;43,86;42,79;1,07;3618;3454;-164;1831;2813;982
11563;26.04.2017;'19 - 20;44,09;42,17;1,92;1176;1202;26;2097;2700;603
11564;26.04.2017;'20 - 21;44,34;41,44;2,9;83;83;0;2271;2441;170
11565;26.04.2017;'21 - 22;42,93;40,03;2,9;0;0;0;2411;2396;-15
11566;26.04.2017;'22 - 23;39,1;37,29;1,81;0;0;0;2453;2252;-201
11567;26.04.2017;'23 - 24;32,58;36,14;-3,56;0;0;0;2379;2214;-165
11568;27.04.2017;'00 - 01;32,19;30,88;1,31;0;0;0;2244;2285;41
11569;27.04.2017;'01 - 02;31,46;32,5;-1,04;0;0;0;2271;2331;60
11570;27.04.2017;'02 - 03;31,06;32,25;-1,19;0;0;0;2386;2624;238
11571;27.04.2017;'03 - 04;31,04;31,5;-0,46;0;0;0;2613;2763;150
11572;27.04.2017;'04 - 05;31,52;30,86;0,66;0;0;0;2778;2718;-60
11573;27.04.2017;'05 - 06;32,48;32,58;-0,1;5;7;2;2798;2662;-136
11574;27.04.2017;'06 - 07;41,19;41,01;0,18;435;400;-35;2588;2488;-100
11575;27.04.2017;'07 - 08;44,97;44,07;0,9;2554;2382;-172;2309;2520;211
11576;27.04.2017;'08 - 09;45,93;44,71;1,22;6135;5710;-425;2130;2153;23
11577;27.04.2017;'09 - 10;43,67;40,32;3,35;10127;9569;-558;2339;2513;174
11578;27.04.2017;'10 - 11;42,92;38,96;3,96;13152;12148;-1004;2872;3730;858
11579;27.04.2017;'11 - 12;40,95;34,9;6,05;14932;13369;-1563;3603;4430;827
11580;27.04.2017;'12 - 13;35,83;33,77;2,06;15637;13240;-2397;4536;5771;1235
11581;27.04.2017;'13 - 14;34,99;33,74;1,25;15433;12598;-2835;5431;6749;1318
11582;27.04.2017;'14 - 15;32,01;32,32;-0,31;14423;11856;-2567;6165;7814;1649
11583;27.04.2017;'15 - 16;32,9;32,36;0,54;12657;10744;-1913;6573;8055;1482
11584;27.04.2017;'16 - 17;32,89;32,33;0,56;10145;8855;-1290;6716;8532;1816
11585;27.04.2017;'17 - 18;35,05;32,52;2,53;7086;6147;-939;6512;8261;1749
11586;27.04.2017;'18 - 19;37,96;34,36;3,6;3910;3412;-498;5943;7359;1416
11587;27.04.2017;'19 - 20;41,97;41,65;0,32;1267;1137;-130;5328;6448;1120
11588;27.04.2017;'20 - 21;41,91;43,12;-1,21;95;89;-6;4825;5992;1167
11589;27.04.2017;'21 - 22;41,08;41,09;-0,01;0;0;0;4570;5424;854
11590;27.04.2017;'22 - 23;34,87;38,05;-3,18;0;0;0;4491;5078;587
11591;27.04.2017;'23 - 24;32;34,39;-2,39;0;0;0;4459;5267;808
11592;28.04.2017;'00 - 01;31,38;31,7;-0,32;0;0;0;5192;5216;24
11593;28.04.2017;'01 - 02;31,23;32,83;-1,6;0;0;0;5034;4825;-209
11594;28.04.2017;'02 - 03;30,61;33,18;-2,57;0;0;0;4853;4738;-115
11595;28.04.2017;'03 - 04;30,92;33,11;-2,19;0;0;0;4688;4810;122
11596;28.04.2017;'04 - 05;31,41;32,2;-0,79;0;0;0;4554;4604;50
11597;28.04.2017;'05 - 06;33,52;34,34;-0,82;5;7;2;4334;4306;-28
11598;28.04.2017;'06 - 07;37,14;42,46;-5,32;422;401;-21;3923;4107;184
11599;28.04.2017;'07 - 08;45,4;48,7;-3,3;2317;2498;181;3482;3210;-272
11600;28.04.2017;'08 - 09;46,94;49,26;-2,32;5442;5912;470;3086;2395;-691
11601;28.04.2017;'09 - 10;44,99;46,24;-1,25;8879;9600;721;2871;2053;-818
11602;28.04.2017;'10 - 11;42,9;43,45;-0,55;11422;12045;623;2842;2408;-434
11603;28.04.2017;'11 - 12;41,9;43,1;-1,2;12958;12339;-619;2924;2636;-288
11604;28.04.2017;'12 - 13;38,99;44,67;-5,68;13639;11735;-1904;3034;3036;2
11605;28.04.2017;'13 - 14;35,46;41,89;-6,43;13474;11733;-1741;3226;3336;110
11606;28.04.2017;'14 - 15;33,62;40,88;-7,26;12659;10616;-2043;3597;3595;-2
11607;28.04.2017;'15 - 16;33,05;41,68;-8,63;11154;9273;-1881;4129;3944;-185
11608;28.04.2017;'16 - 17;32,76;40,86;-8,1;9140;7820;-1320;4633;4129;-504
11609;28.04.2017;'17 - 18;33,78;40,34;-6,56;6641;5961;-680;4849;4794;-55
11610;28.04.2017;'18 - 19;40,29;42,44;-2,15;3810;3628;-182;4767;5000;233
11611;28.04.2017;'19 - 20;43,91;44,36;-0,45;1271;1394;123;4710;4768;58
11612;28.04.2017;'20 - 21;42,99;42,96;0,03;103;112;9;4546;3928;-618
11613;28.04.2017;'21 - 22;37,97;37,85;0,12;0;0;0;4575;4188;-387
11614;28.04.2017;'22 - 23;32,65;34,35;-1,7;0;0;0;4745;4414;-331
11615;28.04.2017;'23 - 24;31,08;32,34;-1,26;0;0;0;5005;4474;-531
11616;29.04.2017;'00 - 01;33,61;34,63;-1,02;0;0;0;4975;4628;-347
11617;29.04.2017;'01 - 02;28,44;32,35;-3,91;0;0;0;5333;4966;-367
11618;29.04.2017;'02 - 03;29,88;31,64;-1,76;0;0;0;5725;5292;-433
11619;29.04.2017;'03 - 04;29,86;31,2;-1,34;0;0;0;6039;5718;-321
11620;29.04.2017;'04 - 05;30,16;30,43;-0,27;0;0;0;6225;6346;121
11621;29.04.2017;'05 - 06;30,58;31,54;-0,96;6;8;2;6159;6419;260
11622;29.04.2017;'06 - 07;32,46;33,23;-0,77;505;518;13;5820;6304;484
11623;29.04.2017;'07 - 08;33,72;34,55;-0,83;2856;2956;100;5314;5447;133
11624;29.04.2017;'08 - 09;32,69;33,81;-1,12;6791;7028;237;4924;4247;-677
11625;29.04.2017;'09 - 10;32,56;34,29;-1,73;11143;11630;487;4928;4756;-172
11626;29.04.2017;'10 - 11;28,81;30,99;-2,18;14710;14142;-568;5143;5155;12
11627;29.04.2017;'11 - 12;26,82;29,4;-2,58;16905;15127;-1778;5209;4971;-238
11628;29.04.2017;'12 - 13;25,43;31,79;-6,36;18019;15937;-2082;4954;4816;-138
11629;29.04.2017;'13 - 14;23,09;30,7;-7,61;18147;16735;-1412;4577;4441;-136
11630;29.04.2017;'14 - 15;25,24;27,26;-2,02;17380;16335;-1045;4145;3818;-327
11631;29.04.2017;'15 - 16;25,04;28,23;-3,19;15699;15505;-194;3648;3415;-233
11632;29.04.2017;'16 - 17;27,46;30,03;-2,57;13096;13213;117;3091;2806;-285
11633;29.04.2017;'17 - 18;29,19;30,28;-1,09;9445;9808;363;2517;2220;-297
11634;29.04.2017;'18 - 19;32,54;31,1;1,44;5139;5702;563;2005;1593;-412
11635;29.04.2017;'19 - 20;34,93;32,04;2,89;1611;1939;328;1724;1193;-531
11636;29.04.2017;'20 - 21;34,79;33,28;1,51;134;159;25;1928;1487;-441
11637;29.04.2017;'21 - 22;34,9;33,17;1,73;0;0;0;2784;2994;210
11638;29.04.2017;'22 - 23;32,93;32,63;0,3;0;0;0;3890;4412;522
11639;29.04.2017;'23 - 24;30,47;30,22;0,25;0;0;0;4913;5795;882
11640;30.04.2017;'00 - 01;29,29;20,99;8,3;0;0;0;5618;7285;1667
11641;30.04.2017;'01 - 02;26,02;10,39;15,63;0;0;0;6499;8210;1711
11642;30.04.2017;'02 - 03;22,06;5,9;16,16;0;0;0;7130;9075;1945
11643;30.04.2017;'03 - 04;13,13;7,57;5,56;0;0;0;7716;9968;2252
11644;30.04.2017;'04 - 05;9,63;7,3;2,33;0;0;0;8370;11053;2683
11645;30.04.2017;'05 - 06;10,06;6,68;3,38;12;11;-1;8832;12070;3238
11646;30.04.2017;'06 - 07;16,8;7,12;9,68;635;780;145;8955;12720;3765
11647;30.04.2017;'07 - 08;9,6;3,16;6,44;3954;4582;628;8888;12268;3380
11648;30.04.2017;'08 - 09;9,56;-2,16;11,72;9900;11076;1176;8839;9778;939
11649;30.04.2017;'09 - 10;8,71;-9,14;17,85;16286;17655;1369;9776;11138;1362
11650;30.04.2017;'10 - 11;3,23;-16,16;19,39;21174;22892;1718;11611;14851;3240
11651;30.04.2017;'11 - 12;-1,9;-37,85;35,95;24284;26073;1789;13759;16462;2703
11652;30.04.2017;'12 - 13;-1,18;-58,3;57,12;25811;27375;1564;15838;16527;689
11653;30.04.2017;'13 - 14;-70,01;-94,55;24,54;25999;27500;1501;17663;15428;-2235
11654;30.04.2017;'14 - 15;-74,92;-100,57;25,65;24758;26626;1868;19142;15456;-3686
11655;30.04.2017;'15 - 16;-71,96;-103,33;31,37;22010;24208;2198;20295;16558;-3737
11656;30.04.2017;'16 - 17;-49,97;-110,94;60,97;17772;19829;2057;21292;18518;-2774
11657;30.04.2017;'17 - 18;-6;-68,71;62,71;12011;13718;1707;22046;21952;-94
11658;30.04.2017;'18 - 19;-1,21;-41,26;40,05;5931;7067;1136;22372;24157;1785
11659;30.04.2017;'19 - 20;8,86;-32,68;41,54;1657;2079;422;22653;25870;3217
11660;30.04.2017;'20 - 21;10,08;-22,92;33;155;172;17;23463;26165;2702
11661;30.04.2017;'21 - 22;8,87;-23,8;32,67;0;0;0;24484;27403;2919
11662;30.04.2017;'22 - 23;-0,54;-28,54;28;0;0;0;25389;27472;2083
11663;30.04.2017;'23 - 24;-70,01;-64,93;-5,08;0;0;0;25693;26762;1069
11664;01.05.2017;'00 - 01;-26,94;-20,32;-6,62;0;0;0;27168;27360;192
11665;01.05.2017;'01 - 02;-25;-13,38;-11,62;0;0;0;26701;26476;-225
11666;01.05.2017;'02 - 03;-30,11;-13,32;-16,79;0;0;0;26093;25572;-521
11667;01.05.2017;'03 - 04;-30,03;-11,93;-18,1;0;0;0;25403;24278;-1125
11668;01.05.2017;'04 - 05;-24,9;-0,99;-23,91;0;0;0;24635;22768;-1867
11669;01.05.2017;'05 - 06;-30,05;-0,31;-29,74;15;13;-2;23696;21870;-1826
11670;01.05.2017;'06 - 07;-62,95;-2,13;-60,82;649;763;114;22523;21073;-1450
11671;01.05.2017;'07 - 08;-53,85;-1,25;-52,6;3482;3759;277;21315;19966;-1349
11672;01.05.2017;'08 - 09;-67,02;-7,52;-59,5;7887;7974;87;20428;18252;-2176
11673;01.05.2017;'09 - 10;-65;-2,44;-62,56;12140;11750;-390;19897;17685;-2212
11674;01.05.2017;'10 - 11;-67,08;1,29;-68,37;14904;14256;-648;19635;18063;-1572
11675;01.05.2017;'11 - 12;-66,85;6,35;-73,2;16215;15383;-832;19654;18425;-1229
11676;01.05.2017;'12 - 13;-60,39;11,35;-71,74;16256;15042;-1214;19719;18483;-1236
11677;01.05.2017;'13 - 14;-61,14;13,58;-74,72;14836;13710;-1126;19643;18684;-959
11678;01.05.2017;'14 - 15;-27,22;16,26;-43,48;12664;11906;-758;19394;18207;-1187
11679;01.05.2017;'15 - 16;-12,01;16,16;-28,17;10252;9758;-494;18920;17488;-1432
11680;01.05.2017;'16 - 17;-1,2;17,31;-18,51;7695;7372;-323;18421;16942;-1479
11681;01.05.2017;'17 - 18;7,42;19,93;-12,51;5103;4671;-432;17985;17022;-963
11682;01.05.2017;'18 - 19;14,01;24,35;-10,34;2754;2468;-286;17650;16698;-952
11683;01.05.2017;'19 - 20;25,78;26,72;-0,94;937;846;-91;17550;15992;-1558
11684;01.05.2017;'20 - 21;24,9;29,31;-4,41;83;67;-16;17699;15986;-1713
11685;01.05.2017;'21 - 22;22,98;27,62;-4,64;0;0;0;17790;16080;-1710
11686;01.05.2017;'22 - 23;22,09;27,3;-5,21;0;0;0;17762;15852;-1910
11687;01.05.2017;'23 - 24;12,05;22,35;-10,3;0;0;0;17593;15444;-2149
11688;02.05.2017;'00 - 01;13,47;22,08;-8,61;0;0;0;17381;15016;-2365
11689;02.05.2017;'01 - 02;12,01;18,1;-6,09;0;0;0;16926;14867;-2059
11690;02.05.2017;'02 - 03;10,41;16,31;-5,9;0;0;0;16494;15098;-1396
11691;02.05.2017;'03 - 04;12,03;13,95;-1,92;0;0;0;16257;15590;-667
11692;02.05.2017;'04 - 05;9,69;13,83;-4,14;0;0;0;16162;16079;-83
11693;02.05.2017;'05 - 06;25,03;22,29;2,74;9;10;1;16131;16568;437
11694;02.05.2017;'06 - 07;33,95;32,3;1,65;355;339;-16;16095;16929;834
11695;02.05.2017;'07 - 08;38,97;36,4;2,57;1668;1604;-64;16137;16986;849
11696;02.05.2017;'08 - 09;39,98;38,17;1,81;3766;3446;-320;16464;17596;1132
11697;02.05.2017;'09 - 10;35,84;36,67;-0,83;6118;5639;-479;17120;18116;996
11698;02.05.2017;'10 - 11;34,85;37,14;-2,29;8197;7956;-241;17793;18696;903
11699;02.05.2017;'11 - 12;33,47;36,4;-2,93;9846;10002;156;18425;19577;1152
11700;02.05.2017;'12 - 13;31,04;34,38;-3,34;10966;11444;478;18921;20424;1503
11701;02.05.2017;'13 - 14;30,78;31,51;-0,73;11410;11714;304;19110;20452;1342
11702;02.05.2017;'14 - 15;30,4;32,26;-1,86;11194;11300;106;18856;19884;1028
11703;02.05.2017;'15 - 16;30,41;34,97;-4,56;10257;9900;-357;18142;19167;1025
11704;02.05.2017;'16 - 17;30,43;35,38;-4,95;8577;8096;-481;17394;17542;148
11705;02.05.2017;'17 - 18;31,02;38,9;-7,88;6200;5680;-520;16770;16592;-178
11706;02.05.2017;'18 - 19;34,97;41,96;-6,99;3408;2943;-465;16350;15987;-363
11707;02.05.2017;'19 - 20;38,52;44,1;-5,58;1084;945;-139;16101;15306;-795
11708;02.05.2017;'20 - 21;38,57;42,75;-4,18;101;52;-49;15924;14936;-988
11709;02.05.2017;'21 - 22;35,23;40,84;-5,61;0;0;0;15685;15312;-373
11710;02.05.2017;'22 - 23;33,34;37,78;-4,44;0;0;0;15483;14582;-901
11711;02.05.2017;'23 - 24;28,46;33,7;-5,24;0;0;0;15183;14580;-603
11712;03.05.2017;'00 - 01;28,59;31,3;-2,71;0;0;0;15306;13982;-1324
11713;03.05.2017;'01 - 02;27,43;29,44;-2,01;0;0;0;14630;13359;-1271
11714;03.05.2017;'02 - 03;27,48;28,73;-1,25;0;0;0;13945;12688;-1257
11715;03.05.2017;'03 - 04;28,5;28,4;0,1;0;0;0;13213;11924;-1289
11716;03.05.2017;'04 - 05;30,35;25,96;4,39;0;0;0;12484;10938;-1546
11717;03.05.2017;'05 - 06;31,95;32,24;-0,29;17;16;-1;11792;10514;-1278
11718;03.05.2017;'06 - 07;39,51;37,81;1,7;639;574;-65;11138;10479;-659
11719;03.05.2017;'07 - 08;44,99;42,6;2,39;2862;2591;-271;10559;10294;-265
11720;03.05.2017;'08 - 09;45;41,1;3,9;6219;5501;-718;10109;9721;-388
11721;03.05.2017;'09 - 10;39,73;43,61;-3,88;9822;8900;-922;9919;9102;-817
11722;03.05.2017;'10 - 11;38,97;40,71;-1,74;12635;12207;-428;9919;9032;-887
11723;03.05.2017;'11 - 12;38,48;39,78;-1,3;14419;14263;-156;10146;9600;-546
11724;03.05.2017;'12 - 13;34,27;34,04;0,23;15275;15071;-204;10579;10519;-60
11725;03.05.2017;'13 - 14;33,94;35,75;-1,81;15052;15004;-48;11200;11300;100
11726;03.05.2017;'14 - 15;34,01;35,26;-1,25;13954;14327;373;11997;12662;665
11727;03.05.2017;'15 - 16;32,83;32,91;-0,08;12064;12933;869;12913;13984;1071
11728;03.05.2017;'16 - 17;31,79;32,81;-1,02;9628;10822;1194;13742;15088;1346
11729;03.05.2017;'17 - 18;32,43;30,67;1,76;6810;7821;1011;14423;16172;1749
11730;03.05.2017;'18 - 19;34,9;32,68;2,22;3855;4437;582;14907;16399;1492
11731;03.05.2017;'19 - 20;37,66;35,48;2,18;1359;1514;155;15279;15829;550
11732;03.05.2017;'20 - 21;38,94;38,12;0,82;134;116;-18;15627;15713;86
11733;03.05.2017;'21 - 22;36,97;37,2;-0,23;0;0;0;15854;16387;533
11734;03.05.2017;'22 - 23;30,52;33,71;-3,19;0;0;0;15917;16167;250
11735;03.05.2017;'23 - 24;28,6;30,12;-1,52;0;0;0;15830;15928;98
11736;04.05.2017;'00 - 01;26,91;31,74;-4,83;0;0;0;18006;15951;-2055
11737;04.05.2017;'01 - 02;26,26;29,39;-3,13;0;0;0;17681;15811;-1870
11738;04.05.2017;'02 - 03;24,57;28,5;-3,93;0;0;0;17468;15566;-1902
11739;04.05.2017;'03 - 04;24,82;29,12;-4,3;0;0;0;17445;15401;-2044
11740;04.05.2017;'04 - 05;25,8;30,06;-4,26;0;0;0;17455;15154;-2301
11741;04.05.2017;'05 - 06;27,57;33,58;-6,01;10;8;-2;17490;14877;-2613
11742;04.05.2017;'06 - 07;33,23;41,34;-8,11;405;410;5;17515;15108;-2407
11743;04.05.2017;'07 - 08;38,94;46,62;-7,68;1861;2026;165;17573;14848;-2725
11744;04.05.2017;'08 - 09;39,91;49,46;-9,55;3947;4276;329;17788;14511;-3277
11745;04.05.2017;'09 - 10;39,14;51,38;-12,24;6114;6568;454;18191;14112;-4079
11746;04.05.2017;'10 - 11;38,94;47,41;-8,47;7813;8742;929;18602;14036;-4566
11747;04.05.2017;'11 - 12;38,95;45,61;-6,66;8967;10120;1153;18977;14787;-4190
11748;04.05.2017;'12 - 13;34,17;41,23;-7,06;9669;10666;997;19317;15428;-3889
11749;04.05.2017;'13 - 14;31,94;38,37;-6,43;9816;10457;641;19581;16068;-3513
11750;04.05.2017;'14 - 15;30,46;36,31;-5,85;9352;9639;287;19668;16483;-3185
11751;04.05.2017;'15 - 16;30,4;35,4;-5;8294;7992;-302;19554;17169;-2385
11752;04.05.2017;'16 - 17;29,79;35,08;-5,29;6674;6040;-634;19472;17648;-1824
11753;04.05.2017;'17 - 18;34,4;37,17;-2,77;4719;4145;-574;19391;17302;-2089
11754;04.05.2017;'18 - 19;36,97;42,32;-5,35;2664;2339;-325;19276;16964;-2312
11755;04.05.2017;'19 - 20;38,97;46,2;-7,23;930;861;-69;19159;17049;-2110
11756;04.05.2017;'20 - 21;38,95;43,34;-4,39;98;68;-30;18913;16308;-2605
11757;04.05.2017;'21 - 22;36,54;38,96;-2,42;0;0;0;18402;15251;-3151
11758;04.05.2017;'22 - 23;32,23;35,55;-3,32;0;0;0;17640;13938;-3702
11759;04.05.2017;'23 - 24;26,97;32,94;-5,97;0;0;0;16643;13643;-3000
11760;05.05.2017;'00 - 01;28,97;30,99;-2,02;0;0;0;13779;13209;-570
11761;05.05.2017;'01 - 02;28,82;27,33;1,49;0;0;0;13163;12555;-608
11762;05.05.2017;'02 - 03;28,42;26,74;1,68;0;0;0;12603;11878;-725
11763;05.05.2017;'03 - 04;28,61;24,95;3,66;0;0;0;12185;11430;-755
11764;05.05.2017;'04 - 05;29,4;26,21;3,19;0;0;0;11787;10711;-1076
11765;05.05.2017;'05 - 06;30,99;30,9;0,09;11;8;-3;11345;9964;-1381
11766;05.05.2017;'06 - 07;37,17;38,51;-1,34;376;220;-156;10832;9868;-964
11767;05.05.2017;'07 - 08;43,82;44,92;-1,1;1660;1226;-434;10356;9098;-1258
11768;05.05.2017;'08 - 09;48,98;53,03;-4,05;3459;2870;-589;9887;8471;-1416
11769;05.05.2017;'09 - 10;49,91;52,97;-3,06;5352;4728;-624;9443;7938;-1505
11770;05.05.2017;'10 - 11;47,9;47,83;0,07;7213;6592;-621;9019;7236;-1783
11771;05.05.2017;'11 - 12;46,38;48,23;-1,85;8950;8136;-814;8588;6240;-2348
11772;05.05.2017;'12 - 13;42;50,9;-8,9;10477;9150;-1327;8132;5542;-2590
11773;05.05.2017;'13 - 14;40,09;46,36;-6,27;11420;9933;-1487;7601;4706;-2895
11774;05.05.2017;'14 - 15;36,97;43,17;-6,2;11613;9942;-1671;6972;4003;-2969
11775;05.05.2017;'15 - 16;35,37;41,65;-6,28;10949;9686;-1263;6359;3810;-2549
11776;05.05.2017;'16 - 17;34,9;41,05;-6,15;9323;8598;-725;5873;2974;-2899
11777;05.05.2017;'17 - 18;37,67;40,91;-3,24;6871;6764;-107;5547;2659;-2888
11778;05.05.2017;'18 - 19;40,33;41,75;-1,42;3932;4180;248;5391;2668;-2723
11779;05.05.2017;'19 - 20;42,09;42,95;-0,86;1406;1604;198;5299;2994;-2305
11780;05.05.2017;'20 - 21;41,16;42,11;-0,95;156;162;6;5246;3326;-1920
11781;05.05.2017;'21 - 22;38,98;42,56;-3,58;0;0;0;5249;3997;-1252
11782;05.05.2017;'22 - 23;39,27;37,3;1,97;0;0;0;5226;4225;-1001
11783;05.05.2017;'23 - 24;34,9;30,81;4,09;0;0;0;5004;4364;-640
11784;06.05.2017;'00 - 01;37,04;31,79;5,25;0;0;0;4151;4678;527
11785;06.05.2017;'01 - 02;32,47;29,88;2,59;0;0;0;3982;4648;666
11786;06.05.2017;'02 - 03;31,04;23,89;7,15;0;0;0;3872;4606;734
11787;06.05.2017;'03 - 04;30,71;25,55;5,16;0;0;0;3890;4601;711
11788;06.05.2017;'04 - 05;30,57;25,47;5,1;0;0;0;3938;4468;530
11789;06.05.2017;'05 - 06;30,86;26,08;4,78;26;17;-9;3884;4438;554
11790;06.05.2017;'06 - 07;30,92;27,59;3,33;792;764;-28;3708;4410;702
11791;06.05.2017;'07 - 08;31,14;28,45;2,69;3481;3412;-69;3433;4147;714
11792;06.05.2017;'08 - 09;33,92;30,48;3,44;7462;7509;47;3089;3410;321
11793;06.05.2017;'09 - 10;33,06;31,39;1,67;11584;12136;552;2966;3188;222
11794;06.05.2017;'10 - 11;31,53;27,83;3,7;14710;16056;1346;3087;3413;326
11795;06.05.2017;'11 - 12;30,64;27,85;2,79;16547;18763;2216;3305;3769;464
11796;06.05.2017;'12 - 13;30,79;25,4;5,39;17289;20242;2953;3532;3991;459
11797;06.05.2017;'13 - 14;30,1;24,28;5,82;17122;20218;3096;3694;4003;309
11798;06.05.2017;'14 - 15;29,6;23,62;5,98;15830;18997;3167;3742;4178;436
11799;06.05.2017;'15 - 16;28,93;24,7;4,23;13671;16486;2815;3820;4342;522
11800;06.05.2017;'16 - 17;28,28;26,18;2,1;10804;12928;2124;4054;4484;430
11801;06.05.2017;'17 - 18;31,02;27,95;3,07;7379;9091;1712;4411;4527;116
11802;06.05.2017;'18 - 19;33,82;33,09;0,73;4040;4996;956;4844;4376;-468
11803;06.05.2017;'19 - 20;37,94;35,83;2,11;1507;1827;320;5381;4450;-931
11804;06.05.2017;'20 - 21;39,9;37,59;2,31;191;189;-2;5910;4608;-1302
11805;06.05.2017;'21 - 22;39,5;37,36;2,14;0;0;0;6316;5425;-891
11806;06.05.2017;'22 - 23;38,92;34;4,92;0;0;0;6481;5776;-705
11807;06.05.2017;'23 - 24;33,93;27,02;6,91;0;0;0;6165;5396;-769
11808;07.05.2017;'00 - 01;28,31;24,33;3,98;0;0;0;4555;4835;280
11809;07.05.2017;'01 - 02;26,73;22,56;4,17;0;0;0;3892;4033;141
11810;07.05.2017;'02 - 03;26,48;22,83;3,65;0;0;0;3339;3207;-132
11811;07.05.2017;'03 - 04;26,17;23,38;2,79;0;0;0;2906;2458;-448
11812;07.05.2017;'04 - 05;26,83;24,67;2,16;0;0;0;2576;2055;-521
11813;07.05.2017;'05 - 06;26,25;24,14;2,11;31;22;-9;2250;1783;-467
11814;07.05.2017;'06 - 07;25,43;23,48;1,95;646;588;-58;1918;1672;-246
11815;07.05.2017;'07 - 08;26,66;24,61;2,05;2369;2248;-121;1623;1332;-291
11816;07.05.2017;'08 - 09;28,66;25,26;3,4;4631;4511;-120;1430;1072;-358
11817;07.05.2017;'09 - 10;30,06;29,7;0,36;6937;7216;279;1465;1096;-369
11818;07.05.2017;'10 - 11;30,33;28,87;1,46;9026;9765;739;1676;1455;-221
11819;07.05.2017;'11 - 12;30,18;28,66;1,52;10717;11528;811;2024;1916;-108
11820;07.05.2017;'12 - 13;29,5;27,03;2,47;11644;12952;1308;2488;2352;-136
11821;07.05.2017;'13 - 14;27,06;27,27;-0,21;11758;13745;1987;3025;2682;-343
11822;07.05.2017;'14 - 15;24;25;-1;11295;13494;2199;3634;3301;-333
11823;07.05.2017;'15 - 16;24,15;25,08;-0,93;10143;12062;1919;4289;4235;-54
11824;07.05.2017;'16 - 17;25,51;24,63;0,88;8282;9890;1608;4869;5378;509
11825;07.05.2017;'17 - 18;27,4;26,28;1,12;5895;7004;1109;5335;6292;957
11826;07.05.2017;'18 - 19;29,8;27,08;2,72;3357;3854;497;5562;6753;1191
11827;07.05.2017;'19 - 20;31,18;28,76;2,42;1271;1357;86;5692;7043;1351
11828;07.05.2017;'20 - 21;32,13;31,8;0,33;172;160;-12;5852;7404;1552
11829;07.05.2017;'21 - 22;32,01;32,49;-0,48;0;0;0;6162;7855;1693
11830;07.05.2017;'22 - 23;31,26;31,29;-0,03;0;0;0;6534;8130;1596
11831;07.05.2017;'23 - 24;27;26,36;0,64;0;0;0;6743;8084;1341
11832;08.05.2017;'00 - 01;27,48;26,67;0,81;0;0;0;5688;7739;2051
11833;08.05.2017;'01 - 02;26,1;24,58;1,52;0;0;0;5612;7083;1471
11834;08.05.2017;'02 - 03;25,81;24,66;1,15;0;0;0;5609;6774;1165
11835;08.05.2017;'03 - 04;24,73;25,74;-1,01;0;0;0;5834;6840;1006
11836;08.05.2017;'04 - 05;25,14;26,13;-0,99;0;0;0;6299;7071;772
11837;08.05.2017;'05 - 06;27,91;28,04;-0,13;26;18;-8;7025;8232;1207
11838;08.05.2017;'06 - 07;32;29,29;2,71;520;343;-177;7930;10000;2070
11839;08.05.2017;'07 - 08;36,06;34,3;1,76;1841;1358;-483;8874;11544;2670
11840;08.05.2017;'08 - 09;40,02;37,24;2,78;3535;2755;-780;9697;12614;2917
11841;08.05.2017;'09 - 10;39,93;37,32;2,61;5329;4173;-1156;10318;13272;2954
11842;08.05.2017;'10 - 11;38,97;37,44;1,53;7013;5400;-1613;10892;14015;3123
11843;08.05.2017;'11 - 12;39,98;42,11;-2,13;8511;6486;-2025;11346;14436;3090
11844;08.05.2017;'12 - 13;40,55;40,59;-0,04;9627;7246;-2381;11635;14676;3041
11845;08.05.2017;'13 - 14;36,74;38,82;-2,08;9941;7430;-2511;12005;14300;2295
11846;08.05.2017;'14 - 15;32,06;39,07;-7,01;9656;7289;-2367;12408;14398;1990
11847;08.05.2017;'15 - 16;31,44;36,4;-4,96;8880;6827;-2053;12771;14756;1985
11848;08.05.2017;'16 - 17;31,05;33,59;-2,54;7492;5988;-1504;13062;14732;1670
11849;08.05.2017;'17 - 18;32,41;34,04;-1,63;5617;4551;-1066;13041;14828;1787
11850;08.05.2017;'18 - 19;34;37,95;-3,95;3422;2739;-683;12532;14285;1753
11851;08.05.2017;'19 - 20;38,8;40,41;-1,61;1402;1144;-258;11807;12873;1066
11852;08.05.2017;'20 - 21;37,62;40,36;-2,74;203;180;-23;10892;10926;34
11853;08.05.2017;'21 - 22;37,99;40,27;-2,28;0;1;1;10001;9496;-505
11854;08.05.2017;'22 - 23;35,07;39,96;-4,89;0;0;0;9267;8696;-571
11855;08.05.2017;'23 - 24;32,44;34,03;-1,59;0;0;0;8495;7869;-626
11856;09.05.2017;'00 - 01;30,81;32,22;-1,41;0;0;0;6427;6426;-1
11857;09.05.2017;'01 - 02;30,56;31,12;-0,56;0;0;0;5122;4880;-242
11858;09.05.2017;'02 - 03;29,5;32,74;-3,24;0;0;0;4147;3910;-237
11859;09.05.2017;'03 - 04;28,94;32,6;-3,66;0;0;0;3455;3006;-449
11860;09.05.2017;'04 - 05;29,9;33,66;-3,76;0;0;0;2945;2390;-555
11861;09.05.2017;'05 - 06;32,07;39,96;-7,89;45;34;-11;2516;2063;-453
11862;09.05.2017;'06 - 07;42,83;47,41;-4,58;884;915;31;2219;1764;-455
11863;09.05.2017;'07 - 08;50,45;53,53;-3,08;3552;3592;40;1967;1326;-641
11864;09.05.2017;'08 - 09;54,99;62,45;-7,46;7486;7746;260;1882;944;-938
11865;09.05.2017;'09 - 10;48,65;56,75;-8,1;11689;12514;825;2316;1314;-1002
11866;09.05.2017;'10 - 11;44,75;46,6;-1,85;14848;16053;1205;3010;1703;-1307
11867;09.05.2017;'11 - 12;43,83;43,31;0,52;16776;17382;606;3690;2043;-1647
11868;09.05.2017;'12 - 13;40,63;41,38;-0,75;17601;16760;-841;4350;2424;-1926
11869;09.05.2017;'13 - 14;38;43,85;-5,85;17611;16056;-1555;5030;2932;-2098
11870;09.05.2017;'14 - 15;35,57;42,49;-6,92;16631;15741;-890;5713;3370;-2343
11871;09.05.2017;'15 - 16;36,2;40,46;-4,26;14698;14537;-161;6450;3960;-2490
11872;09.05.2017;'16 - 17;34,44;38,96;-4,52;11973;12283;310;7173;4424;-2749
11873;09.05.2017;'17 - 18;39,64;39,56;0,08;8610;8960;350;7535;4528;-3007
11874;09.05.2017;'18 - 19;44,9;43,79;1,11;4993;5460;467;7495;4090;-3405
11875;09.05.2017;'19 - 20;47,45;45,58;1,87;1981;2225;244;7144;3614;-3530
11876;09.05.2017;'20 - 21;49,12;47,4;1,72;280;303;23;6704;3278;-3426
11877;09.05.2017;'21 - 22;46,93;45,99;0,94;0;0;0;6423;3282;-3141
11878;09.05.2017;'22 - 23;39,9;40,59;-0,69;0;0;0;6341;3976;-2365
11879;09.05.2017;'23 - 24;34,06;36,6;-2,54;0;0;0;6381;4849;-1532
11880;10.05.2017;'00 - 01;32,06;34,81;-2,75;0;0;0;6904;5625;-1279
11881;10.05.2017;'01 - 02;30,99;33,57;-2,58;0;0;0;7501;6237;-1264
11882;10.05.2017;'02 - 03;30,75;29,66;1,09;0;0;0;7996;6604;-1392
11883;10.05.2017;'03 - 04;30,72;28,59;2,13;0;0;0;8368;7014;-1354
11884;10.05.2017;'04 - 05;31,03;28,62;2,41;0;0;0;8633;6834;-1799
11885;10.05.2017;'05 - 06;33,11;32,23;0,88;39;34;-5;8606;6707;-1899
11886;10.05.2017;'06 - 07;42,04;41,71;0,33;894;1102;208;8144;6160;-1984
11887;10.05.2017;'07 - 08;49,98;49,99;-0,01;3855;4405;550;7603;5038;-2565
11888;10.05.2017;'08 - 09;49,07;46,68;2,39;8471;9508;1037;7377;4500;-2877
11889;10.05.2017;'09 - 10;43,86;39,51;4,35;13213;14798;1585;7394;4232;-3162
11890;10.05.2017;'10 - 11;39,16;35,75;3,41;16816;19063;2247;7364;4512;-2852
11891;10.05.2017;'11 - 12;39,22;34;5,22;19034;21958;2924;7156;4898;-2258
11892;10.05.2017;'12 - 13;36,13;32,33;3,8;20096;23298;3202;6782;5246;-1536
11893;10.05.2017;'13 - 14;36,12;31,71;4,41;20520;24009;3489;6430;5273;-1157
11894;10.05.2017;'14 - 15;34,52;30,58;3,94;19802;23541;3739;6176;5104;-1072
11895;10.05.2017;'15 - 16;34,12;30,09;4,03;17996;21636;3640;5882;4879;-1003
11896;10.05.2017;'16 - 17;35,01;30,4;4,61;15078;18076;2998;5338;4273;-1065
11897;10.05.2017;'17 - 18;41,08;35,19;5,89;10959;13085;2126;4545;3321;-1224
11898;10.05.2017;'18 - 19;44,01;41,55;2,46;6197;7346;1149;3578;2458;-1120
11899;10.05.2017;'19 - 20;48,04;42,27;5,77;2328;2669;341;2750;1989;-761
11900;10.05.2017;'20 - 21;47,35;42,53;4,82;328;372;44;2325;1926;-399
11901;10.05.2017;'21 - 22;48,04;42,22;5,82;0;1;1;2467;2422;-45
11902;10.05.2017;'22 - 23;42,94;40,85;2,09;0;0;0;2826;3007;181
11903;10.05.2017;'23 - 24;32,6;32,2;0,4;0;0;0;3047;3475;428
11904;11.05.2017;'00 - 01;31,16;32,37;-1,21;0;0;0;3397;3636;239
11905;11.05.2017;'01 - 02;30,41;31,14;-0,73;0;0;0;3772;3738;-34
11906;11.05.2017;'02 - 03;29,5;32,33;-2,83;0;0;0;3986;4024;38
11907;11.05.2017;'03 - 04;29,17;32,32;-3,15;0;0;0;3982;4409;427
11908;11.05.2017;'04 - 05;29,59;32,72;-3,13;0;0;0;3944;4665;721
11909;11.05.2017;'05 - 06;30,89;34,87;-3,98;58;54;-4;4001;5058;1057
11910;11.05.2017;'06 - 07;34,91;39,66;-4,75;1090;1311;221;3996;5556;1560
11911;11.05.2017;'07 - 08;43,1;43,62;-0,52;4438;5210;772;3775;5058;1283
11912;11.05.2017;'08 - 09;44,49;42,86;1,63;9346;10853;1507;3290;3398;108
11913;11.05.2017;'09 - 10;41,93;38,55;3,38;14333;16370;2037;2940;3108;168
11914;11.05.2017;'10 - 11;38,54;34,74;3,8;18191;20539;2348;3135;3183;48
11915;11.05.2017;'11 - 12;37,47;33,67;3,8;20461;23613;3152;3473;3473;0
11916;11.05.2017;'12 - 13;35,32;32,2;3,12;21166;25119;3953;4002;4423;421
11917;11.05.2017;'13 - 14;34,38;29,52;4,86;20864;24766;3902;4571;5647;1076
11918;11.05.2017;'14 - 15;32,64;28,63;4,01;19355;22420;3065;5135;6728;1593
11919;11.05.2017;'15 - 16;33,82;32,5;1,32;16711;18245;1534;5792;7750;1958
11920;11.05.2017;'16 - 17;33,19;38,31;-5,12;12969;13489;520;6498;8744;2246
11921;11.05.2017;'17 - 18;34,8;39,2;-4,4;8706;8702;-4;7565;10070;2505
11922;11.05.2017;'18 - 19;35,75;38,73;-2,98;4687;4636;-51;9223;11714;2491
11923;11.05.2017;'19 - 20;34,94;39,74;-4,8;1773;1746;-27;11220;12547;1327
11924;11.05.2017;'20 - 21;33,11;38,54;-5,43;270;250;-20;13384;13497;113
11925;11.05.2017;'21 - 22;31,5;40,22;-8,72;1;1;0;15178;15918;740
11926;11.05.2017;'22 - 23;27,6;35,62;-8,02;0;0;0;16167;16334;167
11927;11.05.2017;'23 - 24;26,01;31,95;-5,94;0;0;0;16392;15465;-927
11928;12.05.2017;'00 - 01;26,05;31,87;-5,82;0;0;0;16248;14744;-1504
11929;12.05.2017;'01 - 02;27,23;31,98;-4,75;0;0;0;15410;13723;-1687
11930;12.05.2017;'02 - 03;27,29;30,89;-3,6;0;0;0;14546;12982;-1564
11931;12.05.2017;'03 - 04;27,27;28,62;-1,35;0;0;0;13821;12393;-1428
11932;12.05.2017;'04 - 05;27,08;27,85;-0,77;0;0;0;13161;11894;-1267
11933;12.05.2017;'05 - 06;29;30,55;-1,55;56;52;-4;12412;11120;-1292
11934;12.05.2017;'06 - 07;34,37;40,6;-6,23;871;824;-47;11510;10464;-1046
11935;12.05.2017;'07 - 08;41,95;46,36;-4,41;3017;2885;-132;10561;9287;-1274
11936;12.05.2017;'08 - 09;43,91;54,54;-10,63;5865;6163;298;9808;7854;-1954
11937;12.05.2017;'09 - 10;42;51,55;-9,55;8957;10102;1145;9366;6638;-2728
11938;12.05.2017;'10 - 11;42,95;48,76;-5,81;11835;13716;1881;9119;6058;-3061
11939;12.05.2017;'11 - 12;42,02;44,1;-2,08;14184;16587;2403;9057;6055;-3002
11940;12.05.2017;'12 - 13;36,03;41,51;-5,48;15649;18257;2608;9153;6489;-2664
11941;12.05.2017;'13 - 14;31,62;37,18;-5,56;16048;18450;2402;9205;7042;-2163
11942;12.05.2017;'14 - 15;30,86;36,41;-5,55;15428;17472;2044;9014;7540;-1474
11943;12.05.2017;'15 - 16;30,45;36,68;-6,23;13911;15399;1488;8538;8003;-535
11944;12.05.2017;'16 - 17;31,38;39,33;-7,95;11528;12459;931;8058;8148;90
11945;12.05.2017;'17 - 18;36,46;41,27;-4,81;8367;8406;39;7590;8034;444
11946;12.05.2017;'18 - 19;40,65;45,68;-5,03;4903;4715;-188;7126;7758;632
11947;12.05.2017;'19 - 20;42;46,07;-4,07;2009;2144;135;6863;6910;47
11948;12.05.2017;'20 - 21;42,62;46,15;-3,53;326;342;16;6898;6702;-196
11949;12.05.2017;'21 - 22;42,93;44,45;-1,52;1;1;0;7125;6352;-773
11950;12.05.2017;'22 - 23;42,93;40,69;2,24;0;0;0;7275;6250;-1025
11951;12.05.2017;'23 - 24;35,91;33,53;2,38;0;0;0;7183;6285;-898
11952;13.05.2017;'00 - 01;29,9;29,5;0,4;0;0;0;6756;6067;-689
11953;13.05.2017;'01 - 02;29,66;30,48;-0,82;0;0;0;6334;5975;-359
11954;13.05.2017;'02 - 03;29,05;35,28;-6,23;0;0;0;5887;5371;-516
11955;13.05.2017;'03 - 04;28,52;29,95;-1,43;0;0;0;5452;4992;-460
11956;13.05.2017;'04 - 05;28,12;29;-0,88;0;0;0;5080;4821;-259
11957;13.05.2017;'05 - 06;28,73;29,57;-0,84;64;51;-13;4732;4852;120
11958;13.05.2017;'06 - 07;29,05;29,87;-0,82;1066;1055;-11;4398;4820;422
11959;13.05.2017;'07 - 08;30,91;29,37;1,54;3772;3819;47;3982;4211;229
11960;13.05.2017;'08 - 09;35,02;29,82;5,2;7546;7772;226;3525;2943;-582
11961;13.05.2017;'09 - 10;35,45;28;7,45;11434;11798;364;3137;2264;-873
11962;13.05.2017;'10 - 11;32;28,74;3,26;14611;14956;345;2911;1855;-1056
11963;13.05.2017;'11 - 12;31,04;28,21;2,83;16965;17617;652;2871;2133;-738
11964;13.05.2017;'12 - 13;30,28;27,78;2,5;18176;18692;516;2988;2732;-256
11965;13.05.2017;'13 - 14;28,75;24,57;4,18;18451;18069;-382;3176;3028;-148
11966;13.05.2017;'14 - 15;27,09;26,15;0,94;17643;16733;-910;3274;3099;-175
11967;13.05.2017;'15 - 16;27,07;26,69;0,38;15759;15685;-74;3246;3063;-183
11968;13.05.2017;'16 - 17;27,44;27,36;0,08;12882;12674;-208;3217;2815;-402
11969;13.05.2017;'17 - 18;29,9;27,94;1,96;9181;8968;-213;3070;2806;-264
11970;13.05.2017;'18 - 19;34,79;32,32;2,47;5360;5229;-131;2773;2665;-108
11971;13.05.2017;'19 - 20;40;33,94;6,06;2207;2004;-203;2567;2768;201
11972;13.05.2017;'20 - 21;41,91;32,5;9,41;370;302;-68;2482;2786;304
11973;13.05.2017;'21 - 22;41,88;32,94;8,94;1;4;3;2601;2587;-14
11974;13.05.2017;'22 - 23;40;34,7;5,3;0;0;0;2842;2724;-118
11975;13.05.2017;'23 - 24;31,08;32,33;-1,25;0;0;0;3113;2765;-348
11976;14.05.2017;'00 - 01;27,66;29,23;-1,57;0;0;0;2956;2712;-244
11977;14.05.2017;'01 - 02;26,54;28,35;-1,81;0;0;0;3204;2924;-280
11978;14.05.2017;'02 - 03;25,65;26,01;-0,36;0;0;0;3455;3406;-49
11979;14.05.2017;'03 - 04;25,63;22,81;2,82;0;0;0;3531;3690;159
11980;14.05.2017;'04 - 05;25,2;20,27;4,93;0;0;0;3498;4195;697
11981;14.05.2017;'05 - 06;25;20,17;4,83;75;67;-8;3365;4208;843
11982;14.05.2017;'06 - 07;25,56;17,26;8,3;1105;1156;51;3045;4002;957
11983;14.05.2017;'07 - 08;25,46;17,9;7,56;3868;3845;-23;2683;3692;1009
11984;14.05.2017;'08 - 09;25,34;21,61;3,73;7785;7759;-26;2387;2872;485
11985;14.05.2017;'09 - 10;26,04;21,66;4,38;11779;12337;558;2321;2828;507
11986;14.05.2017;'10 - 11;25,04;17,9;7,14;14840;16257;1417;2458;3289;831
11987;14.05.2017;'11 - 12;26,48;16,63;9,85;16803;17831;1028;2701;3763;1062
11988;14.05.2017;'12 - 13;27,02;17,25;9,77;17565;17798;233;2987;4212;1225
11989;14.05.2017;'13 - 14;24,3;15,78;8,52;17619;16854;-765;3312;4365;1053
11990;14.05.2017;'14 - 15;21,06;15,94;5,12;16638;15816;-822;3545;4544;999
11991;14.05.2017;'15 - 16;20,99;14,76;6,23;14644;14064;-580;3591;4666;1075
11992;14.05.2017;'16 - 17;23,9;16,66;7,24;11978;11580;-398;3700;4089;389
11993;14.05.2017;'17 - 18;27,63;22,9;4,73;8686;8394;-292;3655;3709;54
11994;14.05.2017;'18 - 19;32,07;29,67;2,4;5134;5012;-122;3284;3343;59
11995;14.05.2017;'19 - 20;35,96;35,13;0,83;2193;2238;45;2876;3059;183
11996;14.05.2017;'20 - 21;39,55;34,16;5,39;381;408;27;2625;2896;271
11997;14.05.2017;'21 - 22;40,99;35,03;5,96;2;2;0;2530;2767;237
11998;14.05.2017;'22 - 23;38,17;35,61;2,56;0;0;0;2610;2864;254
11999;14.05.2017;'23 - 24;31,46;32,49;-1,03;0;0;0;2851;3369;518
12000;15.05.2017;'00 - 01;30,32;30,95;-0,63;0;0;0;3636;3641;5
12001;15.05.2017;'01 - 02;27,43;30,29;-2,86;0;0;0;4040;4119;79
12002;15.05.2017;'02 - 03;27,18;30,2;-3,02;0;0;0;4166;4460;294
12003;15.05.2017;'03 - 04;26,7;28,09;-1,39;0;0;0;3967;4394;427
12004;15.05.2017;'04 - 05;27,16;26,59;0,57;0;0;0;3741;3971;230
12005;15.05.2017;'05 - 06;29,77;29,01;0,76;80;67;-13;3304;3630;326
12006;15.05.2017;'06 - 07;35,38;38,77;-3,39;1194;1246;52;2677;3147;470
12007;15.05.2017;'07 - 08;44,02;42,74;1,28;4213;4493;280;2036;2474;438
12008;15.05.2017;'08 - 09;46,1;44,05;2,05;8589;9307;718;1619;1742;123
12009;15.05.2017;'09 - 10;43,95;39,1;4,85;13189;14206;1017;1566;1482;-84
12010;15.05.2017;'10 - 11;41,94;35,07;6,87;16997;18006;1009;1675;1430;-245
12011;15.05.2017;'11 - 12;40,07;34,75;5,32;19536;20522;986;1859;1827;-32
12012;15.05.2017;'12 - 13;35,66;33,93;1,73;20848;21898;1050;2140;2468;328
12013;15.05.2017;'13 - 14;35,04;33,2;1,84;21134;22120;986;2448;3023;575
12014;15.05.2017;'14 - 15;33,48;32,27;1,21;20294;21700;1406;2684;3252;568
12015;15.05.2017;'15 - 16;32,98;32,57;0,41;18282;19846;1564;2758;3221;463
12016;15.05.2017;'16 - 17;33,14;31,57;1,57;15054;16804;1750;2748;3086;338
12017;15.05.2017;'17 - 18;37,74;35,5;2,24;10751;12267;1516;2560;2668;108
12018;15.05.2017;'18 - 19;42,82;40,67;2,15;6097;7189;1092;2164;2110;-54
12019;15.05.2017;'19 - 20;45,73;43,78;1,95;2431;2786;355;1787;1632;-155
12020;15.05.2017;'20 - 21;44,2;44,49;-0,29;442;464;22;1643;1864;221
12021;15.05.2017;'21 - 22;42,29;42,51;-0,22;2;1;-1;1861;2320;459
12022;15.05.2017;'22 - 23;40,22;40,34;-0,12;0;0;0;2305;2907;602
12023;15.05.2017;'23 - 24;31,08;32,43;-1,35;0;0;0;2956;3793;837
12024;16.05.2017;'00 - 01;29,5;30,26;-0,76;0;0;0;4261;4710;449
12025;16.05.2017;'01 - 02;28,01;27,42;0,59;0;0;0;4910;5668;758
12026;16.05.2017;'02 - 03;26,7;25,43;1,27;0;0;0;5373;5886;513
12027;16.05.2017;'03 - 04;26,53;24,74;1,79;0;0;0;5529;5640;111
12028;16.05.2017;'04 - 05;26,38;25,71;0,67;0;0;0;5608;5698;90
12029;16.05.2017;'05 - 06;27,93;26,79;1,14;77;74;-3;5684;6226;542
12030;16.05.2017;'06 - 07;31,81;30,83;0,98;1094;1252;158;5804;6644;840
12031;16.05.2017;'07 - 08;39,96;38,58;1,38;3738;4286;548;5944;7020;1076
12032;16.05.2017;'08 - 09;41,35;36,75;4,6;7415;8921;1506;6048;6594;546
12033;16.05.2017;'09 - 10;38,42;32,06;6,36;11241;13693;2452;6061;6031;-30
12034;16.05.2017;'10 - 11;34,53;31,4;3,13;14468;17353;2885;6035;5836;-199
12035;16.05.2017;'11 - 12;34,84;31,43;3,41;16849;19638;2789;5965;5587;-378
12036;16.05.2017;'12 - 13;31,88;30,47;1,41;18281;20955;2674;5845;5332;-513
12037;16.05.2017;'13 - 14;31,06;30,47;0,59;18665;21102;2437;5717;5008;-709
12038;16.05.2017;'14 - 15;31,58;30,79;0,79;17987;20147;2160;5466;4676;-790
12039;16.05.2017;'15 - 16;32,33;30,74;1,59;16196;17856;1660;5132;4544;-588
12040;16.05.2017;'16 - 17;34,52;32,7;1,82;13332;14806;1474;4885;4254;-631
12041;16.05.2017;'17 - 18;37,04;36,56;0,48;9497;10680;1183;4771;4103;-668
12042;16.05.2017;'18 - 19;41;40,11;0,89;5322;6036;714;4937;3970;-967
12043;16.05.2017;'19 - 20;42,94;41,41;1,53;2102;2381;279;5259;4082;-1177
12044;16.05.2017;'20 - 21;42,77;40,88;1,89;388;388;0;5757;4385;-1372
12045;16.05.2017;'21 - 22;41,5;42,01;-0,51;3;1;-2;6440;4570;-1870
12046;16.05.2017;'22 - 23;37,01;40,56;-3,55;0;0;0;7192;4756;-2436
12047;16.05.2017;'23 - 24;31,92;36,15;-4,23;0;0;0;7679;4952;-2727
12048;17.05.2017;'00 - 01;29,66;33,44;-3,78;0;0;0;5694;4636;-1058
12049;17.05.2017;'01 - 02;27,7;32,71;-5,01;0;0;0;5566;4471;-1095
12050;17.05.2017;'02 - 03;27,17;30,76;-3,59;0;0;0;5391;4230;-1161
12051;17.05.2017;'03 - 04;26,45;27,98;-1,53;0;0;0;5213;4078;-1135
12052;17.05.2017;'04 - 05;26,49;26,86;-0,37;0;0;0;5052;3931;-1121
12053;17.05.2017;'05 - 06;27,58;29,12;-1,54;83;78;-5;4864;3842;-1022
12054;17.05.2017;'06 - 07;36,19;36,66;-0,47;1166;1311;145;4571;3956;-615
12055;17.05.2017;'07 - 08;41;38,58;2,42;4308;4688;380;4165;3286;-879
12056;17.05.2017;'08 - 09;41;40,03;0,97;9026;10059;1033;3594;2232;-1362
12057;17.05.2017;'09 - 10;38,95;38,48;0,47;14117;15807;1690;2953;1742;-1211
12058;17.05.2017;'10 - 11;33,54;34,86;-1,32;18464;20611;2147;2581;1888;-693
12059;17.05.2017;'11 - 12;32,94;32,98;-0,04;21735;24090;2355;2677;2252;-425
12060;17.05.2017;'12 - 13;31,03;33,81;-2,78;23766;25930;2164;3143;2776;-367
12061;17.05.2017;'13 - 14;30,21;31,42;-1,21;24313;26290;1977;3669;3527;-142
12062;17.05.2017;'14 - 15;29,14;30,77;-1,63;23411;25307;1896;4191;4453;262
12063;17.05.2017;'15 - 16;28,22;30,35;-2,13;21109;22865;1756;4753;5465;712
12064;17.05.2017;'16 - 17;29,48;31,85;-2,37;17481;18914;1433;5336;6540;1204
12065;17.05.2017;'17 - 18;34,77;36,09;-1,32;12514;13531;1017;6164;8100;1936
12066;17.05.2017;'18 - 19;38,34;39,29;-0,95;6992;7616;624;7348;9527;2179
12067;17.05.2017;'19 - 20;40,98;40,15;0,83;2746;2908;162;8851;10408;1557
12068;17.05.2017;'20 - 21;37,9;36,98;0,92;541;500;-41;10933;11710;777
12069;17.05.2017;'21 - 22;34,02;37,82;-3,8;5;3;-2;13430;15544;2114
12070;17.05.2017;'22 - 23;31,01;32,2;-1,19;0;0;0;15608;18677;3069
12071;17.05.2017;'23 - 24;26,68;28,52;-1,84;0;0;0;16891;20028;3137
12072;18.05.2017;'00 - 01;26,04;23,91;2,13;0;0;0;18270;19970;1700
12073;18.05.2017;'01 - 02;24,31;19,63;4,68;0;0;0;18207;19394;1187
12074;18.05.2017;'02 - 03;22,43;20,53;1,9;0;0;0;17970;18920;950
12075;18.05.2017;'03 - 04;20,68;20,93;-0,25;0;0;0;17464;18018;554
12076;18.05.2017;'04 - 05;22,46;25,17;-2,71;0;0;0;16883;17497;614
12077;18.05.2017;'05 - 06;26,06;27,12;-1,06;122;114;-8;16027;15939;-88
12078;18.05.2017;'06 - 07;32,68;30,11;2,57;1406;1616;210;14732;14342;-390
12079;18.05.2017;'07 - 08;40,4;42,05;-1,65;4987;5319;332;13041;11390;-1651
12080;18.05.2017;'08 - 09;42,98;43,6;-0,62;9909;10492;583;11305;8317;-2988
12081;18.05.2017;'09 - 10;37,93;42,22;-4,29;14635;15132;497;10063;7529;-2534
12082;18.05.2017;'10 - 11;33,14;36,44;-3,3;18098;18544;446;9151;7617;-1534
12083;18.05.2017;'11 - 12;31,75;34,21;-2,46;20195;20485;290;8472;7747;-725
12084;18.05.2017;'12 - 13;31,02;34,52;-3,5;21040;20797;-243;7961;7256;-705
12085;18.05.2017;'13 - 14;29,99;35,09;-5,1;20461;20265;-196;7494;5895;-1599
12086;18.05.2017;'14 - 15;31;38,19;-7,19;18732;18802;70;6927;4784;-2143
12087;18.05.2017;'15 - 16;30,78;40,3;-9,52;16067;16628;561;6324;4369;-1955
12088;18.05.2017;'16 - 17;36,1;42,11;-6,01;12617;13251;634;5726;4005;-1721
12089;18.05.2017;'17 - 18;37,98;42,6;-4,62;8597;9258;661;5158;3622;-1536
12090;18.05.2017;'18 - 19;39,45;43,8;-4,35;4756;5393;637;4618;3342;-1276
12091;18.05.2017;'19 - 20;39,54;43,39;-3,85;1957;2317;360;4248;3583;-665
12092;18.05.2017;'20 - 21;39,91;40,74;-0,83;393;441;48;4095;3773;-322
12093;18.05.2017;'21 - 22;38,95;38,45;0,5;3;6;3;4089;3736;-353
12094;18.05.2017;'22 - 23;37,86;36,66;1,2;0;0;0;4147;4343;196
12095;18.05.2017;'23 - 24;32,26;29,88;2,38;0;0;0;4119;4395;276
12096;19.05.2017;'00 - 01;30;26,56;3,44;0;0;0;3790;4550;760
12097;19.05.2017;'01 - 02;28,6;25,34;3,26;0;0;0;3755;4910;1155
12098;19.05.2017;'02 - 03;26,67;23,85;2,82;0;0;0;3798;5082;1284
12099;19.05.2017;'03 - 04;26,31;20,64;5,67;0;0;0;3933;5065;1132
12100;19.05.2017;'04 - 05;25,97;22,99;2,98;0;0;0;4262;5183;921
12101;19.05.2017;'05 - 06;27,6;25,92;1,68;116;106;-10;4536;5589;1053
12102;19.05.2017;'06 - 07;30,9;32,84;-1,94;1230;1237;7;4617;5926;1309
12103;19.05.2017;'07 - 08;39,91;37,62;2,29;3857;3782;-75;4772;5552;780
12104;19.05.2017;'08 - 09;41,55;39,02;2,53;7281;7368;87;4890;5052;162
12105;19.05.2017;'09 - 10;39,9;38,43;1,47;10600;10872;272;5029;4944;-85
12106;19.05.2017;'10 - 11;38,95;38,24;0,71;13048;13742;694;5364;4847;-517
12107;19.05.2017;'11 - 12;39,8;39,06;0,74;14560;15388;828;5680;5352;-328
12108;19.05.2017;'12 - 13;37,72;36,51;1,21;15204;15624;420;5828;6355;527
12109;19.05.2017;'13 - 14;36,38;35,56;0,82;14711;14628;-83;6037;6864;827
12110;19.05.2017;'14 - 15;35,05;34,49;0,56;13362;13022;-340;6308;7258;950
12111;19.05.2017;'15 - 16;34,59;32,14;2,45;11360;10620;-740;6729;8036;1307
12112;19.05.2017;'16 - 17;31,06;30,45;0,61;8855;7788;-1067;7376;9364;1988
12113;19.05.2017;'17 - 18;36,01;31,46;4,55;6114;4896;-1218;7940;11290;3350
12114;19.05.2017;'18 - 19;38,5;32,28;6,22;3491;2559;-932;8260;13213;4953
12115;19.05.2017;'19 - 20;38,97;31,79;7,18;1457;1055;-402;8730;13911;5181
12116;19.05.2017;'20 - 21;36,04;30,22;5,82;288;195;-93;9256;13913;4657
12117;19.05.2017;'21 - 22;37;29,53;7,47;2;2;0;9661;14408;4747
12118;19.05.2017;'22 - 23;36,98;27,75;9,23;0;0;0;10005;15055;5050
12119;19.05.2017;'23 - 24;32,76;23,61;9,15;0;0;0;10038;15064;5026
12120;20.05.2017;'00 - 01;24,02;19,61;4,41;0;0;0;11066;14389;3323
12121;20.05.2017;'01 - 02;24,26;19,41;4,85;0;0;0;10916;13772;2856
12122;20.05.2017;'02 - 03;24,74;21,01;3,73;0;0;0;10701;13560;2859
12123;20.05.2017;'03 - 04;26,71;20,02;6,69;0;0;0;10301;12622;2321
12124;20.05.2017;'04 - 05;25,93;20,16;5,77;0;0;0;9868;11514;1646
12125;20.05.2017;'05 - 06;24,08;21,07;3,01;81;109;28;9304;10176;872
12126;20.05.2017;'06 - 07;26,5;24,85;1,65;1037;1337;300;8655;8991;336
12127;20.05.2017;'07 - 08;26,06;27,01;-0,95;3527;4639;1112;8007;7914;-93
12128;20.05.2017;'08 - 09;27;25,17;1,83;7160;9598;2438;7561;7627;66
12129;20.05.2017;'09 - 10;25,3;20,7;4,6;10907;14517;3610;7333;7630;297
12130;20.05.2017;'10 - 11;23,99;15,93;8,06;13547;17884;4337;7176;7212;36
12131;20.05.2017;'11 - 12;24,11;15,48;8,63;15038;19193;4155;6949;7238;289
12132;20.05.2017;'12 - 13;23,83;16,54;7,29;15599;18921;3322;6492;6960;468
12133;20.05.2017;'13 - 14;22,83;16,39;6,44;15461;18438;2977;6014;6508;494
12134;20.05.2017;'14 - 15;21,44;16;5,44;14577;17501;2924;5593;6094;501
12135;20.05.2017;'15 - 16;21,73;13,66;8,07;13016;15835;2819;5154;5671;517
12136;20.05.2017;'16 - 17;23,92;15,93;7,99;10922;13536;2614;4656;5296;640
12137;20.05.2017;'17 - 18;25,64;16,61;9,03;8188;10111;1923;4120;4763;643
12138;20.05.2017;'18 - 19;29;25,23;3,77;5096;6298;1202;3596;4057;461
12139;20.05.2017;'19 - 20;33,34;28,14;5,2;2342;2924;582;3149;3207;58
12140;20.05.2017;'20 - 21;33,5;28,48;5,02;522;628;106;2833;2444;-389
12141;20.05.2017;'21 - 22;33,08;27,96;5,12;8;10;2;2766;2406;-360
12142;20.05.2017;'22 - 23;34,12;28,07;6,05;0;0;0;2870;2498;-372
12143;20.05.2017;'23 - 24;30,05;25,78;4,27;0;0;0;3029;2730;-299
12144;21.05.2017;'00 - 01;23,66;23,26;0,4;0;0;0;3156;3139;-17
12145;21.05.2017;'01 - 02;18,12;21,02;-2,9;0;0;0;3347;3539;192
12146;21.05.2017;'02 - 03;14,12;17,86;-3,74;0;0;0;3624;3910;286
12147;21.05.2017;'03 - 04;12,18;13,07;-0,89;0;0;0;3880;4280;400
12148;21.05.2017;'04 - 05;11,65;11,68;-0,03;0;0;0;4113;4498;385
12149;21.05.2017;'05 - 06;11,52;10,31;1,21;147;255;108;4124;4579;455
12150;21.05.2017;'06 - 07;11,98;9,74;2,24;1524;1854;330;3745;4303;558
12151;21.05.2017;'07 - 08;12,36;10,73;1,63;5404;5810;406;3243;3269;26
12152;21.05.2017;'08 - 09;13,7;12,99;0,71;11017;11573;556;2753;2148;-605
12153;21.05.2017;'09 - 10;12,07;13,7;-1,63;16611;17392;781;2560;2332;-228
12154;21.05.2017;'10 - 11;10,02;10,29;-0,27;20304;21279;975;2708;3024;316
12155;21.05.2017;'11 - 12;11,86;10,39;1,47;21881;21684;-197;2787;2898;111
12156;21.05.2017;'12 - 13;12,29;12,05;0,24;22192;21308;-884;2709;2608;-101
12157;21.05.2017;'13 - 14;11,93;12,82;-0,89;21514;20837;-677;2579;2489;-90
12158;21.05.2017;'14 - 15;10,28;12,25;-1,97;19797;19999;202;2437;2400;-37
12159;21.05.2017;'15 - 16;11,93;10,43;1,5;17238;18423;1185;2278;2243;-35
12160;21.05.2017;'16 - 17;16,92;11,21;5,71;14098;15628;1530;2135;2000;-135
12161;21.05.2017;'17 - 18;23,05;14,95;8,1;10202;11583;1381;2027;1863;-164
12162;21.05.2017;'18 - 19;28,12;25,58;2,54;6006;7098;1092;1922;1800;-122
12163;21.05.2017;'19 - 20;32,91;29,76;3,15;2608;3137;529;1915;1625;-290
12164;21.05.2017;'20 - 21;35,07;32,45;2,62;582;696;114;2084;1813;-271
12165;21.05.2017;'21 - 22;35,32;32,95;2,37;10;16;6;2440;2406;-34
12166;21.05.2017;'22 - 23;36,11;31,67;4,44;0;0;0;2884;3173;289
12167;21.05.2017;'23 - 24;33,43;28,9;4,53;0;0;0;3194;3784;590
12168;22.05.2017;'00 - 01;29,84;26,2;3,64;0;0;0;3190;4290;1100
12169;22.05.2017;'01 - 02;28,01;23,55;4,46;0;0;0;3269;4620;1351
12170;22.05.2017;'02 - 03;26,9;22,33;4,57;0;0;0;3360;4510;1150
12171;22.05.2017;'03 - 04;26,01;21,84;4,17;0;0;0;3322;4226;904
12172;22.05.2017;'04 - 05;26,86;21,85;5,01;0;0;0;3225;4024;799
12173;22.05.2017;'05 - 06;27,38;23,32;4,06;154;168;14;3078;4055;977
12174;22.05.2017;'06 - 07;35,49;29,99;5,5;1558;1760;202;2829;3810;981
12175;22.05.2017;'07 - 08;40;39,5;0,5;5211;5452;241;2455;3079;624
12176;22.05.2017;'08 - 09;42,2;39,54;2,66;10454;10776;322;1908;1900;-8
12177;22.05.2017;'09 - 10;38,82;36,67;2,15;15804;16439;635;1403;1458;55
12178;22.05.2017;'10 - 11;37,02;34,27;2,75;19918;21138;1220;1242;1449;207
12179;22.05.2017;'11 - 12;36,99;34,42;2,57;22133;23514;1381;1268;1518;250
12180;22.05.2017;'12 - 13;36,96;33,86;3,1;22762;23990;1228;1266;1374;108
12181;22.05.2017;'13 - 14;37,91;33,28;4,63;22239;23230;991;1224;1207;-17
12182;22.05.2017;'14 - 15;36,93;33,5;3,43;20724;22067;1343;1228;1029;-199
12183;22.05.2017;'15 - 16;36,94;33,16;3,78;18278;20215;1937;1336;934;-402
12184;22.05.2017;'16 - 17;36,2;33,98;2,22;15293;17344;2051;1400;944;-456
12185;22.05.2017;'17 - 18;38,71;38,26;0,45;11316;12938;1622;1540;1103;-437
12186;22.05.2017;'18 - 19;43,65;40,83;2,82;6684;7712;1028;1774;1352;-422
12187;22.05.2017;'19 - 20;44,36;41,87;2,49;2821;3172;351;2209;1728;-481
12188;22.05.2017;'20 - 21;41,95;40,76;1,19;641;662;21;2895;2328;-567
12189;22.05.2017;'21 - 22;41,21;40,95;0,26;10;8;-2;3696;3317;-379
12190;22.05.2017;'22 - 23;40,84;39,96;0,88;0;0;0;4574;4437;-137
12191;22.05.2017;'23 - 24;34,07;35,34;-1,27;0;0;0;5166;5302;136
12192;23.05.2017;'00 - 01;32,24;29,69;2,55;0;0;0;5593;5863;270
12193;23.05.2017;'01 - 02;32,17;30,26;1,91;0;0;0;5635;6181;546
12194;23.05.2017;'02 - 03;29,72;30,63;-0,91;0;0;0;5563;6156;593
12195;23.05.2017;'03 - 04;28,05;28,05;0;0;0;0;5440;6000;560
12196;23.05.2017;'04 - 05;28,04;26,96;1,08;0;0;0;5340;5615;275
12197;23.05.2017;'05 - 06;29,71;28,05;1,66;170;174;4;5206;5466;260
12198;23.05.2017;'06 - 07;36,99;34,43;2,56;1644;1777;133;4892;5216;324
12199;23.05.2017;'07 - 08;41,78;41,82;-0,04;5230;5558;328;4416;4226;-190
12200;23.05.2017;'08 - 09;41,4;44,83;-3,43;10353;10928;575;3668;2335;-1333
12201;23.05.2017;'09 - 10;41,89;42,71;-0,82;15616;16354;738;3017;1432;-1585
12202;23.05.2017;'10 - 11;38,05;39,78;-1,73;19833;20676;843;2861;1563;-1298
12203;23.05.2017;'11 - 12;36,94;38,13;-1,19;22395;23267;872;3299;2656;-643
12204;23.05.2017;'12 - 13;33,97;35,97;-2;23353;23932;579;4553;4970;417
12205;23.05.2017;'13 - 14;30,5;33,34;-2,84;22990;23243;253;6222;7461;1239
12206;23.05.2017;'14 - 15;31,01;32,26;-1,25;21589;21332;-257;8077;10430;2353
12207;23.05.2017;'15 - 16;29,1;31;-1,9;18953;18560;-393;9677;13039;3362
12208;23.05.2017;'16 - 17;29,06;29,07;-0,01;15351;14824;-527;11078;14666;3588
12209;23.05.2017;'17 - 18;31,84;34,21;-2,37;10930;10280;-650;12095;15433;3338
12210;23.05.2017;'18 - 19;33,75;38,88;-5,13;6354;5978;-376;12567;16907;4340
12211;23.05.2017;'19 - 20;37,11;39,87;-2,76;2801;2748;-53;12842;16978;4136
12212;23.05.2017;'20 - 21;35,64;37,42;-1,78;648;616;-32;12977;16642;3665
12213;23.05.2017;'21 - 22;35;35,49;-0,49;12;12;0;13113;16250;3137
12214;23.05.2017;'22 - 23;30,99;36,28;-5,29;0;0;0;13432;16057;2625
12215;23.05.2017;'23 - 24;28,41;31,23;-2,82;0;0;0;13706;15896;2190
12216;24.05.2017;'00 - 01;27,15;30,29;-3,14;0;0;0;15754;16124;370
12217;24.05.2017;'01 - 02;24,45;29,37;-4,92;0;0;0;16122;16248;126
12218;24.05.2017;'02 - 03;20,09;26,55;-6,46;0;0;0;16276;16190;-86
12219;24.05.2017;'03 - 04;20,13;27,06;-6,93;0;0;0;16155;14734;-1421
12220;24.05.2017;'04 - 05;21,56;31,45;-9,89;0;0;0;15835;13758;-2077
12221;24.05.2017;'05 - 06;26,03;36,52;-10,49;129;158;29;15375;12777;-2598
12222;24.05.2017;'06 - 07;30,1;39,64;-9,54;1307;1492;185;14918;11426;-3492
12223;24.05.2017;'07 - 08;36,93;44,7;-7,77;4195;4480;285;14682;10978;-3704
12224;24.05.2017;'08 - 09;37,55;45,33;-7,78;8268;8682;414;14609;12034;-2575
12225;24.05.2017;'09 - 10;34,97;39,12;-4,15;12295;12992;697;14645;12199;-2446
12226;24.05.2017;'10 - 11;31,98;36,78;-4,8;15339;16110;771;14639;12574;-2065
12227;24.05.2017;'11 - 12;32,35;37,45;-5,1;17314;17490;176;14566;13107;-1459
12228;24.05.2017;'12 - 13;30,09;36,56;-6,47;18148;17468;-680;14501;12999;-1502
12229;24.05.2017;'13 - 14;28,8;36,44;-7,64;17715;16528;-1187;14383;13012;-1371
12230;24.05.2017;'14 - 15;29,79;37,59;-7,8;16323;14198;-2125;14119;13035;-1084
12231;24.05.2017;'15 - 16;32,96;38,64;-5,68;14281;11764;-2517;13574;12618;-956
12232;24.05.2017;'16 - 17;32,13;39,36;-7,23;11646;9290;-2356;12772;11940;-832
12233;24.05.2017;'17 - 18;36,91;41,59;-4,68;8411;6863;-1548;11684;11263;-421
12234;24.05.2017;'18 - 19;39,92;42,62;-2,7;5075;4490;-585;10231;9878;-353
12235;24.05.2017;'19 - 20;40,57;43,86;-3,29;2347;2263;-84;8630;7901;-729
12236;24.05.2017;'20 - 21;40,84;42,44;-1,6;563;521;-42;7482;6129;-1353
12237;24.05.2017;'21 - 22;40,06;42,73;-2,67;11;14;3;6888;5360;-1528
12238;24.05.2017;'22 - 23;40,98;42,05;-1,07;0;0;0;6712;5226;-1486
12239;24.05.2017;'23 - 24;36,91;36,7;0,21;0;0;0;6728;5391;-1337
12240;25.05.2017;'00 - 01;33,41;30,71;2,7;0;0;0;6128;5777;-351
12241;25.05.2017;'01 - 02;31,98;30,89;1,09;0;0;0;6211;5979;-232
12242;25.05.2017;'02 - 03;28,07;28,01;0,06;0;0;0;6316;6192;-124
12243;25.05.2017;'03 - 04;28;27,08;0,92;0;0;0;6369;6261;-108
12244;25.05.2017;'04 - 05;27,97;25,62;2,35;0;1;1;6355;6256;-99
12245;25.05.2017;'05 - 06;26,97;26,04;0,93;174;160;-14;6167;5942;-225
12246;25.05.2017;'06 - 07;24,59;22,49;2,1;1516;1609;93;5795;5548;-247
12247;25.05.2017;'07 - 08;24,93;22,36;2,57;4732;4764;32;5513;5412;-101
12248;25.05.2017;'08 - 09;25,85;24,36;1,49;9146;9079;-67;5693;6021;328
12249;25.05.2017;'09 - 10;25,79;23,3;2,49;13667;13816;149;6122;6384;262
12250;25.05.2017;'10 - 11;25,59;19,98;5,61;17192;17289;97;6703;6655;-48
12251;25.05.2017;'11 - 12;26,02;18;8,02;19365;19118;-247;7241;6768;-473
12252;25.05.2017;'12 - 13;25,16;20,73;4,43;20343;20333;-10;7836;7058;-778
12253;25.05.2017;'13 - 14;21,74;15,97;5,77;20253;20788;535;8467;7066;-1401
12254;25.05.2017;'14 - 15;19,97;14,46;5,51;19177;20903;1726;9058;6888;-2170
12255;25.05.2017;'15 - 16;19,99;12,38;7,61;17002;19512;2510;9612;7184;-2428
12256;25.05.2017;'16 - 17;21,12;10,94;10,18;13743;16432;2689;9942;7368;-2574
12257;25.05.2017;'17 - 18;27,08;21,53;5,55;9923;12346;2423;9836;7343;-2493
12258;25.05.2017;'18 - 19;29,9;28,74;1,16;5999;7579;1580;9219;6908;-2311
12259;25.05.2017;'19 - 20;33,92;33,81;0,11;2722;3345;623;8360;5904;-2456
12260;25.05.2017;'20 - 21;36,7;33,8;2,9;662;779;117;7645;4975;-2670
12261;25.05.2017;'21 - 22;36,69;33,71;2,98;17;18;1;7397;5139;-2258
12262;25.05.2017;'22 - 23;36,98;33,36;3,62;0;0;0;7511;5664;-1847
12263;25.05.2017;'23 - 24;31,08;28,38;2,7;0;0;0;7598;5981;-1617
12264;26.05.2017;'00 - 01;28,12;27,44;0,68;0;0;0;6625;6074;-551
12265;26.05.2017;'01 - 02;25,38;24,55;0,83;0;0;0;6496;5760;-736
12266;26.05.2017;'02 - 03;24,06;23,11;0,95;0;0;0;6392;5682;-710
12267;26.05.2017;'03 - 04;23,51;22,82;0,69;0;0;0;6221;5501;-720
12268;26.05.2017;'04 - 05;24,27;20,3;3,97;0;1;1;5955;5201;-754
12269;26.05.2017;'05 - 06;26,39;22,42;3,97;186;172;-14;5476;4893;-583
12270;26.05.2017;'06 - 07;33,94;26,31;7,63;1580;1736;156;4691;4429;-262
12271;26.05.2017;'07 - 08;37,93;30,51;7,42;5184;5577;393;3795;3370;-425
12272;26.05.2017;'08 - 09;38,3;29,49;8,81;10254;10661;407;3126;2426;-700
12273;26.05.2017;'09 - 10;36,48;29,78;6,7;15191;16177;986;2787;2287;-500
12274;26.05.2017;'10 - 11;34,01;27,82;6,19;19036;20950;1914;2534;2230;-304
12275;26.05.2017;'11 - 12;33,08;26,16;6,92;21640;24663;3023;2387;2366;-21
12276;26.05.2017;'12 - 13;30,86;23,43;7,43;23134;26864;3730;2359;2483;124
12277;26.05.2017;'13 - 14;28,32;20,79;7,53;23619;27281;3662;2366;2558;192
12278;26.05.2017;'14 - 15;27,12;20,77;6,35;22986;26228;3242;2409;2643;234
12279;26.05.2017;'15 - 16;27,53;20,86;6,67;21157;23627;2470;2442;2638;196
12280;26.05.2017;'16 - 17;28,63;23,83;4,8;17956;19839;1883;2480;2589;109
12281;26.05.2017;'17 - 18;34,64;32,95;1,69;13241;14594;1353;2501;2547;46
12282;26.05.2017;'18 - 19;38,85;37,88;0,97;7613;8460;847;2540;2548;8
12283;26.05.2017;'19 - 20;41,97;39,56;2,41;3046;3432;386;2612;2556;-56
12284;26.05.2017;'20 - 21;41,95;40,99;0,96;764;753;-11;2856;2709;-147
12285;26.05.2017;'21 - 22;39,99;40,94;-0,95;22;20;-2;3379;3696;317
12286;26.05.2017;'22 - 23;39,96;39,54;0,42;0;0;0;3962;4554;592
12287;26.05.2017;'23 - 24;35,2;34,73;0,47;0;0;0;4307;5460;1153
12288;27.05.2017;'00 - 01;35,91;30,47;5,44;0;0;0;5704;6328;624
12289;27.05.2017;'01 - 02;31,03;27,34;3,69;0;0;0;5832;7022;1190
12290;27.05.2017;'02 - 03;27,6;24,83;2,77;0;0;0;5914;7689;1775
12291;27.05.2017;'03 - 04;26;23,66;2,34;0;0;0;5956;8321;2365
12292;27.05.2017;'04 - 05;24,58;21,76;2,82;0;1;1;6018;8707;2689
12293;27.05.2017;'05 - 06;24,4;21,73;2,67;210;197;-13;5971;8710;2739
12294;27.05.2017;'06 - 07;26,1;22,89;3,21;1745;1895;150;5653;8376;2723
12295;27.05.2017;'07 - 08;29,14;25,27;3,87;5968;6300;332;4883;6540;1657
12296;27.05.2017;'08 - 09;30,13;26,54;3,59;12109;12492;383;3922;4407;485
12297;27.05.2017;'09 - 10;29,36;23,44;5,92;18088;18453;365;3671;3977;306
12298;27.05.2017;'10 - 11;26,1;18,38;7,72;22737;23024;287;3943;4384;441
12299;27.05.2017;'11 - 12;24,69;14,02;10,67;25798;25976;178;4405;5102;697
12300;27.05.2017;'12 - 13;22,04;11,72;10,32;27378;27488;110;4981;6044;1063
12301;27.05.2017;'13 - 14;15,27;10,29;4,98;27523;27634;111;5574;7223;1649
12302;27.05.2017;'14 - 15;13,38;9,42;3,96;26346;26486;140;6131;8156;2025
12303;27.05.2017;'15 - 16;14,9;7,54;7,36;23760;24030;270;6650;8607;1957
12304;27.05.2017;'16 - 17;20,09;10,93;9,16;19750;20117;367;7158;8692;1534
12305;27.05.2017;'17 - 18;27,31;20,71;6,6;14290;14713;423;7586;8513;927
12306;27.05.2017;'18 - 19;34,3;30,59;3,71;8182;8609;427;7967;8592;625
12307;27.05.2017;'19 - 20;37,13;33,27;3,86;3334;3380;46;8519;8334;-185
12308;27.05.2017;'20 - 21;35,97;35,41;0,56;817;767;-50;9758;8529;-1229
12309;27.05.2017;'21 - 22;34,34;38,2;-3,86;26;18;-8;11883;11388;-495
12310;27.05.2017;'22 - 23;33,98;36,53;-2,55;0;0;0;14030;14019;-11
12311;27.05.2017;'23 - 24;24,68;27,4;-2,72;0;0;0;15081;15292;211
12312;28.05.2017;'00 - 01;20,72;19,43;1,29;0;0;0;15555;15224;-331
12313;28.05.2017;'01 - 02;16,08;18,45;-2,37;0;0;0;14914;14348;-566
12314;28.05.2017;'02 - 03;18,66;18,59;0,07;0;0;0;14095;13002;-1093
12315;28.05.2017;'03 - 04;16,58;17,15;-0,57;0;0;0;12979;11497;-1482
12316;28.05.2017;'04 - 05;14,25;18,35;-4,1;0;2;2;11760;10604;-1156
12317;28.05.2017;'05 - 06;9,91;11,9;-1,99;214;209;-5;10523;10166;-357
12318;28.05.2017;'06 - 07;14,36;10,31;4,05;1697;1834;137;9020;9201;181
12319;28.05.2017;'07 - 08;18,27;12,09;6,18;5766;5698;-68;7171;7455;284
12320;28.05.2017;'08 - 09;19,04;14,4;4,64;11401;11185;-216;5779;5830;51
12321;28.05.2017;'09 - 10;17,18;15,85;1,33;16807;16733;-74;5248;5011;-237
12322;28.05.2017;'10 - 11;11,65;18,97;-7,32;21124;20704;-420;5017;5184;167
12323;28.05.2017;'11 - 12;11,63;16,86;-5,23;24024;23334;-690;5040;5868;828
12324;28.05.2017;'12 - 13;15,07;16,25;-1,18;25458;24948;-510;5299;7042;1743
12325;28.05.2017;'13 - 14;10,18;14,92;-4,74;25382;25070;-312;5581;7797;2216
12326;28.05.2017;'14 - 15;10,08;12,7;-2,62;24012;23885;-127;5759;7956;2197
12327;28.05.2017;'15 - 16;10,14;14,06;-3,92;21338;21469;131;5772;7417;1645
12328;28.05.2017;'16 - 17;10,08;16,73;-6,65;17426;17481;55;5730;6750;1020
12329;28.05.2017;'17 - 18;21,95;25,76;-3,81;12441;12571;130;5451;6513;1062
12330;28.05.2017;'18 - 19;31,05;38,62;-7,57;7042;7325;283;5007;5805;798
12331;28.05.2017;'19 - 20;36,95;40,99;-4,04;2929;3166;237;4692;4702;10
12332;28.05.2017;'20 - 21;38,66;41,6;-2,94;753;807;54;4566;4183;-383
12333;28.05.2017;'21 - 22;38,65;42,45;-3,8;24;30;6;4693;4601;-92
12334;28.05.2017;'22 - 23;40,66;46,3;-5,64;0;0;0;4933;4383;-550
12335;28.05.2017;'23 - 24;36,92;42,88;-5,96;0;0;0;5025;4023;-1002
12336;29.05.2017;'00 - 01;29,02;36,29;-7,27;0;0;0;4190;3564;-626
12337;29.05.2017;'01 - 02;28,3;30,81;-2,51;0;0;0;3873;3357;-516
12338;29.05.2017;'02 - 03;26,27;30,11;-3,84;0;0;0;3518;3236;-282
12339;29.05.2017;'03 - 04;25,6;28,02;-2,42;0;0;0;3195;2940;-255
12340;29.05.2017;'04 - 05;25,6;26,29;-0,69;0;2;2;2902;2845;-57
12341;29.05.2017;'05 - 06;26,4;28,79;-2,39;210;194;-16;2565;2994;429
12342;29.05.2017;'06 - 07;35,97;37,7;-1,73;1636;1686;50;2234;2568;334
12343;29.05.2017;'07 - 08;42,7;48,19;-5,49;5358;4869;-489;1887;1820;-67
12344;29.05.2017;'08 - 09;43,06;59,13;-16,07;10388;9306;-1082;1582;1172;-410
12345;29.05.2017;'09 - 10;42,71;52,15;-9,44;15382;14381;-1001;1383;1111;-272
12346;29.05.2017;'10 - 11;41,82;49,73;-7,91;19676;19014;-662;1293;1319;26
12347;29.05.2017;'11 - 12;41,32;46,09;-4,77;22748;22638;-110;1336;1037;-299
12348;29.05.2017;'12 - 13;37,99;42,49;-4,5;24485;24666;181;1479;1160;-319
12349;29.05.2017;'13 - 14;37,41;42,8;-5,39;24754;24880;126;1668;1428;-240
12350;29.05.2017;'14 - 15;35,58;43,01;-7,43;23698;24032;334;1856;1621;-235
12351;29.05.2017;'15 - 16;36,32;43,75;-7,43;21165;21540;375;2002;1983;-19
12352;29.05.2017;'16 - 17;37,91;46,7;-8,79;17336;17693;357;2127;2118;-9
12353;29.05.2017;'17 - 18;42,18;53,53;-11,35;12431;12606;175;2199;2211;12
12354;29.05.2017;'18 - 19;44,08;63,85;-19,77;7173;7270;97;2309;2491;182
12355;29.05.2017;'19 - 20;46,15;69,23;-23,08;3081;3104;23;2749;2419;-330
12356;29.05.2017;'20 - 21;43,76;70,67;-26,91;800;799;-1;3431;2241;-1190
12357;29.05.2017;'21 - 22;42,02;73,82;-31,8;29;26;-3;4191;2554;-1637
12358;29.05.2017;'22 - 23;40,91;66,57;-25,66;0;0;0;5139;3124;-2015
12359;29.05.2017;'23 - 24;32,69;50,13;-17,44;0;0;0;5776;3629;-2147
12360;30.05.2017;'00 - 01;35,81;42,06;-6,25;0;0;0;4608;3808;-800
12361;30.05.2017;'01 - 02;32,55;37,67;-5,12;0;0;0;4760;3813;-947
12362;30.05.2017;'02 - 03;30,93;35,66;-4,73;0;0;0;4924;4281;-643
12363;30.05.2017;'03 - 04;28,77;35,55;-6,78;0;0;0;5124;4900;-224
12364;30.05.2017;'04 - 05;28,41;31,6;-3,19;1;2;1;5434;5332;-102
12365;30.05.2017;'05 - 06;31,3;35,48;-4,18;225;200;-25;5577;5602;25
12366;30.05.2017;'06 - 07;38,05;42,88;-4,83;1691;1692;1;5389;5299;-90
12367;30.05.2017;'07 - 08;49,6;51,3;-1,7;5176;4845;-331;5047;4848;-199
12368;30.05.2017;'08 - 09;52,23;63,24;-11,01;9869;9075;-794;4838;4460;-378
12369;30.05.2017;'09 - 10;50,08;55,4;-5,32;14472;13063;-1409;5200;5283;83
12370;30.05.2017;'10 - 11;45,02;51,11;-6,09;18182;16120;-2062;6148;7304;1156
12371;30.05.2017;'11 - 12;43,26;46,36;-3,1;20643;17939;-2704;7573;8836;1263
12372;30.05.2017;'12 - 13;35;44,68;-9,68;21780;18747;-3033;9324;9038;-286
12373;30.05.2017;'13 - 14;31,09;45,07;-13,98;21609;18778;-2831;11130;9898;-1232
12374;30.05.2017;'14 - 15;30,3;43,9;-13,6;20431;18054;-2377;12423;10447;-1976
12375;30.05.2017;'15 - 16;30,95;43,35;-12,4;18174;16628;-1546;12854;9626;-3228
12376;30.05.2017;'16 - 17;31,57;44,61;-13,04;14892;13369;-1523;12962;10206;-2756
12377;30.05.2017;'17 - 18;35,1;46,14;-11,04;10739;9272;-1467;12736;9960;-2776
12378;30.05.2017;'18 - 19;39,91;47,48;-7,57;6362;5377;-985;12130;9858;-2272
12379;30.05.2017;'19 - 20;41,96;49,17;-7,21;2905;2510;-395;11505;10393;-1112
12380;30.05.2017;'20 - 21;40,06;46,92;-6,86;761;734;-27;11029;10643;-386
12381;30.05.2017;'21 - 22;39,21;43,83;-4,62;27;26;-1;10945;11956;1011
12382;30.05.2017;'22 - 23;34,44;38,7;-4,26;0;0;0;11283;13043;1760
12383;30.05.2017;'23 - 24;28,44;32,17;-3,73;0;0;0;11785;13415;1630
12384;31.05.2017;'00 - 01;28,68;29,59;-0,91;0;0;0;12261;13837;1576
12385;31.05.2017;'01 - 02;28,38;27,82;0,56;0;0;0;12979;14032;1053
12386;31.05.2017;'02 - 03;27,28;27,27;0,01;0;0;0;13403;13490;87
12387;31.05.2017;'03 - 04;27,09;29,05;-1,96;0;0;0;13518;13633;115
12388;31.05.2017;'04 - 05;27,37;26,15;1,22;1;2;1;13506;13547;41
12389;31.05.2017;'05 - 06;28,33;28,42;-0,09;216;200;-16;13350;13407;57
12390;31.05.2017;'06 - 07;32,09;34,11;-2,02;1660;1714;54;13117;13128;11
12391;31.05.2017;'07 - 08;39,07;40,71;-1,64;4854;4948;94;13156;12974;-182
12392;31.05.2017;'08 - 09;39,94;40,64;-0,7;9286;9637;351;13578;13243;-335
12393;31.05.2017;'09 - 10;35,13;34,8;0,33;13725;14646;921;14177;13482;-695
12394;31.05.2017;'10 - 11;30,08;30,71;-0,63;17323;18322;999;14795;14168;-627
12395;31.05.2017;'11 - 12;29,61;31,22;-1,61;19853;20462;609;15281;15326;45
12396;31.05.2017;'12 - 13;29,75;30,58;-0,83;21375;21690;315;15630;15516;-114
12397;31.05.2017;'13 - 14;28,7;30,85;-2,15;21888;21781;-107;15863;15596;-267
12398;31.05.2017;'14 - 15;28,37;31,97;-3,6;21265;21323;58;15984;15142;-842
12399;31.05.2017;'15 - 16;29,98;32,04;-2,06;19441;20027;586;15959;14747;-1212
12400;31.05.2017;'16 - 17;29,9;32,51;-2,61;16332;17051;719;15787;14498;-1289
12401;31.05.2017;'17 - 18;35,29;33,45;1,84;12056;12938;882;15281;13958;-1323
12402;31.05.2017;'18 - 19;38,95;40,76;-1,81;7139;7966;827;14300;13506;-794
12403;31.05.2017;'19 - 20;42,11;41,36;0,75;3099;3560;461;13032;12251;-781
12404;31.05.2017;'20 - 21;41,45;40,81;0,64;824;915;91;11723;10423;-1300
12405;31.05.2017;'21 - 22;41,75;40,19;1,56;35;37;2;10612;9329;-1283
12406;31.05.2017;'22 - 23;40,51;40,23;0,28;0;0;0;9749;8999;-750
12407;31.05.2017;'23 - 24;31,2;32,98;-1,78;0;0;0;9051;8602;-449
12408;01.06.2017;'00 - 01;30,51;29,53;0,98;0;0;0;7489;7902;413
12409;01.06.2017;'01 - 02;28,85;29,52;-0,67;0;0;0;6988;7233;245
12410;01.06.2017;'02 - 03;28,94;28,26;0,68;0;0;0;6609;6642;33
12411;01.06.2017;'03 - 04;29,1;25,22;3,88;0;0;0;6270;6174;-96
12412;01.06.2017;'04 - 05;28,8;25,44;3,36;1;3;2;5969;6160;191
12413;01.06.2017;'05 - 06;28,81;25,75;3,06;247;238;-9;5599;5821;222
12414;01.06.2017;'06 - 07;34,43;27,72;6,71;1793;2016;223;5151;4987;-164
12415;01.06.2017;'07 - 08;39,35;37,24;2,11;5736;5950;214;4734;4103;-631
12416;01.06.2017;'08 - 09;41,28;38,61;2,67;11296;11070;-226;4372;4424;52
12417;01.06.2017;'09 - 10;38,03;34,95;3,08;16710;16493;-217;4028;4196;168
12418;01.06.2017;'10 - 11;33,24;31,5;1,74;21106;21298;192;3721;3880;159
12419;01.06.2017;'11 - 12;33;31,8;1,2;24101;24244;143;3487;3955;468
12420;01.06.2017;'12 - 13;31,01;30,71;0,3;25655;25473;-182;3327;3783;456
12421;01.06.2017;'13 - 14;31,86;29,58;2,28;25741;25483;-258;3238;3577;339
12422;01.06.2017;'14 - 15;31,34;30,11;1,23;24597;24452;-145;3212;3412;200
12423;01.06.2017;'15 - 16;34,08;30,34;3,74;22205;22407;202;3181;3156;-25
12424;01.06.2017;'16 - 17;35,08;31,51;3,57;18430;18871;441;3050;2977;-73
12425;01.06.2017;'17 - 18;40,96;34,41;6,55;13362;13955;593;2830;2885;55
12426;01.06.2017;'18 - 19;44,92;38,61;6,31;7708;8321;613;2518;2721;203
12427;01.06.2017;'19 - 20;50;42,2;7,8;3187;3680;493;2247;2404;157
12428;01.06.2017;'20 - 21;46,88;41,92;4,96;845;990;145;2177;1874;-303
12429;01.06.2017;'21 - 22;44,91;40,51;4,4;39;40;1;2383;2088;-295
12430;01.06.2017;'22 - 23;44,95;39,54;5,41;0;0;0;2741;2450;-291
12431;01.06.2017;'23 - 24;39,94;33,99;5,95;0;0;0;2964;2485;-479
12432;02.06.2017;'00 - 01;30,41;30,47;-0,06;0;0;0;2863;2280;-583
12433;02.06.2017;'01 - 02;29,32;30,69;-1,37;0;0;0;2639;2124;-515
12434;02.06.2017;'02 - 03;28,38;29,94;-1,56;0;0;0;2457;1824;-633
12435;02.06.2017;'03 - 04;28,04;26,95;1,09;0;0;0;2271;1619;-652
12436;02.06.2017;'04 - 05;28,32;27,1;1,22;1;4;3;2037;1400;-637
12437;02.06.2017;'05 - 06;28,36;28,3;0,06;252;242;-10;1799;1320;-479
12438;02.06.2017;'06 - 07;35,33;33,14;2,19;1813;2049;236;1552;1248;-304
12439;02.06.2017;'07 - 08;40,24;38,61;1,63;5744;6091;347;1269;992;-277
12440;02.06.2017;'08 - 09;41,5;39,45;2,05;11194;11312;118;972;568;-404
12441;02.06.2017;'09 - 10;39,96;36,54;3,42;16489;16531;42;758;424;-334
12442;02.06.2017;'10 - 11;38,67;35,78;2,89;20612;20722;110;684;410;-274
12443;02.06.2017;'11 - 12;37,89;35;2,89;23269;23736;467;664;484;-180
12444;02.06.2017;'12 - 13;37,34;34,15;3,19;24353;24694;341;674;651;-23
12445;02.06.2017;'13 - 14;35,08;33,34;1,74;23893;23812;-81;687;806;119
12446;02.06.2017;'14 - 15;33,62;34,7;-1,08;22401;21991;-410;713;886;173
12447;02.06.2017;'15 - 16;34,82;34,68;0,14;19854;19243;-611;758;918;160
12448;02.06.2017;'16 - 17;35,96;36;-0,04;16256;15822;-434;805;1055;250
12449;02.06.2017;'17 - 18;39,7;38,46;1,24;11724;11719;-5;909;1105;196
12450;02.06.2017;'18 - 19;42,78;39,87;2,91;6869;7046;177;1136;1520;384
12451;02.06.2017;'19 - 20;44,9;39,05;5,85;3018;3169;151;1522;2020;498
12452;02.06.2017;'20 - 21;43,52;38,98;4,54;808;784;-24;2179;2308;129
12453;02.06.2017;'21 - 22;41,98;38,94;3,04;38;26;-12;3077;3615;538
12454;02.06.2017;'22 - 23;41,96;38,91;3,05;0;0;0;4028;5198;1170
12455;02.06.2017;'23 - 24;36,64;33,71;2,93;0;0;0;4764;6364;1600
12456;03.06.2017;'00 - 01;30,08;30,64;-0,56;0;0;0;5692;6986;1294
12457;03.06.2017;'01 - 02;30,76;33,51;-2,75;0;0;0;5574;7095;1521
12458;03.06.2017;'02 - 03;28,74;30,9;-2,16;0;0;0;5434;7090;1656
12459;03.06.2017;'03 - 04;27,06;29,4;-2,34;0;0;0;5284;7247;1963
12460;03.06.2017;'04 - 05;26,49;27,58;-1,09;1;4;3;5132;7175;2043
12461;03.06.2017;'05 - 06;25;24,93;0,07;251;216;-35;4867;6893;2026
12462;03.06.2017;'06 - 07;26,51;26,56;-0,05;1796;1656;-140;4394;6326;1932
12463;03.06.2017;'07 - 08;26,89;26,27;0,62;5117;4748;-369;3705;5006;1301
12464;03.06.2017;'08 - 09;30,79;33,07;-2,28;9607;8898;-709;3054;3893;839
12465;03.06.2017;'09 - 10;31,25;33,74;-2,49;14059;13212;-847;2639;3306;667
12466;03.06.2017;'10 - 11;28,31;31,64;-3,33;17653;17069;-584;2479;3032;553
12467;03.06.2017;'11 - 12;27,03;29,31;-2,28;20061;19557;-504;2726;3425;699
12468;03.06.2017;'12 - 13;26,49;28,49;-2;21224;20205;-1019;3183;3762;579
12469;03.06.2017;'13 - 14;26,93;29,03;-2,1;20807;19155;-1652;3574;3762;188
12470;03.06.2017;'14 - 15;26,71;28,1;-1,39;19277;17234;-2043;3715;3546;-169
12471;03.06.2017;'15 - 16;26,97;28,29;-1,32;16839;14757;-2082;3690;3170;-520
12472;03.06.2017;'16 - 17;28,29;28,42;-0,13;13342;11736;-1606;3660;2951;-709
12473;03.06.2017;'17 - 18;33,94;34,59;-0,65;9234;8747;-487;3690;2770;-920
12474;03.06.2017;'18 - 19;37,3;38,23;-0,93;5455;5077;-378;3929;2436;-1493
12475;03.06.2017;'19 - 20;38,16;39,02;-0,86;2515;2277;-238;4367;2610;-1757
12476;03.06.2017;'20 - 21;36,96;39,48;-2,52;636;522;-114;4852;2928;-1924
12477;03.06.2017;'21 - 22;36,97;39,27;-2,3;27;14;-13;5438;2896;-2542
12478;03.06.2017;'22 - 23;38,57;41,4;-2,83;0;0;0;6138;2848;-3290
12479;03.06.2017;'23 - 24;35,91;38,13;-2,22;0;0;0;6680;3332;-3348
12480;04.06.2017;'00 - 01;29,93;31,3;-1,37;0;0;0;4487;3406;-1081
12481;04.06.2017;'01 - 02;26,93;27,35;-0,42;0;0;0;4826;3941;-885
12482;04.06.2017;'02 - 03;23,24;24,44;-1,2;0;0;0;5222;4430;-792
12483;04.06.2017;'03 - 04;22,54;24,12;-1,58;0;0;0;5594;5191;-403
12484;04.06.2017;'04 - 05;21,58;18,78;2,8;1;3;2;6046;5827;-219
12485;04.06.2017;'05 - 06;19,5;13,63;5,87;111;89;-22;6522;6382;-140
12486;04.06.2017;'06 - 07;19,85;12,88;6,97;763;660;-103;6903;6912;9
12487;04.06.2017;'07 - 08;20,33;16;4,33;2095;1698;-397;7329;7252;-77
12488;04.06.2017;'08 - 09;22,55;24,59;-2,04;3859;3200;-659;7749;7843;94
12489;04.06.2017;'09 - 10;23,79;26,62;-2,83;5935;5435;-500;8254;8947;693
12490;04.06.2017;'10 - 11;22,99;24,9;-1,91;8460;8344;-116;8936;10570;1634
12491;04.06.2017;'11 - 12;23,06;20,76;2,3;11113;10774;-339;9751;12006;2255
12492;04.06.2017;'12 - 13;19,34;12,86;6,48;13373;12496;-877;10760;13640;2880
12493;04.06.2017;'13 - 14;15,08;7,31;7,77;14691;13703;-988;11847;15684;3837
12494;04.06.2017;'14 - 15;9,98;-10,14;20,12;15162;14377;-785;12660;16376;3716
12495;04.06.2017;'15 - 16;10,41;-7,58;17,99;14795;14605;-190;12836;16922;4086
12496;04.06.2017;'16 - 17;3,43;-13,35;16,78;13141;13439;298;12506;16150;3644
12497;04.06.2017;'17 - 18;10,23;-0,55;10,78;10343;10976;633;11612;15144;3532
12498;04.06.2017;'18 - 19;25,76;14,34;11,42;6617;7184;567;10081;13655;3574
12499;04.06.2017;'19 - 20;31,06;24,82;6,24;3109;3389;280;8355;11138;2783
12500;04.06.2017;'20 - 21;34,91;26,66;8,25;892;900;8;7004;8508;1504
12501;04.06.2017;'21 - 22;34,99;30,45;4,54;45;49;4;6144;6900;756
12502;04.06.2017;'22 - 23;39,91;33,37;6,54;0;0;0;5653;6391;738
12503;04.06.2017;'23 - 24;34,9;26,24;8,66;0;0;0;5247;5964;717
12504;05.06.2017;'00 - 01;28,92;25,96;2,96;0;0;0;6040;5167;-873
12505;05.06.2017;'01 - 02;24,72;18,47;6,25;0;0;0;5482;4532;-950
12506;05.06.2017;'02 - 03;23,09;18,48;4,61;0;0;0;4996;4525;-471
12507;05.06.2017;'03 - 04;22,22;13,73;8,49;0;0;0;4603;4396;-207
12508;05.06.2017;'04 - 05;22,19;13,09;9,1;2;4;2;4316;4243;-73
12509;05.06.2017;'05 - 06;23,09;15,3;7,79;263;267;4;4142;4279;137
12510;05.06.2017;'06 - 07;24,1;14,69;9,41;1794;1924;130;4062;4482;420
12511;05.06.2017;'07 - 08;24,62;15,82;8,8;4969;4945;-24;4010;4198;188
12512;05.06.2017;'08 - 09;27,02;21,45;5,57;9092;8804;-288;4195;4181;-14
12513;05.06.2017;'09 - 10;27,12;26,75;0,37;13112;12582;-530;4732;4702;-30
12514;05.06.2017;'10 - 11;24,35;23,72;0,63;16100;15722;-378;5389;5035;-354
12515;05.06.2017;'11 - 12;25,31;22,45;2,86;17895;17649;-246;5833;4948;-885
12516;05.06.2017;'12 - 13;24,52;23,1;1,42;18544;18634;90;5834;4919;-915
12517;05.06.2017;'13 - 14;24,11;17,92;6,19;18075;18448;373;5528;4760;-768
12518;05.06.2017;'14 - 15;23,08;16,64;6,44;16690;17370;680;5020;4524;-496
12519;05.06.2017;'15 - 16;23,84;14,5;9,34;14541;15252;711;4326;3718;-608
12520;05.06.2017;'16 - 17;26,86;17,63;9,23;11986;12212;226;3556;3195;-361
12521;05.06.2017;'17 - 18;30,02;24,13;5,89;8970;9114;144;2776;3166;390
12522;05.06.2017;'18 - 19;35,94;28,14;7,8;5673;5917;244;2173;2958;785
12523;05.06.2017;'19 - 20;39,01;31,62;7,39;2763;2978;215;1977;3009;1032
12524;05.06.2017;'20 - 21;39,65;28,44;11,21;802;876;74;2430;3138;708
12525;05.06.2017;'21 - 22;38,61;29,64;8,97;41;45;4;3716;4082;366
12526;05.06.2017;'22 - 23;38,42;33,4;5,02;0;0;0;5456;5912;456
12527;05.06.2017;'23 - 24;30,14;27,24;2,9;0;0;0;7220;8584;1364
12528;06.06.2017;'00 - 01;24,22;20,96;3,26;0;0;0;9906;11356;1450
12529;06.06.2017;'01 - 02;19,3;12,64;6,66;0;0;0;11054;13250;2196
12530;06.06.2017;'02 - 03;14,49;6,68;7,81;0;0;0;11790;14337;2547
12531;06.06.2017;'03 - 04;10,54;5,64;4,9;0;0;0;12209;13954;1745
12532;06.06.2017;'04 - 05;10,22;7;3,22;2;4;2;12518;13730;1212
12533;06.06.2017;'05 - 06;13,38;8,35;5,03;258;256;-2;12619;13586;967
12534;06.06.2017;'06 - 07;29,22;24,58;4,64;1744;1804;60;12377;13183;806
12535;06.06.2017;'07 - 08;30,36;33,37;-3,01;4631;4676;45;11985;12270;285
12536;06.06.2017;'08 - 09;36,08;35,88;0,2;8173;8062;-111;12140;12058;-82
12537;06.06.2017;'09 - 10;30,11;32,71;-2,6;11509;11124;-385;13215;13411;196
12538;06.06.2017;'10 - 11;28,09;32,59;-4,5;13871;12975;-896;14772;16114;1342
12539;06.06.2017;'11 - 12;27,27;31,38;-4,11;15049;13061;-1988;16673;18574;1901
12540;06.06.2017;'12 - 13;25,95;27,78;-1,83;15320;13500;-1820;18667;21135;2468
12541;06.06.2017;'13 - 14;23,45;26,11;-2,66;14574;13507;-1067;20447;22902;2455
12542;06.06.2017;'14 - 15;22,67;21,23;1,44;13359;12510;-849;21558;24410;2852
12543;06.06.2017;'15 - 16;19,94;20,58;-0,64;11724;10514;-1210;22216;24778;2562
12544;06.06.2017;'16 - 17;18,62;21,31;-2,69;9782;8634;-1148;22814;24610;1796
12545;06.06.2017;'17 - 18;20,04;23,18;-3,14;7500;7063;-437;23103;23161;58
12546;06.06.2017;'18 - 19;22,72;25,09;-2,37;4941;4924;-17;23023;21720;-1303
12547;06.06.2017;'19 - 20;23,08;27,65;-4,57;2546;2702;156;22904;21850;-1054
12548;06.06.2017;'20 - 21;21,92;26,05;-4,13;735;843;108;22516;21142;-1374
12549;06.06.2017;'21 - 22;20,44;26,29;-5,85;36;50;14;22320;20331;-1989
12550;06.06.2017;'22 - 23;20,23;27,1;-6,87;0;0;0;22662;19965;-2697
12551;06.06.2017;'23 - 24;4,39;19,6;-15,21;0;0;0;23193;20331;-2862
12552;07.06.2017;'00 - 01;10,67;15,62;-4,95;0;0;0;22981;22098;-883
12553;07.06.2017;'01 - 02;8,8;10,9;-2,1;0;0;0;23814;22963;-851
12554;07.06.2017;'02 - 03;6,82;2,53;4,29;0;0;0;24628;24256;-372
12555;07.06.2017;'03 - 04;2,1;-4,19;6,29;0;0;0;25199;24658;-541
12556;07.06.2017;'04 - 05;1,74;-6,32;8,06;2;4;2;25924;25194;-730
12557;07.06.2017;'05 - 06;5,26;1,57;3,69;272;243;-29;26780;25705;-1075
12558;07.06.2017;'06 - 07;12,33;11,09;1,24;1808;1831;23;28004;27133;-871
12559;07.06.2017;'07 - 08;23,07;22,16;0,91;5063;4998;-65;29562;28574;-988
12560;07.06.2017;'08 - 09;18,06;15,31;2,75;9098;8855;-243;31082;30485;-597
12561;07.06.2017;'09 - 10;10,05;2,22;7,83;12812;12208;-604;32070;31242;-828
12562;07.06.2017;'10 - 11;9,66;0,64;9,02;15701;14320;-1381;32727;31614;-1113
12563;07.06.2017;'11 - 12;10,3;9,24;1,06;17587;16320;-1267;33225;32705;-520
12564;07.06.2017;'12 - 13;9,65;5,92;3,73;18551;17336;-1215;33519;32887;-632
12565;07.06.2017;'13 - 14;10,19;6,09;4,1;18605;18995;390;33672;32947;-725
12566;07.06.2017;'14 - 15;8,97;3,34;5,63;17992;18218;226;33538;33108;-430
12567;07.06.2017;'15 - 16;9,71;-1,11;10,82;16613;16315;-298;33090;32900;-190
12568;07.06.2017;'16 - 17;10,17;2,37;7,8;14159;14230;71;32435;32096;-339
12569;07.06.2017;'17 - 18;11,79;6,86;4,93;10764;10689;-75;31316;31268;-48
12570;07.06.2017;'18 - 19;20,37;18,39;1,98;6736;6770;34;29536;29584;48
12571;07.06.2017;'19 - 20;25,78;25,18;0,6;3161;3066;-95;27298;26929;-369
12572;07.06.2017;'20 - 21;24,08;27,09;-3,01;897;858;-39;25158;24219;-939
12573;07.06.2017;'21 - 22;25,56;30,58;-5,02;39;37;-2;23623;23025;-598
12574;07.06.2017;'22 - 23;25,45;30,88;-5,43;0;0;0;22719;22380;-339
12575;07.06.2017;'23 - 24;18,93;23,4;-4,47;0;0;0;22186;22477;291
12576;08.06.2017;'00 - 01;14,09;17,28;-3,19;0;0;0;21753;22059;306
12577;08.06.2017;'01 - 02;10,2;11,01;-0,81;0;0;0;21373;21774;401
12578;08.06.2017;'02 - 03;9,91;11,17;-1,26;0;0;0;20749;20924;175
12579;08.06.2017;'03 - 04;9,86;11,83;-1,97;0;0;0;19780;19428;-352
12580;08.06.2017;'04 - 05;9,92;11,42;-1,5;2;2;0;18560;17621;-939
12581;08.06.2017;'05 - 06;19,06;19,37;-0,31;280;258;-22;16978;15918;-1060
12582;08.06.2017;'06 - 07;32,77;32,49;0,28;1824;1894;70;15157;13831;-1326
12583;08.06.2017;'07 - 08;35,51;34,12;1,39;4948;5294;346;13469;12259;-1210
12584;08.06.2017;'08 - 09;35,51;35,4;0,11;8990;9809;819;12391;11280;-1111
12585;08.06.2017;'09 - 10;33,65;32,26;1,39;12875;13988;1113;12036;11148;-888
12586;08.06.2017;'10 - 11;32,25;29,87;2,38;16168;16811;643;12172;11714;-458
12587;08.06.2017;'11 - 12;32,45;30,53;1,92;18617;19268;651;12289;12695;406
12588;08.06.2017;'12 - 13;31,13;27,59;3,54;19950;20629;679;12195;13462;1267
12589;08.06.2017;'13 - 14;30;27,67;2,33;20117;21157;1040;11968;13402;1434
12590;08.06.2017;'14 - 15;29,88;28,59;1,29;19371;21021;1650;11454;12744;1290
12591;08.06.2017;'15 - 16;30,02;27,99;2,03;17664;19489;1825;10610;11436;826
12592;08.06.2017;'16 - 17;31,65;30,13;1,52;15016;16886;1870;9608;10330;722
12593;08.06.2017;'17 - 18;34,79;32,53;2,26;11324;12780;1456;8303;8734;431
12594;08.06.2017;'18 - 19;38,01;36,69;1,32;6926;7878;952;6789;7272;483
12595;08.06.2017;'19 - 20;43,91;43,05;0,86;3205;3642;437;5621;6272;651
12596;08.06.2017;'20 - 21;41,87;43,2;-1,33;923;988;65;5446;6321;875
12597;08.06.2017;'21 - 22;37,6;39,99;-2,39;45;46;1;6661;7271;610
12598;08.06.2017;'22 - 23;36,13;40;-3,87;0;0;0;8579;8770;191
12599;08.06.2017;'23 - 24;30,75;35,64;-4,89;0;0;0;10185;9666;-519
12600;09.06.2017;'00 - 01;28,18;31,58;-3,4;0;0;0;12078;10180;-1898
12601;09.06.2017;'01 - 02;27,92;31,08;-3,16;0;0;0;12303;10074;-2229
12602;09.06.2017;'02 - 03;25,88;32,07;-6,19;0;0;0;12305;10305;-2000
12603;09.06.2017;'03 - 04;24,63;30,19;-5,56;0;0;0;12051;10820;-1231
12604;09.06.2017;'04 - 05;24,9;26,79;-1,89;2;2;0;11640;11332;-308
12605;09.06.2017;'05 - 06;28,21;27,2;1,01;296;306;10;10957;10791;-166
12606;09.06.2017;'06 - 07;33,29;32,4;0,89;1874;2174;300;9865;8964;-901
12607;09.06.2017;'07 - 08;39,38;43,17;-3,79;5282;6058;776;8511;6743;-1768
12608;09.06.2017;'08 - 09;42,59;45,79;-3,2;9707;10985;1278;7265;4554;-2711
12609;09.06.2017;'09 - 10;40,59;43,32;-2,73;13641;15433;1792;6666;4313;-2353
12610;09.06.2017;'10 - 11;40,22;43,03;-2,81;16234;18019;1785;6820;5305;-1515
12611;09.06.2017;'11 - 12;40,81;40,85;-0,04;17535;18779;1244;7478;7724;246
12612;09.06.2017;'12 - 13;36,38;37,56;-1,18;17831;18570;739;8670;10170;1500
12613;09.06.2017;'13 - 14;33,83;36,26;-2,43;17122;17380;258;10048;12814;2766
12614;09.06.2017;'14 - 15;31,05;34,35;-3,3;15667;15395;-272;11038;14140;3102
12615;09.06.2017;'15 - 16;29,09;32,08;-2,99;13655;13235;-420;11465;14368;2903
12616;09.06.2017;'16 - 17;29,69;30,63;-0,94;11206;10736;-470;11733;14629;2896
12617;09.06.2017;'17 - 18;31,44;31,34;0,1;8493;8094;-399;11509;14936;3427
12618;09.06.2017;'18 - 19;33,2;34,37;-1,17;5587;5508;-79;10825;14014;3189
12619;09.06.2017;'19 - 20;35,07;35,07;0;2817;2835;18;9913;12663;2750
12620;09.06.2017;'20 - 21;34,97;35,64;-0,67;878;838;-40;8852;11317;2465
12621;09.06.2017;'21 - 22;35,9;35,89;0,01;54;59;5;7846;10114;2268
12622;09.06.2017;'22 - 23;37,86;36,45;1,41;0;0;0;7244;7986;742
12623;09.06.2017;'23 - 24;36,01;36,69;-0,68;0;0;0;7159;6692;-467
12624;10.06.2017;'00 - 01;34,65;34,71;-0,06;0;0;0;6299;5954;-345
12625;10.06.2017;'01 - 02;31,92;34,05;-2,13;0;0;0;6181;5471;-710
12626;10.06.2017;'02 - 03;28,9;33,6;-4,7;0;0;0;6072;5093;-979
12627;10.06.2017;'03 - 04;27,68;33,26;-5,58;0;0;0;5867;5105;-762
12628;10.06.2017;'04 - 05;27,06;30,84;-3,78;2;2;0;5593;4854;-739
12629;10.06.2017;'05 - 06;27,05;29,22;-2,17;316;281;-35;5133;4551;-582
12630;10.06.2017;'06 - 07;27,79;30,02;-2,23;1988;2033;45;4494;3911;-583
12631;10.06.2017;'07 - 08;29,71;31,15;-1,44;5633;5952;319;3817;2523;-1294
12632;10.06.2017;'08 - 09;30,9;35,78;-4,88;10720;11524;804;3431;2294;-1137
12633;10.06.2017;'09 - 10;31,94;31,43;0,51;15820;17047;1227;3645;2989;-656
12634;10.06.2017;'10 - 11;29,9;29,08;0,82;19829;21012;1183;4121;3857;-264
12635;10.06.2017;'11 - 12;29,94;28,18;1,76;22451;22560;109;4576;4312;-264
12636;10.06.2017;'12 - 13;28,35;29,7;-1,35;23653;23240;-413;4805;4734;-71
12637;10.06.2017;'13 - 14;25,86;26,53;-0,67;23536;23660;124;4832;5013;181
12638;10.06.2017;'14 - 15;25,01;25,48;-0,47;22226;23038;812;4691;4692;1
12639;10.06.2017;'15 - 16;25,03;23,13;1,9;19737;20927;1190;4318;4100;-218
12640;10.06.2017;'16 - 17;26,6;24,5;2,1;16277;17442;1165;3783;3156;-627
12641;10.06.2017;'17 - 18;29,1;29,03;0,07;11991;12986;995;3108;2397;-711
12642;10.06.2017;'18 - 19;35,41;35,39;0,02;7302;7946;644;2371;1919;-452
12643;10.06.2017;'19 - 20;38,24;33,44;4,8;3424;3671;247;1756;1697;-59
12644;10.06.2017;'20 - 21;38,78;32,53;6,25;1075;1048;-27;1485;1322;-163
12645;10.06.2017;'21 - 22;38,28;33,74;4,54;69;57;-12;1645;1354;-291
12646;10.06.2017;'22 - 23;39,68;35,62;4,06;0;0;0;2186;2126;-60
12647;10.06.2017;'23 - 24;36,94;33,74;3,2;0;0;0;3074;3781;707
12648;11.06.2017;'00 - 01;29,1;33,85;-4,75;0;0;0;5387;5902;515
12649;11.06.2017;'01 - 02;25,12;26,7;-1,58;0;0;0;6910;7792;882
12650;11.06.2017;'02 - 03;21,78;20,69;1,09;0;0;0;8153;9248;1095
12651;11.06.2017;'03 - 04;18;12,68;5,32;0;0;0;8881;10054;1173
12652;11.06.2017;'04 - 05;15,39;12,36;3,03;2;2;0;9315;10717;1402
12653;11.06.2017;'05 - 06;12,6;8,11;4,49;297;285;-12;9315;10731;1416
12654;11.06.2017;'06 - 07;12,84;7,84;5;1963;2088;125;8684;10320;1636
12655;11.06.2017;'07 - 08;16,49;12,85;3,64;5977;6246;269;7728;8292;564
12656;11.06.2017;'08 - 09;18;16,02;1,98;11555;11938;383;6646;6089;-557
12657;11.06.2017;'09 - 10;18,75;22,84;-4,09;16876;17430;554;6004;5684;-320
12658;11.06.2017;'10 - 11;18,95;20,45;-1,5;21052;21924;872;5733;6001;268
12659;11.06.2017;'11 - 12;20,58;21,71;-1,13;24036;24786;750;5680;6503;823
12660;11.06.2017;'12 - 13;10,19;11,6;-1,41;25558;26265;707;5849;6648;799
12661;11.06.2017;'13 - 14;8,35;9,77;-1,42;25584;26220;636;6154;6808;654
12662;11.06.2017;'14 - 15;10,34;7,48;2,86;24287;24785;498;6474;7026;552
12663;11.06.2017;'15 - 16;10,18;7,59;2,59;21657;21530;-127;6726;7177;451
12664;11.06.2017;'16 - 17;18,87;15,01;3,86;17615;16915;-700;6896;6876;-20
12665;11.06.2017;'17 - 18;23,58;23,78;-0,2;12542;11658;-884;6873;6910;37
12666;11.06.2017;'18 - 19;30,36;32,88;-2,52;7297;6462;-835;6790;6872;82
12667;11.06.2017;'19 - 20;33,13;33,99;-0,86;3237;2634;-603;7123;7085;-38
12668;11.06.2017;'20 - 21;33,62;32,19;1,43;973;750;-223;8031;7987;-44
12669;11.06.2017;'21 - 22;33,4;33,54;-0,14;67;44;-23;9425;7911;-1514
12670;11.06.2017;'22 - 23;33,7;36,13;-2,43;0;0;0;11045;8661;-2384
12671;11.06.2017;'23 - 24;28,61;39,65;-11,04;0;0;0;11917;10344;-1573
12672;12.06.2017;'00 - 01;25,02;27,27;-2,25;0;0;0;12158;10695;-1463
12673;12.06.2017;'01 - 02;20,66;24,59;-3,93;0;0;0;12825;11630;-1195
12674;12.06.2017;'02 - 03;18,15;23,76;-5,61;0;0;0;13578;13472;-106
12675;12.06.2017;'03 - 04;14,6;16,81;-2,21;0;0;0;14067;15066;999
12676;12.06.2017;'04 - 05;15,66;12,8;2,86;2;1;-1;14585;15974;1389
12677;12.06.2017;'05 - 06;20,37;15,81;4,56;261;209;-52;15071;16190;1119
12678;12.06.2017;'06 - 07;30,08;25,73;4,35;1704;1643;-61;15364;16041;677
12679;12.06.2017;'07 - 08;36,04;33,5;2,54;4631;4470;-161;15635;16328;693
12680;12.06.2017;'08 - 09;36,45;36,06;0,39;8501;8145;-356;16361;18290;1929
12681;12.06.2017;'09 - 10;34,49;29,86;4,63;12455;11920;-535;18332;19828;1496
12682;12.06.2017;'10 - 11;28,81;26,02;2,79;15712;14973;-739;20599;22125;1526
12683;12.06.2017;'11 - 12;26,83;25,87;0,96;18023;16427;-1596;22455;24630;2175
12684;12.06.2017;'12 - 13;18,51;9,94;8,57;19477;17926;-1551;24185;26778;2593
12685;12.06.2017;'13 - 14;11,31;1,49;9,82;20123;19070;-1053;25694;27498;1804
12686;12.06.2017;'14 - 15;10,92;-0,07;10,99;19763;19600;-163;26752;27599;847
12687;12.06.2017;'15 - 16;11,72;4,13;7,59;18111;18370;259;27213;27614;401
12688;12.06.2017;'16 - 17;10,01;6,8;3,21;15186;15562;376;27293;27156;-137
12689;12.06.2017;'17 - 18;19,77;20,47;-0,7;11319;11816;497;26694;26699;5
12690;12.06.2017;'18 - 19;28,98;30,55;-1,57;6909;7258;349;25258;25817;559
12691;12.06.2017;'19 - 20;35,91;35,42;0,49;3192;3313;121;23424;24368;944
12692;12.06.2017;'20 - 21;35,91;34,77;1,14;1005;979;-26;21698;22114;416
12693;12.06.2017;'21 - 22;35,43;34,79;0,64;70;47;-23;20299;20625;326
12694;12.06.2017;'22 - 23;36,99;35,76;1,23;0;0;0;19547;19299;-248
12695;12.06.2017;'23 - 24;29,97;32,95;-2,98;0;0;0;19051;19078;27
12696;13.06.2017;'00 - 01;28,06;32,75;-4,69;0;0;0;18706;18334;-372
12697;13.06.2017;'01 - 02;27;33,64;-6,64;0;0;0;18454;17841;-613
12698;13.06.2017;'02 - 03;24,63;32,13;-7,5;0;0;0;18114;17276;-838
12699;13.06.2017;'03 - 04;23,47;31,17;-7,7;0;0;0;17483;16690;-793
12700;13.06.2017;'04 - 05;23,95;30,98;-7,03;2;2;0;16889;15966;-923
12701;13.06.2017;'05 - 06;25,5;32,48;-6,98;309;268;-41;16327;15396;-931
12702;13.06.2017;'06 - 07;33,12;35,94;-2,82;1889;1901;12;16067;15077;-990
12703;13.06.2017;'07 - 08;39,47;42,45;-2,98;5375;5334;-41;15729;14355;-1374
12704;13.06.2017;'08 - 09;40;40,85;-0,85;10170;9770;-400;15603;14478;-1125
12705;13.06.2017;'09 - 10;33,9;34,05;-0,15;14786;13936;-850;16342;15165;-1177
12706;13.06.2017;'10 - 11;29,92;32,88;-2,96;18109;16161;-1948;16686;15128;-1558
12707;13.06.2017;'11 - 12;29,65;35,07;-5,42;20022;17356;-2666;16780;14984;-1796
12708;13.06.2017;'12 - 13;28,07;35,67;-7,6;20816;18284;-2532;16617;15205;-1412
12709;13.06.2017;'13 - 14;28,43;34,55;-6,12;20813;18992;-1821;16321;14768;-1553
12710;13.06.2017;'14 - 15;28,46;34,78;-6,32;19916;18698;-1218;15967;14339;-1628
12711;13.06.2017;'15 - 16;29,17;35,24;-6,07;18113;17302;-811;15487;14208;-1279
12712;13.06.2017;'16 - 17;33,98;37,38;-3,4;15273;15276;3;14773;13936;-837
12713;13.06.2017;'17 - 18;36,9;40,07;-3,17;11454;11693;239;13671;13174;-497
12714;13.06.2017;'18 - 19;38,52;42,19;-3,67;7094;7356;262;12143;12639;496
12715;13.06.2017;'19 - 20;42,92;45,73;-2,81;3354;3655;301;10330;10856;526
12716;13.06.2017;'20 - 21;41,95;44,77;-2,82;1084;1136;52;8728;9013;285
12717;13.06.2017;'21 - 22;40,96;44,03;-3,07;81;81;0;7660;7550;-110
12718;13.06.2017;'22 - 23;41,12;43,4;-2,28;0;0;0;6964;7018;54
12719;13.06.2017;'23 - 24;36,9;38,79;-1,89;0;0;0;6359;6822;463
12720;14.06.2017;'00 - 01;32,21;35,13;-2,92;0;0;0;5628;6482;854
12721;14.06.2017;'01 - 02;29,18;29,23;-0,05;0;0;0;5340;5990;650
12722;14.06.2017;'02 - 03;28,95;26,35;2,6;0;0;0;5105;5486;381
12723;14.06.2017;'03 - 04;27,86;26,16;1,7;0;0;0;4858;4763;-95
12724;14.06.2017;'04 - 05;27,5;26,5;1;2;3;1;4611;4267;-344
12725;14.06.2017;'05 - 06;28,98;26,42;2,56;338;319;-19;4280;4162;-118
12726;14.06.2017;'06 - 07;34,4;31,86;2,54;2010;2206;196;3846;3927;81
12727;14.06.2017;'07 - 08;41,26;39,27;1,99;5714;6304;590;3329;3171;-158
12728;14.06.2017;'08 - 09;43,76;39,67;4,09;10893;11664;771;2997;3118;121
12729;14.06.2017;'09 - 10;41,63;38,9;2,73;15875;16545;670;2786;2831;45
12730;14.06.2017;'10 - 11;41,12;35,59;5,53;19773;20564;791;2563;2319;-244
12731;14.06.2017;'11 - 12;39,93;35,74;4,19;22350;23560;1210;2438;2057;-381
12732;14.06.2017;'12 - 13;36,94;34,03;2,91;23643;25594;1951;2396;1955;-441
12733;14.06.2017;'13 - 14;35,99;32,4;3,59;23745;26237;2492;2401;2050;-351
12734;14.06.2017;'14 - 15;35,92;31,55;4,37;22712;25464;2752;2396;2020;-376
12735;14.06.2017;'15 - 16;35,02;31,92;3,1;20517;23370;2853;2371;2012;-359
12736;14.06.2017;'16 - 17;35,85;34,95;0,9;17250;19734;2484;2316;1803;-513
12737;14.06.2017;'17 - 18;40,53;39,78;0,75;12912;14903;1991;2198;1642;-556
12738;14.06.2017;'18 - 19;45,26;43,07;2,19;7902;9113;1211;2051;1414;-637
12739;14.06.2017;'19 - 20;49,95;49,73;0,22;3606;4032;426;1956;1396;-560
12740;14.06.2017;'20 - 21;44,64;51,55;-6,91;1156;1151;-5;1985;1634;-351
12741;14.06.2017;'21 - 22;42,91;48,47;-5,56;89;73;-16;2318;2333;15
12742;14.06.2017;'22 - 23;42,8;41,61;1,19;0;0;0;2806;3118;312
12743;14.06.2017;'23 - 24;35,44;35,51;-0,07;0;0;0;3102;3367;265
12744;15.06.2017;'00 - 01;33;33,74;-0,74;0;0;0;3756;3518;-238
12745;15.06.2017;'01 - 02;31,04;32,06;-1,02;0;0;0;3885;3595;-290
12746;15.06.2017;'02 - 03;30,97;32,69;-1,72;0;0;0;4009;3849;-160
12747;15.06.2017;'03 - 04;29,39;32,64;-3,25;0;0;0;4162;3950;-212
12748;15.06.2017;'04 - 05;28,8;32,65;-3,85;3;3;0;4285;4211;-74
12749;15.06.2017;'05 - 06;28,88;32,44;-3,56;329;318;-11;4250;4618;368
12750;15.06.2017;'06 - 07;32,02;34,13;-2,11;2030;2160;130;3966;4854;888
12751;15.06.2017;'07 - 08;37,81;35,52;2,29;6179;6292;113;3402;3980;578
12752;15.06.2017;'08 - 09;38;35,27;2,73;12078;11964;-114;2809;2935;126
12753;15.06.2017;'09 - 10;35,49;34,72;0,77;17715;17452;-263;2787;2899;112
12754;15.06.2017;'10 - 11;29,95;32,4;-2,45;21960;21616;-344;3011;3090;79
12755;15.06.2017;'11 - 12;31,97;32,62;-0,65;24596;24376;-220;3334;3193;-141
12756;15.06.2017;'12 - 13;28,44;30,53;-2,09;25762;25504;-258;3735;3650;-85
12757;15.06.2017;'13 - 14;27,73;30,41;-2,68;25333;25216;-117;4119;4258;139
12758;15.06.2017;'14 - 15;28,55;28,36;0,19;23619;22978;-641;4342;4431;89
12759;15.06.2017;'15 - 16;27,16;28,79;-1,63;20659;19374;-1285;4340;4515;175
12760;15.06.2017;'16 - 17;29,51;31,2;-1,69;16420;14818;-1602;4309;4958;649
12761;15.06.2017;'17 - 18;33,81;36,78;-2,97;11443;9781;-1662;4321;6295;1974
12762;15.06.2017;'18 - 19;36,9;39,46;-2,56;6600;5695;-905;4592;8223;3631
12763;15.06.2017;'19 - 20;37,01;38,6;-1,59;2946;2750;-196;5279;9163;3884
12764;15.06.2017;'20 - 21;36,62;35,58;1,04;871;850;-21;6231;9571;3340
12765;15.06.2017;'21 - 22;35,02;36,27;-1,25;66;80;14;7304;10692;3388
12766;15.06.2017;'22 - 23;34,58;35,86;-1,28;0;0;0;8449;11797;3348
12767;15.06.2017;'23 - 24;30;31,82;-1,82;0;0;0;9475;12157;2682
12768;16.06.2017;'00 - 01;28,5;33,48;-4,98;0;0;0;11615;11960;345
12769;16.06.2017;'01 - 02;23,93;27,7;-3,77;0;0;0;12047;10602;-1445
12770;16.06.2017;'02 - 03;22;27,75;-5,75;0;0;0;12419;10472;-1947
12771;16.06.2017;'03 - 04;21,07;29,01;-7,94;0;0;0;12708;11708;-1000
12772;16.06.2017;'04 - 05;21,05;27,76;-6,71;2;2;0;13243;12824;-419
12773;16.06.2017;'05 - 06;22,41;28,2;-5,79;263;244;-19;13935;13611;-324
12774;16.06.2017;'06 - 07;28,69;34,36;-5,67;1681;1817;136;14624;14094;-530
12775;16.06.2017;'07 - 08;33,53;38,75;-5,22;4658;4699;41;15310;14322;-988
12776;16.06.2017;'08 - 09;28,66;36,1;-7,44;8827;8341;-486;16399;15815;-584
12777;16.06.2017;'09 - 10;27,32;34,25;-6,93;13287;12760;-527;17842;18064;222
12778;16.06.2017;'10 - 11;21,97;26,37;-4,4;16979;16324;-655;19427;19872;445
12779;16.06.2017;'11 - 12;18,84;20,11;-1,27;19507;17810;-1697;21084;21862;778
12780;16.06.2017;'12 - 13;9,82;9,35;0,47;20777;18468;-2309;22728;23706;978
12781;16.06.2017;'13 - 14;7,53;4,38;3,15;20788;18466;-2322;24132;24784;652
12782;16.06.2017;'14 - 15;0,88;3,41;-2,53;19765;17681;-2084;25287;26328;1041
12783;16.06.2017;'15 - 16;1,52;3,35;-1,83;17582;15732;-1850;25907;27161;1254
12784;16.06.2017;'16 - 17;7,51;7,63;-0,12;14500;13325;-1175;26238;27747;1509
12785;16.06.2017;'17 - 18;10,1;14,36;-4,26;10700;9629;-1071;25905;27559;1654
12786;16.06.2017;'18 - 19;20,73;20,75;-0,02;6682;5916;-766;24786;26440;1654
12787;16.06.2017;'19 - 20;25,08;26,62;-1,54;3229;3008;-221;23269;24948;1679
12788;16.06.2017;'20 - 21;26,49;26,98;-0,49;989;1032;43;21694;22756;1062
12789;16.06.2017;'21 - 22;26,56;27,28;-0,72;71;90;19;20333;20651;318
12790;16.06.2017;'22 - 23;28,67;31,81;-3,14;0;0;0;19402;19093;-309
12791;16.06.2017;'23 - 24;21,83;25,86;-4,03;0;0;0;18892;18960;68
12792;17.06.2017;'00 - 01;19,81;24,67;-4,86;0;0;0;18043;19055;1012
12793;17.06.2017;'01 - 02;14,97;20,18;-5,21;0;0;0;17775;19308;1533
12794;17.06.2017;'02 - 03;17,08;16,57;0,51;0;0;0;17370;18829;1459
12795;17.06.2017;'03 - 04;19,49;18,55;0,94;0;0;0;16755;18197;1442
12796;17.06.2017;'04 - 05;18,46;20,39;-1,93;1;2;1;16196;17345;1149
12797;17.06.2017;'05 - 06;19,77;21,97;-2,2;259;238;-21;15652;16249;597
12798;17.06.2017;'06 - 07;19,14;21,87;-2,73;1712;1692;-20;15210;14648;-562
12799;17.06.2017;'07 - 08;21;27,34;-6,34;4717;4333;-384;14964;13485;-1479
12800;17.06.2017;'08 - 09;23,01;31,03;-8,02;8628;7694;-934;14710;13079;-1631
12801;17.06.2017;'09 - 10;23,49;31,94;-8,45;12389;10800;-1589;14347;13034;-1313
12802;17.06.2017;'10 - 11;22,76;31,74;-8,98;15455;13316;-2139;13774;13160;-614
12803;17.06.2017;'11 - 12;22,35;31,25;-8,9;17558;15835;-1723;13224;12961;-263
12804;17.06.2017;'12 - 13;21,03;29,9;-8,87;18687;17637;-1050;12751;12479;-272
12805;17.06.2017;'13 - 14;21,08;29,5;-8,42;18805;18505;-300;12303;11976;-327
12806;17.06.2017;'14 - 15;20,16;28,32;-8,16;18038;18064;26;11734;11549;-185
12807;17.06.2017;'15 - 16;20,1;27,84;-7,74;16365;16186;-179;11076;10940;-136
12808;17.06.2017;'16 - 17;22,68;28,01;-5,33;13753;13420;-333;10273;9650;-623
12809;17.06.2017;'17 - 18;27,62;34,02;-6,4;10376;10126;-250;9187;8420;-767
12810;17.06.2017;'18 - 19;31,63;38,01;-6,38;6546;6405;-141;7788;7030;-758
12811;17.06.2017;'19 - 20;35,1;39,29;-4,19;3055;3125;70;6368;5526;-842
12812;17.06.2017;'20 - 21;35,83;39,31;-3,48;959;924;-35;5207;4480;-727
12813;17.06.2017;'21 - 22;36,97;39,99;-3,02;76;56;-20;4497;3934;-563
12814;17.06.2017;'22 - 23;38;38,61;-0,61;0;0;0;4083;3938;-145
12815;17.06.2017;'23 - 24;35,85;34,94;0,91;0;0;0;3752;3999;247
12816;18.06.2017;'00 - 01;35,99;35,01;0,98;0;0;0;3700;3931;231
12817;18.06.2017;'01 - 02;30,08;31,31;-1,23;0;0;0;3395;3743;348
12818;18.06.2017;'02 - 03;28,53;26,87;1,66;0;0;0;3159;3389;230
12819;18.06.2017;'03 - 04;26,81;24,85;1,96;0;0;0;2966;3034;68
12820;18.06.2017;'04 - 05;25,11;22,86;2,25;3;3;0;2735;2714;-21
12821;18.06.2017;'05 - 06;24,29;22,26;2,03;282;258;-24;2390;2190;-200
12822;18.06.2017;'06 - 07;24,33;20,72;3,61;1798;1889;91;1954;1658;-296
12823;18.06.2017;'07 - 08;25,68;23,15;2,53;5322;5411;89;1560;1172;-388
12824;18.06.2017;'08 - 09;25,54;25,66;-0,12;10302;10524;222;1351;1056;-295
12825;18.06.2017;'09 - 10;24,4;24,51;-0,11;15178;15772;594;1356;1196;-160
12826;18.06.2017;'10 - 11;24,34;22,05;2,29;18907;19360;453;1474;1322;-152
12827;18.06.2017;'11 - 12;24,24;22,69;1,55;21316;21607;291;1637;1412;-225
12828;18.06.2017;'12 - 13;24,13;22,09;2,04;22620;23693;1073;1799;1478;-321
12829;18.06.2017;'13 - 14;23,53;19,84;3,69;23077;24730;1653;1957;1606;-351
12830;18.06.2017;'14 - 15;21,98;16,42;5,56;22580;24412;1832;2095;1752;-343
12831;18.06.2017;'15 - 16;22,9;13,77;9,13;20880;22608;1728;2185;1880;-305
12832;18.06.2017;'16 - 17;23,6;15,06;8,54;17829;19469;1640;2228;1835;-393
12833;18.06.2017;'17 - 18;27,18;20,08;7,1;13473;14812;1339;2162;1669;-493
12834;18.06.2017;'18 - 19;33,52;31,24;2,28;8261;9202;941;2035;1635;-400
12835;18.06.2017;'19 - 20;37,48;38,89;-1,41;3714;4150;436;1953;1637;-316
12836;18.06.2017;'20 - 21;38,98;37,4;1,58;1195;1195;0;1965;1536;-429
12837;18.06.2017;'21 - 22;39,09;37,04;2,05;95;85;-10;2110;1826;-284
12838;18.06.2017;'22 - 23;41,22;40,95;0,27;0;0;0;2315;2297;-18
12839;18.06.2017;'23 - 24;37,08;35,93;1,15;0;0;0;2408;2610;202
12840;19.06.2017;'00 - 01;33,88;35;-1,12;0;0;0;2560;2585;25
12841;19.06.2017;'01 - 02;30,2;29,9;0,3;0;0;0;2447;2511;64
12842;19.06.2017;'02 - 03;29,1;27,72;1,38;0;0;0;2317;2324;7
12843;19.06.2017;'03 - 04;28,67;27,5;1,17;0;0;0;2132;2071;-61
12844;19.06.2017;'04 - 05;28,57;28,56;0,01;3;3;0;1966;1961;-5
12845;19.06.2017;'05 - 06;29,1;30,81;-1,71;308;295;-13;1804;1917;113
12846;19.06.2017;'06 - 07;38,3;40,81;-2,51;1916;2070;154;1651;1762;111
12847;19.06.2017;'07 - 08;42,97;43,38;-0,41;6095;6348;253;1428;1466;38
12848;19.06.2017;'08 - 09;44,03;42,81;1,22;12089;12284;195;1150;899;-251
12849;19.06.2017;'09 - 10;40,98;39,07;1,91;17853;17987;134;982;790;-192
12850;19.06.2017;'10 - 11;38,24;37,96;0,28;22348;22373;25;1072;966;-106
12851;19.06.2017;'11 - 12;38,49;37,33;1,16;25291;25018;-273;1162;1184;22
12852;19.06.2017;'12 - 13;34,96;37,46;-2,5;26858;26386;-472;1201;1130;-71
12853;19.06.2017;'13 - 14;35,06;37,73;-2,67;27064;26536;-528;1200;987;-213
12854;19.06.2017;'14 - 15;35,88;38,53;-2,65;25995;25596;-399;1191;882;-309
12855;19.06.2017;'15 - 16;38,33;39,72;-1,39;23563;23455;-108;1168;827;-341
12856;19.06.2017;'16 - 17;39,51;40,23;-0,72;19804;19930;126;1154;798;-356
12857;19.06.2017;'17 - 18;42,1;42,22;-0,12;14771;14993;222;1147;758;-389
12858;19.06.2017;'18 - 19;45,6;47,24;-1,64;8890;9242;352;1162;828;-334
12859;19.06.2017;'19 - 20;49,99;54,6;-4,61;3858;4060;202;1247;841;-406
12860;19.06.2017;'20 - 21;45,4;50,52;-5,12;1221;1177;-44;1401;868;-533
12861;19.06.2017;'21 - 22;44,13;53,37;-9,24;105;88;-17;1636;1069;-567
12862;19.06.2017;'22 - 23;43,68;49,76;-6,08;0;0;0;1944;1274;-670
12863;19.06.2017;'23 - 24;36,66;40,29;-3,63;0;0;0;2192;1608;-584
12864;20.06.2017;'00 - 01;32,39;36,23;-3,84;0;0;0;1904;1857;-47
12865;20.06.2017;'01 - 02;32,1;35,17;-3,07;0;0;0;2153;2120;-33
12866;20.06.2017;'02 - 03;30,15;34,9;-4,75;0;0;0;2458;2627;169
12867;20.06.2017;'03 - 04;28,74;33,56;-4,82;0;0;0;2816;3030;214
12868;20.06.2017;'04 - 05;28,47;32,2;-3,73;3;2;-1;3199;3848;649
12869;20.06.2017;'05 - 06;30,47;33,72;-3,25;309;292;-17;3447;4617;1170
12870;20.06.2017;'06 - 07;36,81;38,98;-2,17;1931;2063;132;3407;4978;1571
12871;20.06.2017;'07 - 08;43,36;43,53;-0,17;6001;5984;-17;3254;4475;1221
12872;20.06.2017;'08 - 09;44,02;45,57;-1,55;11751;11341;-410;3163;3528;365
12873;20.06.2017;'09 - 10;42,3;38,88;3,42;17275;16756;-519;3273;3227;-46
12874;20.06.2017;'10 - 11;39,66;37,45;2,21;21628;20961;-667;3625;3260;-365
12875;20.06.2017;'11 - 12;36,99;37,16;-0,17;24481;23815;-666;4228;4005;-223
12876;20.06.2017;'12 - 13;32,75;36,73;-3,98;25898;24927;-971;5162;4830;-332
12877;20.06.2017;'13 - 14;32;35,35;-3,35;26011;24476;-1535;6308;5781;-527
12878;20.06.2017;'14 - 15;31,84;35,78;-3,94;24687;22984;-1703;7535;7037;-498
12879;20.06.2017;'15 - 16;31,86;35,49;-3,63;22164;20708;-1456;8629;7978;-651
12880;20.06.2017;'16 - 17;31,99;35,21;-3,22;18538;17412;-1126;9539;8803;-736
12881;20.06.2017;'17 - 18;37,34;38,52;-1,18;13764;13016;-748;10041;9209;-832
12882;20.06.2017;'18 - 19;38,08;43,12;-5,04;8303;8020;-283;10152;9662;-490
12883;20.06.2017;'19 - 20;39,71;44,05;-4,34;3735;3904;169;10066;9691;-375
12884;20.06.2017;'20 - 21;39,95;43,01;-3,06;1251;1254;3;9770;9292;-478
12885;20.06.2017;'21 - 22;38,9;40,98;-2,08;110;108;-2;9205;8508;-697
12886;20.06.2017;'22 - 23;38,57;36,92;1,65;0;0;0;8631;8242;-389
12887;20.06.2017;'23 - 24;34,91;33,86;1,05;0;0;0;7960;7986;26
12888;21.06.2017;'00 - 01;32,05;33,78;-1,73;0;0;0;5947;7394;1447
12889;21.06.2017;'01 - 02;31,94;30,93;1,01;0;0;0;5252;6460;1208
12890;21.06.2017;'02 - 03;31,34;30,42;0,92;0;0;0;4724;5894;1170
12891;21.06.2017;'03 - 04;30,87;27,7;3,17;0;0;0;4282;5472;1190
12892;21.06.2017;'04 - 05;30,68;27,71;2,97;3;3;0;3831;5008;1177
12893;21.06.2017;'05 - 06;30,92;28,77;2,15;309;303;-6;3336;4602;1266
12894;21.06.2017;'06 - 07;38,41;40,4;-1,99;1943;2095;152;2800;3688;888
12895;21.06.2017;'07 - 08;44,02;44,28;-0,26;5952;5926;-26;2247;2113;-134
12896;21.06.2017;'08 - 09;44,65;45,47;-0,82;11764;11142;-622;1806;1482;-324
12897;21.06.2017;'09 - 10;43,24;44,69;-1,45;17275;16371;-904;1500;1357;-143
12898;21.06.2017;'10 - 11;40,06;42,02;-1,96;21615;20532;-1083;1330;1433;103
12899;21.06.2017;'11 - 12;39,54;37,67;1,87;24576;23605;-971;1289;1579;290
12900;21.06.2017;'12 - 13;37,64;35,23;2,41;26042;25016;-1026;1328;1649;321
12901;21.06.2017;'13 - 14;36,09;34,83;1,26;26120;24559;-1561;1388;1649;261
12902;21.06.2017;'14 - 15;33,65;34,38;-0,73;24885;23135;-1750;1461;1568;107
12903;21.06.2017;'15 - 16;34,69;35,62;-0,93;22390;21010;-1380;1490;1514;24
12904;21.06.2017;'16 - 17;38,2;37,67;0,53;18779;17896;-883;1500;1364;-136
12905;21.06.2017;'17 - 18;45,64;44,7;0,94;13879;13387;-492;1498;1332;-166
12906;21.06.2017;'18 - 19;50,94;48,81;2,13;8294;8149;-145;1463;1250;-213
12907;21.06.2017;'19 - 20;56,95;53,93;3,02;3681;3776;95;1478;1148;-330
12908;21.06.2017;'20 - 21;51,03;52,8;-1,77;1233;1309;76;1617;1232;-385
12909;21.06.2017;'21 - 22;45,44;43,17;2,27;114;109;-5;1936;1189;-747
12910;21.06.2017;'22 - 23;44,05;43,1;0,95;0;0;0;2419;1226;-1193
12911;21.06.2017;'23 - 24;36,68;36,62;0,06;0;0;0;2910;1416;-1494
12912;22.06.2017;'00 - 01;35,94;36,53;-0,59;0;0;0;2562;1700;-862
12913;22.06.2017;'01 - 02;34,45;36,76;-2,31;0;0;0;3003;2190;-813
12914;22.06.2017;'02 - 03;32,04;34,45;-2,41;0;0;0;3493;2436;-1057
12915;22.06.2017;'03 - 04;30,96;32,91;-1,95;0;0;0;3947;2734;-1213
12916;22.06.2017;'04 - 05;29,2;30,4;-1,2;2;3;1;4467;3638;-829
12917;22.06.2017;'05 - 06;30,2;32,19;-1,99;309;284;-25;4930;4252;-678
12918;22.06.2017;'06 - 07;36,46;38,45;-1,99;1951;2002;51;5338;5233;-105
12919;22.06.2017;'07 - 08;42,39;47,36;-4,97;5627;5728;101;5604;5268;-336
12920;22.06.2017;'08 - 09;44,8;44,83;-0,03;10745;10898;153;5324;4185;-1139
12921;22.06.2017;'09 - 10;40,88;42,05;-1,17;15736;15683;-53;5015;4500;-515
12922;22.06.2017;'10 - 11;38,91;41,64;-2,73;19560;19237;-323;5422;6415;993
12923;22.06.2017;'11 - 12;37,15;39,12;-1,97;22173;21878;-295;6358;9865;3507
12924;22.06.2017;'12 - 13;34,96;32,41;2,55;23495;23248;-247;7758;10782;3024
12925;22.06.2017;'13 - 14;31,71;31,81;-0,1;23349;22742;-607;9439;12479;3040
12926;22.06.2017;'14 - 15;30,29;29,88;0,41;21933;20493;-1440;10735;14249;3514
12927;22.06.2017;'15 - 16;30,37;30,41;-0,04;19558;17064;-2494;11385;14907;3522
12928;22.06.2017;'16 - 17;30,17;33,77;-3,6;16166;12801;-3365;11958;15333;3375
12929;22.06.2017;'17 - 18;37,43;38,64;-1,21;11769;8416;-3353;12240;15112;2872
12930;22.06.2017;'18 - 19;39,9;40,49;-0,59;7066;4658;-2408;11994;16220;4226
12931;22.06.2017;'19 - 20;41,91;37,98;3,93;3286;2236;-1050;11434;16201;4767
12932;22.06.2017;'20 - 21;38,99;34,36;4,63;1046;822;-224;10839;16910;6071
12933;22.06.2017;'21 - 22;37,56;33,61;3,95;83;80;-3;10426;18415;7989
12934;22.06.2017;'22 - 23;36,07;28,83;7,24;0;0;0;10424;18022;7598
12935;22.06.2017;'23 - 24;30,95;22,94;8,01;0;0;0;10591;19198;8607
12936;23.06.2017;'00 - 01;25,33;21,7;3,63;0;0;0;17642;18364;722
12937;23.06.2017;'01 - 02;23,55;22,22;1,33;0;0;0;18037;17423;-614
12938;23.06.2017;'02 - 03;22,43;29,29;-6,86;0;0;0;18435;18391;-44
12939;23.06.2017;'03 - 04;21,41;26,93;-5,52;0;0;0;18616;20199;1583
12940;23.06.2017;'04 - 05;21,59;25,09;-3,5;1;2;1;18599;20706;2107
12941;23.06.2017;'05 - 06;23,34;24,53;-1,19;242;169;-73;18163;19684;1521
12942;23.06.2017;'06 - 07;28,09;43,98;-15,89;1658;1385;-273;17367;19695;2328
12943;23.06.2017;'07 - 08;36,26;50,74;-14,48;4460;3836;-624;16545;18422;1877
12944;23.06.2017;'08 - 09;38,28;62,73;-24,45;8305;6816;-1489;15972;17452;1480
12945;23.06.2017;'09 - 10;34,09;52,22;-18,13;12336;9870;-2466;15676;17762;2086
12946;23.06.2017;'10 - 11;30,45;43,3;-12,85;15993;12868;-3125;15612;19592;3980
12947;23.06.2017;'11 - 12;29,05;37,49;-8,44;18868;15968;-2900;15785;20604;4819
12948;23.06.2017;'12 - 13;27,77;34,81;-7,04;20676;18521;-2155;16181;20848;4667
12949;23.06.2017;'13 - 14;26,1;27,64;-1,54;21303;20046;-1257;16698;21138;4440
12950;23.06.2017;'14 - 15;25,07;21,71;3,36;20851;20241;-610;17139;21470;4331
12951;23.06.2017;'15 - 16;24,98;17,85;7,13;19183;18728;-455;17273;22341;5068
12952;23.06.2017;'16 - 17;25,01;15,74;9,27;16281;15790;-491;16931;21058;4127
12953;23.06.2017;'17 - 18;29,06;21,72;7,34;12291;12286;-5;15806;19850;4044
12954;23.06.2017;'18 - 19;36,46;33,08;3,38;7610;7889;279;13921;18126;4205
12955;23.06.2017;'19 - 20;38,42;33,31;5,11;3549;3772;223;11953;15288;3335
12956;23.06.2017;'20 - 21;38,44;33,47;4,97;1143;1148;5;10361;13210;2849
12957;23.06.2017;'21 - 22;37,98;33,8;4,18;93;76;-17;9380;12460;3080
12958;23.06.2017;'22 - 23;39,23;34,91;4,32;0;0;0;8987;12273;3286
12959;23.06.2017;'23 - 24;36,43;29,04;7,39;0;0;0;9076;12329;3253
12960;24.06.2017;'00 - 01;29,33;28;1,33;0;0;0;9727;12429;2702
12961;24.06.2017;'01 - 02;28,01;29,91;-1,9;0;0;0;10585;12369;1784
12962;24.06.2017;'02 - 03;24,01;30,65;-6,64;0;0;0;11430;12480;1050
12963;24.06.2017;'03 - 04;23,02;28,75;-5,73;0;0;0;12084;12806;722
12964;24.06.2017;'04 - 05;20,6;28,04;-7,44;1;1;0;12668;13272;604
12965;24.06.2017;'05 - 06;19,99;25,3;-5,31;220;178;-42;13048;13420;372
12966;24.06.2017;'06 - 07;22,09;27,73;-5,64;1517;1532;15;13259;13639;380
12967;24.06.2017;'07 - 08;24,53;28,96;-4,43;4572;4338;-234;13524;14115;591
12968;24.06.2017;'08 - 09;25,66;31,69;-6,03;8843;8026;-817;14218;15614;1396
12969;24.06.2017;'09 - 10;24,8;32,58;-7,78;12977;11704;-1273;15416;17869;2453
12970;24.06.2017;'10 - 11;22;24,04;-2,04;16253;14971;-1282;16739;19869;3130
12971;24.06.2017;'11 - 12;11,82;6,81;5,01;18526;17030;-1496;17782;21134;3352
12972;24.06.2017;'12 - 13;11,79;5,18;6,61;19845;18557;-1288;18332;22149;3817
12973;24.06.2017;'13 - 14;10,32;3,19;7,13;20195;19520;-675;18554;22720;4166
12974;24.06.2017;'14 - 15;7,38;-24,35;31,73;19460;19550;90;18503;22463;3960
12975;24.06.2017;'15 - 16;9,77;-26,18;35,95;17665;18150;485;18045;22120;4075
12976;24.06.2017;'16 - 17;12,64;-19,85;32,49;14899;15287;388;17403;21966;4563
12977;24.06.2017;'17 - 18;20,31;2,36;17,95;11151;11236;85;16477;19900;3423
12978;24.06.2017;'18 - 19;29,59;18,01;11,58;6773;7045;272;15106;17881;2775
12979;24.06.2017;'19 - 20;31,07;25,17;5,9;3014;3332;318;13561;15282;1721
12980;24.06.2017;'20 - 21;29,82;27,4;2,42;916;1004;88;12130;12212;82
12981;24.06.2017;'21 - 22;31,38;29,05;2,33;71;60;-11;10948;10480;-468
12982;24.06.2017;'22 - 23;31,94;33,39;-1,45;0;0;0;10227;9692;-535
12983;24.06.2017;'23 - 24;29,75;30,67;-0,92;0;0;0;10006;9174;-832
12984;25.06.2017;'00 - 01;28,06;30,68;-2,62;0;0;0;10106;8921;-1185
12985;25.06.2017;'01 - 02;23,59;26,23;-2,64;0;0;0;10438;9040;-1398
12986;25.06.2017;'02 - 03;20,79;22,09;-1,3;0;0;0;10857;9360;-1497
12987;25.06.2017;'03 - 04;18,25;20,11;-1,86;0;0;0;11205;9989;-1216
12988;25.06.2017;'04 - 05;14,45;16,91;-2,46;1;1;0;11557;10638;-919
12989;25.06.2017;'05 - 06;10,25;11,63;-1,38;211;190;-21;11938;11760;-178
12990;25.06.2017;'06 - 07;10,26;10,01;0,25;1391;1408;17;12279;12398;119
12991;25.06.2017;'07 - 08;17,69;12,62;5,07;3739;3662;-77;12692;12307;-385
12992;25.06.2017;'08 - 09;17,77;19,1;-1,33;6703;6177;-526;13739;13353;-386
12993;25.06.2017;'09 - 10;16,11;22,09;-5,98;9602;8634;-968;15509;15962;453
12994;25.06.2017;'10 - 11;13,29;20,54;-7,25;12048;11194;-854;17450;18264;814
12995;25.06.2017;'11 - 12;13,61;13,79;-0,18;13983;13016;-967;19022;20126;1104
12996;25.06.2017;'12 - 13;11,27;5,52;5,75;15237;13577;-1660;20034;21112;1078
12997;25.06.2017;'13 - 14;7,32;6,48;0,84;15466;13227;-2239;20726;21296;570
12998;25.06.2017;'14 - 15;0,65;9,1;-8,45;14882;12655;-2227;20946;20516;-430
12999;25.06.2017;'15 - 16;3,3;10,21;-6,91;13536;11676;-1860;20565;19894;-671
13000;25.06.2017;'16 - 17;8,17;8,55;-0,38;11399;10334;-1065;19857;19003;-854
13001;25.06.2017;'17 - 18;17,01;14,44;2,57;8602;7748;-854;18522;17714;-808
13002;25.06.2017;'18 - 19;21,69;18,67;3,02;5460;4884;-576;16575;15912;-663
13003;25.06.2017;'19 - 20;29,21;32,58;-3,37;2678;2481;-197;14546;13316;-1230
13004;25.06.2017;'20 - 21;33,94;38,15;-4,21;839;775;-64;12928;11942;-986
13005;25.06.2017;'21 - 22;35,21;38,3;-3,09;64;48;-16;11903;11553;-350
13006;25.06.2017;'22 - 23;38,91;40,02;-1,11;0;0;0;11448;10607;-841
13007;25.06.2017;'23 - 24;36,21;38,99;-2,78;0;0;0;11562;10011;-1551
13008;26.06.2017;'00 - 01;33,29;32,23;1,06;0;0;0;11035;9476;-1559
13009;26.06.2017;'01 - 02;30,8;30,95;-0,15;0;0;0;11655;9868;-1787
13010;26.06.2017;'02 - 03;28,03;31,15;-3,12;0;0;0;12190;10744;-1446
13011;26.06.2017;'03 - 04;26,16;28,47;-2,31;0;0;0;12518;11256;-1262
13012;26.06.2017;'04 - 05;23,96;26,11;-2,15;1;1;0;12886;11126;-1760
13013;26.06.2017;'05 - 06;26,21;29,06;-2,85;225;186;-39;13072;10814;-2258
13014;26.06.2017;'06 - 07;37,12;38,16;-1,04;1583;1504;-79;13093;10684;-2409
13015;26.06.2017;'07 - 08;39,43;40,09;-0,66;4561;4579;18;13160;9809;-3351
13016;26.06.2017;'08 - 09;38,98;41,27;-2,29;8774;9133;359;13258;10296;-2962
13017;26.06.2017;'09 - 10;34,43;34,77;-0,34;13135;13495;360;13321;11330;-1991
13018;26.06.2017;'10 - 11;28,85;28,83;0,02;16584;17106;522;13309;11668;-1641
13019;26.06.2017;'11 - 12;28,09;30,3;-2,21;19034;19360;326;13246;11459;-1787
13020;26.06.2017;'12 - 13;27,49;30,91;-3,42;20641;20873;232;13035;11420;-1615
13021;26.06.2017;'13 - 14;27,35;30,78;-3,43;21351;21433;82;12657;11324;-1333
13022;26.06.2017;'14 - 15;26,2;30,2;-4;21063;20976;-87;12166;11104;-1062
13023;26.06.2017;'15 - 16;27,2;31,11;-3,91;19560;19552;-8;11581;10518;-1063
13024;26.06.2017;'16 - 17;28,03;31,89;-3,86;16894;16782;-112;10880;9389;-1491
13025;26.06.2017;'17 - 18;35,38;36,56;-1,18;12971;13026;55;9959;8372;-1587
13026;26.06.2017;'18 - 19;39,9;41,75;-1,85;8056;8373;317;8752;7508;-1244
13027;26.06.2017;'19 - 20;42,91;44,06;-1,15;3677;3965;288;7549;6672;-877
13028;26.06.2017;'20 - 21;41,58;43,26;-1,68;1181;1171;-10;6564;5897;-667
13029;26.06.2017;'21 - 22;40,55;39,56;0,99;102;97;-5;5896;5418;-478
13030;26.06.2017;'22 - 23;42,4;40,02;2,38;0;0;0;5502;5414;-88
13031;26.06.2017;'23 - 24;38,46;36,11;2,35;0;0;0;5167;4852;-315
13032;27.06.2017;'00 - 01;31,07;33,54;-2,47;0;0;0;4697;4762;65
13033;27.06.2017;'01 - 02;30,07;30,88;-0,81;0;0;0;4383;4582;199
13034;27.06.2017;'02 - 03;29,09;29,12;-0,03;0;0;0;4078;4297;219
13035;27.06.2017;'03 - 04;29,04;27,99;1,05;0;0;0;3742;3815;73
13036;27.06.2017;'04 - 05;28,69;28,9;-0,21;2;2;0;3400;3272;-128
13037;27.06.2017;'05 - 06;29,41;31,61;-2,2;251;224;-27;3018;2793;-225
13038;27.06.2017;'06 - 07;37,94;40,13;-2,19;1581;1405;-176;2569;2278;-291
13039;27.06.2017;'07 - 08;43,55;50,16;-6,61;4402;3748;-654;2110;1741;-369
13040;27.06.2017;'08 - 09;46,66;52,23;-5,57;8114;6850;-1264;1753;1277;-476
13041;27.06.2017;'09 - 10;46,3;51,95;-5,65;11806;10326;-1480;1568;1109;-459
13042;27.06.2017;'10 - 11;46,69;49,91;-3,22;14942;13120;-1822;1495;1018;-477
13043;27.06.2017;'11 - 12;48,04;45,2;2,84;17217;15406;-1811;1513;982;-531
13044;27.06.2017;'12 - 13;45,95;45,99;-0,04;18419;17017;-1402;1622;1112;-510
13045;27.06.2017;'13 - 14;44,45;45;-0,55;18562;17688;-874;1775;1281;-494
13046;27.06.2017;'14 - 15;44,1;42,9;1,2;17892;17364;-528;2012;1565;-447
13047;27.06.2017;'15 - 16;40,15;41,98;-1,83;16221;15874;-347;2426;1948;-478
13048;27.06.2017;'16 - 17;42,53;44,16;-1,63;13422;13100;-322;3009;2534;-475
13049;27.06.2017;'17 - 18;42,6;45;-2,4;9862;9742;-120;3738;3161;-577
13050;27.06.2017;'18 - 19;43,93;44,77;-0,84;6044;5803;-241;4643;3824;-819
13051;27.06.2017;'19 - 20;43,95;46,28;-2,33;2837;2697;-140;5720;4554;-1166
13052;27.06.2017;'20 - 21;40,24;45,01;-4,77;895;824;-71;6950;5523;-1427
13053;27.06.2017;'21 - 22;37,98;43,37;-5,39;75;48;-27;8261;7116;-1145
13054;27.06.2017;'22 - 23;32,62;37,87;-5,25;0;0;0;9549;8876;-673
13055;27.06.2017;'23 - 24;27,3;32,53;-5,23;0;0;0;10463;10419;-44
13056;28.06.2017;'00 - 01;28,77;30,16;-1,39;0;0;0;11903;11381;-522
13057;28.06.2017;'01 - 02;27,35;28,78;-1,43;0;0;0;12282;11848;-434
13058;28.06.2017;'02 - 03;26,38;28,93;-2,55;0;0;0;12587;12200;-387
13059;28.06.2017;'03 - 04;26,02;28,01;-1,99;0;0;0;12701;12372;-329
13060;28.06.2017;'04 - 05;25,96;27,65;-1,69;2;2;0;12713;12644;-69
13061;28.06.2017;'05 - 06;27,96;30,25;-2,29;234;222;-12;12523;12913;390
13062;28.06.2017;'06 - 07;32,76;37,82;-5,06;1487;1487;0;12033;13187;1154
13063;28.06.2017;'07 - 08;38,64;40,7;-2,06;4149;3659;-490;11420;11809;389
13064;28.06.2017;'08 - 09;41,51;45,96;-4,45;7578;6455;-1123;10921;11394;473
13065;28.06.2017;'09 - 10;41,99;46,4;-4,41;10914;9237;-1677;10715;11824;1109
13066;28.06.2017;'10 - 11;41,95;43,03;-1,08;13537;12101;-1436;10816;12435;1619
13067;28.06.2017;'11 - 12;42,7;41,89;0,81;15274;14348;-926;11010;12890;1880
13068;28.06.2017;'12 - 13;41,45;39,43;2,02;16028;15748;-280;11194;13545;2351
13069;28.06.2017;'13 - 14;38,97;35,29;3,68;15829;16100;271;11376;13291;1915
13070;28.06.2017;'14 - 15;36,57;34,75;1,82;15034;16071;1037;11139;12880;1741
13071;28.06.2017;'15 - 16;33,79;32,97;0,82;13717;15088;1371;10441;12057;1616
13072;28.06.2017;'16 - 17;34,9;35,48;-0,58;11669;12488;819;9863;11270;1407
13073;28.06.2017;'17 - 18;38,4;39,11;-0,71;8844;9214;370;9473;10356;883
13074;28.06.2017;'18 - 19;38,97;41,47;-2,5;5584;5900;316;9330;9491;161
13075;28.06.2017;'19 - 20;40;41,65;-1,65;2748;2992;244;9338;8908;-430
13076;28.06.2017;'20 - 21;38,95;40,85;-1,9;877;976;99;9347;8168;-1179
13077;28.06.2017;'21 - 22;35,61;38,38;-2,77;68;69;1;9261;7726;-1535
13078;28.06.2017;'22 - 23;35,92;38,75;-2,83;0;0;0;9139;7080;-2059
13079;28.06.2017;'23 - 24;31,24;35,23;-3,99;0;0;0;8737;5969;-2768
13080;29.06.2017;'00 - 01;32,42;31,97;0,45;0;0;0;7769;4941;-2828
13081;29.06.2017;'01 - 02;30,59;31;-0,41;0;0;0;7112;4851;-2261
13082;29.06.2017;'02 - 03;29,94;27,82;2,12;0;0;0;6568;4628;-1940
13083;29.06.2017;'03 - 04;29,03;27,28;1,75;0;0;0;6011;4482;-1529
13084;29.06.2017;'04 - 05;29,05;27,29;1,76;1;1;0;5618;4296;-1322
13085;29.06.2017;'05 - 06;30,12;27,83;2,29;148;142;-6;5376;3968;-1408
13086;29.06.2017;'06 - 07;33,95;29,74;4,21;962;981;19;5188;4003;-1185
13087;29.06.2017;'07 - 08;41,9;39,71;2,19;2438;2404;-34;5019;4032;-987
13088;29.06.2017;'08 - 09;46,96;42,28;4,68;4164;4066;-98;4914;3983;-931
13089;29.06.2017;'09 - 10;47,53;42,04;5,49;5872;5869;-3;4934;4134;-800
13090;29.06.2017;'10 - 11;47,53;40,69;6,84;7602;7790;188;5077;4368;-709
13091;29.06.2017;'11 - 12;47,81;40,31;7,5;9256;10334;1078;5279;5127;-152
13092;29.06.2017;'12 - 13;45,99;38,41;7,58;10459;12138;1679;5584;6070;486
13093;29.06.2017;'13 - 14;45,2;37,16;8,04;10962;12766;1804;5986;7013;1027
13094;29.06.2017;'14 - 15;41,71;34,93;6,78;11086;12707;1621;6490;7965;1475
13095;29.06.2017;'15 - 16;39,17;33,73;5,44;10384;11795;1411;7079;9380;2301
13096;29.06.2017;'16 - 17;38,28;32,33;5,95;8677;9933;1256;7708;10671;2963
13097;29.06.2017;'17 - 18;38,23;32,8;5,43;6534;7425;891;8196;11964;3768
13098;29.06.2017;'18 - 19;38,94;34,23;4,71;4189;4427;238;8366;11870;3504
13099;29.06.2017;'19 - 20;39,01;35,31;3,7;2081;2122;41;8500;11703;3203
13100;29.06.2017;'20 - 21;35,52;32,6;2,92;658;650;-8;8835;11226;2391
13101;29.06.2017;'21 - 22;34,99;32,42;2,57;48;33;-15;9202;11526;2324
13102;29.06.2017;'22 - 23;36,48;33,75;2,73;0;0;0;9736;11615;1879
13103;29.06.2017;'23 - 24;33,5;31,07;2,43;0;0;0;10384;12225;1841
13104;30.06.2017;'00 - 01;29,29;27,17;2,12;0;0;0;10389;13248;2859
13105;30.06.2017;'01 - 02;29,01;25,21;3,8;0;0;0;11005;14201;3196
13106;30.06.2017;'02 - 03;28,06;22,7;5,36;0;0;0;11603;15144;3541
13107;30.06.2017;'03 - 04;27;21,19;5,81;0;0;0;12111;15836;3725
13108;30.06.2017;'04 - 05;25,58;19,19;6,39;0;0;0;12644;16190;3546
13109;30.06.2017;'05 - 06;28;21,1;6,9;151;98;-53;13117;16340;3223
13110;30.06.2017;'06 - 07;31,96;27,58;4,38;1281;1059;-222;13606;16185;2579
13111;30.06.2017;'07 - 08;37,93;35,79;2,14;3699;3124;-575;14230;15964;1734
13112;30.06.2017;'08 - 09;38,91;37,37;1,54;7034;6584;-450;14919;16900;1981
13113;30.06.2017;'09 - 10;35,99;33,92;2,07;10446;10382;-64;15618;18348;2730
13114;30.06.2017;'10 - 11;35,51;27,21;8,3;13491;13291;-200;16231;19510;3279
13115;30.06.2017;'11 - 12;32,24;27,51;4,73;15897;15548;-349;16678;21084;4406
13116;30.06.2017;'12 - 13;29,33;24,2;5,13;17446;16797;-649;16919;21806;4887
13117;30.06.2017;'13 - 14;27,29;23,04;4,25;18050;17175;-875;16994;21882;4888
13118;30.06.2017;'14 - 15;25,08;22,47;2,61;17712;17103;-609;16772;21019;4247
13119;30.06.2017;'15 - 16;25,09;22,31;2,78;16291;15791;-500;16143;19750;3607
13120;30.06.2017;'16 - 17;27,29;23,83;3,46;13714;13186;-528;15280;18520;3240
13121;30.06.2017;'17 - 18;30,51;29,15;1,36;10270;9996;-274;14105;16860;2755
13122;30.06.2017;'18 - 19;36,36;35,3;1,06;6412;6314;-98;12691;14826;2135
13123;30.06.2017;'19 - 20;38,92;36,57;2,35;3120;3010;-110;11276;12646;1370
13124;30.06.2017;'20 - 21;38,71;36,3;2,41;1022;876;-146;10277;10976;699
13125;30.06.2017;'21 - 22;36,61;35,52;1,09;71;40;-31;10092;9854;-238
13126;30.06.2017;'22 - 23;38,95;36,98;1,97;0;0;0;10445;9544;-901
13127;30.06.2017;'23 - 24;34,07;35,26;-1,19;0;0;0;11024;9620;-1404
13128;01.07.2017;'00 - 01;32,17;37,54;-5,37;0;0;0;10077;9971;-106
13129;01.07.2017;'01 - 02;29,04;34,88;-5,84;0;0;0;10577;10535;-42
13130;01.07.2017;'02 - 03;26,96;30,36;-3,4;0;0;0;11001;10886;-115
13131;01.07.2017;'03 - 04;26,08;29,63;-3,55;0;0;0;11226;11317;91
13132;01.07.2017;'04 - 05;26,04;26,4;-0,36;0;0;0;11505;11498;-7
13133;01.07.2017;'05 - 06;25,59;25,45;0,14;143;124;-19;11795;12108;313
13134;01.07.2017;'06 - 07;25,56;25,77;-0,21;1099;1088;-11;12039;12442;403
13135;01.07.2017;'07 - 08;26,77;28,38;-1,61;3003;3040;37;12366;12307;-59
13136;01.07.2017;'08 - 09;28,82;33,09;-4,27;5421;5501;80;12873;12838;-35
13137;01.07.2017;'09 - 10;32,4;34,12;-1,72;7677;7813;136;13410;13790;380
13138;01.07.2017;'10 - 11;33,35;32,22;1,13;9369;9853;484;13918;14922;1004
13139;01.07.2017;'11 - 12;33,15;32,06;1,09;10530;11141;611;14245;15713;1468
13140;01.07.2017;'12 - 13;29,1;27,09;2,01;11222;12213;991;14466;16293;1827
13141;01.07.2017;'13 - 14;26,07;23,65;2,42;11389;12537;1148;14691;16628;1937
13142;01.07.2017;'14 - 15;26,33;22,31;4,02;11075;11899;824;14837;16209;1372
13143;01.07.2017;'15 - 16;26,04;23,89;2,15;10093;10865;772;14842;16321;1479
13144;01.07.2017;'16 - 17;26,09;25,24;0,85;8411;9270;859;14842;16648;1806
13145;01.07.2017;'17 - 18;29,01;26,15;2,86;6310;7103;793;14555;15719;1164
13146;01.07.2017;'18 - 19;29,34;30,39;-1,05;4009;4564;555;13936;14411;475
13147;01.07.2017;'19 - 20;29,89;32,77;-2,88;1932;2245;313;13199;13035;-164
13148;01.07.2017;'20 - 21;30,12;31,76;-1,64;610;676;66;12588;12041;-547
13149;01.07.2017;'21 - 22;29,63;32,43;-2,8;51;59;8;12195;12281;86
13150;01.07.2017;'22 - 23;28,87;33,03;-4,16;0;0;0;12093;12551;458
13151;01.07.2017;'23 - 24;26,26;28,48;-2,22;0;0;0;12093;12486;393
13152;02.07.2017;'00 - 01;24,36;23,86;0,5;0;0;0;11792;12043;251
13153;02.07.2017;'01 - 02;23,12;22,79;0,33;0;0;0;11514;11938;424
13154;02.07.2017;'02 - 03;22,73;21,03;1,7;0;0;0;11310;11884;574
13155;02.07.2017;'03 - 04;22,63;20,57;2,06;0;0;0;11138;12408;1270
13156;02.07.2017;'04 - 05;20,27;18,15;2,12;1;1;0;11018;13116;2098
13157;02.07.2017;'05 - 06;20,59;11,2;9,39;168;136;-32;10802;13310;2508
13158;02.07.2017;'06 - 07;21,3;10,38;10,92;1034;992;-42;10543;12804;2261
13159;02.07.2017;'07 - 08;23,07;15,21;7,86;2940;2754;-186;10544;12262;1718
13160;02.07.2017;'08 - 09;24,76;16,8;7,96;5605;5034;-571;10869;11872;1003
13161;02.07.2017;'09 - 10;25,56;20,9;4,66;8365;7473;-892;11385;11700;315
13162;02.07.2017;'10 - 11;20,71;23,74;-3,03;10613;9736;-877;12077;11627;-450
13163;02.07.2017;'11 - 12;23,32;26,29;-2,97;12389;11517;-872;12740;12734;-6
13164;02.07.2017;'12 - 13;21,36;24,47;-3,11;13409;12371;-1038;13340;13114;-226
13165;02.07.2017;'13 - 14;19,08;25,52;-6,44;13377;12106;-1271;13919;13874;-45
13166;02.07.2017;'14 - 15;10,47;21,51;-11,04;12817;11109;-1708;14148;14778;630
13167;02.07.2017;'15 - 16;9,96;17,59;-7,63;11611;9734;-1877;14004;15636;1632
13168;02.07.2017;'16 - 17;17,31;19,54;-2,23;9664;8467;-1197;13656;15989;2333
13169;02.07.2017;'17 - 18;19,72;16,6;3,12;7299;6812;-487;13125;15752;2627
13170;02.07.2017;'18 - 19;28,63;26,39;2,24;4712;4646;-66;12407;15320;2913
13171;02.07.2017;'19 - 20;32,9;30,85;2,05;2331;2562;231;11547;14526;2979
13172;02.07.2017;'20 - 21;35,37;32,56;2,81;777;840;63;10630;12536;1906
13173;02.07.2017;'21 - 22;37;32,99;4,01;71;72;1;9745;11698;1953
13174;02.07.2017;'22 - 23;38,92;34,49;4,43;0;0;0;9050;11761;2711
13175;02.07.2017;'23 - 24;37,06;31,86;5,2;0;0;0;8512;11699;3187
13176;03.07.2017;'00 - 01;26,04;30,7;-4,66;0;0;0;10905;11292;387
13177;03.07.2017;'01 - 02;23,51;26,44;-2,93;0;0;0;10774;11192;418
13178;03.07.2017;'02 - 03;22,86;25,55;-2,69;0;0;0;10586;10734;148
13179;03.07.2017;'03 - 04;22,56;23,94;-1,38;0;0;0;10277;9894;-383
13180;03.07.2017;'04 - 05;24,86;22,96;1,9;1;1;0;9896;9537;-359
13181;03.07.2017;'05 - 06;26,78;26,67;0,11;222;172;-50;9460;8914;-546
13182;03.07.2017;'06 - 07;34,93;34,24;0,69;1445;1524;79;8962;8097;-865
13183;03.07.2017;'07 - 08;41,25;44,93;-3,68;4462;4830;368;8562;6880;-1682
13184;03.07.2017;'08 - 09;41,61;44,97;-3,36;8851;9374;523;8684;7300;-1384
13185;03.07.2017;'09 - 10;38,94;38,15;0,79;13424;14073;649;9445;9296;-149
13186;03.07.2017;'10 - 11;35,35;33,09;2,26;17388;18204;816;10336;10844;508
13187;03.07.2017;'11 - 12;32,92;31,23;1,69;20322;21030;708;11213;11779;566
13188;03.07.2017;'12 - 13;28,68;27,52;1,16;21876;22598;722;12038;12648;610
13189;03.07.2017;'13 - 14;28,17;26,43;1,74;21983;23080;1097;12778;13102;324
13190;03.07.2017;'14 - 15;26,91;26,09;0,82;20980;22033;1053;13381;13492;111
13191;03.07.2017;'15 - 16;28,02;26,17;1,85;18894;19701;807;13820;14134;314
13192;03.07.2017;'16 - 17;28,59;28,14;0,45;15643;16051;408;14092;14766;674
13193;03.07.2017;'17 - 18;32,18;30,71;1,47;11579;11980;401;13888;14924;1036
13194;03.07.2017;'18 - 19;38,94;35,47;3,47;7079;7390;311;13136;14597;1461
13195;03.07.2017;'19 - 20;42,78;38,14;4,64;3269;3489;220;12265;13280;1015
13196;03.07.2017;'20 - 21;40,91;37,24;3,67;1048;1018;-30;11524;11480;-44
13197;03.07.2017;'21 - 22;39,37;37,94;1,43;89;54;-35;11091;11313;222
13198;03.07.2017;'22 - 23;39,91;36,73;3,18;0;0;0;11114;11832;718
13199;03.07.2017;'23 - 24;32,04;33,92;-1,88;0;0;0;11247;12263;1016
13200;04.07.2017;'00 - 01;28,83;27,79;1,04;0;0;0;11803;11773;-30
13201;04.07.2017;'01 - 02;28,63;28,45;0,18;0;0;0;11910;11728;-182
13202;04.07.2017;'02 - 03;28,49;28,78;-0,29;0;0;0;11961;11458;-503
13203;04.07.2017;'03 - 04;28,43;29,47;-1,04;0;0;0;11924;10987;-937
13204;04.07.2017;'04 - 05;27,99;29,53;-1,54;1;1;0;11828;10618;-1210
13205;04.07.2017;'05 - 06;28,44;30,62;-2,18;213;180;-33;11398;9955;-1443
13206;04.07.2017;'06 - 07;35,81;38,09;-2,28;1512;1599;87;10675;9117;-1558
13207;04.07.2017;'07 - 08;41,63;42,09;-0,46;4528;4648;120;10065;8400;-1665
13208;04.07.2017;'08 - 09;41,79;40,27;1,52;8800;8796;-4;9886;9008;-878
13209;04.07.2017;'09 - 10;36;37,01;-1,01;13234;13286;52;9963;9592;-371
13210;04.07.2017;'10 - 11;34,74;35,9;-1,16;16792;17455;663;10153;9844;-309
13211;04.07.2017;'11 - 12;32,97;34,44;-1,47;19175;20150;975;10328;10270;-58
13212;04.07.2017;'12 - 13;31,93;30,95;0,98;20440;21152;712;10341;10602;261
13213;04.07.2017;'13 - 14;31,93;31,38;0,55;20872;21476;604;10153;10545;392
13214;04.07.2017;'14 - 15;30,55;32,08;-1,53;20442;21082;640;9840;9913;73
13215;04.07.2017;'15 - 16;32,6;33,39;-0,79;18956;19722;766;9298;8995;-303
13216;04.07.2017;'16 - 17;32,93;33,32;-0,39;16317;17241;924;8546;7701;-845
13217;04.07.2017;'17 - 18;36,95;36,99;-0,04;12489;13345;856;7572;6316;-1256
13218;04.07.2017;'18 - 19;40;41,04;-1,04;7753;8478;725;6357;4909;-1448
13219;04.07.2017;'19 - 20;44,04;43,06;0,98;3533;3925;392;5151;3528;-1623
13220;04.07.2017;'20 - 21;43,1;44,06;-0,96;1166;1132;-34;4227;2424;-1803
13221;04.07.2017;'21 - 22;41,68;43,96;-2,28;108;60;-48;3695;1928;-1767
13222;04.07.2017;'22 - 23;40,54;42,78;-2,24;0;0;0;3436;1794;-1642
13223;04.07.2017;'23 - 24;37,29;38,78;-1,49;0;0;0;3224;1594;-1630
13224;05.07.2017;'00 - 01;34,99;37,75;-2,76;0;0;0;2329;1357;-972
13225;05.07.2017;'01 - 02;32,51;35,86;-3,35;0;0;0;2155;1276;-879
13226;05.07.2017;'02 - 03;31,02;33,58;-2,56;0;0;0;2031;1205;-826
13227;05.07.2017;'03 - 04;29,07;30,96;-1,89;0;0;0;1927;1113;-814
13228;05.07.2017;'04 - 05;29,54;31,82;-2,28;0;0;0;1836;1208;-628
13229;05.07.2017;'05 - 06;31,89;33,35;-1,46;192;138;-54;1707;1509;-198
13230;05.07.2017;'06 - 07;38,02;37,22;0,8;1428;1425;-3;1556;1634;78
13231;05.07.2017;'07 - 08;43,92;41,37;2,55;4463;4512;49;1392;1341;-51
13232;05.07.2017;'08 - 09;46,01;40,82;5,19;8956;9058;102;1239;1098;-141
13233;05.07.2017;'09 - 10;44,18;40,95;3,23;13584;13778;194;1105;1018;-87
13234;05.07.2017;'10 - 11;43,71;39,68;4,03;17453;17892;439;1063;1056;-7
13235;05.07.2017;'11 - 12;42,06;38,91;3,15;20269;21084;815;1093;1100;7
13236;05.07.2017;'12 - 13;38,93;37,62;1,31;21861;22878;1017;1200;1104;-96
13237;05.07.2017;'13 - 14;38,09;35,71;2,38;22101;23586;1485;1345;1169;-176
13238;05.07.2017;'14 - 15;37,44;33,81;3,63;21187;22858;1671;1522;1298;-224
13239;05.07.2017;'15 - 16;37,38;33,96;3,42;19174;20603;1429;1702;1440;-262
13240;05.07.2017;'16 - 17;38,9;37,19;1,71;16118;17239;1121;1846;1544;-302
13241;05.07.2017;'17 - 18;41,51;41,45;0,06;12114;12923;809;1913;1568;-345
13242;05.07.2017;'18 - 19;42,52;42,22;0,3;7508;8288;780;1892;1563;-329
13243;05.07.2017;'19 - 20;44,55;44,9;-0,35;3542;3938;396;1887;1522;-365
13244;05.07.2017;'20 - 21;44,15;44,58;-0,43;1178;1165;-13;1945;1575;-370
13245;05.07.2017;'21 - 22;43,93;42,78;1,15;102;75;-27;2078;1770;-308
13246;05.07.2017;'22 - 23;41,66;42,44;-0,78;0;0;0;2260;2066;-194
13247;05.07.2017;'23 - 24;36,07;36,8;-0,73;0;0;0;2288;1896;-392
13248;06.07.2017;'00 - 01;33,03;33,09;-0,06;0;0;0;1795;1592;-203
13249;06.07.2017;'01 - 02;32,21;32,6;-0,39;0;0;0;1573;1474;-99
13250;06.07.2017;'02 - 03;30,62;31,8;-1,18;0;0;0;1389;1298;-91
13251;06.07.2017;'03 - 04;30,11;31,21;-1,1;0;0;0;1279;1142;-137
13252;06.07.2017;'04 - 05;29,19;30,06;-0,87;1;0;-1;1164;1087;-77
13253;06.07.2017;'05 - 06;32,06;31,32;0,74;233;188;-45;1011;1052;41
13254;06.07.2017;'06 - 07;36,94;37,21;-0,27;1655;1721;66;798;913;115
13255;06.07.2017;'07 - 08;42,29;42,56;-0,27;5313;5434;121;547;591;44
13256;06.07.2017;'08 - 09;48,24;42,77;5,47;10762;11034;272;381;233;-148
13257;06.07.2017;'09 - 10;43,08;40,95;2,13;16350;16662;312;342;165;-177
13258;06.07.2017;'10 - 11;41,86;41,09;0,77;20776;21171;395;321;207;-114
13259;06.07.2017;'11 - 12;40,03;41,69;-1,66;23802;23874;72;332;243;-89
13260;06.07.2017;'12 - 13;35,71;38,35;-2,64;25425;25222;-203;380;327;-53
13261;06.07.2017;'13 - 14;35,75;39,11;-3,36;25658;25289;-369;438;477;39
13262;06.07.2017;'14 - 15;35,54;39,22;-3,68;24579;24184;-395;506;608;102
13263;06.07.2017;'15 - 16;39,52;40,88;-1,36;22223;21152;-1071;596;1007;411
13264;06.07.2017;'16 - 17;40,6;44,17;-3,57;18637;17094;-1543;700;1026;326
13265;06.07.2017;'17 - 18;44,31;47,44;-3,13;13736;12460;-1276;802;1033;231
13266;06.07.2017;'18 - 19;45,87;53,96;-8,09;8161;7501;-660;970;1269;299
13267;06.07.2017;'19 - 20;53,71;54,01;-0,3;3514;3352;-162;1294;1695;401
13268;06.07.2017;'20 - 21;49,56;51,87;-2,31;1103;954;-149;1938;2591;653
13269;06.07.2017;'21 - 22;46,03;46,93;-0,9;100;54;-46;3020;3556;536
13270;06.07.2017;'22 - 23;42,71;45,33;-2,62;0;0;0;4285;5511;1226
13271;06.07.2017;'23 - 24;35,61;35,65;-0,04;0;0;0;5158;7250;2092
13272;07.07.2017;'00 - 01;34,16;31,11;3,05;0;0;0;5737;8642;2905
13273;07.07.2017;'01 - 02;32,07;28,96;3,11;0;0;0;5788;9265;3477
13274;07.07.2017;'02 - 03;30,8;26,88;3,92;0;0;0;5772;8359;2587
13275;07.07.2017;'03 - 04;30,69;29,69;1;0;0;0;5631;7042;1411
13276;07.07.2017;'04 - 05;29,64;29,81;-0,17;0;0;0;5520;6416;896
13277;07.07.2017;'05 - 06;30,84;31,69;-0,85;175;124;-51;5241;6372;1131
13278;07.07.2017;'06 - 07;35,87;34,56;1,31;1363;1207;-156;4703;5515;812
13279;07.07.2017;'07 - 08;41,88;41,9;-0,02;4173;3489;-684;4237;4836;599
13280;07.07.2017;'08 - 09;45,54;48,61;-3,07;8157;6934;-1223;3913;3834;-79
13281;07.07.2017;'09 - 10;45,58;49,2;-3,62;12291;10944;-1347;3950;3421;-529
13282;07.07.2017;'10 - 11;44,61;48,42;-3,81;15992;14660;-1332;4236;3300;-936
13283;07.07.2017;'11 - 12;43,31;53,2;-9,89;18861;17530;-1331;4716;3718;-998
13284;07.07.2017;'12 - 13;39,65;44,86;-5,21;20585;19716;-869;5344;3888;-1456
13285;07.07.2017;'13 - 14;34,43;41,47;-7,04;21108;21162;54;6098;4481;-1617
13286;07.07.2017;'14 - 15;32,05;39,21;-7,16;20583;20996;413;6846;5546;-1300
13287;07.07.2017;'15 - 16;31,84;36,97;-5,13;18858;18590;-268;7386;6580;-806
13288;07.07.2017;'16 - 17;32,4;37,75;-5,35;16049;15442;-607;7825;7241;-584
13289;07.07.2017;'17 - 18;37,87;39,89;-2,02;12159;11379;-780;7873;7441;-432
13290;07.07.2017;'18 - 19;40,58;42,31;-1,73;7534;7114;-420;7292;7104;-188
13291;07.07.2017;'19 - 20;42,74;44,64;-1,9;3500;3356;-144;6471;5813;-658
13292;07.07.2017;'20 - 21;41,8;44;-2,2;1138;1074;-64;5668;4738;-930
13293;07.07.2017;'21 - 22;40,46;42,09;-1,63;94;71;-23;5171;4001;-1170
13294;07.07.2017;'22 - 23;40,99;43,19;-2,2;0;0;0;4953;3636;-1317
13295;07.07.2017;'23 - 24;35,91;37,25;-1,34;0;0;0;4874;3489;-1385
13296;08.07.2017;'00 - 01;37,08;38,54;-1,46;0;0;0;4475;3233;-1242
13297;08.07.2017;'01 - 02;34,64;39,39;-4,75;0;0;0;4538;3187;-1351
13298;08.07.2017;'02 - 03;32,05;36,24;-4,19;0;0;0;4699;3524;-1175
13299;08.07.2017;'03 - 04;30,68;33,14;-2,46;0;0;0;4897;3919;-978
13300;08.07.2017;'04 - 05;29,87;31,6;-1,73;0;0;0;5044;3988;-1056
13301;08.07.2017;'05 - 06;29,09;31,25;-2,16;196;141;-55;5058;4126;-932
13302;08.07.2017;'06 - 07;30;32,05;-2,05;1495;1460;-35;4986;4444;-542
13303;08.07.2017;'07 - 08;32,02;33,16;-1,14;4595;4456;-139;4948;4658;-290
13304;08.07.2017;'08 - 09;34,58;36,44;-1,86;8964;8748;-216;5150;4463;-687
13305;08.07.2017;'09 - 10;36,71;39,02;-2,31;13409;12791;-618;5601;4834;-767
13306;08.07.2017;'10 - 11;35,89;38,54;-2,65;16984;16714;-270;6201;5793;-408
13307;08.07.2017;'11 - 12;35,37;35,92;-0,55;19349;19594;245;6768;6982;214
13308;08.07.2017;'12 - 13;33,22;33,38;-0,16;20529;20767;238;7265;7856;591
13309;08.07.2017;'13 - 14;31,41;28,61;2,8;20575;21217;642;7673;8337;664
13310;08.07.2017;'14 - 15;30,18;28,34;1,84;19627;20107;480;7914;8935;1021
13311;08.07.2017;'15 - 16;30,05;28,97;1,08;17771;17688;-83;7940;8737;797
13312;08.07.2017;'16 - 17;31,4;30,07;1,33;15134;14715;-419;7874;8241;367
13313;08.07.2017;'17 - 18;33,18;34,7;-1,52;11649;11483;-166;7421;7755;334
13314;08.07.2017;'18 - 19;36,98;36,59;0,39;7403;7212;-191;6495;6998;503
13315;08.07.2017;'19 - 20;40,04;37,21;2,83;3510;3475;-35;5547;6034;487
13316;08.07.2017;'20 - 21;39,63;35,75;3,88;1160;1040;-120;4757;4750;-7
13317;08.07.2017;'21 - 22;39,82;35,19;4,63;92;63;-29;4137;4129;-8
13318;08.07.2017;'22 - 23;42,09;38,83;3,26;0;0;0;3681;3838;157
13319;08.07.2017;'23 - 24;39,67;37,54;2,13;0;0;0;3306;3498;192
13320;09.07.2017;'00 - 01;32,21;30,68;1,53;0;0;0;3130;3178;48
13321;09.07.2017;'01 - 02;31,08;29,57;1,51;0;0;0;2888;3098;210
13322;09.07.2017;'02 - 03;29,84;28,72;1,12;0;0;0;2660;2759;99
13323;09.07.2017;'03 - 04;29,2;27,93;1,27;0;0;0;2366;2582;216
13324;09.07.2017;'04 - 05;29,62;28,79;0,83;0;0;0;2006;2456;450
13325;09.07.2017;'05 - 06;29,46;26,33;3,13;202;144;-58;1625;2137;512
13326;09.07.2017;'06 - 07;29,49;26,11;3,38;1477;1440;-37;1262;2030;768
13327;09.07.2017;'07 - 08;29,83;27,02;2,81;4666;4114;-552;930;1416;486
13328;09.07.2017;'08 - 09;30,03;28,45;1,58;9215;7905;-1310;695;1086;391
13329;09.07.2017;'09 - 10;31,26;31,26;0;13887;12014;-1873;598;1072;474
13330;09.07.2017;'10 - 11;31,26;30,83;0,43;17798;15466;-2332;551;968;417
13331;09.07.2017;'11 - 12;32,4;31,37;1,03;20654;18439;-2215;552;875;323
13332;09.07.2017;'12 - 13;32,07;31,43;0,64;22199;20692;-1507;595;875;280
13333;09.07.2017;'13 - 14;31;28,2;2,8;22273;22243;-30;633;870;237
13334;09.07.2017;'14 - 15;29,88;26,88;3;21064;21753;689;681;843;162
13335;09.07.2017;'15 - 16;30,69;24,86;5,83;18720;19594;874;736;791;55
13336;09.07.2017;'16 - 17;31,28;28;3,28;15298;15514;216;791;867;76
13337;09.07.2017;'17 - 18;33,8;29,19;4,61;10994;10972;-22;868;951;83
13338;09.07.2017;'18 - 19;36,75;32,75;4;6570;6260;-310;1037;1102;65
13339;09.07.2017;'19 - 20;40,53;38,22;2,31;3055;3062;7;1332;1393;61
13340;09.07.2017;'20 - 21;40,53;39,12;1,41;984;975;-9;1794;1842;48
13341;09.07.2017;'21 - 22;40,59;40,6;-0,01;80;64;-16;2469;2867;398
13342;09.07.2017;'22 - 23;42,28;41,79;0,49;0;0;0;3256;4128;872
13343;09.07.2017;'23 - 24;40,08;38,55;1,53;0;0;0;3731;5006;1275
13344;10.07.2017;'00 - 01;32,76;29,35;3,41;0;0;0;3706;5160;1454
13345;10.07.2017;'01 - 02;29,92;28,21;1,71;0;0;0;3622;5008;1386
13346;10.07.2017;'02 - 03;29,44;27,77;1,67;0;0;0;3508;4774;1266
13347;10.07.2017;'03 - 04;29,59;27,18;2,41;0;0;0;3406;4414;1008
13348;10.07.2017;'04 - 05;29,31;27,09;2,22;0;0;0;3386;3807;421
13349;10.07.2017;'05 - 06;30,6;28,04;2,56;145;109;-36;3311;3597;286
13350;10.07.2017;'06 - 07;38,03;37,16;0,87;1082;950;-132;3075;3420;345
13351;10.07.2017;'07 - 08;44,03;44,2;-0,17;3142;2690;-452;2754;2674;-80
13352;10.07.2017;'08 - 09;50,07;51,16;-1,09;5748;4638;-1110;2462;2058;-404
13353;10.07.2017;'09 - 10;50;57,11;-7,11;8402;6656;-1746;2321;1813;-508
13354;10.07.2017;'10 - 11;48,73;56,81;-8,08;10825;8990;-1835;2396;1920;-476
13355;10.07.2017;'11 - 12;48,72;55,74;-7,02;12832;11725;-1107;2646;2232;-414
13356;10.07.2017;'12 - 13;47,69;51,95;-4,26;14297;14612;315;3026;2640;-386
13357;10.07.2017;'13 - 14;46,65;48,81;-2,16;14990;16020;1030;3460;3115;-345
13358;10.07.2017;'14 - 15;44,18;46,04;-1,86;14998;16038;1040;3798;3613;-185
13359;10.07.2017;'15 - 16;42,93;43,18;-0,25;13933;14766;833;4023;4129;106
13360;10.07.2017;'16 - 17;40,65;42,95;-2,3;11755;12146;391;4182;4552;370
13361;10.07.2017;'17 - 18;40,95;43,35;-2,4;8905;8782;-123;4244;4506;262
13362;10.07.2017;'18 - 19;41,62;45,08;-3,46;5580;5362;-218;4155;4196;41
13363;10.07.2017;'19 - 20;42,97;48,13;-5,16;2617;2653;36;4198;3944;-254
13364;10.07.2017;'20 - 21;40,21;44,78;-4,57;794;831;37;4482;3613;-869
13365;10.07.2017;'21 - 22;38,86;42,42;-3,56;55;39;-16;5047;3546;-1501
13366;10.07.2017;'22 - 23;39,92;43,49;-3,57;0;0;0;5814;3596;-2218
13367;10.07.2017;'23 - 24;33,45;41,05;-7,6;0;0;0;6493;3879;-2614
13368;11.07.2017;'00 - 01;30,93;34,32;-3,39;0;0;0;4506;4732;226
13369;11.07.2017;'01 - 02;30,28;32,14;-1,86;0;0;0;4703;5112;409
13370;11.07.2017;'02 - 03;29,63;30,62;-0,99;0;0;0;4903;5612;709
13371;11.07.2017;'03 - 04;28,96;26,4;2,56;0;0;0;5039;6166;1127
13372;11.07.2017;'04 - 05;28,95;28,69;0,26;0;0;0;5214;6172;958
13373;11.07.2017;'05 - 06;30,08;30,54;-0,46;130;94;-36;5404;5962;558
13374;11.07.2017;'06 - 07;34,51;36,45;-1,94;1086;990;-96;5523;5876;353
13375;11.07.2017;'07 - 08;41,44;39,4;2,04;3235;3186;-49;5725;5414;-311
13376;11.07.2017;'08 - 09;44,22;41,77;2,45;6227;6253;26;6138;5399;-739
13377;11.07.2017;'09 - 10;43,43;40,95;2,48;9513;9866;353;6719;6156;-563
13378;11.07.2017;'10 - 11;42,03;41,08;0,95;12725;13228;503;7447;7450;3
13379;11.07.2017;'11 - 12;41,45;40,47;0,98;15634;16098;464;8309;9074;765
13380;11.07.2017;'12 - 13;39,42;37,24;2,18;17545;18198;653;9189;9902;713
13381;11.07.2017;'13 - 14;36,01;32,22;3,79;17934;18735;801;10078;10750;672
13382;11.07.2017;'14 - 15;34,21;29,82;4,39;17249;17682;433;10740;11359;619
13383;11.07.2017;'15 - 16;34,42;30,09;4,33;15488;15644;156;10934;11698;764
13384;11.07.2017;'16 - 17;35,39;32,09;3,3;12694;12572;-122;10854;11685;831
13385;11.07.2017;'17 - 18;37,62;35,82;1,8;9421;9680;259;10288;10749;461
13386;11.07.2017;'18 - 19;39,99;38,99;1;5931;6219;288;9176;8961;-215
13387;11.07.2017;'19 - 20;41,58;40,53;1,05;2899;3170;271;7868;6953;-915
13388;11.07.2017;'20 - 21;40,7;41,67;-0,97;884;938;54;6819;5350;-1469
13389;11.07.2017;'21 - 22;38,94;41,56;-2,62;60;37;-23;6229;4910;-1319
13390;11.07.2017;'22 - 23;39,36;41,55;-2,19;0;0;0;6092;4814;-1278
13391;11.07.2017;'23 - 24;34,25;36,89;-2,64;0;0;0;6148;4253;-1895
13392;12.07.2017;'00 - 01;32,29;30,63;1,66;0;0;0;4642;4032;-610
13393;12.07.2017;'01 - 02;30,14;29,98;0,16;0;0;0;4694;4122;-572
13394;12.07.2017;'02 - 03;29,1;28,32;0,78;0;0;0;4649;4046;-603
13395;12.07.2017;'03 - 04;28,52;27,81;0,71;0;0;0;4560;4142;-418
13396;12.07.2017;'04 - 05;28,43;29,05;-0,62;0;0;0;4541;4884;343
13397;12.07.2017;'05 - 06;29,3;28,09;1,21;124;101;-23;4633;5864;1231
13398;12.07.2017;'06 - 07;34,77;31,73;3,04;965;980;15;4923;6450;1527
13399;12.07.2017;'07 - 08;39,94;41,38;-1,44;2696;2693;-3;5416;6733;1317
13400;12.07.2017;'08 - 09;44,01;44,13;-0,12;4861;4470;-391;6025;7109;1084
13401;12.07.2017;'09 - 10;44,31;44,65;-0,34;7019;6368;-651;6980;8551;1571
13402;12.07.2017;'10 - 11;44,16;43,3;0,86;8697;7688;-1009;8222;9715;1493
13403;12.07.2017;'11 - 12;43,9;43,13;0,77;9735;8200;-1535;9534;10717;1183
13404;12.07.2017;'12 - 13;41,07;42,71;-1,64;10139;8674;-1465;11048;12678;1630
13405;12.07.2017;'13 - 14;39,9;40,76;-0,86;9937;9011;-926;12709;14388;1679
13406;12.07.2017;'14 - 15;37,27;39,55;-2,28;9284;8716;-568;14241;16346;2105
13407;12.07.2017;'15 - 16;33,93;36,89;-2,96;8481;8675;194;15696;18321;2625
13408;12.07.2017;'16 - 17;32,19;33,21;-1,02;7533;8818;1285;17369;20409;3040
13409;12.07.2017;'17 - 18;33,29;30,74;2,55;6234;7519;1285;18686;21493;2807
13410;12.07.2017;'18 - 19;32,95;29,96;2,99;4397;5345;948;19865;22470;2605
13411;12.07.2017;'19 - 20;32,91;31,22;1,69;2272;2610;338;21100;23288;2188
13412;12.07.2017;'20 - 21;30,5;30,46;0,04;712;745;33;21727;24000;2273
13413;12.07.2017;'21 - 22;30,6;30,85;-0,25;51;45;-6;21739;23825;2086
13414;12.07.2017;'22 - 23;30,09;29,25;0,84;0;0;0;21604;22930;1326
13415;12.07.2017;'23 - 24;27,82;27,71;0,11;0;0;0;21338;22811;1473
13416;13.07.2017;'00 - 01;26,02;26,18;-0,16;0;0;0;20305;22048;1743
13417;13.07.2017;'01 - 02;24,37;22,91;1,46;0;0;0;19374;20455;1081
13418;13.07.2017;'02 - 03;23,04;22,06;0,98;0;0;0;18377;18320;-57
13419;13.07.2017;'03 - 04;24,76;20,92;3,84;0;0;0;17227;16644;-583
13420;13.07.2017;'04 - 05;26,45;22,36;4,09;0;0;0;16104;14974;-1130
13421;13.07.2017;'05 - 06;28,09;27,17;0,92;156;117;-39;15081;13550;-1531
13422;13.07.2017;'06 - 07;31,06;34,16;-3,1;1361;1429;68;14148;12485;-1663
13423;13.07.2017;'07 - 08;38,12;42,47;-4,35;4386;4629;243;13319;10920;-2399
13424;13.07.2017;'08 - 09;36,73;42,43;-5,7;8806;9370;564;12707;10398;-2309
13425;13.07.2017;'09 - 10;36,07;39,38;-3,31;13493;13661;168;12125;10501;-1624
13426;13.07.2017;'10 - 11;35,52;37,19;-1,67;17742;16834;-908;11301;10148;-1153
13427;13.07.2017;'11 - 12;34,96;39,22;-4,26;21087;19410;-1677;10380;9134;-1246
13428;13.07.2017;'12 - 13;30,26;37,06;-6,8;23214;21436;-1778;9515;8388;-1127
13429;13.07.2017;'13 - 14;30,04;36,07;-6,03;24095;22562;-1533;8777;7933;-844
13430;13.07.2017;'14 - 15;29,07;32,78;-3,71;23799;22656;-1143;8149;7355;-794
13431;13.07.2017;'15 - 16;30,27;32,87;-2,6;22074;21476;-598;7488;6561;-927
13432;13.07.2017;'16 - 17;33,46;33,53;-0,07;18747;18521;-226;6793;5776;-1017
13433;13.07.2017;'17 - 18;38,08;39,74;-1,66;14055;14233;178;5953;4853;-1100
13434;13.07.2017;'18 - 19;41,35;42,16;-0,81;8478;8890;412;5003;3844;-1159
13435;13.07.2017;'19 - 20;46,82;43,58;3,24;3644;3984;340;4073;2606;-1467
13436;13.07.2017;'20 - 21;45,09;42,91;2,18;1084;1148;64;3389;1794;-1595
13437;13.07.2017;'21 - 22;42,93;42,89;0,04;74;52;-22;3034;1530;-1504
13438;13.07.2017;'22 - 23;42,13;43,18;-1,05;0;0;0;2887;1512;-1375
13439;13.07.2017;'23 - 24;38,12;40,31;-2,19;0;0;0;2791;1538;-1253
13440;14.07.2017;'00 - 01;34,4;33,94;0,46;0;0;0;2236;1508;-728
13441;14.07.2017;'01 - 02;32,34;32,01;0,33;0;0;0;2112;1535;-577
13442;14.07.2017;'02 - 03;30,36;30,63;-0,27;0;0;0;2134;1495;-639
13443;14.07.2017;'03 - 04;29,08;30,72;-1,64;0;0;0;2292;1518;-774
13444;14.07.2017;'04 - 05;29,55;30,87;-1,32;0;0;0;2522;1773;-749
13445;14.07.2017;'05 - 06;30,41;31,19;-0,78;150;129;-21;2741;2192;-549
13446;14.07.2017;'06 - 07;39,94;36,62;3,32;1196;1192;-4;2905;2478;-427
13447;14.07.2017;'07 - 08;44,99;41,05;3,94;3737;3718;-19;2974;2509;-465
13448;14.07.2017;'08 - 09;46;41,54;4,46;7438;7482;44;2999;2182;-817
13449;14.07.2017;'09 - 10;43,32;40,05;3,27;11471;12067;596;3119;1934;-1185
13450;14.07.2017;'10 - 11;41,62;38,54;3,08;14884;16169;1285;3436;2046;-1390
13451;14.07.2017;'11 - 12;38,94;37,06;1,88;17304;17791;487;3900;2030;-1870
13452;14.07.2017;'12 - 13;37,1;38,59;-1,49;18565;17316;-1249;4355;2606;-1749
13453;14.07.2017;'13 - 14;35,97;37,24;-1,27;18581;16548;-2033;4868;3246;-1622
13454;14.07.2017;'14 - 15;31,91;33,66;-1,75;17572;15098;-2474;5417;3892;-1525
13455;14.07.2017;'15 - 16;30,34;34,62;-4,28;15719;13292;-2427;6033;4188;-1845
13456;14.07.2017;'16 - 17;31,29;36,21;-4,92;13247;11531;-1716;6709;4783;-1926
13457;14.07.2017;'17 - 18;36,92;39,03;-2,11;10126;8530;-1596;7181;5673;-1508
13458;14.07.2017;'18 - 19;40,93;41,34;-0,41;6387;5234;-1153;7492;5591;-1901
13459;14.07.2017;'19 - 20;42,96;41,83;1,13;3005;2545;-460;7958;4664;-3294
13460;14.07.2017;'20 - 21;39,69;41,07;-1,38;911;798;-113;8398;4322;-4076
13461;14.07.2017;'21 - 22;39,1;39,94;-0,84;56;38;-18;8546;4304;-4242
13462;14.07.2017;'22 - 23;39,71;40,26;-0,55;0;0;0;8838;5172;-3666
13463;14.07.2017;'23 - 24;36,65;38,06;-1,41;0;0;0;9225;5726;-3499
13464;15.07.2017;'00 - 01;34,57;32,3;2,27;0;0;0;5541;5835;294
13465;15.07.2017;'01 - 02;31,08;29,75;1,33;0;0;0;5718;5570;-148
13466;15.07.2017;'02 - 03;30,82;27,82;3;0;0;0;5892;5461;-431
13467;15.07.2017;'03 - 04;30,01;26,11;3,9;0;0;0;5881;5616;-265
13468;15.07.2017;'04 - 05;29,4;25,44;3,96;0;0;0;5899;5418;-481
13469;15.07.2017;'05 - 06;29,17;24,27;4,9;124;94;-30;5807;5116;-691
13470;15.07.2017;'06 - 07;30,46;28;2,46;1112;1154;42;5541;4532;-1009
13471;15.07.2017;'07 - 08;30,82;28,52;2,3;3635;3858;223;5153;3666;-1487
13472;15.07.2017;'08 - 09;31,94;29;2,94;7285;7793;508;4634;3067;-1567
13473;15.07.2017;'09 - 10;33,81;36,57;-2,76;11237;11669;432;4067;2738;-1329
13474;15.07.2017;'10 - 11;33,43;35,39;-1,96;14634;14644;10;3548;2480;-1068
13475;15.07.2017;'11 - 12;33,06;35,45;-2,39;17209;16244;-965;3239;2317;-922
13476;15.07.2017;'12 - 13;32,22;36,46;-4,24;18729;16786;-1943;3163;2428;-735
13477;15.07.2017;'13 - 14;30,76;34,5;-3,74;18995;16762;-2233;3237;2750;-487
13478;15.07.2017;'14 - 15;29,07;31,05;-1,98;18251;16672;-1579;3447;3216;-231
13479;15.07.2017;'15 - 16;28,64;29,86;-1,22;16458;15363;-1095;3626;3564;-62
13480;15.07.2017;'16 - 17;29,04;27,56;1,48;13728;12900;-828;3761;3678;-83
13481;15.07.2017;'17 - 18;30,98;30,26;0,72;10253;9983;-270;3654;3454;-200
13482;15.07.2017;'18 - 19;35,21;35,08;0,13;6380;6619;239;3225;2896;-329
13483;15.07.2017;'19 - 20;37,54;36,2;1,34;2990;3245;255;2741;2286;-455
13484;15.07.2017;'20 - 21;37;35,54;1,46;885;907;22;2371;1985;-386
13485;15.07.2017;'21 - 22;36,9;36,12;0,78;54;39;-15;2252;1824;-428
13486;15.07.2017;'22 - 23;37,98;35,95;2,03;0;0;0;2348;2130;-218
13487;15.07.2017;'23 - 24;36,01;32,99;3,02;0;0;0;2633;2856;223
13488;16.07.2017;'00 - 01;34,65;30,08;4,57;0;0;0;2825;3655;830
13489;16.07.2017;'01 - 02;30,05;27,48;2,57;0;0;0;3722;4621;899
13490;16.07.2017;'02 - 03;28,68;25,85;2,83;0;0;0;4693;5496;803
13491;16.07.2017;'03 - 04;27,78;23,65;4,13;0;0;0;5413;6330;917
13492;16.07.2017;'04 - 05;27,72;22,68;5,04;0;0;0;5947;6825;878
13493;16.07.2017;'05 - 06;27,4;19,82;7,58;141;104;-37;6306;6876;570
13494;16.07.2017;'06 - 07;27,53;20,09;7,44;1198;1253;55;6505;7228;723
13495;16.07.2017;'07 - 08;27,6;19,37;8,23;3542;4120;578;6681;7270;589
13496;16.07.2017;'08 - 09;27,4;20,79;6,61;6597;8192;1595;6812;7274;462
13497;16.07.2017;'09 - 10;28,49;22,77;5,72;9595;12143;2548;6940;7384;444
13498;16.07.2017;'10 - 11;28,99;21,91;7,08;11889;14968;3079;7178;7623;445
13499;16.07.2017;'11 - 12;28,99;21,16;7,83;13399;16460;3061;7479;7987;508
13500;16.07.2017;'12 - 13;29,76;19,41;10,35;14143;17220;3077;7718;8347;629
13501;16.07.2017;'13 - 14;26,95;17,19;9,76;14146;17339;3193;7903;8681;778
13502;16.07.2017;'14 - 15;25,99;14,99;11;13518;16473;2955;7943;8368;425
13503;16.07.2017;'15 - 16;25,22;16,15;9,07;12227;14589;2362;7732;8294;562
13504;16.07.2017;'16 - 17;27,55;22,13;5,42;10249;11992;1743;7469;8463;994
13505;16.07.2017;'17 - 18;28,57;26,85;1,72;7727;8916;1189;7069;7634;565
13506;16.07.2017;'18 - 19;31,79;32,31;-0,52;4846;5479;633;6577;6602;25
13507;16.07.2017;'19 - 20;35,41;35,6;-0,19;2256;2540;284;6139;5873;-266
13508;16.07.2017;'20 - 21;36,65;36,73;-0,08;640;672;32;5799;5112;-687
13509;16.07.2017;'21 - 22;37,14;38,05;-0,91;36;20;-16;5556;4592;-964
13510;16.07.2017;'22 - 23;41,02;40,58;0,44;0;0;0;5414;4586;-828
13511;16.07.2017;'23 - 24;38,79;38,25;0,54;0;0;0;5295;4794;-501
13512;17.07.2017;'00 - 01;31,47;36,1;-4,63;0;0;0;5589;4608;-981
13513;17.07.2017;'01 - 02;30,11;35,28;-5,17;0;0;0;5457;4666;-791
13514;17.07.2017;'02 - 03;29,32;32,86;-3,54;0;0;0;5420;4625;-795
13515;17.07.2017;'03 - 04;27,57;32,41;-4,84;0;0;0;5310;4826;-484
13516;17.07.2017;'04 - 05;27,92;32,36;-4,44;0;0;0;5141;4656;-485
13517;17.07.2017;'05 - 06;29,21;34,14;-4,93;101;73;-28;4858;4377;-481
13518;17.07.2017;'06 - 07;36,89;41,53;-4,64;1019;1076;57;4455;3996;-459
13519;17.07.2017;'07 - 08;42,83;45,8;-2,97;3456;3743;287;4062;3150;-912
13520;17.07.2017;'08 - 09;42,97;46,84;-3,87;7082;7887;805;3897;2748;-1149
13521;17.07.2017;'09 - 10;42,3;42,99;-0,69;11103;12407;1304;4010;3178;-832
13522;17.07.2017;'10 - 11;42,4;41,58;0,82;14669;16143;1474;4310;3357;-953
13523;17.07.2017;'11 - 12;42,74;40,95;1,79;17457;18537;1080;4635;3632;-1003
13524;17.07.2017;'12 - 13;40,85;38,83;2,02;19314;19848;534;4905;4233;-672
13525;17.07.2017;'13 - 14;36,95;37,39;-0,44;19967;20179;212;5144;4790;-354
13526;17.07.2017;'14 - 15;35,98;35;0,98;19405;19452;47;5352;5177;-175
13527;17.07.2017;'15 - 16;35,3;33,57;1,73;17732;17913;181;5433;5488;55
13528;17.07.2017;'16 - 17;35,94;34,6;1,34;15044;15596;552;5445;5657;212
13529;17.07.2017;'17 - 18;39,94;41,55;-1,61;11368;12135;767;5304;5221;-83
13530;17.07.2017;'18 - 19;42,05;45,5;-3,45;7016;7808;792;4962;4398;-564
13531;17.07.2017;'19 - 20;44,95;46,93;-1,98;3190;3723;533;4511;3890;-621
13532;17.07.2017;'20 - 21;43,79;46,83;-3,04;941;993;52;4089;3202;-887
13533;17.07.2017;'21 - 22;40,98;45,88;-4,9;55;38;-17;3879;3148;-731
13534;17.07.2017;'22 - 23;40,95;45,27;-4,32;0;0;0;3847;3652;-195
13535;17.07.2017;'23 - 24;35,4;38,93;-3,53;0;0;0;3768;3817;49
13536;18.07.2017;'00 - 01;33,69;35,77;-2,08;0;0;0;3417;3712;295
13537;18.07.2017;'01 - 02;31,18;32,92;-1,74;0;0;0;3360;3610;250
13538;18.07.2017;'02 - 03;29,85;30,56;-0,71;0;0;0;3380;3481;101
13539;18.07.2017;'03 - 04;29,56;29,54;0,02;0;0;0;3312;3297;-15
13540;18.07.2017;'04 - 05;30,28;30,01;0,27;0;0;0;3137;2924;-213
13541;18.07.2017;'05 - 06;32,01;30,96;1,05;141;93;-48;2841;2667;-174
13542;18.07.2017;'06 - 07;37,72;39,68;-1,96;1363;1362;-1;2403;2465;62
13543;18.07.2017;'07 - 08;40,91;43,77;-2,86;4985;4914;-71;1818;1903;85
13544;18.07.2017;'08 - 09;42,88;42,85;0,03;10493;10228;-265;1321;1031;-290
13545;18.07.2017;'09 - 10;42,43;41,35;1,08;16188;15769;-419;1149;771;-378
13546;18.07.2017;'10 - 11;41,75;41,34;0,41;20783;20214;-569;1156;842;-314
13547;18.07.2017;'11 - 12;38,92;41,1;-2,18;23842;23242;-600;1239;1050;-189
13548;18.07.2017;'12 - 13;34,17;34,69;-0,52;25459;24722;-737;1345;1052;-293
13549;18.07.2017;'13 - 14;34,12;34,22;-0,1;25645;24876;-769;1402;1032;-370
13550;18.07.2017;'14 - 15;33,69;34,33;-0,64;24381;23836;-545;1483;1107;-376
13551;18.07.2017;'15 - 16;34,62;35,64;-1,02;21860;21750;-110;1577;1212;-365
13552;18.07.2017;'16 - 17;38,57;38,67;-0,1;18243;18402;159;1708;1346;-362
13553;18.07.2017;'17 - 18;42,97;41,15;1,82;13403;13696;293;1985;1617;-368
13554;18.07.2017;'18 - 19;45,79;43,46;2,33;7939;8416;477;2449;2034;-415
13555;18.07.2017;'19 - 20;46,89;46,17;0,72;3433;3762;329;3091;2516;-575
13556;18.07.2017;'20 - 21;43,97;44,94;-0,97;1003;993;-10;3983;3329;-654
13557;18.07.2017;'21 - 22;42,99;44,85;-1,86;58;38;-20;5294;5682;388
13558;18.07.2017;'22 - 23;40,83;41,94;-1,11;0;0;0;6617;8196;1579
13559;18.07.2017;'23 - 24;33,95;30,26;3,69;0;0;0;7376;9700;2324
13560;19.07.2017;'00 - 01;30,93;30,26;0,67;0;0;0;7508;10107;2599
13561;19.07.2017;'01 - 02;29,59;27,99;1,6;0;0;0;7600;10028;2428
13562;19.07.2017;'02 - 03;28,62;27,94;0,68;0;0;0;7639;10132;2493
13563;19.07.2017;'03 - 04;27,3;28,07;-0,77;0;0;0;7672;10023;2351
13564;19.07.2017;'04 - 05;27,63;28,17;-0,54;0;0;0;7630;9684;2054
13565;19.07.2017;'05 - 06;29,03;29,66;-0,63;126;83;-43;7512;9534;2022
13566;19.07.2017;'06 - 07;37,96;38,82;-0,86;1277;1308;31;7222;8897;1675
13567;19.07.2017;'07 - 08;42,16;43,15;-0,99;4919;4840;-79;6588;7351;763
13568;19.07.2017;'08 - 09;42,91;44,65;-1,74;10563;10227;-336;5936;5944;8
13569;19.07.2017;'09 - 10;40,08;44,28;-4,2;16325;15876;-449;5736;5760;24
13570;19.07.2017;'10 - 11;37,93;42,05;-4,12;21057;20695;-362;5817;6197;380
13571;19.07.2017;'11 - 12;34,55;41,25;-6,7;24269;24065;-204;6086;7409;1323
13572;19.07.2017;'12 - 13;31,7;33,09;-1,39;25667;25677;10;6707;8904;2197
13573;19.07.2017;'13 - 14;31,71;30,59;1,12;25419;25576;157;7342;9026;1684
13574;19.07.2017;'14 - 15;32,9;28,23;4,67;23824;23953;129;7691;9241;1550
13575;19.07.2017;'15 - 16;36,54;30,69;5,85;21036;20922;-114;7653;9401;1748
13576;19.07.2017;'16 - 17;38,03;32,54;5,49;17419;16790;-629;7558;9596;2038
13577;19.07.2017;'17 - 18;40,52;39,89;0,63;12709;11854;-855;7741;9712;1971
13578;19.07.2017;'18 - 19;42,97;43,68;-0,71;7432;6699;-733;8374;10148;1774
13579;19.07.2017;'19 - 20;44;44,35;-0,35;3189;2882;-307;9354;10854;1500
13580;19.07.2017;'20 - 21;42,16;41,82;0,34;897;760;-137;10279;12163;1884
13581;19.07.2017;'21 - 22;40,58;39,8;0,78;47;31;-16;11029;13788;2759
13582;19.07.2017;'22 - 23;39,09;38,86;0,23;0;0;0;11480;14425;2945
13583;19.07.2017;'23 - 24;32,97;32,98;-0,01;0;0;0;11155;13675;2520
13584;20.07.2017;'00 - 01;30,54;30,29;0,25;0;0;0;11118;12077;959
13585;20.07.2017;'01 - 02;31,46;31,62;-0,16;0;0;0;10191;10066;-125
13586;20.07.2017;'02 - 03;29,6;31,43;-1,83;0;0;0;9259;8801;-458
13587;20.07.2017;'03 - 04;28,1;29,6;-1,5;0;0;0;8499;8180;-319
13588;20.07.2017;'04 - 05;28,52;29,35;-0,83;0;0;0;7884;8095;211
13589;20.07.2017;'05 - 06;30,32;29,52;0,8;91;60;-31;7329;7303;-26
13590;20.07.2017;'06 - 07;38,27;34,75;3,52;975;920;-55;6826;6468;-358
13591;20.07.2017;'07 - 08;47,26;41,67;5,59;3294;3013;-281;6302;5643;-659
13592;20.07.2017;'08 - 09;43,26;43,03;0,23;6444;6482;38;5850;5405;-445
13593;20.07.2017;'09 - 10;43,25;43,58;-0,33;9629;10187;558;5642;4709;-933
13594;20.07.2017;'10 - 11;41,73;42,55;-0,82;12305;12593;288;5655;4498;-1157
13595;20.07.2017;'11 - 12;41,93;42,41;-0,48;14337;14338;1;5900;5020;-880
13596;20.07.2017;'12 - 13;40;40,33;-0,33;15602;15342;-260;6211;5374;-837
13597;20.07.2017;'13 - 14;38,36;40,36;-2;16099;14808;-1291;6535;5539;-996
13598;20.07.2017;'14 - 15;36,9;41,76;-4,86;15930;13855;-2075;6808;6014;-794
13599;20.07.2017;'15 - 16;35,74;39,5;-3,76;14795;12783;-2012;6910;6310;-600
13600;20.07.2017;'16 - 17;34,48;37,2;-2,72;12623;11084;-1539;6739;6644;-95
13601;20.07.2017;'17 - 18;36,97;38,82;-1,85;9637;8915;-722;6347;7154;807
13602;20.07.2017;'18 - 19;39,77;38,64;1,13;6077;5855;-222;5754;7408;1654
13603;20.07.2017;'19 - 20;41,93;38,23;3,7;2858;2931;73;5156;7120;1964
13604;20.07.2017;'20 - 21;41,05;38,29;2,76;808;767;-41;5007;5930;923
13605;20.07.2017;'21 - 22;40,11;36,58;3,53;39;21;-18;5307;6192;885
13606;20.07.2017;'22 - 23;39,74;35,98;3,76;0;0;0;6073;7444;1371
13607;20.07.2017;'23 - 24;34,29;28,26;6,03;0;0;0;6684;9176;2492
13608;21.07.2017;'00 - 01;29,65;28,29;1,36;0;0;0;9575;9623;48
13609;21.07.2017;'01 - 02;29,1;27,97;1,13;0;0;0;10015;9648;-367
13610;21.07.2017;'02 - 03;28,42;27,02;1,4;0;0;0;10028;8877;-1151
13611;21.07.2017;'03 - 04;27,07;26,18;0,89;0;0;0;9307;8125;-1182
13612;21.07.2017;'04 - 05;27,32;26,03;1,29;0;0;0;8106;7585;-521
13613;21.07.2017;'05 - 06;29,99;28,67;1,32;100;66;-34;6760;6438;-322
13614;21.07.2017;'06 - 07;36,8;35,03;1,77;1162;1213;51;5345;5308;-37
13615;21.07.2017;'07 - 08;40,06;37,54;2,52;4203;4497;294;4160;3948;-212
13616;21.07.2017;'08 - 09;41,83;37,92;3,91;8906;9394;488;3274;3014;-260
13617;21.07.2017;'09 - 10;40,87;33,4;7,47;13917;14592;675;2758;2400;-358
13618;21.07.2017;'10 - 11;38,44;35,57;2,87;18094;19340;1246;2461;1989;-472
13619;21.07.2017;'11 - 12;39,04;35,98;3,06;21021;22382;1361;2153;1772;-381
13620;21.07.2017;'12 - 13;35,98;33,44;2,54;22689;23805;1116;1914;1520;-394
13621;21.07.2017;'13 - 14;32,94;32,2;0,74;23064;23836;772;1672;1366;-306
13622;21.07.2017;'14 - 15;32,87;32,29;0,58;22155;22708;553;1453;1226;-227
13623;21.07.2017;'15 - 16;32,9;32,32;0,58;19980;20360;380;1278;1150;-128
13624;21.07.2017;'16 - 17;35,11;34,25;0,86;16594;17037;443;1148;1201;53
13625;21.07.2017;'17 - 18;39,01;35,36;3,65;12135;12828;693;1153;1396;243
13626;21.07.2017;'18 - 19;41,42;36,99;4,43;7241;7928;687;1368;1682;314
13627;21.07.2017;'19 - 20;42,63;38,12;4,51;3169;3452;283;1840;2195;355
13628;21.07.2017;'20 - 21;42,01;38,08;3,93;879;804;-75;2757;3130;373
13629;21.07.2017;'21 - 22;40,57;36,55;4,02;42;22;-20;4269;4932;663
13630;21.07.2017;'22 - 23;41,38;36,5;4,88;0;0;0;5881;7274;1393
13631;21.07.2017;'23 - 24;36,79;31,99;4,8;0;0;0;7073;10176;3103
13632;22.07.2017;'00 - 01;32,2;27,54;4,66;0;0;0;7276;11865;4589
13633;22.07.2017;'01 - 02;31,57;24,6;6,97;0;0;0;7535;12030;4495
13634;22.07.2017;'02 - 03;29,92;24,65;5,27;0;0;0;7654;10780;3126
13635;22.07.2017;'03 - 04;28,74;25,33;3,41;0;0;0;7508;10182;2674
13636;22.07.2017;'04 - 05;28,75;26,17;2,58;0;0;0;7284;9659;2375
13637;22.07.2017;'05 - 06;28,54;24,96;3,58;82;60;-22;7035;9201;2166
13638;22.07.2017;'06 - 07;29,7;27,44;2,26;953;921;-32;6625;8080;1455
13639;22.07.2017;'07 - 08;30,92;28,41;2,51;3451;3073;-378;5941;6350;409
13640;22.07.2017;'08 - 09;34,96;34,68;0,28;7122;6135;-987;5318;5132;-186
13641;22.07.2017;'09 - 10;36,47;36,41;0,06;11101;10361;-740;5050;4408;-642
13642;22.07.2017;'10 - 11;35,69;35,54;0,15;14673;14397;-276;4896;4281;-615
13643;22.07.2017;'11 - 12;34,66;35,82;-1,16;17541;17566;25;4905;4226;-679
13644;22.07.2017;'12 - 13;32,25;34,85;-2,6;19247;19150;-97;4992;4502;-490
13645;22.07.2017;'13 - 14;30,02;30,86;-0,84;19518;19547;29;5102;4882;-220
13646;22.07.2017;'14 - 15;29,48;31,57;-2,09;18803;18844;41;5132;5666;534
13647;22.07.2017;'15 - 16;29,9;29,92;-0,02;17079;16886;-193;5003;6376;1373
13648;22.07.2017;'16 - 17;30,55;27,91;2,64;14424;13818;-606;4931;6419;1488
13649;22.07.2017;'17 - 18;33,25;30,86;2,39;10806;10314;-492;4971;6408;1437
13650;22.07.2017;'18 - 19;38,52;35,8;2,72;6601;6458;-143;5157;6518;1361
13651;22.07.2017;'19 - 20;39,89;36,48;3,41;2954;2970;16;5540;6621;1081
13652;22.07.2017;'20 - 21;39;35,32;3,68;802;726;-76;5995;6595;600
13653;22.07.2017;'21 - 22;38,09;35,73;2,36;35;16;-19;6573;6394;-179
13654;22.07.2017;'22 - 23;40;35,77;4,23;0;0;0;7123;7365;242
13655;22.07.2017;'23 - 24;36,67;34,61;2,06;0;0;0;7400;8401;1001
13656;23.07.2017;'00 - 01;32,99;26,99;6;0;0;0;5768;8806;3038
13657;23.07.2017;'01 - 02;28,78;23,49;5,29;0;0;0;6012;8764;2752
13658;23.07.2017;'02 - 03;26,69;20,43;6,26;0;0;0;6271;8453;2182
13659;23.07.2017;'03 - 04;24,68;16,95;7,73;0;0;0;6430;8328;1898
13660;23.07.2017;'04 - 05;23,07;16,78;6,29;0;0;0;6659;8004;1345
13661;23.07.2017;'05 - 06;23,96;17,47;6,49;65;42;-23;6675;7790;1115
13662;23.07.2017;'06 - 07;23,9;15,23;8,67;857;684;-173;6559;7578;1019
13663;23.07.2017;'07 - 08;25,17;15,12;10,05;3116;2581;-535;6735;7389;654
13664;23.07.2017;'08 - 09;25,78;19,87;5,91;6364;5374;-990;7240;8680;1440
13665;23.07.2017;'09 - 10;26,67;18,8;7,87;9782;8487;-1295;7868;10104;2236
13666;23.07.2017;'10 - 11;26,87;16,83;10,04;12853;11800;-1053;8694;12042;3348
13667;23.07.2017;'11 - 12;27,18;16,37;10,81;15441;14144;-1297;9598;13445;3847
13668;23.07.2017;'12 - 13;27,89;13,91;13,98;17211;15838;-1373;10470;14514;4044
13669;23.07.2017;'13 - 14;26,3;13,47;12,83;17904;16602;-1302;11325;15189;3864
13670;23.07.2017;'14 - 15;22,76;11,34;11,42;17665;16254;-1411;11846;14800;2954
13671;23.07.2017;'15 - 16;20,34;12,32;8,02;16411;15428;-983;11744;14153;2409
13672;23.07.2017;'16 - 17;23,07;12,76;10,31;13941;13659;-282;11260;12699;1439
13673;23.07.2017;'17 - 18;27,05;19,11;7,94;10478;10461;-17;10149;11235;1086
13674;23.07.2017;'18 - 19;29,62;21,3;8,32;6435;6378;-57;8430;8914;484
13675;23.07.2017;'19 - 20;37,05;32,22;4,83;2895;2928;33;6670;6180;-490
13676;23.07.2017;'20 - 21;38,51;35,61;2,9;788;666;-122;5320;3970;-1350
13677;23.07.2017;'21 - 22;39,42;37,52;1,9;30;13;-17;4651;3086;-1565
13678;23.07.2017;'22 - 23;42,85;45,11;-2,26;0;0;0;4472;3104;-1368
13679;23.07.2017;'23 - 24;39,82;38,76;1,06;0;0;0;4439;2981;-1458
13680;24.07.2017;'00 - 01;39,65;33,88;5,77;0;0;0;3422;2749;-673
13681;24.07.2017;'01 - 02;35,62;29,82;5,8;0;0;0;3324;2415;-909
13682;24.07.2017;'02 - 03;32,7;28,52;4,18;0;0;0;3228;2120;-1108
13683;24.07.2017;'03 - 04;31,28;27,81;3,47;0;0;0;2891;1502;-1389
13684;24.07.2017;'04 - 05;30,46;27,78;2,68;0;0;0;2497;996;-1501
13685;24.07.2017;'05 - 06;33,24;29,01;4,23;70;47;-23;2186;1097;-1089
13686;24.07.2017;'06 - 07;41,9;37,64;4,26;805;765;-40;1987;1203;-784
13687;24.07.2017;'07 - 08;44,18;42,94;1,24;2756;2671;-85;1831;1360;-471
13688;24.07.2017;'08 - 09;44,12;51,61;-7,49;5408;5109;-299;1756;1406;-350
13689;24.07.2017;'09 - 10;48,23;53,99;-5,76;7999;7363;-636;1873;1664;-209
13690;24.07.2017;'10 - 11;48,45;54,45;-6;9871;9271;-600;2162;1909;-253
13691;24.07.2017;'11 - 12;47,77;53,52;-5,75;10958;10358;-600;2418;2256;-162
13692;24.07.2017;'12 - 13;46,47;49,33;-2,86;11405;10652;-753;2570;2874;304
13693;24.07.2017;'13 - 14;44,91;45,51;-0,6;11197;10204;-993;2673;3544;871
13694;24.07.2017;'14 - 15;42,29;42,92;-0,63;10524;9948;-576;2742;3959;1217
13695;24.07.2017;'15 - 16;40,94;39,3;1,64;9321;8988;-333;2956;4198;1242
13696;24.07.2017;'16 - 17;39,2;37,05;2,15;7583;7737;154;3286;4285;999
13697;24.07.2017;'17 - 18;39,7;36,34;3,36;5577;6118;541;3686;4468;782
13698;24.07.2017;'18 - 19;38,18;37,43;0,75;3487;4062;575;4123;4730;607
13699;24.07.2017;'19 - 20;38,66;37;1,66;1636;1908;272;4490;4982;492
13700;24.07.2017;'20 - 21;36,43;36,09;0,34;442;481;39;4813;5202;389
13701;24.07.2017;'21 - 22;34,73;35,87;-1,14;15;12;-3;5068;5776;708
13702;24.07.2017;'22 - 23;34,59;35,28;-0,69;0;0;0;5246;6124;878
13703;24.07.2017;'23 - 24;30,39;28,8;1,59;0;0;0;5337;6377;1040
13704;25.07.2017;'00 - 01;31,01;28,98;2,03;0;0;0;5697;6687;990
13705;25.07.2017;'01 - 02;28,96;25,05;3,91;0;0;0;5814;7101;1287
13706;25.07.2017;'02 - 03;27,09;23,64;3,45;0;0;0;6102;7436;1334
13707;25.07.2017;'03 - 04;27,47;22,61;4,86;0;0;0;6357;7808;1451
13708;25.07.2017;'04 - 05;26,04;22,26;3,78;0;0;0;6682;8171;1489
13709;25.07.2017;'05 - 06;26,21;24,6;1,61;29;15;-14;7082;8733;1651
13710;25.07.2017;'06 - 07;31,63;28,74;2,89;448;374;-74;7452;9335;1883
13711;25.07.2017;'07 - 08;37,96;34,03;3,93;1731;1414;-317;7750;9948;2198
13712;25.07.2017;'08 - 09;39,48;35,1;4,38;3543;2856;-687;8067;10246;2179
13713;25.07.2017;'09 - 10;40,06;35,93;4,13;5456;4663;-793;8354;10157;1803
13714;25.07.2017;'10 - 11;40,37;36,83;3,54;7123;6290;-833;8628;10455;1827
13715;25.07.2017;'11 - 12;40,8;37,96;2,84;8346;8207;-139;8817;10632;1815
13716;25.07.2017;'12 - 13;39,75;34,69;5,06;9091;9192;101;8961;11589;2628
13717;25.07.2017;'13 - 14;38,94;31,7;7,24;9077;9202;125;9017;12550;3533
13718;25.07.2017;'14 - 15;36,98;30,18;6,8;8575;8444;-131;9203;12888;3685
13719;25.07.2017;'15 - 16;36,43;29,77;6,66;7661;7212;-449;9388;14009;4621
13720;25.07.2017;'16 - 17;34,97;29,61;5,36;6128;6004;-124;9656;14390;4734
13721;25.07.2017;'17 - 18;34,99;28,8;6,19;4409;4333;-76;9763;15074;5311
13722;25.07.2017;'18 - 19;36,95;29,15;7,8;2690;2562;-128;9617;15243;5626
13723;25.07.2017;'19 - 20;35,4;31,04;4,36;1183;1070;-113;9450;15251;5801
13724;25.07.2017;'20 - 21;33,78;28,96;4,82;283;201;-82;9415;15102;5687
13725;25.07.2017;'21 - 22;32,96;26,58;6,38;9;2;-7;9502;14755;5253
13726;25.07.2017;'22 - 23;32,21;26,99;5,22;0;0;0;9676;14387;4711
13727;25.07.2017;'23 - 24;29,01;25,44;3,57;0;0;0;9810;14117;4307
13728;26.07.2017;'00 - 01;25,74;28,41;-2,67;0;0;0;14306;13836;-470
13729;26.07.2017;'01 - 02;25,24;28,37;-3,13;0;0;0;14494;13508;-986
13730;26.07.2017;'02 - 03;22,64;26,72;-4,08;0;0;0;14682;13307;-1375
13731;26.07.2017;'03 - 04;21,12;27,42;-6,3;0;0;0;14582;13295;-1287
13732;26.07.2017;'04 - 05;21,23;28,28;-7,05;0;0;0;14440;12940;-1500
13733;26.07.2017;'05 - 06;26,16;29,85;-3,69;20;11;-9;14168;12713;-1455
13734;26.07.2017;'06 - 07;29,08;33,52;-4,44;284;260;-24;13705;13109;-596
13735;26.07.2017;'07 - 08;34,49;39,55;-5,06;1118;1178;60;13173;13048;-125
13736;26.07.2017;'08 - 09;37,78;41,89;-4,11;2619;2708;89;12688;12152;-536
13737;26.07.2017;'09 - 10;37,92;42,02;-4,1;4593;4631;38;12375;11452;-923
13738;26.07.2017;'10 - 11;37,96;42,36;-4,4;6451;6624;173;12106;11073;-1033
13739;26.07.2017;'11 - 12;38,08;42,05;-3,97;8087;8051;-36;11770;11074;-696
13740;26.07.2017;'12 - 13;37,96;40,42;-2,46;9044;9063;19;11464;11179;-285
13741;26.07.2017;'13 - 14;37,73;38,69;-0,96;9340;9541;201;11087;11366;279
13742;26.07.2017;'14 - 15;36,08;38,68;-2,6;9295;9554;259;10748;11111;363
13743;26.07.2017;'15 - 16;35,23;37,42;-2,19;8673;9152;479;10366;10584;218
13744;26.07.2017;'16 - 17;34,38;36,32;-1,94;7455;8372;917;9932;10200;268
13745;26.07.2017;'17 - 18;35,27;35,54;-0,27;5856;6756;900;9334;9549;215
13746;26.07.2017;'18 - 19;36,39;35,78;0,61;3839;4452;613;8505;8231;-274
13747;26.07.2017;'19 - 20;37,94;38,08;-0,14;1773;2134;361;7676;6838;-838
13748;26.07.2017;'20 - 21;36,93;37,41;-0,48;492;530;38;7103;5974;-1129
13749;26.07.2017;'21 - 22;35,93;38,47;-2,54;20;16;-4;6938;6299;-639
13750;26.07.2017;'22 - 23;35,75;37,38;-1,63;0;0;0;7026;6715;-311
13751;26.07.2017;'23 - 24;30,07;33,8;-3,73;0;0;0;7204;7865;661
13752;27.07.2017;'00 - 01;28,75;29,25;-0,5;0;0;0;7456;8892;1436
13753;27.07.2017;'01 - 02;26,7;26,47;0,23;0;0;0;8320;9727;1407
13754;27.07.2017;'02 - 03;24,85;24,07;0,78;0;0;0;9058;10047;989
13755;27.07.2017;'03 - 04;23,69;23,93;-0,24;0;0;0;9375;10335;960
13756;27.07.2017;'04 - 05;24,48;21,62;2,86;0;0;0;9384;10340;956
13757;27.07.2017;'05 - 06;27,02;22,66;4,36;46;28;-18;9055;10228;1173
13758;27.07.2017;'06 - 07;29,19;28,19;1;647;726;79;8493;9420;927
13759;27.07.2017;'07 - 08;35,31;35,36;-0,05;2297;2780;483;7883;7868;-15
13760;27.07.2017;'08 - 09;37,91;36,63;1,28;4607;5550;943;7388;6968;-420
13761;27.07.2017;'09 - 10;37,89;36,07;1,82;7056;7716;660;7260;7208;-52
13762;27.07.2017;'10 - 11;38,05;37,01;1,04;9046;9370;324;8048;7491;-557
13763;27.07.2017;'11 - 12;38,48;38,33;0,15;10552;10406;-146;8689;8046;-643
13764;27.07.2017;'12 - 13;38,5;39,49;-0,99;11348;11016;-332;9044;8251;-793
13765;27.07.2017;'13 - 14;38,03;39,63;-1,6;11325;11490;165;9311;8514;-797
13766;27.07.2017;'14 - 15;36;37,86;-1,86;10931;11355;424;9442;8519;-923
13767;27.07.2017;'15 - 16;34,52;36,27;-1,75;10001;10646;645;9239;8172;-1067
13768;27.07.2017;'16 - 17;35,29;35,51;-0,22;8363;9386;1023;8907;7449;-1458
13769;27.07.2017;'17 - 18;35,74;37,3;-1,56;6246;7239;993;8518;6283;-2235
13770;27.07.2017;'18 - 19;37,32;38,82;-1,5;3954;4638;684;7797;5438;-2359
13771;27.07.2017;'19 - 20;38,98;38,63;0,35;1848;2000;152;6653;4669;-1984
13772;27.07.2017;'20 - 21;38,06;37,63;0,43;467;389;-78;5769;4089;-1680
13773;27.07.2017;'21 - 22;36,87;38,52;-1,65;14;7;-7;5564;4516;-1048
13774;27.07.2017;'22 - 23;36,55;37,13;-0,58;0;0;0;5853;4794;-1059
13775;27.07.2017;'23 - 24;31,62;35,12;-3,5;0;0;0;6165;5378;-787
13776;28.07.2017;'00 - 01;33,86;33,31;0,55;0;0;0;6316;5895;-421
13777;28.07.2017;'01 - 02;29,04;27,93;1,11;0;0;0;6595;6132;-463
13778;28.07.2017;'02 - 03;28,1;26,7;1,4;0;0;0;6987;6426;-561
13779;28.07.2017;'03 - 04;26,8;27,03;-0,23;0;0;0;7265;7124;-141
13780;28.07.2017;'04 - 05;26,46;25,86;0,6;0;0;0;7478;7706;228
13781;28.07.2017;'05 - 06;27,48;25,77;1,71;45;32;-13;7618;8238;620
13782;28.07.2017;'06 - 07;32,13;32,63;-0,5;778;847;69;7857;8770;913
13783;28.07.2017;'07 - 08;38;35,62;2,38;3102;3626;524;8147;7666;-481
13784;28.07.2017;'08 - 09;38,8;37,5;1,3;6718;7730;1012;8873;7787;-1086
13785;28.07.2017;'09 - 10;37,05;37,83;-0,78;10751;12081;1330;10567;9678;-889
13786;28.07.2017;'10 - 11;35,5;35,28;0,22;14244;15664;1420;12741;12199;-542
13787;28.07.2017;'11 - 12;31;31,57;-0,57;16746;17680;934;14724;15526;802
13788;28.07.2017;'12 - 13;27,51;29,62;-2,11;18104;17918;-186;16239;18518;2279
13789;28.07.2017;'13 - 14;25,17;25,76;-0,59;18322;17336;-986;17298;19652;2354
13790;28.07.2017;'14 - 15;23,69;21,77;1,92;17578;16858;-720;17927;19869;1942
13791;28.07.2017;'15 - 16;24,34;21,4;2,94;15762;15937;175;18065;19443;1378
13792;28.07.2017;'16 - 17;26,31;22,58;3,73;13249;13968;719;17698;18874;1176
13793;28.07.2017;'17 - 18;28,87;23,22;5,65;9951;10594;643;16457;17543;1086
13794;28.07.2017;'18 - 19;34,15;28,33;5,82;5934;6542;608;14362;14870;508
13795;28.07.2017;'19 - 20;36,96;34,25;2,71;2487;2754;267;12168;11969;-199
13796;28.07.2017;'20 - 21;36,94;34,89;2,05;583;526;-57;10598;9278;-1320
13797;28.07.2017;'21 - 22;36,3;35,09;1,21;14;4;-10;9862;8495;-1367
13798;28.07.2017;'22 - 23;35,95;35,57;0,38;0;0;0;9730;8289;-1441
13799;28.07.2017;'23 - 24;32,24;34,23;-1,99;0;0;0;9931;9070;-861
13800;29.07.2017;'00 - 01;27,77;27,94;-0,17;0;0;0;10367;9737;-630
13801;29.07.2017;'01 - 02;23,35;18,3;5,05;0;0;0;11073;10584;-489
13802;29.07.2017;'02 - 03;18,99;15,71;3,28;0;0;0;11877;11908;31
13803;29.07.2017;'03 - 04;14,17;9,98;4,19;0;0;0;12641;12720;79
13804;29.07.2017;'04 - 05;10,04;9,04;1;0;0;0;13422;13263;-159
13805;29.07.2017;'05 - 06;11,89;10,12;1,77;41;23;-18;14283;14114;-169
13806;29.07.2017;'06 - 07;14,41;11,05;3,36;783;690;-93;15135;15690;555
13807;29.07.2017;'07 - 08;17,11;11,28;5,83;3305;3166;-139;15953;16750;797
13808;29.07.2017;'08 - 09;19,78;12,78;7;7294;7312;18;16697;17080;383
13809;29.07.2017;'09 - 10;18,05;14,88;3,17;11611;11930;319;17376;18080;704
13810;29.07.2017;'10 - 11;9,93;15,06;-5,13;15218;15639;421;18369;19724;1355
13811;29.07.2017;'11 - 12;15,78;5,95;9,83;17677;17654;-23;19239;20280;1041
13812;29.07.2017;'12 - 13;10,17;5,36;4,81;18792;18969;177;19668;19795;127
13813;29.07.2017;'13 - 14;9,92;2,21;7,71;18649;19650;1001;19531;18932;-599
13814;29.07.2017;'14 - 15;9,27;6,15;3,12;17536;19563;2027;18604;17116;-1488
13815;29.07.2017;'15 - 16;14,05;4,41;9,64;15597;17666;2069;16848;14272;-2576
13816;29.07.2017;'16 - 17;19,26;12,02;7,24;13031;14752;1721;14481;11396;-3085
13817;29.07.2017;'17 - 18;25,47;25,06;0,41;9650;11184;1534;11948;8885;-3063
13818;29.07.2017;'18 - 19;30,13;30,56;-0,43;5787;6800;1013;9457;6653;-2804
13819;29.07.2017;'19 - 20;34,45;31,19;3,26;2482;2858;376;7192;4456;-2736
13820;29.07.2017;'20 - 21;35,43;32,8;2,63;583;532;-51;5607;3031;-2576
13821;29.07.2017;'21 - 22;35,65;33,18;2,47;12;2;-10;4787;3154;-1633
13822;29.07.2017;'22 - 23;34,76;31,74;3,02;0;0;0;4481;4312;-169
13823;29.07.2017;'23 - 24;30,6;27,41;3,19;0;0;0;4685;5782;1097
13824;30.07.2017;'00 - 01;26,92;19,57;7,35;0;0;0;5694;7402;1708
13825;30.07.2017;'01 - 02;21,16;9,58;11,58;0;0;0;6994;8828;1834
13826;30.07.2017;'02 - 03;16,22;7,49;8,73;0;0;0;8545;10003;1458
13827;30.07.2017;'03 - 04;12,79;8,65;4,14;0;0;0;10118;10523;405
13828;30.07.2017;'04 - 05;10,73;9,43;1,3;0;0;0;11802;10438;-1364
13829;30.07.2017;'05 - 06;10,03;11,77;-1,74;42;26;-16;13298;11907;-1391
13830;30.07.2017;'06 - 07;8,44;6,6;1,84;883;897;14;14435;13524;-911
13831;30.07.2017;'07 - 08;7,67;5,31;2,36;3817;3792;-25;15143;14080;-1063
13832;30.07.2017;'08 - 09;2,05;4,51;-2,46;8529;8204;-325;15419;13372;-2047
13833;30.07.2017;'09 - 10;1,94;7,64;-5,7;13782;13163;-619;16165;14230;-1935
13834;30.07.2017;'10 - 11;-5,15;3,58;-8,73;18255;17251;-1004;17307;17327;20
13835;30.07.2017;'11 - 12;-0,02;-12,55;12,53;21373;20846;-527;18482;19857;1375
13836;30.07.2017;'12 - 13;-45,42;-57,71;12,29;22836;22454;-382;19394;20680;1286
13837;30.07.2017;'13 - 14;-67,05;-86,12;19,07;22380;22988;608;20046;17971;-2075
13838;30.07.2017;'14 - 15;-64,9;-86,41;21,51;20506;21289;783;19953;17374;-2579
13839;30.07.2017;'15 - 16;-14,23;-71,65;57,42;17654;18268;614;18712;19100;388
13840;30.07.2017;'16 - 17;-0,91;-56,41;55,5;14223;14131;-92;16823;21250;4427
13841;30.07.2017;'17 - 18;5,01;-25,62;30,63;10127;10414;287;14543;20671;6128
13842;30.07.2017;'18 - 19;22,54;14,56;7,98;5941;6280;339;12016;18255;6239
13843;30.07.2017;'19 - 20;31,77;27,3;4,47;2557;2643;86;9681;13686;4005
13844;30.07.2017;'20 - 21;34,52;33,38;1,14;578;568;-10;7901;9974;2073
13845;30.07.2017;'21 - 22;35,93;35,74;0,19;10;8;-2;7150;8409;1259
13846;30.07.2017;'22 - 23;37,67;38,68;-1,01;0;0;0;6960;7145;185
13847;30.07.2017;'23 - 24;35,87;35,39;0,48;0;0;0;6886;6260;-626
13848;31.07.2017;'00 - 01;32;35,13;-3,13;0;0;0;6759;5745;-1014
13849;31.07.2017;'01 - 02;26,55;30,76;-4,21;0;0;0;6597;5314;-1283
13850;31.07.2017;'02 - 03;26,11;29,78;-3,67;0;0;0;6689;5366;-1323
13851;31.07.2017;'03 - 04;24,65;28,1;-3,45;0;0;0;6825;5624;-1201
13852;31.07.2017;'04 - 05;24,64;24,81;-0,17;0;0;0;7077;6027;-1050
13853;31.07.2017;'05 - 06;26,57;26,47;0,1;36;20;-16;7210;6215;-995
13854;31.07.2017;'06 - 07;32,15;31,34;0,81;845;784;-61;7173;6392;-781
13855;31.07.2017;'07 - 08;36,92;35,31;1,61;3825;3715;-110;6885;6097;-788
13856;31.07.2017;'08 - 09;36,92;38,49;-1,57;8723;8888;165;6498;5376;-1122
13857;31.07.2017;'09 - 10;35,45;35,92;-0,47;13968;14588;620;6529;5490;-1039
13858;31.07.2017;'10 - 11;33,29;33,86;-0,57;18179;19272;1093;7209;5894;-1315
13859;31.07.2017;'11 - 12;33,89;33,89;0;20985;21664;679;7800;6772;-1028
13860;31.07.2017;'12 - 13;29,03;28,74;0,29;22264;22138;-126;8492;7304;-1188
13861;31.07.2017;'13 - 14;28,07;29,4;-1,33;22260;21680;-580;8994;7640;-1354
13862;31.07.2017;'14 - 15;28,02;32,68;-4,66;21105;20250;-855;8879;7564;-1315
13863;31.07.2017;'15 - 16;28,71;35,26;-6,55;18798;17419;-1379;7952;6922;-1030
13864;31.07.2017;'16 - 17;30,05;34,69;-4,64;15581;14014;-1567;6556;5982;-574
13865;31.07.2017;'17 - 18;35,51;37,41;-1,9;11355;9814;-1541;4943;4742;-201
13866;31.07.2017;'18 - 19;37,91;45,66;-7,75;6630;5889;-741;3538;3551;13
13867;31.07.2017;'19 - 20;38,9;52,22;-13,32;2712;2660;-52;2640;2683;43
13868;31.07.2017;'20 - 21;38,9;46,04;-7,14;594;508;-86;2307;2430;123
13869;31.07.2017;'21 - 22;38,07;44,63;-6,56;10;4;-6;2549;2705;156
13870;31.07.2017;'22 - 23;37,84;44,18;-6,34;0;0;0;3074;3080;6
13871;31.07.2017;'23 - 24;32,91;37,95;-5,04;0;0;0;3557;3556;-1
13872;01.08.2017;'00 - 01;30,57;30,04;0,53;0;0;0;3090;3809;719
13873;01.08.2017;'01 - 02;28,01;28,2;-0,19;0;0;0;3226;3975;749
13874;01.08.2017;'02 - 03;27,3;25,92;1,38;0;0;0;3317;4049;732
13875;01.08.2017;'03 - 04;26,79;24,54;2,25;0;0;0;3280;4174;894
13876;01.08.2017;'04 - 05;26,81;24,47;2,34;0;0;0;3289;4616;1327
13877;01.08.2017;'05 - 06;27,54;26,27;1,27;28;17;-11;3187;4750;1563
13878;01.08.2017;'06 - 07;32,66;29,16;3,5;710;674;-36;2999;5829;2830
13879;01.08.2017;'07 - 08;37;32,3;4,7;3297;3040;-257;2725;6538;3813
13880;01.08.2017;'08 - 09;38,94;32,34;6,6;7444;6904;-540;2172;5894;3722
13881;01.08.2017;'09 - 10;38,09;34,78;3,31;11905;11650;-255;1673;3639;1966
13882;01.08.2017;'10 - 11;37,9;36,53;1,37;15742;15994;252;1429;2841;1412
13883;01.08.2017;'11 - 12;37,08;35,22;1,86;18533;18945;412;1332;2689;1357
13884;01.08.2017;'12 - 13;36,45;35,91;0,54;20149;20349;200;1405;2878;1473
13885;01.08.2017;'13 - 14;35,93;35,03;0,9;20515;20410;-105;1575;3484;1909
13886;01.08.2017;'14 - 15;35,91;34,46;1,45;19639;18673;-966;1709;3364;1655
13887;01.08.2017;'15 - 16;36;34,38;1,62;17364;15952;-1412;1817;3581;1764
13888;01.08.2017;'16 - 17;36,61;35,5;1,11;13962;12468;-1494;2010;4040;2030
13889;01.08.2017;'17 - 18;38,47;36,61;1,86;9702;8355;-1347;2157;4300;2143
13890;01.08.2017;'18 - 19;40,94;37,95;2,99;5319;4451;-868;2337;4587;2250
13891;01.08.2017;'19 - 20;41,06;38,42;2,64;2056;1682;-374;2629;5155;2526
13892;01.08.2017;'20 - 21;38,96;36,32;2,64;408;320;-88;3053;5146;2093
13893;01.08.2017;'21 - 22;37,04;35,38;1,66;5;5;0;3734;4443;709
13894;01.08.2017;'22 - 23;35,94;37,62;-1,68;0;0;0;4459;3871;-588
13895;01.08.2017;'23 - 24;31,69;36,57;-4,88;0;0;0;4976;3760;-1216
13896;02.08.2017;'00 - 01;27,62;32,04;-4,42;0;0;0;5130;3364;-1766
13897;02.08.2017;'01 - 02;26,59;31,88;-5,29;0;0;0;5176;3088;-2088
13898;02.08.2017;'02 - 03;26,2;31,33;-5,13;0;0;0;5427;3548;-1879
13899;02.08.2017;'03 - 04;25,09;30,82;-5,73;0;0;0;5688;4129;-1559
13900;02.08.2017;'04 - 05;25,78;29,95;-4,17;0;0;0;5889;4654;-1235
13901;02.08.2017;'05 - 06;27,25;31,98;-4,73;25;16;-9;5935;4815;-1120
13902;02.08.2017;'06 - 07;30,26;36,09;-5,83;696;619;-77;5726;5070;-656
13903;02.08.2017;'07 - 08;35,05;40,21;-5,16;3183;3113;-70;5330;4301;-1029
13904;02.08.2017;'08 - 09;36,57;41,2;-4,63;7157;7078;-79;4783;3088;-1695
13905;02.08.2017;'09 - 10;36,47;41,22;-4,75;11590;11370;-220;4442;2406;-2036
13906;02.08.2017;'10 - 11;35,96;38,72;-2,76;15542;15335;-207;4536;2593;-1943
13907;02.08.2017;'11 - 12;35,14;38,79;-3,65;18572;18250;-322;4844;3318;-1526
13908;02.08.2017;'12 - 13;33,07;36,94;-3,87;20277;19419;-858;5204;4446;-758
13909;02.08.2017;'13 - 14;29,9;33,29;-3,39;20429;19805;-624;5474;5758;284
13910;02.08.2017;'14 - 15;30,07;32,92;-2,85;19498;19553;55;5532;6108;576
13911;02.08.2017;'15 - 16;31,69;31,49;0,2;17480;18005;525;5156;6504;1348
13912;02.08.2017;'16 - 17;34,9;30,01;4,89;14383;14652;269;4460;6078;1618
13913;02.08.2017;'17 - 18;35,99;33,75;2,24;10363;10302;-61;3529;4957;1428
13914;02.08.2017;'18 - 19;39,23;36,86;2,37;5957;5604;-353;2561;3599;1038
13915;02.08.2017;'19 - 20;40,94;38,14;2,8;2385;2149;-236;1851;2339;488
13916;02.08.2017;'20 - 21;39,27;39,26;0,01;473;321;-152;1611;2148;537
13917;02.08.2017;'21 - 22;38,15;39,53;-1,38;6;0;-6;1924;2485;561
13918;02.08.2017;'22 - 23;37,53;37,6;-0,07;0;0;0;2651;3740;1089
13919;02.08.2017;'23 - 24;34,46;34,29;0,17;0;0;0;3669;5057;1388
13920;03.08.2017;'00 - 01;28,1;32,24;-4,14;0;0;0;5922;5912;-10
13921;03.08.2017;'01 - 02;26,47;31,37;-4,9;0;0;0;7123;6438;-685
13922;03.08.2017;'02 - 03;24,76;30,23;-5,47;0;0;0;8108;7304;-804
13923;03.08.2017;'03 - 04;23,36;27,15;-3,79;0;0;0;8657;8170;-487
13924;03.08.2017;'04 - 05;23,39;26,76;-3,37;0;0;0;9220;8900;-320
13925;03.08.2017;'05 - 06;25,08;27,86;-2,78;15;10;-5;10051;9709;-342
13926;03.08.2017;'06 - 07;28,58;34,77;-6,19;510;478;-32;10953;11003;50
13927;03.08.2017;'07 - 08;34,94;37,19;-2,25;2376;2130;-246;11828;11784;-44
13928;03.08.2017;'08 - 09;35,98;37,55;-1,57;5229;4308;-921;12565;11991;-574
13929;03.08.2017;'09 - 10;35,98;40,5;-4,52;8298;6993;-1305;13287;12280;-1007
13930;03.08.2017;'10 - 11;35,89;41,13;-5,24;10956;9427;-1529;14355;13570;-785
13931;03.08.2017;'11 - 12;34,72;39,71;-4,99;12954;10431;-2523;15834;15728;-106
13932;03.08.2017;'12 - 13;30,57;32,93;-2,36;14273;12079;-2194;17622;18012;390
13933;03.08.2017;'13 - 14;27,13;33,26;-6,13;14906;13552;-1354;19557;21134;1577
13934;03.08.2017;'14 - 15;22,03;25,56;-3,53;15067;14570;-497;21286;24152;2866
13935;03.08.2017;'15 - 16;20,28;21,5;-1,22;14434;14271;-163;22599;26184;3585
13936;03.08.2017;'16 - 17;18,09;14,71;3,38;12900;12745;-155;23649;27223;3574
13937;03.08.2017;'17 - 18;23,99;18,61;5,38;10206;9987;-219;23703;26843;3140
13938;03.08.2017;'18 - 19;26,82;30,03;-3,21;6315;6205;-110;22447;25318;2871
13939;03.08.2017;'19 - 20;29,76;33,92;-4,16;2557;2549;-8;20363;21853;1490
13940;03.08.2017;'20 - 21;30,76;33,76;-3;521;430;-91;18303;19335;1032
13941;03.08.2017;'21 - 22;31,85;35,02;-3,17;6;2;-4;17102;18034;932
13942;03.08.2017;'22 - 23;29,69;35,11;-5,42;0;0;0;16493;17044;551
13943;03.08.2017;'23 - 24;25,52;33,79;-8,27;0;0;0;16010;16270;260
13944;04.08.2017;'00 - 01;25,16;34,9;-9,74;0;0;0;15737;15563;-174
13945;04.08.2017;'01 - 02;22,7;29,61;-6,91;0;0;0;15501;14957;-544
13946;04.08.2017;'02 - 03;21,3;28;-6,7;0;0;0;15399;14869;-530
13947;04.08.2017;'03 - 04;19,03;24,2;-5,17;0;0;0;15364;14686;-678
13948;04.08.2017;'04 - 05;18,95;23,47;-4,52;0;0;0;15399;14901;-498
13949;04.08.2017;'05 - 06;21,48;23,75;-2,27;19;15;-4;15419;15169;-250
13950;04.08.2017;'06 - 07;30,5;34,69;-4,19;628;564;-64;15593;15237;-356
13951;04.08.2017;'07 - 08;34,99;37,24;-2,25;2852;2646;-206;16070;15171;-899
13952;04.08.2017;'08 - 09;35,02;39,03;-4,01;6223;5768;-455;17236;15672;-1564
13953;04.08.2017;'09 - 10;33,59;39,04;-5,45;10092;9485;-607;19626;18075;-1551
13954;04.08.2017;'10 - 11;28,42;36,19;-7,77;13447;13236;-211;22664;21619;-1045
13955;04.08.2017;'11 - 12;21,62;25,83;-4,21;15825;15869;44;25137;24339;-798
13956;04.08.2017;'12 - 13;17,05;20,53;-3,48;17317;17233;-84;26713;26528;-185
13957;04.08.2017;'13 - 14;10,35;9,16;1,19;17933;17371;-562;27488;27185;-303
13958;04.08.2017;'14 - 15;9,58;14,09;-4,51;17532;16818;-714;27718;26907;-811
13959;04.08.2017;'15 - 16;10,36;18,93;-8,57;16091;15249;-842;27188;26513;-675
13960;04.08.2017;'16 - 17;10,32;19,52;-9,2;13625;12965;-660;26241;25972;-269
13961;04.08.2017;'17 - 18;20,04;24,42;-4,38;10026;9733;-293;24606;24853;247
13962;04.08.2017;'18 - 19;28,46;33,05;-4,59;5857;5895;38;22076;22880;804
13963;04.08.2017;'19 - 20;35,01;37,96;-2,95;2302;2400;98;19244;19779;535
13964;04.08.2017;'20 - 21;34,48;37,1;-2,62;441;382;-59;16900;16199;-701
13965;04.08.2017;'21 - 22;34,93;38,23;-3,3;6;2;-4;15214;14655;-559
13966;04.08.2017;'22 - 23;34,96;39,13;-4,17;0;0;0;14244;14073;-171
13967;04.08.2017;'23 - 24;31,06;36,75;-5,69;0;0;0;13713;14026;313
13968;05.08.2017;'00 - 01;24,97;35,18;-10,21;0;0;0;14070;13299;-771
13969;05.08.2017;'01 - 02;24,97;33,18;-8,21;0;0;0;13410;12772;-638
13970;05.08.2017;'02 - 03;25,05;32,59;-7,54;0;0;0;12823;12253;-570
13971;05.08.2017;'03 - 04;24,02;30,78;-6,76;0;0;0;12024;11756;-268
13972;05.08.2017;'04 - 05;23,1;29,77;-6,67;0;0;0;11126;10968;-158
13973;05.08.2017;'05 - 06;24,74;31,12;-6,38;18;14;-4;10113;10373;260
13974;05.08.2017;'06 - 07;24,17;30,44;-6,27;607;638;31;8982;9672;690
13975;05.08.2017;'07 - 08;27,68;31,2;-3,52;2913;3358;445;7852;8362;510
13976;05.08.2017;'08 - 09;31;33,09;-2,09;6587;7733;1146;7072;7086;14
13977;05.08.2017;'09 - 10;32,82;32,25;0,57;10568;12310;1742;6956;7123;167
13978;05.08.2017;'10 - 11;31,88;29,49;2,39;13715;15476;1761;7263;8030;767
13979;05.08.2017;'11 - 12;27,21;25,37;1,84;15821;17145;1324;7659;8674;1015
13980;05.08.2017;'12 - 13;25,06;25,28;-0,22;16865;17562;697;8087;9344;1257
13981;05.08.2017;'13 - 14;23,37;24,54;-1,17;16853;17211;358;8299;9846;1547
13982;05.08.2017;'14 - 15;23,43;23,9;-0,47;15979;16019;40;8329;10876;2547
13983;05.08.2017;'15 - 16;24,55;20,16;4,39;14255;14012;-243;8123;11843;3720
13984;05.08.2017;'16 - 17;25,33;20,67;4,66;11907;11173;-734;7941;11694;3753
13985;05.08.2017;'17 - 18;27,98;26,28;1,7;8834;8298;-536;7596;11328;3732
13986;05.08.2017;'18 - 19;32,09;30,29;1,8;5251;5158;-93;7006;10414;3408
13987;05.08.2017;'19 - 20;33,96;29,44;4,52;2114;2165;51;6498;8934;2436
13988;05.08.2017;'20 - 21;33,63;31;2,63;392;338;-54;6254;8098;1844
13989;05.08.2017;'21 - 22;33,8;32,79;1,01;3;1;-2;6327;8100;1773
13990;05.08.2017;'22 - 23;34,3;31,85;2,45;0;0;0;6567;8644;2077
13991;05.08.2017;'23 - 24;32,74;28,82;3,92;0;0;0;6974;9018;2044
13992;06.08.2017;'00 - 01;25,73;20,62;5,11;0;0;0;9335;9872;537
13993;06.08.2017;'01 - 02;20,57;14,12;6,45;0;0;0;9670;10573;903
13994;06.08.2017;'02 - 03;18,03;8,61;9,42;0;0;0;9916;11359;1443
13995;06.08.2017;'03 - 04;16,59;3,56;13,03;0;0;0;9813;11297;1484
13996;06.08.2017;'04 - 05;13,69;2,75;10,94;0;0;0;9534;11086;1552
13997;06.08.2017;'05 - 06;10,87;4,84;6,03;16;12;-4;8995;10152;1157
13998;06.08.2017;'06 - 07;10,75;6,58;4,17;592;588;-4;8182;9507;1325
13999;06.08.2017;'07 - 08;12,6;5,18;7,42;3140;3249;109;7329;8260;931
14000;06.08.2017;'08 - 09;16,32;9,45;6,87;7403;7736;333;6790;7208;418
14001;06.08.2017;'09 - 10;18;10,6;7,4;12025;13133;1108;6828;7896;1068
14002;06.08.2017;'10 - 11;10,46;6,51;3,95;15570;16913;1343;7203;8822;1619
14003;06.08.2017;'11 - 12;13,33;4,37;8,96;17840;18732;892;7633;9539;1906
14004;06.08.2017;'12 - 13;14,13;9,33;4,8;18877;19124;247;7917;9405;1488
14005;06.08.2017;'13 - 14;10,83;11,81;-0,98;18796;18368;-428;8006;9497;1491
14006;06.08.2017;'14 - 15;10,41;11,15;-0,74;17756;17738;-18;7908;9203;1295
14007;06.08.2017;'15 - 16;10,32;11,16;-0,84;15805;15954;149;7580;8931;1351
14008;06.08.2017;'16 - 17;13,01;10,17;2,84;13133;13479;346;7099;7774;675
14009;06.08.2017;'17 - 18;19,57;17,17;2,4;9647;10061;414;6324;6628;304
14010;06.08.2017;'18 - 19;28,66;29,5;-0,84;5664;6357;693;5257;5347;90
14011;06.08.2017;'19 - 20;32,94;32,41;0,53;2233;2609;376;4156;3956;-200
14012;06.08.2017;'20 - 21;34,95;32,73;2,22;408;404;-4;3285;2541;-744
14013;06.08.2017;'21 - 22;36,05;35,19;0,86;3;1;-2;2872;2006;-866
14014;06.08.2017;'22 - 23;36,07;35,86;0,21;0;0;0;2706;1820;-886
14015;06.08.2017;'23 - 24;34,94;35,21;-0,27;0;0;0;2634;1825;-809
14016;07.08.2017;'00 - 01;31,1;26,85;4,25;0;0;0;2469;1962;-507
14017;07.08.2017;'01 - 02;28;23,7;4,3;0;0;0;2568;2399;-169
14018;07.08.2017;'02 - 03;26,11;22,99;3,12;0;0;0;2843;2932;89
14019;07.08.2017;'03 - 04;24,8;20,69;4,11;0;0;0;3208;3509;301
14020;07.08.2017;'04 - 05;25,47;19,61;5,86;0;0;0;3743;4292;549
14021;07.08.2017;'05 - 06;28,28;20,38;7,9;15;11;-4;4251;5159;908
14022;07.08.2017;'06 - 07;35,18;26,64;8,54;655;668;13;4646;6239;1593
14023;07.08.2017;'07 - 08;37,93;28,92;9,01;3919;4030;111;4870;6537;1667
14024;07.08.2017;'08 - 09;37,85;29,24;8,61;9656;9645;-11;4653;5225;572
14025;07.08.2017;'09 - 10;36,42;30,41;6,01;15902;16068;166;4344;4295;-49
14026;07.08.2017;'10 - 11;34,08;31,42;2,66;20823;21215;392;4465;5009;544
14027;07.08.2017;'11 - 12;33,14;30,13;3,01;23995;24165;170;4697;5890;1193
14028;07.08.2017;'12 - 13;29,03;28,36;0,67;25566;24884;-682;4834;6499;1665
14029;07.08.2017;'13 - 14;26,87;28,13;-1,26;25855;25183;-672;4794;6202;1408
14030;07.08.2017;'14 - 15;27,47;27,13;0,34;24779;24532;-247;4435;5354;919
14031;07.08.2017;'15 - 16;29,04;26,83;2,21;22298;22394;96;3767;4602;835
14032;07.08.2017;'16 - 17;32,65;30,01;2,64;18594;18945;351;3051;3802;751
14033;07.08.2017;'17 - 18;36,95;31,09;5,86;13442;13763;321;2499;2951;452
14034;07.08.2017;'18 - 19;42,16;38,03;4,13;7343;7616;273;2329;2318;-11
14035;07.08.2017;'19 - 20;45,11;41,65;3,46;2487;2651;164;2632;2007;-625
14036;07.08.2017;'20 - 21;44,9;40,07;4,83;439;347;-92;3543;2707;-836
14037;07.08.2017;'21 - 22;39,94;38,87;1,07;3;0;-3;5175;4846;-329
14038;07.08.2017;'22 - 23;35,92;38,61;-2,69;0;0;0;6948;7271;323
14039;07.08.2017;'23 - 24;29,94;31,65;-1,71;0;0;0;8301;8652;351
14040;08.08.2017;'00 - 01;28,09;26,72;1,37;0;0;0;7706;8964;1258
14041;08.08.2017;'01 - 02;26,86;24,18;2,68;0;0;0;7876;8581;705
14042;08.08.2017;'02 - 03;25,34;23,5;1,84;0;0;0;7999;8083;84
14043;08.08.2017;'03 - 04;24,59;26,3;-1,71;0;0;0;8109;7870;-239
14044;08.08.2017;'04 - 05;24,64;26,2;-1,56;0;0;0;8303;7899;-404
14045;08.08.2017;'05 - 06;26,96;28,47;-1,51;13;8;-5;8447;8204;-243
14046;08.08.2017;'06 - 07;31;37,05;-6,05;617;657;40;8425;9314;889
14047;08.08.2017;'07 - 08;35;38,79;-3,79;3460;3697;237;7930;8904;974
14048;08.08.2017;'08 - 09;36,51;39,65;-3,14;8176;8175;-1;7078;6987;-91
14049;08.08.2017;'09 - 10;37,06;39,52;-2,46;13166;12451;-715;6614;6073;-541
14050;08.08.2017;'10 - 11;36,2;39,47;-3,27;17063;15981;-1082;6793;7514;721
14051;08.08.2017;'11 - 12;36,38;37,91;-1,53;19443;17590;-1853;7644;9388;1744
14052;08.08.2017;'12 - 13;34,74;37,82;-3,08;20326;17732;-2594;8952;10880;1928
14053;08.08.2017;'13 - 14;31,51;34,99;-3,48;19781;17442;-2339;10248;11724;1476
14054;08.08.2017;'14 - 15;29,56;34,77;-5,21;18057;15417;-2640;11172;11521;349
14055;08.08.2017;'15 - 16;30,95;36,79;-5,84;15397;12675;-2722;11874;12403;529
14056;08.08.2017;'16 - 17;31,33;34,54;-3,21;11950;9837;-2113;12311;13629;1318
14057;08.08.2017;'17 - 18;32,36;34,28;-1,92;7959;6654;-1305;12307;14024;1717
14058;08.08.2017;'18 - 19;33,9;34,89;-0,99;4221;3706;-515;12150;13697;1547
14059;08.08.2017;'19 - 20;33,91;34,51;-0,6;1518;1514;-4;12345;10832;-1513
14060;08.08.2017;'20 - 21;33,03;36,05;-3,02;246;206;-40;12934;9412;-3522
14061;08.08.2017;'21 - 22;32,07;37;-4,93;1;0;-1;13764;10639;-3125
14062;08.08.2017;'22 - 23;31,06;33,87;-2,81;0;0;0;14271;11690;-2581
14063;08.08.2017;'23 - 24;27,97;28,91;-0,94;0;0;0;14160;12045;-2115
14064;09.08.2017;'00 - 01;25;27,95;-2,95;0;0;0;11515;12304;789
14065;09.08.2017;'01 - 02;23,63;23,65;-0,02;0;0;0;11410;12432;1022
14066;09.08.2017;'02 - 03;21,13;21,84;-0,71;0;0;0;11595;13224;1629
14067;09.08.2017;'03 - 04;19,08;21,36;-2,28;0;0;0;11693;12938;1245
14068;09.08.2017;'04 - 05;19,09;20,63;-1,54;0;0;0;11872;12436;564
14069;09.08.2017;'05 - 06;24,57;26,47;-1,9;6;4;-2;11941;11960;19
14070;09.08.2017;'06 - 07;27,8;35,66;-7,86;460;378;-82;11777;12003;226
14071;09.08.2017;'07 - 08;31,57;38,04;-6,47;2720;2608;-112;11624;10839;-785
14072;09.08.2017;'08 - 09;34,85;40,43;-5,58;6634;6555;-79;11781;10121;-1660
14073;09.08.2017;'09 - 10;33,15;39,99;-6,84;11184;11485;301;12314;10586;-1728
14074;09.08.2017;'10 - 11;31,49;36,48;-4,99;15436;16154;718;12750;11100;-1650
14075;09.08.2017;'11 - 12;31,34;34,96;-3,62;18744;19702;958;12793;11490;-1303
14076;09.08.2017;'12 - 13;27,74;32,62;-4,88;20791;21611;820;12492;11008;-1484
14077;09.08.2017;'13 - 14;26,56;32,73;-6,17;21013;21581;568;12099;10309;-1790
14078;09.08.2017;'14 - 15;27,75;32,5;-4,75;19901;19829;-72;11593;9274;-2319
14079;09.08.2017;'15 - 16;29,96;34,42;-4,46;17570;17418;-152;10869;8444;-2425
14080;09.08.2017;'16 - 17;31,25;34,68;-3,43;14227;14148;-79;9965;7780;-2185
14081;09.08.2017;'17 - 18;34,92;37,62;-2,7;10003;10015;12;8828;6894;-1934
14082;09.08.2017;'18 - 19;35,96;43,54;-7,58;5450;5391;-59;7535;5636;-1899
14083;09.08.2017;'19 - 20;40,1;46,68;-6,58;1908;1897;-11;6385;4389;-1996
14084;09.08.2017;'20 - 21;38,33;50,64;-12,31;315;258;-57;5767;3673;-2094
14085;09.08.2017;'21 - 22;39,42;50,25;-10,83;1;0;-1;5716;3919;-1797
14086;09.08.2017;'22 - 23;37,35;44,73;-7,38;0;0;0;5808;4622;-1186
14087;09.08.2017;'23 - 24;34,51;35,05;-0,54;0;0;0;5693;5348;-345
14088;10.08.2017;'00 - 01;29,91;29,27;0,64;0;0;0;4105;5399;1294
14089;10.08.2017;'01 - 02;28,24;29,06;-0,82;0;0;0;3985;5432;1447
14090;10.08.2017;'02 - 03;27,79;26,78;1,01;0;0;0;3960;5050;1090
14091;10.08.2017;'03 - 04;26,6;25,4;1,2;0;0;0;3811;4861;1050
14092;10.08.2017;'04 - 05;26,02;24,71;1,31;0;0;0;3669;4331;662
14093;10.08.2017;'05 - 06;28,44;26,17;2,27;4;2;-2;3480;3959;479
14094;10.08.2017;'06 - 07;33,81;30,31;3,5;265;253;-12;3284;3609;325
14095;10.08.2017;'07 - 08;36,81;36,23;0,58;1430;1540;110;3032;2988;-44
14096;10.08.2017;'08 - 09;40,88;39,42;1,46;3319;3428;109;2737;2653;-84
14097;10.08.2017;'09 - 10;41,95;41,76;0,19;5317;4954;-363;2573;2352;-221
14098;10.08.2017;'10 - 11;41,95;43,2;-1,25;7002;6706;-296;2559;2255;-304
14099;10.08.2017;'11 - 12;41,93;45,68;-3,75;8242;8126;-116;2703;2125;-578
14100;10.08.2017;'12 - 13;41,63;47,87;-6,24;8974;8930;-44;2966;2088;-878
14101;10.08.2017;'13 - 14;40,95;48,35;-7,4;9048;9054;6;3286;2416;-870
14102;10.08.2017;'14 - 15;39,2;45,35;-6,15;8606;8527;-79;3606;2812;-794
14103;10.08.2017;'15 - 16;37,88;43,96;-6,08;7625;7234;-391;3887;3436;-451
14104;10.08.2017;'16 - 17;36,24;42,79;-6,55;6093;5584;-509;4163;4198;35
14105;10.08.2017;'17 - 18;37,05;42,49;-5,44;4285;3811;-474;4412;4712;300
14106;10.08.2017;'18 - 19;38;41,55;-3,55;2428;2165;-263;4633;5042;409
14107;10.08.2017;'19 - 20;39,61;39,94;-0,33;911;748;-163;4815;5110;295
14108;10.08.2017;'20 - 21;35,99;36,42;-0,43;149;98;-51;4955;5136;181
14109;10.08.2017;'21 - 22;35,56;36,63;-1,07;1;0;-1;5105;5822;717
14110;10.08.2017;'22 - 23;34,78;34,97;-0,19;0;0;0;5219;6525;1306
14111;10.08.2017;'23 - 24;30,97;30,43;0,54;0;0;0;5214;6615;1401
14112;11.08.2017;'00 - 01;28,99;28,88;0,11;0;0;0;5226;6080;854
14113;11.08.2017;'01 - 02;28,13;28,69;-0,56;0;0;0;5185;6099;914
14114;11.08.2017;'02 - 03;27,03;26,86;0,17;0;0;0;5196;5974;778
14115;11.08.2017;'03 - 04;26,29;25,07;1,22;0;0;0;5017;5266;249
14116;11.08.2017;'04 - 05;26,12;26,42;-0,3;0;0;0;4898;4945;47
14117;11.08.2017;'05 - 06;28,11;28,43;-0,32;2;2;0;4805;4922;117
14118;11.08.2017;'06 - 07;31,79;32,22;-0,43;161;167;6;4577;4842;265
14119;11.08.2017;'07 - 08;40,75;36,84;3,91;848;935;87;4296;4445;149
14120;11.08.2017;'08 - 09;46,98;42,7;4,28;1911;1966;55;3998;3745;-253
14121;11.08.2017;'09 - 10;49,68;42,76;6,92;3011;3324;313;3789;3215;-574
14122;11.08.2017;'10 - 11;51,18;44,57;6,61;3875;4508;633;3703;2890;-813
14123;11.08.2017;'11 - 12;61,36;50,37;10,99;4485;4730;245;3759;2547;-1212
14124;11.08.2017;'12 - 13;52,65;44,85;7,8;4901;5275;374;3944;2704;-1240
14125;11.08.2017;'13 - 14;46,8;41,92;4,88;4978;5273;295;4196;3140;-1056
14126;11.08.2017;'14 - 15;39,09;37,83;1,26;4845;4790;-55;4425;3432;-993
14127;11.08.2017;'15 - 16;39,01;35,72;3,29;4500;3568;-932;4622;3597;-1025
14128;11.08.2017;'16 - 17;36,88;33,6;3,28;3778;2933;-845;4878;3727;-1151
14129;11.08.2017;'17 - 18;37,42;36,09;1,33;2806;2362;-444;5124;4026;-1098
14130;11.08.2017;'18 - 19;38,08;33,45;4,63;1688;1707;19;5183;4584;-599
14131;11.08.2017;'19 - 20;36,21;33,39;2,82;634;608;-26;5214;5065;-149
14132;11.08.2017;'20 - 21;34,32;32,38;1,94;87;50;-37;5326;5186;-140
14133;11.08.2017;'21 - 22;34,61;32,83;1,78;0;0;0;5682;5110;-572
14134;11.08.2017;'22 - 23;33,36;32,1;1,26;0;0;0;6039;5351;-688
14135;11.08.2017;'23 - 24;30,71;28,26;2,45;0;0;0;6459;5909;-550
14136;12.08.2017;'00 - 01;25,63;27,48;-1,85;0;0;0;8150;6394;-1756
14137;12.08.2017;'01 - 02;23,05;25,39;-2,34;0;0;0;8936;7561;-1375
14138;12.08.2017;'02 - 03;20,72;22,22;-1,5;0;0;0;9720;8624;-1096
14139;12.08.2017;'03 - 04;20,06;18,19;1,87;0;0;0;10217;9098;-1119
14140;12.08.2017;'04 - 05;18,85;16,18;2,67;0;0;0;10574;9669;-905
14141;12.08.2017;'05 - 06;17,03;15,64;1,39;1;2;1;10739;9962;-777
14142;12.08.2017;'06 - 07;19,59;17,17;2,42;193;230;37;10812;10070;-742
14143;12.08.2017;'07 - 08;20,91;19,26;1,65;1106;1379;273;10815;9732;-1083
14144;12.08.2017;'08 - 09;24,37;24,21;0,16;2590;3088;498;10975;9555;-1420
14145;12.08.2017;'09 - 10;25,84;27,04;-1,2;4208;4870;662;11497;10026;-1471
14146;12.08.2017;'10 - 11;25,36;26,58;-1,22;5710;6672;962;12255;10997;-1258
14147;12.08.2017;'11 - 12;25,5;24,25;1,25;6996;8498;1502;13064;12260;-804
14148;12.08.2017;'12 - 13;24,49;20,14;4,35;7829;9904;2075;13903;13852;-51
14149;12.08.2017;'13 - 14;19,01;10,22;8,79;7974;10163;2189;14589;14668;79
14150;12.08.2017;'14 - 15;15,23;3,85;11,38;7627;9827;2200;14849;15497;648
14151;12.08.2017;'15 - 16;16,41;4,56;11,85;6824;9164;2340;14782;16220;1438
14152;12.08.2017;'16 - 17;15,99;2,09;13,9;5499;7460;1961;14689;16142;1453
14153;12.08.2017;'17 - 18;18,77;7,92;10,85;3972;5232;1260;14423;16270;1847
14154;12.08.2017;'18 - 19;24,81;18,13;6,68;2315;3129;814;14014;15079;1065
14155;12.08.2017;'19 - 20;25,44;20,63;4,81;872;1174;302;13701;14330;629
14156;12.08.2017;'20 - 21;25,67;20,98;4,69;121;114;-7;13623;14235;612
14157;12.08.2017;'21 - 22;25,54;21,8;3,74;0;0;0;13764;14696;932
14158;12.08.2017;'22 - 23;24,02;18,11;5,91;0;0;0;13953;14805;852
14159;12.08.2017;'23 - 24;17,93;14,31;3,62;0;0;0;14005;14458;453
14160;13.08.2017;'00 - 01;15,74;10,89;4,85;0;0;0;12721;13482;761
14161;13.08.2017;'01 - 02;15,42;8,99;6,43;0;0;0;11878;12181;303
14162;13.08.2017;'02 - 03;12,93;8,8;4,13;0;0;0;11043;11012;-31
14163;13.08.2017;'03 - 04;11,64;7,8;3,84;0;0;0;9931;9708;-223
14164;13.08.2017;'04 - 05;13,34;9,18;4,16;0;0;0;8966;8451;-515
14165;13.08.2017;'05 - 06;11,95;8,94;3,01;3;2;-1;7986;7612;-374
14166;13.08.2017;'06 - 07;11,77;10,47;1,3;295;275;-20;7005;6423;-582
14167;13.08.2017;'07 - 08;16,07;13,39;2,68;1797;1888;91;6084;5303;-781
14168;13.08.2017;'08 - 09;19;17,86;1,14;4457;4776;319;5348;4236;-1112
14169;13.08.2017;'09 - 10;21,02;21,34;-0,32;7640;8640;1000;4947;3837;-1110
14170;13.08.2017;'10 - 11;19,69;16,79;2,9;10705;12446;1741;4709;3788;-921
14171;13.08.2017;'11 - 12;21,09;13,84;7,25;13309;15154;1845;4603;3935;-668
14172;13.08.2017;'12 - 13;19,33;9,55;9,78;15214;16415;1201;4587;4217;-370
14173;13.08.2017;'13 - 14;16,07;7,5;8,57;16023;16810;787;4620;4518;-102
14174;13.08.2017;'14 - 15;13,24;9;4,24;15944;16777;833;4589;4609;20
14175;13.08.2017;'15 - 16;11,8;8,45;3,35;14730;15708;978;4393;4344;-49
14176;13.08.2017;'16 - 17;10,8;7,37;3,43;12459;13682;1223;4091;3813;-278
14177;13.08.2017;'17 - 18;21,89;15,87;6,02;9254;10248;994;3539;3247;-292
14178;13.08.2017;'18 - 19;28,39;27,95;0,44;5288;6064;776;2808;2419;-389
14179;13.08.2017;'19 - 20;33;34,13;-1,13;1815;2089;274;2107;1696;-411
14180;13.08.2017;'20 - 21;34,98;37,52;-2,54;232;183;-49;1664;1231;-433
14181;13.08.2017;'21 - 22;36,47;37,74;-1,27;0;0;0;1560;1210;-350
14182;13.08.2017;'22 - 23;35,8;37,79;-1,99;0;0;0;1573;1312;-261
14183;13.08.2017;'23 - 24;32;34,36;-2,36;0;0;0;1600;1364;-236
14184;14.08.2017;'00 - 01;28,69;30,94;-2,25;0;0;0;1464;1450;-14
14185;14.08.2017;'01 - 02;26,37;25,45;0,92;0;0;0;1498;1531;33
14186;14.08.2017;'02 - 03;25,24;24,07;1,17;0;0;0;1728;1660;-68
14187;14.08.2017;'03 - 04;25,17;23,7;1,47;0;0;0;1882;1973;91
14188;14.08.2017;'04 - 05;25,28;23,99;1,29;0;0;0;2128;2316;188
14189;14.08.2017;'05 - 06;27,64;24,95;2,69;2;2;0;2411;2928;517
14190;14.08.2017;'06 - 07;32,9;32,27;0,63;454;448;-6;2596;3862;1266
14191;14.08.2017;'07 - 08;37,9;36,88;1,02;3192;3419;227;2654;4380;1726
14192;14.08.2017;'08 - 09;38,44;35,03;3,41;8212;8784;572;2406;3488;1082
14193;14.08.2017;'09 - 10;36,64;34,03;2,61;13844;15068;1224;2081;2903;822
14194;14.08.2017;'10 - 11;35,04;31,72;3,32;18505;20216;1711;2038;3034;996
14195;14.08.2017;'11 - 12;34,96;29,88;5,08;21643;23553;1910;2156;2981;825
14196;14.08.2017;'12 - 13;33,4;29,2;4,2;23157;24704;1547;2419;2850;431
14197;14.08.2017;'13 - 14;31,93;28,26;3,67;23039;24450;1411;2565;2917;352
14198;14.08.2017;'14 - 15;31,87;28,39;3,48;21492;22778;1286;2616;3164;548
14199;14.08.2017;'15 - 16;33;29,31;3,69;18764;20188;1424;2688;3763;1075
14200;14.08.2017;'16 - 17;34,87;29,35;5,52;15283;16630;1347;2914;4423;1509
14201;14.08.2017;'17 - 18;37,07;30,91;6,16;10740;11940;1200;3380;5024;1644
14202;14.08.2017;'18 - 19;39,64;33,22;6,42;5736;6538;802;4218;5512;1294
14203;14.08.2017;'19 - 20;41,96;37,46;4,5;1854;2131;277;5487;5849;362
14204;14.08.2017;'20 - 21;38,39;36,15;2,24;223;178;-45;7212;7542;330
14205;14.08.2017;'21 - 22;37,76;37,61;0,15;0;0;0;9235;11071;1836
14206;14.08.2017;'22 - 23;32,96;33,8;-0,84;0;0;0;10920;13396;2476
14207;14.08.2017;'23 - 24;26,82;25,98;0,84;0;0;0;11845;14250;2405
14208;15.08.2017;'00 - 01;23,9;22,92;0,98;0;0;0;13053;14020;967
14209;15.08.2017;'01 - 02;23,05;21,4;1,65;0;0;0;12849;13110;261
14210;15.08.2017;'02 - 03;22,07;22,72;-0,65;0;0;0;12563;12302;-261
14211;15.08.2017;'03 - 04;19,3;22,02;-2,72;0;0;0;11952;11381;-571
14212;15.08.2017;'04 - 05;19,25;22,08;-2,83;0;0;0;11331;10324;-1007
14213;15.08.2017;'05 - 06;21,47;25,45;-3,98;2;2;0;10838;9588;-1250
14214;15.08.2017;'06 - 07;26,23;30,56;-4,33;435;415;-20;10426;9535;-891
14215;15.08.2017;'07 - 08;26,96;30,42;-3,46;3225;3369;144;9658;8658;-1000
14216;15.08.2017;'08 - 09;27,96;33,02;-5,06;8400;8685;285;8305;6445;-1860
14217;15.08.2017;'09 - 10;26,84;33,48;-6,64;14093;14312;219;6788;5008;-1780
14218;15.08.2017;'10 - 11;26,08;32,04;-5,96;18818;18420;-398;5772;4960;-812
14219;15.08.2017;'11 - 12;26,69;30,76;-4,07;22099;20720;-1379;5511;5683;172
14220;15.08.2017;'12 - 13;25,38;30,24;-4,86;23603;21897;-1706;5874;6113;239
14221;15.08.2017;'13 - 14;23,07;27,22;-4,15;23430;22263;-1167;6465;6424;-41
14222;15.08.2017;'14 - 15;21,26;27,97;-6,71;21922;20596;-1326;6951;6160;-791
14223;15.08.2017;'15 - 16;25,18;31,14;-5,96;19124;17085;-2039;7165;5798;-1367
14224;15.08.2017;'16 - 17;26,08;32,87;-6,79;15041;12235;-2806;7275;6336;-939
14225;15.08.2017;'17 - 18;31,34;38;-6,66;9922;7459;-2463;7182;5970;-1212
14226;15.08.2017;'18 - 19;35,24;42,21;-6,97;4909;3638;-1271;6963;6446;-517
14227;15.08.2017;'19 - 20;35,3;48,19;-12,89;1462;1029;-433;7183;7171;-12
14228;15.08.2017;'20 - 21;35,36;45,05;-9,69;159;80;-79;7572;8431;859
14229;15.08.2017;'21 - 22;34,95;41,95;-7;0;0;0;7905;8968;1063
14230;15.08.2017;'22 - 23;29,04;37,75;-8,71;0;0;0;8295;8558;263
14231;15.08.2017;'23 - 24;27,1;35,23;-8,13;0;0;0;8460;7885;-575
14232;16.08.2017;'00 - 01;28,93;34,84;-5,91;0;0;0;8919;7450;-1469
14233;16.08.2017;'01 - 02;27,99;34,14;-6,15;0;0;0;8907;6470;-2437
14234;16.08.2017;'02 - 03;27,11;33,08;-5,97;0;0;0;9031;5896;-3135
14235;16.08.2017;'03 - 04;26,79;30,63;-3,84;0;0;0;8671;5626;-3045
14236;16.08.2017;'04 - 05;27,64;28,97;-1,33;0;0;0;8161;4993;-3168
14237;16.08.2017;'05 - 06;28,72;29,81;-1,09;0;0;0;7400;4192;-3208
14238;16.08.2017;'06 - 07;34,98;35,73;-0,75;246;162;-84;6474;3941;-2533
14239;16.08.2017;'07 - 08;37,61;39,58;-1,97;1871;1447;-424;5473;3666;-1807
14240;16.08.2017;'08 - 09;42;42,61;-0,61;5019;3931;-1088;4635;2414;-2221
14241;16.08.2017;'09 - 10;41,91;45,04;-3,13;8944;7991;-953;4077;2109;-1968
14242;16.08.2017;'10 - 11;40,92;43,52;-2,6;12988;12616;-372;3718;1664;-2054
14243;16.08.2017;'11 - 12;40,91;41,46;-0,55;16512;16915;403;3407;1323;-2084
14244;16.08.2017;'12 - 13;38,44;38,09;0,35;18940;19314;374;3093;1109;-1984
14245;16.08.2017;'13 - 14;36,07;35,32;0,75;19955;19999;44;2753;1064;-1689
14246;16.08.2017;'14 - 15;35,56;35,92;-0,36;19757;19361;-396;2423;861;-1562
14247;16.08.2017;'15 - 16;34,31;34,28;0,03;18071;17676;-395;2070;752;-1318
14248;16.08.2017;'16 - 17;36,27;35,87;0,4;14749;14370;-379;1708;625;-1083
14249;16.08.2017;'17 - 18;39,94;40,14;-0,2;10238;9819;-419;1334;560;-774
14250;16.08.2017;'18 - 19;41,93;40,82;1,11;5434;5216;-218;1058;586;-472
14251;16.08.2017;'19 - 20;43,15;42,1;1,05;1741;1708;-33;947;986;39
14252;16.08.2017;'20 - 21;41,95;40,32;1,63;185;152;-33;1119;1632;513
14253;16.08.2017;'21 - 22;40,1;39,6;0,5;0;0;0;1661;2628;967
14254;16.08.2017;'22 - 23;36,02;36,3;-0,28;0;0;0;2447;3991;1544
14255;16.08.2017;'23 - 24;32;30,19;1,81;0;0;0;3344;5386;2042
14256;17.08.2017;'00 - 01;29,82;27,94;1,88;0;0;0;3730;6114;2384
14257;17.08.2017;'01 - 02;28,44;26,55;1,89;0;0;0;4301;6474;2173
14258;17.08.2017;'02 - 03;26,96;26,12;0,84;0;0;0;4919;6574;1655
14259;17.08.2017;'03 - 04;26,83;25,93;0,9;0;0;0;5214;7068;1854
14260;17.08.2017;'04 - 05;26,96;23,94;3,02;0;0;0;5458;7097;1639
14261;17.08.2017;'05 - 06;28,57;27,3;1,27;1;0;-1;5814;7061;1247
14262;17.08.2017;'06 - 07;33,94;32,32;1,62;368;362;-6;6212;7611;1399
14263;17.08.2017;'07 - 08;36,9;34,59;2,31;2804;3044;240;6404;7520;1116
14264;17.08.2017;'08 - 09;40,14;34,7;5,44;7180;7446;266;6040;6208;168
14265;17.08.2017;'09 - 10;39,24;33,57;5,67;11952;12222;270;5615;5124;-491
14266;17.08.2017;'10 - 11;36,47;33,27;3,2;15742;16029;287;6106;5870;-236
14267;17.08.2017;'11 - 12;36,02;33,62;2,4;18191;18259;68;6990;7436;446
14268;17.08.2017;'12 - 13;33,39;34,67;-1,28;19156;18805;-351;7998;9384;1386
14269;17.08.2017;'13 - 14;31,64;32,23;-0,59;18470;17892;-578;8993;10551;1558
14270;17.08.2017;'14 - 15;30;33,46;-3,46;16664;15383;-1281;9604;11184;1580
14271;17.08.2017;'15 - 16;30,19;33,71;-3,52;14104;12714;-1390;9781;11890;2109
14272;17.08.2017;'16 - 17;31,68;35,29;-3,61;11075;9831;-1244;9795;12020;2225
14273;17.08.2017;'17 - 18;35,32;38,4;-3,08;7528;6542;-986;9522;12178;2656
14274;17.08.2017;'18 - 19;37,42;39,06;-1,64;3953;3520;-433;9022;11073;2051
14275;17.08.2017;'19 - 20;38,97;40,92;-1,95;1220;1056;-164;8653;10078;1425
14276;17.08.2017;'20 - 21;38,35;39,66;-1,31;114;88;-26;8425;9281;856
14277;17.08.2017;'21 - 22;37,62;39,03;-1,41;0;0;0;8175;8842;667
14278;17.08.2017;'22 - 23;36,87;37,13;-0,26;0;0;0;7924;8847;923
14279;17.08.2017;'23 - 24;31,7;33,26;-1,56;0;0;0;7672;8689;1017
14280;18.08.2017;'00 - 01;29,21;28,5;0,71;0;0;0;7740;8210;470
14281;18.08.2017;'01 - 02;28,29;30,26;-1,97;0;0;0;7202;7964;762
14282;18.08.2017;'02 - 03;27,28;28,58;-1,3;0;0;0;7007;7336;329
14283;18.08.2017;'03 - 04;26,35;26,39;-0,04;0;0;0;6769;7126;357
14284;18.08.2017;'04 - 05;27,7;29,3;-1,6;0;0;0;6598;6914;316
14285;18.08.2017;'05 - 06;28,61;31,72;-3,11;0;0;0;6638;6952;314
14286;18.08.2017;'06 - 07;33,63;34,39;-0,76;303;292;-11;6851;7714;863
14287;18.08.2017;'07 - 08;38,48;38,58;-0,1;2253;2448;195;7198;8247;1049
14288;18.08.2017;'08 - 09;42,25;39,4;2,85;5713;6080;367;7629;7684;55
14289;18.08.2017;'09 - 10;38,88;39,55;-0,67;9476;9864;388;8216;7115;-1101
14290;18.08.2017;'10 - 11;36,1;41,6;-5,5;12425;12902;477;9105;6948;-2157
14291;18.08.2017;'11 - 12;36,85;44,06;-7,21;14406;14840;434;9934;7206;-2728
14292;18.08.2017;'12 - 13;36,29;43,18;-6,89;15356;15940;584;10537;7339;-3198
14293;18.08.2017;'13 - 14;33,17;38,76;-5,59;15135;16364;1229;10923;7551;-3372
14294;18.08.2017;'14 - 15;31,1;36,5;-5,4;14079;15065;986;10969;7868;-3101
14295;18.08.2017;'15 - 16;31,56;36,8;-5,24;12261;12797;536;10661;7814;-2847
14296;18.08.2017;'16 - 17;32,4;38,16;-5,76;9575;9870;295;10336;7610;-2726
14297;18.08.2017;'17 - 18;35,71;40,25;-4,54;6390;6004;-386;9898;7076;-2822
14298;18.08.2017;'18 - 19;37,43;44,35;-6,92;3240;2467;-773;9284;7865;-1419
14299;18.08.2017;'19 - 20;38,7;44,42;-5,72;953;648;-305;8586;8338;-248
14300;18.08.2017;'20 - 21;36,99;40,3;-3,31;82;58;-24;7913;8096;183
14301;18.08.2017;'21 - 22;37,02;36,19;0,83;0;0;0;7453;8143;690
14302;18.08.2017;'22 - 23;34,95;33,86;1,09;0;0;0;7367;8476;1109
14303;18.08.2017;'23 - 24;29,45;29,59;-0,14;0;0;0;7658;9550;1892
14304;19.08.2017;'00 - 01;22,22;29,88;-7,66;0;0;0;11321;9923;-1398
14305;19.08.2017;'01 - 02;22,01;25,2;-3,19;0;0;0;12254;11901;-353
14306;19.08.2017;'02 - 03;13,11;13,16;-0,05;0;0;0;13106;13204;98
14307;19.08.2017;'03 - 04;10,93;9,87;1,06;0;0;0;13475;13887;412
14308;19.08.2017;'04 - 05;10,47;7,51;2,96;0;0;0;13597;14738;1141
14309;19.08.2017;'05 - 06;10,93;6,28;4,65;0;0;0;13608;14677;1069
14310;19.08.2017;'06 - 07;11;8,88;2,12;255;208;-47;13762;14592;830
14311;19.08.2017;'07 - 08;15,93;11,26;4,67;2104;1960;-144;14242;14335;93
14312;19.08.2017;'08 - 09;20,74;18,52;2,22;5687;5010;-677;15196;15127;-69
14313;19.08.2017;'09 - 10;18,96;18,56;0,4;9808;8456;-1352;16693;16125;-568
14314;19.08.2017;'10 - 11;14,62;18;-3,38;13428;12034;-1394;18180;18105;-75
14315;19.08.2017;'11 - 12;12,42;16,18;-3,76;16207;14998;-1209;19225;18976;-249
14316;19.08.2017;'12 - 13;7,13;14,19;-7,06;17924;17070;-854;19585;19400;-185
14317;19.08.2017;'13 - 14;-0,07;9,53;-9,6;18412;18188;-224;19677;19199;-478
14318;19.08.2017;'14 - 15;-4;6,14;-10,14;17876;17659;-217;19532;18925;-607
14319;19.08.2017;'15 - 16;-0,22;2,8;-3,02;16234;15986;-248;19174;18216;-958
14320;19.08.2017;'16 - 17;8,16;5,09;3,07;13539;13089;-450;18639;17893;-746
14321;19.08.2017;'17 - 18;11,33;7,15;4,18;9673;9270;-403;17536;16000;-1536
14322;19.08.2017;'18 - 19;22,03;21,62;0,41;5114;4940;-174;15820;14258;-1562
14323;19.08.2017;'19 - 20;26,63;25,52;1,11;1478;1417;-61;13818;11897;-1921
14324;19.08.2017;'20 - 21;26,63;26,75;-0,12;131;83;-48;12436;11062;-1374
14325;19.08.2017;'21 - 22;27;22,88;4,12;0;0;0;11978;10836;-1142
14326;19.08.2017;'22 - 23;25,33;22,21;3,12;0;0;0;12011;12062;51
14327;19.08.2017;'23 - 24;20,05;15,09;4,96;0;0;0;12234;12772;538
14328;20.08.2017;'00 - 01;10,84;6,87;3,97;0;0;0;11644;12948;1304
14329;20.08.2017;'01 - 02;10,1;3,04;7,06;0;0;0;11889;12799;910
14330;20.08.2017;'02 - 03;9,77;1,08;8,69;0;0;0;12095;12928;833
14331;20.08.2017;'03 - 04;9,01;0,01;9;0;0;0;12123;13161;1038
14332;20.08.2017;'04 - 05;5,18;-1,1;6,28;0;0;0;12169;13214;1045
14333;20.08.2017;'05 - 06;8,51;-1,85;10,36;0;0;0;11985;13186;1201
14334;20.08.2017;'06 - 07;8,17;-0,99;9,16;272;269;-3;11663;13444;1781
14335;20.08.2017;'07 - 08;5,06;-1,94;7;2659;2772;113;11228;12326;1098
14336;20.08.2017;'08 - 09;9,65;-1,1;10,75;7519;7757;238;10766;10974;208
14337;20.08.2017;'09 - 10;5,59;1,72;3,87;13018;13660;642;10609;10999;390
14338;20.08.2017;'10 - 11;2,66;-2,02;4,68;17254;17780;526;11439;12367;928
14339;20.08.2017;'11 - 12;2,1;-2,94;5,04;19630;19367;-263;12622;14274;1652
14340;20.08.2017;'12 - 13;-0,01;0,41;-0,42;20482;19030;-1452;13361;15021;1660
14341;20.08.2017;'13 - 14;-14,35;-1,95;-12,4;20096;17771;-2325;13766;15306;1540
14342;20.08.2017;'14 - 15;-12,93;-0,56;-12,37;18820;16509;-2311;14078;15976;1898
14343;20.08.2017;'15 - 16;-6,37;-0,01;-6,36;16530;14881;-1649;14282;16025;1743
14344;20.08.2017;'16 - 17;-3,57;0,48;-4,05;13378;12370;-1008;14230;15704;1474
14345;20.08.2017;'17 - 18;7,53;5,02;2,51;9314;8714;-600;13727;14886;1159
14346;20.08.2017;'18 - 19;14,13;15;-0,87;4854;4590;-264;12640;13665;1025
14347;20.08.2017;'19 - 20;26,5;27,01;-0,51;1365;1324;-41;11273;12382;1109
14348;20.08.2017;'20 - 21;28,5;30,55;-2,05;104;74;-30;10330;11368;1038
14349;20.08.2017;'21 - 22;30,57;31,51;-0,94;0;0;0;9952;11692;1740
14350;20.08.2017;'22 - 23;29,06;28,77;0,29;0;0;0;9692;11622;1930
14351;20.08.2017;'23 - 24;23,18;18,04;5,14;0;0;0;9492;11332;1840
14352;21.08.2017;'00 - 01;19,55;15,93;3,62;0;0;0;11021;11191;170
14353;21.08.2017;'01 - 02;12,34;11,69;0,65;0;0;0;11092;11015;-77
14354;21.08.2017;'02 - 03;10,96;8,97;1,99;0;0;0;11192;11059;-133
14355;21.08.2017;'03 - 04;9,74;7,25;2,49;0;0;0;11068;11211;143
14356;21.08.2017;'04 - 05;9,96;10,12;-0,16;0;0;0;10990;11178;188
14357;21.08.2017;'05 - 06;20,34;20,92;-0,58;0;0;0;10864;10944;80
14358;21.08.2017;'06 - 07;29,93;33,22;-3,29;242;248;6;10657;10722;65
14359;21.08.2017;'07 - 08;35,17;45,71;-10,54;2287;2393;106;10406;10143;-263
14360;21.08.2017;'08 - 09;36,8;43,84;-7,04;6324;6615;291;9939;9306;-633
14361;21.08.2017;'09 - 10;35,54;39,85;-4,31;10901;11669;768;9560;9455;-105
14362;21.08.2017;'10 - 11;33,77;36,55;-2,78;14709;15789;1080;9958;10366;408
14363;21.08.2017;'11 - 12;31,16;34,16;-3;17245;18085;840;10388;10696;308
14364;21.08.2017;'12 - 13;30,96;32,56;-1,6;18364;18746;382;10551;10562;11
14365;21.08.2017;'13 - 14;29,62;31,79;-2,17;18521;19279;758;10597;10448;-149
14366;21.08.2017;'14 - 15;27,93;29,66;-1,73;17733;18774;1041;10551;10544;-7
14367;21.08.2017;'15 - 16;29,87;28,77;1,1;15898;16912;1014;10328;10325;-3
14368;21.08.2017;'16 - 17;32,06;32,42;-0,36;13103;13795;692;9826;10079;253
14369;21.08.2017;'17 - 18;34,71;35,57;-0,86;9203;9654;451;8988;9762;774
14370;21.08.2017;'18 - 19;39,8;42,17;-2,37;4773;4958;185;7798;8644;846
14371;21.08.2017;'19 - 20;41,86;43,92;-2,06;1281;1372;91;6366;6822;456
14372;21.08.2017;'20 - 21;41,01;43,1;-2,09;93;68;-25;5449;5458;9
14373;21.08.2017;'21 - 22;40,31;42,16;-1,85;0;0;0;4929;5235;306
14374;21.08.2017;'22 - 23;37,71;39,21;-1,5;0;0;0;4669;4946;277
14375;21.08.2017;'23 - 24;32;32,61;-0,61;0;0;0;4506;4796;290
14376;22.08.2017;'00 - 01;32,77;34,83;-2,06;0;0;0;4255;4611;356
14377;22.08.2017;'01 - 02;30;30,92;-0,92;0;0;0;4159;4559;400
14378;22.08.2017;'02 - 03;29,53;30,75;-1,22;0;0;0;4187;4734;547
14379;22.08.2017;'03 - 04;27,9;28,13;-0,23;0;0;0;4098;4754;656
14380;22.08.2017;'04 - 05;27,78;25,71;2,07;0;0;0;4001;4666;665
14381;22.08.2017;'05 - 06;31,78;28,43;3,35;0;0;0;3872;4392;520
14382;22.08.2017;'06 - 07;37,71;33,83;3,88;252;249;-3;3652;3940;288
14383;22.08.2017;'07 - 08;42,24;42,47;-0,23;2534;2580;46;3367;3607;240
14384;22.08.2017;'08 - 09;42,42;41,28;1,14;7209;7124;-85;3003;3130;127
14385;22.08.2017;'09 - 10;39,99;40,74;-0,75;12448;12545;97;2860;2780;-80
14386;22.08.2017;'10 - 11;37,76;38,48;-0,72;16751;17219;468;3318;3397;79
14387;22.08.2017;'11 - 12;36,91;36,65;0,26;19647;20443;796;3779;3871;92
14388;22.08.2017;'12 - 13;35,57;35,46;0,11;21003;21532;529;4060;4417;357
14389;22.08.2017;'13 - 14;35,36;35,68;-0,32;21096;20974;-122;4197;4628;431
14390;22.08.2017;'14 - 15;35,08;36,18;-1,1;20034;20316;282;4176;4604;428
14391;22.08.2017;'15 - 16;36,06;36,38;-0,32;17774;18240;466;3932;4634;702
14392;22.08.2017;'16 - 17;37,39;35,33;2,06;14455;14974;519;3557;4356;799
14393;22.08.2017;'17 - 18;42,02;38,79;3,23;9991;10478;487;3108;3728;620
14394;22.08.2017;'18 - 19;44,71;45,3;-0,59;5079;5311;232;2655;2814;159
14395;22.08.2017;'19 - 20;48,17;48,02;0,15;1351;1336;-15;2308;2074;-234
14396;22.08.2017;'20 - 21;45,07;47,62;-2,55;97;54;-43;2304;2175;-129
14397;22.08.2017;'21 - 22;43,38;45,59;-2,21;0;0;0;2591;2595;4
14398;22.08.2017;'22 - 23;38,81;39,24;-0,43;0;0;0;2906;2913;7
14399;22.08.2017;'23 - 24;34,85;34,47;0,38;0;0;0;3041;3060;19
14400;23.08.2017;'00 - 01;30,97;30,5;0,47;0;0;0;3152;3026;-126
14401;23.08.2017;'01 - 02;30,93;30,75;0,18;0;0;0;2949;2849;-100
14402;23.08.2017;'02 - 03;29,63;29,06;0,57;0;0;0;2874;2665;-209
14403;23.08.2017;'03 - 04;28,4;27,23;1,17;0;0;0;2619;2426;-193
14404;23.08.2017;'04 - 05;28,06;26,63;1,43;0;0;0;2458;2159;-299
14405;23.08.2017;'05 - 06;29,76;30,73;-0,97;0;0;0;2414;2140;-274
14406;23.08.2017;'06 - 07;36,93;35,89;1,04;263;263;0;2365;2340;-25
14407;23.08.2017;'07 - 08;40,92;39,41;1,51;2729;2852;123;2244;2330;86
14408;23.08.2017;'08 - 09;43,36;39,92;3,44;7874;8046;172;1780;1810;30
14409;23.08.2017;'09 - 10;40,72;40,37;0,35;13816;14141;325;1219;880;-339
14410;23.08.2017;'10 - 11;38,24;41,3;-3,06;18826;19503;677;1052;836;-216
14411;23.08.2017;'11 - 12;37,5;39,3;-1,8;22268;23200;932;1051;1151;100
14412;23.08.2017;'12 - 13;36,25;36,15;0,1;24016;24913;897;1150;1234;84
14413;23.08.2017;'13 - 14;34;34,22;-0,22;24455;25365;910;1275;1315;40
14414;23.08.2017;'14 - 15;32,5;33,5;-1;23575;24362;787;1367;1521;154
14415;23.08.2017;'15 - 16;34,1;34,13;-0,03;21156;21662;506;1419;1886;467
14416;23.08.2017;'16 - 17;37,06;37,16;-0,1;17237;17237;0;1519;2217;698
14417;23.08.2017;'17 - 18;40,24;41,96;-1,72;11691;11338;-353;1757;2457;700
14418;23.08.2017;'18 - 19;45,94;48,48;-2,54;5604;5115;-489;2261;2623;362
14419;23.08.2017;'19 - 20;48,05;49,41;-1,36;1344;1162;-182;3084;3132;48
14420;23.08.2017;'20 - 21;44,9;46,18;-1,28;93;34;-59;4445;4847;402
14421;23.08.2017;'21 - 22;41,92;42,64;-0,72;0;0;0;6248;6883;635
14422;23.08.2017;'22 - 23;35,96;38,53;-2,57;0;0;0;7842;8342;500
14423;23.08.2017;'23 - 24;31,29;34,41;-3,12;0;0;0;8881;9127;246
14424;24.08.2017;'00 - 01;29,99;33,2;-3,21;0;0;0;8538;9516;978
14425;24.08.2017;'01 - 02;29,48;31,31;-1,83;0;0;0;8661;9594;933
14426;24.08.2017;'02 - 03;28,1;30,75;-2,65;0;0;0;8756;9070;314
14427;24.08.2017;'03 - 04;27,73;29,56;-1,83;0;0;0;8371;8674;303
14428;24.08.2017;'04 - 05;28;29,35;-1,35;0;0;0;7955;8241;286
14429;24.08.2017;'05 - 06;30,27;33,73;-3,46;0;0;0;7676;8341;665
14430;24.08.2017;'06 - 07;36,45;38,43;-1,98;195;186;-9;7629;8734;1105
14431;24.08.2017;'07 - 08;39,42;44,2;-4,78;2081;2158;77;7489;8811;1322
14432;24.08.2017;'08 - 09;42,14;46,35;-4,21;5829;5857;28;6890;7892;1002
14433;24.08.2017;'09 - 10;42,09;45,13;-3,04;10127;9790;-337;6345;6869;524
14434;24.08.2017;'10 - 11;40,7;44,86;-4,16;13936;13326;-610;6821;6855;34
14435;24.08.2017;'11 - 12;39,94;45,29;-5,35;16759;16257;-502;7605;7746;141
14436;24.08.2017;'12 - 13;32,38;38,67;-6,29;18387;17998;-389;8386;8485;99
14437;24.08.2017;'13 - 14;29,63;34,21;-4,58;18808;18735;-73;9386;8656;-730
14438;24.08.2017;'14 - 15;29,69;34,44;-4,75;18119;18431;312;10135;8945;-1190
14439;24.08.2017;'15 - 16;29,8;36,96;-7,16;16137;16748;611;10453;9430;-1023
14440;24.08.2017;'16 - 17;31,76;37,09;-5,33;13042;13356;314;10387;9400;-987
14441;24.08.2017;'17 - 18;39,7;43,17;-3,47;8941;8577;-364;9831;9195;-636
14442;24.08.2017;'18 - 19;42,75;45,42;-2,67;4473;3978;-495;8761;8498;-263
14443;24.08.2017;'19 - 20;44,89;47,56;-2,67;1122;919;-203;7613;7162;-451
14444;24.08.2017;'20 - 21;44,55;48,9;-4,35;65;25;-40;6882;6594;-288
14445;24.08.2017;'21 - 22;42,91;45,26;-2,35;0;0;0;6490;6572;82
14446;24.08.2017;'22 - 23;39,22;40,79;-1,57;0;0;0;6236;6618;382
14447;24.08.2017;'23 - 24;33,96;33,83;0,13;0;0;0;6032;6304;272
14448;25.08.2017;'00 - 01;33,43;36,59;-3,16;0;0;0;5308;5881;573
14449;25.08.2017;'01 - 02;31,31;34,75;-3,44;0;0;0;5032;5662;630
14450;25.08.2017;'02 - 03;30,13;32,86;-2,73;0;0;0;4935;5124;189
14451;25.08.2017;'03 - 04;29,51;31,61;-2,1;0;0;0;4703;4868;165
14452;25.08.2017;'04 - 05;29,94;32,17;-2,23;0;0;0;4530;4778;248
14453;25.08.2017;'05 - 06;32,28;34,62;-2,34;0;0;0;4330;4806;476
14454;25.08.2017;'06 - 07;38,05;39,81;-1,76;202;194;-8;4061;4951;890
14455;25.08.2017;'07 - 08;42,97;43,22;-0,25;2315;2345;30;3772;4721;949
14456;25.08.2017;'08 - 09;44,9;43,06;1,84;6777;6474;-303;3407;3932;525
14457;25.08.2017;'09 - 10;44,67;45,35;-0,68;12016;11964;-52;3177;3376;199
14458;25.08.2017;'10 - 11;41,77;43,54;-1,77;16616;17047;431;3393;3956;563
14459;25.08.2017;'11 - 12;39,87;38,78;1,09;19791;20864;1073;3653;4826;1173
14460;25.08.2017;'12 - 13;37,92;33,24;4,68;21338;22536;1198;3815;5111;1296
14461;25.08.2017;'13 - 14;34,98;30,14;4,84;21380;22852;1472;3806;5086;1280
14462;25.08.2017;'14 - 15;33,09;30,7;2,39;20072;21422;1350;3652;4588;936
14463;25.08.2017;'15 - 16;33,99;33,03;0,96;17577;18454;877;3342;3770;428
14464;25.08.2017;'16 - 17;36,04;35,43;0,61;14090;14133;43;2915;3039;124
14465;25.08.2017;'17 - 18;40,41;44,62;-4,21;9535;8845;-690;2440;2464;24
14466;25.08.2017;'18 - 19;43,98;47,95;-3,97;4645;3946;-699;2015;2012;-3
14467;25.08.2017;'19 - 20;45,7;49,58;-3,88;1096;811;-285;1780;1373;-407
14468;25.08.2017;'20 - 21;45,4;48,45;-3,05;56;18;-38;1877;1528;-349
14469;25.08.2017;'21 - 22;42,91;45,01;-2,1;0;0;0;2231;1789;-442
14470;25.08.2017;'22 - 23;39,7;43,02;-3,32;0;0;0;2621;2058;-563
14471;25.08.2017;'23 - 24;35,43;38,57;-3,14;0;0;0;2910;2118;-792
14472;26.08.2017;'00 - 01;34,75;37,82;-3,07;0;0;0;2499;2075;-424
14473;26.08.2017;'01 - 02;32,21;37,97;-5,76;0;0;0;2531;2232;-299
14474;26.08.2017;'02 - 03;31,38;35,93;-4,55;0;0;0;2642;2580;-62
14475;26.08.2017;'03 - 04;30,89;35,6;-4,71;0;0;0;2661;2707;46
14476;26.08.2017;'04 - 05;30,61;35,44;-4,83;0;0;0;2702;2711;9
14477;26.08.2017;'05 - 06;30,29;36,04;-5,75;0;0;0;2732;2761;29
14478;26.08.2017;'06 - 07;30,47;35,82;-5,35;165;142;-23;2704;3020;316
14479;26.08.2017;'07 - 08;31,04;36,77;-5,73;2074;2016;-58;2556;3216;660
14480;26.08.2017;'08 - 09;34,82;39,99;-5,17;6250;5791;-459;2078;2850;772
14481;26.08.2017;'09 - 10;35,96;40,05;-4,09;11021;10272;-749;1410;1558;148
14482;26.08.2017;'10 - 11;35,65;39,53;-3,88;15145;14342;-803;1124;1009;-115
14483;26.08.2017;'11 - 12;34,99;40,33;-5,34;18108;17322;-786;1248;906;-342
14484;26.08.2017;'12 - 13;31,52;35,67;-4,15;19703;19524;-179;1450;926;-524
14485;26.08.2017;'13 - 14;30,78;33,13;-2,35;19711;20352;641;1635;1075;-560
14486;26.08.2017;'14 - 15;30,23;31,14;-0,91;18541;19435;894;1790;1242;-548
14487;26.08.2017;'15 - 16;31,92;31,48;0,44;16279;16767;488;1918;1416;-502
14488;26.08.2017;'16 - 17;32,17;32,54;-0,37;12983;12924;-59;1984;1454;-530
14489;26.08.2017;'17 - 18;36,82;36,69;0,13;8667;8404;-263;1879;1478;-401
14490;26.08.2017;'18 - 19;39,67;42,75;-3,08;4140;3914;-226;1717;1366;-351
14491;26.08.2017;'19 - 20;42;44,1;-2,1;925;797;-128;1705;1577;-128
14492;26.08.2017;'20 - 21;42,38;43,34;-0,96;45;18;-27;1800;1942;142
14493;26.08.2017;'21 - 22;39,97;40,91;-0,94;0;0;0;1965;1939;-26
14494;26.08.2017;'22 - 23;38,44;40,53;-2,09;0;0;0;2188;2212;24
14495;26.08.2017;'23 - 24;34,9;37,48;-2,58;0;0;0;2481;2706;225
14496;27.08.2017;'00 - 01;34,95;32,92;2,03;0;0;0;2751;3634;883
14497;27.08.2017;'01 - 02;31,88;29,76;2,12;0;0;0;3333;4992;1659
14498;27.08.2017;'02 - 03;30,01;24,04;5,97;0;0;0;4104;6595;2491
14499;27.08.2017;'03 - 04;28,71;20,21;8,5;0;0;0;4533;7304;2771
14500;27.08.2017;'04 - 05;29,32;19,92;9,4;0;0;0;4683;7824;3141
14501;27.08.2017;'05 - 06;28,82;20,68;8,14;0;0;0;4670;7935;3265
14502;27.08.2017;'06 - 07;29,67;21,65;8,02;153;150;-3;4471;7579;3108
14503;27.08.2017;'07 - 08;28,46;22,67;5,79;1936;2046;110;4152;6565;2413
14504;27.08.2017;'08 - 09;29,44;26,55;2,89;5732;5714;-18;3741;5326;1585
14505;27.08.2017;'09 - 10;26,04;22,63;3,41;9992;10513;521;3408;5330;1922
14506;27.08.2017;'10 - 11;22,18;15,93;6,25;13569;14941;1372;3663;6152;2489
14507;27.08.2017;'11 - 12;22,06;8,27;13,79;16009;17904;1895;4233;6292;2059
14508;27.08.2017;'12 - 13;20,74;7,61;13,13;17437;18935;1498;4790;6597;1807
14509;27.08.2017;'13 - 14;25,42;9,22;16,2;17774;18954;1180;5343;7231;1888
14510;27.08.2017;'14 - 15;23,89;12,03;11,86;16951;17510;559;5726;7486;1760
14511;27.08.2017;'15 - 16;27;18,9;8,1;14820;15148;328;5868;7277;1409
14512;27.08.2017;'16 - 17;28,74;25,08;3,66;11875;12597;722;5698;6688;990
14513;27.08.2017;'17 - 18;30,63;29,44;1,19;8096;8493;397;5195;5876;681
14514;27.08.2017;'18 - 19;35,2;35,06;0,14;3949;4062;113;4318;4534;216
14515;27.08.2017;'19 - 20;38,96;42,3;-3,34;878;861;-17;3385;3029;-356
14516;27.08.2017;'20 - 21;42,21;41,89;0,32;37;17;-20;2889;2692;-197
14517;27.08.2017;'21 - 22;42,43;41,93;0,5;0;0;0;2678;2561;-117
14518;27.08.2017;'22 - 23;38;39,9;-1,9;0;0;0;2564;2432;-132
14519;27.08.2017;'23 - 24;35,98;35,56;0,42;0;0;0;2446;2370;-76
14520;28.08.2017;'00 - 01;33,54;33,61;-0,07;0;0;0;2341;2225;-116
14521;28.08.2017;'01 - 02;30,94;31,71;-0,77;0;0;0;2221;2155;-66
14522;28.08.2017;'02 - 03;30,64;30,66;-0,02;0;0;0;2180;2168;-12
14523;28.08.2017;'03 - 04;30,4;29,57;0,83;0;0;0;1939;2045;106
14524;28.08.2017;'04 - 05;30,42;29,39;1,03;0;0;0;1768;1917;149
14525;28.08.2017;'05 - 06;31,99;30,55;1,44;0;0;0;1621;1741;120
14526;28.08.2017;'06 - 07;41,99;37,66;4,33;156;148;-8;1505;1619;114
14527;28.08.2017;'07 - 08;43,98;42,89;1,09;2147;2279;132;1416;1552;136
14528;28.08.2017;'08 - 09;45,56;43,17;2,39;6707;6911;204;1090;1324;234
14529;28.08.2017;'09 - 10;44,97;41,12;3,85;12154;12737;583;602;762;160
14530;28.08.2017;'10 - 11;43,5;38,21;5,29;16852;17716;864;402;606;204
14531;28.08.2017;'11 - 12;40,06;33,92;6,14;20150;21011;861;397;598;201
14532;28.08.2017;'12 - 13;35,63;33,75;1,88;21740;22546;806;440;559;119
14533;28.08.2017;'13 - 14;32,4;36,36;-3,96;21789;22866;1077;467;509;42
14534;28.08.2017;'14 - 15;31,5;34,61;-3,11;20600;21850;1250;487;546;59
14535;28.08.2017;'15 - 16;36,95;36,26;0,69;18185;19333;1148;487;571;84
14536;28.08.2017;'16 - 17;39,51;38,37;1,14;14696;15510;814;513;583;70
14537;28.08.2017;'17 - 18;44,53;45,9;-1,37;9891;10252;361;575;500;-75
14538;28.08.2017;'18 - 19;46,6;49,53;-2,93;4626;4616;-10;720;364;-356
14539;28.08.2017;'19 - 20;50;52,88;-2,88;940;842;-98;1078;542;-536
14540;28.08.2017;'20 - 21;47,59;52,45;-4,86;39;14;-25;1757;1366;-391
14541;28.08.2017;'21 - 22;44,26;48,07;-3,81;0;0;0;2796;2723;-73
14542;28.08.2017;'22 - 23;38,99;42,24;-3,25;0;0;0;3838;4330;492
14543;28.08.2017;'23 - 24;32;32,88;-0,88;0;0;0;4597;5520;923
14544;29.08.2017;'00 - 01;30,86;34,06;-3,2;0;0;0;5398;6291;893
14545;29.08.2017;'01 - 02;30,2;33,08;-2,88;0;0;0;5854;6488;634
14546;29.08.2017;'02 - 03;29,96;31,9;-1,94;0;0;0;6138;6748;610
14547;29.08.2017;'03 - 04;29,31;30,11;-0,8;0;0;0;6110;6756;646
14548;29.08.2017;'04 - 05;29,38;30,86;-1,48;0;0;0;6028;6291;263
14549;29.08.2017;'05 - 06;30,77;32,91;-2,14;0;0;0;5954;5929;-25
14550;29.08.2017;'06 - 07;35;37,45;-2,45;146;124;-22;5816;5896;80
14551;29.08.2017;'07 - 08;42,07;44,21;-2,14;2279;2441;162;5468;5602;134
14552;29.08.2017;'08 - 09;45,54;45,7;-0,16;7647;7685;38;4475;4386;-89
14553;29.08.2017;'09 - 10;42,99;43,05;-0,06;13986;13949;-37;3076;2172;-904
14554;29.08.2017;'10 - 11;38,97;40,19;-1,22;19375;19354;-21;2427;1640;-787
14555;29.08.2017;'11 - 12;35,58;36,77;-1,19;23088;23062;-26;2482;2158;-324
14556;29.08.2017;'12 - 13;31,32;33,38;-2,06;25019;24866;-153;2774;2850;76
14557;29.08.2017;'13 - 14;32,1;35;-2,9;25327;25087;-240;3083;3523;440
14558;29.08.2017;'14 - 15;32,49;35,43;-2,94;24136;23750;-386;3149;3864;715
14559;29.08.2017;'15 - 16;33;36,01;-3,01;21305;20920;-385;3030;3784;754
14560;29.08.2017;'16 - 17;37,68;39,1;-1,42;16983;16464;-519;2812;3155;343
14561;29.08.2017;'17 - 18;45,47;45,65;-0,18;11163;10620;-543;2546;2612;66
14562;29.08.2017;'18 - 19;49,01;48,93;0,08;4993;4548;-445;2391;2064;-327
14563;29.08.2017;'19 - 20;52,47;52,65;-0,18;946;712;-234;2561;1740;-821
14564;29.08.2017;'20 - 21;49,98;51,25;-1,27;33;3;-30;3112;2294;-818
14565;29.08.2017;'21 - 22;45,87;46,16;-0,29;0;0;0;3959;3331;-628
14566;29.08.2017;'22 - 23;40,04;41,48;-1,44;0;0;0;4947;4315;-632
14567;29.08.2017;'23 - 24;32,82;33,16;-0,34;0;0;0;5828;5157;-671
14568;30.08.2017;'00 - 01;32,98;34,97;-1,99;0;0;0;5247;5672;425
14569;30.08.2017;'01 - 02;30,26;31,38;-1,12;0;0;0;5545;6222;677
14570;30.08.2017;'02 - 03;29,83;29,23;0,6;0;0;0;5767;6504;737
14571;30.08.2017;'03 - 04;29,56;28,64;0,92;0;0;0;5649;6580;931
14572;30.08.2017;'04 - 05;29,6;28,12;1,48;0;0;0;5557;6192;635
14573;30.08.2017;'05 - 06;30,82;29,8;1,02;0;0;0;5611;5730;119
14574;30.08.2017;'06 - 07;36,51;37,74;-1,23;144;134;-10;5713;5834;121
14575;30.08.2017;'07 - 08;42;44,63;-2,63;2209;2354;145;5729;6182;453
14576;30.08.2017;'08 - 09;44,43;45,56;-1,13;7053;6992;-61;5234;5714;480
14577;30.08.2017;'09 - 10;43,97;45,3;-1,33;12752;12239;-513;4321;4168;-153
14578;30.08.2017;'10 - 11;43,39;45,64;-2,25;17552;16237;-1315;3995;3467;-528
14579;30.08.2017;'11 - 12;39,91;54,76;-14,85;20739;18703;-2036;4320;4260;-60
14580;30.08.2017;'12 - 13;33;44,77;-11,77;22207;20162;-2045;4927;5538;611
14581;30.08.2017;'13 - 14;32,75;37,58;-4,83;22007;19999;-2008;5724;6872;1148
14582;30.08.2017;'14 - 15;32,83;36,39;-3,56;20413;18296;-2117;6539;7788;1249
14583;30.08.2017;'15 - 16;32,14;39,52;-7,38;17459;15521;-1938;7234;7898;664
14584;30.08.2017;'16 - 17;37,4;45,6;-8,2;13477;11546;-1931;7990;7864;-126
14585;30.08.2017;'17 - 18;40,56;46,62;-6,06;8475;6751;-1724;8774;8236;-538
14586;30.08.2017;'18 - 19;42,39;46,52;-4,13;3580;2772;-808;9620;8953;-667
14587;30.08.2017;'19 - 20;42,4;45,27;-2,87;643;415;-228;10590;9816;-774
14588;30.08.2017;'20 - 21;41,39;44,7;-3,31;16;3;-13;11296;11477;181
14589;30.08.2017;'21 - 22;37,04;41,38;-4,34;0;0;0;11859;12199;340
14590;30.08.2017;'22 - 23;32,48;32,32;0,16;0;0;0;12061;12341;280
14591;30.08.2017;'23 - 24;30,89;31,24;-0,35;0;0;0;11824;12128;304
14592;31.08.2017;'00 - 01;31;27,36;3,64;0;0;0;8406;12310;3904
14593;31.08.2017;'01 - 02;29,97;23,33;6,64;0;0;0;7757;12384;4627
14594;31.08.2017;'02 - 03;29,75;22,76;6,99;0;0;0;7563;12420;4857
14595;31.08.2017;'03 - 04;28,83;21,92;6,91;0;0;0;7499;12775;5276
14596;31.08.2017;'04 - 05;28,89;19,95;8,94;0;0;0;7553;12302;4749
14597;31.08.2017;'05 - 06;30,06;21,25;8,81;0;0;0;7658;10884;3226
14598;31.08.2017;'06 - 07;34,15;27,84;6,31;89;78;-11;7757;9992;2235
14599;31.08.2017;'07 - 08;39,92;36,01;3,91;1172;1274;102;7921;9640;1719
14600;31.08.2017;'08 - 09;43,28;40,36;2,92;3503;3802;299;8209;9112;903
14601;31.08.2017;'09 - 10;44,92;42,52;2,4;6105;6587;482;8774;9222;448
14602;31.08.2017;'10 - 11;44,08;40,11;3,97;8144;8517;373;9809;10530;721
14603;31.08.2017;'11 - 12;44,8;40,02;4,78;9574;9024;-550;10624;10893;269
14604;31.08.2017;'12 - 13;42,98;40,38;2,6;10284;9348;-936;11219;10632;-587
14605;31.08.2017;'13 - 14;41,97;40,11;1,86;10182;8827;-1355;12007;10612;-1395
14606;31.08.2017;'14 - 15;40,06;38,74;1,32;9444;7156;-2288;12164;10815;-1349
14607;31.08.2017;'15 - 16;41,97;40,22;1,75;8089;5958;-2131;11531;10790;-741
14608;31.08.2017;'16 - 17;41,94;39,89;2,05;6142;4774;-1368;10845;10451;-394
14609;31.08.2017;'17 - 18;42,05;38,36;3,69;3880;3260;-620;9884;9483;-401
14610;31.08.2017;'18 - 19;43,6;39,87;3,73;1766;1754;-12;8610;7918;-692
14611;31.08.2017;'19 - 20;43,8;40,51;3,29;370;430;60;7359;6251;-1108
14612;31.08.2017;'20 - 21;44,09;41,1;2,99;9;5;-4;6421;5126;-1295
14613;31.08.2017;'21 - 22;41,92;39,45;2,47;0;0;0;5922;4252;-1670
14614;31.08.2017;'22 - 23;35,59;35,86;-0,27;0;0;0;5511;3976;-1535
14615;31.08.2017;'23 - 24;33,41;30,49;2,92;0;0;0;5132;3743;-1389
14616;01.09.2017;'00 - 01;33,09;29,26;3,83;0;0;0;3559;3489;-70
14617;01.09.2017;'01 - 02;31,07;28,56;2,51;0;0;0;3263;3189;-74
14618;01.09.2017;'02 - 03;29,89;27,84;2,05;0;0;0;3040;3106;66
14619;01.09.2017;'03 - 04;29,64;27,32;2,32;0;0;0;2679;2847;168
14620;01.09.2017;'04 - 05;29,65;26,21;3,44;0;0;0;2329;2565;236
14621;01.09.2017;'05 - 06;31,71;28,43;3,28;0;0;0;2027;2204;177
14622;01.09.2017;'06 - 07;36,04;31,28;4,76;54;42;-12;1730;1950;220
14623;01.09.2017;'07 - 08;43,46;38,2;5,26;855;929;74;1414;1616;202
14624;01.09.2017;'08 - 09;45,83;40,29;5,54;3056;3090;34;1068;1259;191
14625;01.09.2017;'09 - 10;45,12;40,74;4,38;5710;5769;59;792;794;2
14626;01.09.2017;'10 - 11;44,9;38,68;6,22;8199;8650;451;696;638;-58
14627;01.09.2017;'11 - 12;45,02;38,88;6,14;10068;9962;-106;693;634;-59
14628;01.09.2017;'12 - 13;44,87;38,88;5,99;11120;10298;-822;743;665;-78
14629;01.09.2017;'13 - 14;43,09;38,55;4,54;11212;10258;-954;796;744;-52
14630;01.09.2017;'14 - 15;39,91;37,63;2,28;10609;9967;-642;844;856;12
14631;01.09.2017;'15 - 16;38,93;35,44;3,49;9337;8847;-490;907;1066;159
14632;01.09.2017;'16 - 17;38,56;33,8;4,76;7445;7583;138;1017;1227;210
14633;01.09.2017;'17 - 18;40,36;33,78;6,58;5010;5262;252;1113;1290;177
14634;01.09.2017;'18 - 19;42,2;35,13;7,07;2367;2350;-17;1176;1360;184
14635;01.09.2017;'19 - 20;43,74;37,27;6,47;469;398;-71;1288;1326;38
14636;01.09.2017;'20 - 21;43,95;36,94;7,01;10;2;-8;1424;1515;91
14637;01.09.2017;'21 - 22;39,4;34,93;4,47;0;0;0;1554;1529;-25
14638;01.09.2017;'22 - 23;36,21;34,31;1,9;0;0;0;1606;1394;-212
14639;01.09.2017;'23 - 24;34,51;32,98;1,53;0;0;0;1612;1237;-375
14640;02.09.2017;'00 - 01;32,22;34,62;-2,4;0;0;0;1526;1191;-335
14641;02.09.2017;'01 - 02;31,73;33,75;-2,02;0;0;0;1528;1220;-308
14642;02.09.2017;'02 - 03;30,06;30,98;-0,92;0;0;0;1689;1257;-432
14643;02.09.2017;'03 - 04;29,64;30,55;-0,91;0;0;0;1745;1271;-474
14644;02.09.2017;'04 - 05;29,48;30,2;-0,72;0;0;0;1801;1252;-549
14645;02.09.2017;'05 - 06;29,99;31,53;-1,54;0;0;0;1841;1219;-622
14646;02.09.2017;'06 - 07;31,1;32,88;-1,78;65;56;-9;1803;1255;-548
14647;02.09.2017;'07 - 08;32,39;32,64;-0,25;1288;1307;19;1669;1300;-369
14648;02.09.2017;'08 - 09;35,1;32,19;2,91;4475;4280;-195;1430;1121;-309
14649;02.09.2017;'09 - 10;38;36,02;1,98;8353;8176;-177;1203;642;-561
14650;02.09.2017;'10 - 11;38,15;37,04;1,11;11740;11566;-174;1225;646;-579
14651;02.09.2017;'11 - 12;38,03;35,11;2,92;14081;13440;-641;1385;1020;-365
14652;02.09.2017;'12 - 13;35,37;34,22;1,15;15297;13562;-1735;1578;1536;-42
14653;02.09.2017;'13 - 14;33;32,48;0,52;15373;12914;-2459;1791;1882;91
14654;02.09.2017;'14 - 15;31,78;32,21;-0,43;14385;12370;-2015;2053;2271;218
14655;02.09.2017;'15 - 16;30,97;31,43;-0,46;12370;10702;-1668;2355;2449;94
14656;02.09.2017;'16 - 17;31,5;32,86;-1,36;9745;8655;-1090;2647;2378;-269
14657;02.09.2017;'17 - 18;32,99;32,07;0,92;6463;5895;-568;2727;2533;-194
14658;02.09.2017;'18 - 19;37,25;33,58;3,67;2965;2794;-171;2583;2246;-337
14659;02.09.2017;'19 - 20;40,32;37,25;3,07;544;468;-76;2427;1822;-605
14660;02.09.2017;'20 - 21;40,52;38,61;1,91;10;4;-6;2288;1742;-546
14661;02.09.2017;'21 - 22;38,02;36,19;1,83;0;0;0;2233;1789;-444
14662;02.09.2017;'22 - 23;35,65;34,32;1,33;0;0;0;2154;1677;-477
14663;02.09.2017;'23 - 24;31,02;31,18;-0,16;0;0;0;2050;1448;-602
14664;03.09.2017;'00 - 01;32,85;28,03;4,82;0;0;0;1822;1303;-519
14665;03.09.2017;'01 - 02;27,84;29,03;-1,19;0;0;0;1620;1314;-306
14666;03.09.2017;'02 - 03;29,8;27,41;2,39;0;0;0;1583;1468;-115
14667;03.09.2017;'03 - 04;28,12;25,99;2,13;0;0;0;1495;1503;8
14668;03.09.2017;'04 - 05;27,6;24,58;3,02;0;0;0;1419;1413;-6
14669;03.09.2017;'05 - 06;27,64;24,29;3,35;0;0;0;1342;1273;-69
14670;03.09.2017;'06 - 07;28,08;26,12;1,96;83;61;-22;1263;1288;25
14671;03.09.2017;'07 - 08;27,63;23,15;4,48;1687;1499;-188;1179;1224;45
14672;03.09.2017;'08 - 09;29,45;27,77;1,68;5914;4956;-958;994;866;-128
14673;03.09.2017;'09 - 10;30,25;30,16;0,09;11068;9722;-1346;793;420;-373
14674;03.09.2017;'10 - 11;29,32;30,28;-0,96;15405;14326;-1079;756;344;-412
14675;03.09.2017;'11 - 12;30,09;27,96;2,13;18237;17315;-922;848;435;-413
14676;03.09.2017;'12 - 13;30,7;28,98;1,72;19642;18107;-1535;973;564;-409
14677;03.09.2017;'13 - 14;26,26;24,54;1,72;19693;18145;-1548;1080;749;-331
14678;03.09.2017;'14 - 15;25,95;23,99;1,96;18350;17195;-1155;1170;973;-197
14679;03.09.2017;'15 - 16;25;21,29;3,71;15803;15200;-603;1210;1171;-39
14680;03.09.2017;'16 - 17;26,46;23,82;2,64;12472;11979;-493;1292;1214;-78
14681;03.09.2017;'17 - 18;29,73;28;1,73;8173;7785;-388;1322;1026;-296
14682;03.09.2017;'18 - 19;34,15;35,19;-1,04;3606;3426;-180;1216;798;-418
14683;03.09.2017;'19 - 20;38,88;38,55;0,33;606;477;-129;1125;576;-549
14684;03.09.2017;'20 - 21;42,27;40,27;2;9;1;-8;1147;743;-404
14685;03.09.2017;'21 - 22;39,91;38,23;1,68;0;0;0;1292;1106;-186
14686;03.09.2017;'22 - 23;38,42;37,14;1,28;0;0;0;1428;1392;-36
14687;03.09.2017;'23 - 24;33,43;30,39;3,04;0;0;0;1515;1684;169
14688;04.09.2017;'00 - 01;31,03;27,84;3,19;0;0;0;1783;1918;135
14689;04.09.2017;'01 - 02;29,72;27,28;2,44;0;0;0;1868;2031;163
14690;04.09.2017;'02 - 03;29,41;26,69;2,72;0;0;0;2027;2228;201
14691;04.09.2017;'03 - 04;27,77;24,35;3,42;0;0;0;2079;2396;317
14692;04.09.2017;'04 - 05;28,09;25,95;2,14;0;0;0;2166;2596;430
14693;04.09.2017;'05 - 06;30,4;27,59;2,81;0;0;0;2293;2673;380
14694;04.09.2017;'06 - 07;39,67;35,82;3,85;84;69;-15;2367;2836;469
14695;04.09.2017;'07 - 08;43,92;40,54;3,38;1845;1930;85;2339;3092;753
14696;04.09.2017;'08 - 09;42,95;43,29;-0,34;7002;6778;-224;2188;2630;442
14697;04.09.2017;'09 - 10;42,04;40,83;1,21;13293;12743;-550;2070;1840;-230
14698;04.09.2017;'10 - 11;38,85;39,65;-0,8;18368;18062;-306;2237;2087;-150
14699;04.09.2017;'11 - 12;35,17;38,53;-3,36;21500;21832;332;2599;2851;252
14700;04.09.2017;'12 - 13;32,36;34,65;-2,29;22814;23142;328;2979;3534;555
14701;04.09.2017;'13 - 14;32,95;33,71;-0,76;22278;22297;19;3360;4125;765
14702;04.09.2017;'14 - 15;33,23;33,37;-0,14;20274;20313;39;3639;4542;903
14703;04.09.2017;'15 - 16;35,26;35,72;-0,46;17247;16968;-279;3777;4822;1045
14704;04.09.2017;'16 - 17;36,6;37,56;-0,96;13522;12853;-669;3764;4934;1170
14705;04.09.2017;'17 - 18;39,23;41,69;-2,46;8606;7793;-813;3585;4605;1020
14706;04.09.2017;'18 - 19;42,91;44,9;-1,99;3599;2983;-616;3314;3975;661
14707;04.09.2017;'19 - 20;45,48;44,76;0,72;559;360;-199;3117;3248;131
14708;04.09.2017;'20 - 21;45,71;46,13;-0,42;7;0;-7;3176;3372;196
14709;04.09.2017;'21 - 22;42,3;44,92;-2,62;0;0;0;3472;3458;-14
14710;04.09.2017;'22 - 23;38,93;39,8;-0,87;0;0;0;3770;3532;-238
14711;04.09.2017;'23 - 24;33,22;34,65;-1,43;0;0;0;4011;3774;-237
14712;05.09.2017;'00 - 01;31,92;29,97;1,95;0;0;0;3456;3950;494
14713;05.09.2017;'01 - 02;29,93;29,59;0,34;0;0;0;3549;3942;393
14714;05.09.2017;'02 - 03;29,7;29,91;-0,21;0;0;0;3780;3930;150
14715;05.09.2017;'03 - 04;29,62;30,43;-0,81;0;0;0;3753;4304;551
14716;05.09.2017;'04 - 05;29,68;28,8;0,88;0;0;0;3711;4842;1131
14717;05.09.2017;'05 - 06;31,02;29,99;1,03;0;0;0;3764;4930;1166
14718;05.09.2017;'06 - 07;36,37;33,94;2,43;70;56;-14;3890;4992;1102
14719;05.09.2017;'07 - 08;42,39;41,38;1,01;1578;1551;-27;3985;5087;1102
14720;05.09.2017;'08 - 09;44,05;42,97;1,08;5533;5143;-390;3898;4476;578
14721;05.09.2017;'09 - 10;42,93;41,62;1,31;10235;9974;-261;3519;3448;-71
14722;05.09.2017;'10 - 11;41,26;39,13;2,13;14311;14637;326;3247;2911;-336
14723;05.09.2017;'11 - 12;41,76;38,52;3,24;17145;18120;975;3372;3348;-24
14724;05.09.2017;'12 - 13;38,49;34,85;3,64;18575;19696;1121;3742;3883;141
14725;05.09.2017;'13 - 14;37,25;33,4;3,85;18464;18800;336;4050;4203;153
14726;05.09.2017;'14 - 15;36,67;32,53;4,14;16962;16546;-416;4178;4232;54
14727;05.09.2017;'15 - 16;38,43;34,86;3,57;14219;13266;-953;4141;4220;79
14728;05.09.2017;'16 - 17;39,05;37,01;2,04;10619;9712;-907;3973;4022;49
14729;05.09.2017;'17 - 18;40,56;37,83;2,73;6418;5654;-764;3671;3937;266
14730;05.09.2017;'18 - 19;43,04;40,1;2,94;2547;2156;-391;3517;3936;419
14731;05.09.2017;'19 - 20;44,22;40,76;3,46;381;230;-151;3625;4046;421
14732;05.09.2017;'20 - 21;44,97;40,67;4,3;2;0;-2;4031;4858;827
14733;05.09.2017;'21 - 22;40,4;36,71;3,69;0;0;0;4532;5506;974
14734;05.09.2017;'22 - 23;37,25;33;4,25;0;0;0;4960;5760;800
14735;05.09.2017;'23 - 24;32,97;30,28;2,69;0;0;0;5309;5819;510
14736;06.09.2017;'00 - 01;29,47;27,92;1,55;0;0;0;5404;5633;229
14737;06.09.2017;'01 - 02;29,06;30,35;-1,29;0;0;0;5543;5281;-262
14738;06.09.2017;'02 - 03;27,83;29,19;-1,36;0;0;0;5840;5365;-475
14739;06.09.2017;'03 - 04;26,19;28,09;-1,9;0;0;0;6107;5510;-597
14740;06.09.2017;'04 - 05;26,42;27,29;-0,87;0;0;0;6444;5839;-605
14741;06.09.2017;'05 - 06;29,19;30,54;-1,35;0;0;0;6809;6484;-325
14742;06.09.2017;'06 - 07;36,32;38,97;-2,65;31;24;-7;7211;7022;-189
14743;06.09.2017;'07 - 08;42,02;44,05;-2,03;704;678;-26;7790;8000;210
14744;06.09.2017;'08 - 09;43,73;45,74;-2,01;2667;2564;-103;8511;9651;1140
14745;06.09.2017;'09 - 10;43;41,88;1,12;5233;5122;-111;9543;11274;1731
14746;06.09.2017;'10 - 11;41;38,26;2,74;7806;7903;97;10847;14275;3428
14747;06.09.2017;'11 - 12;40,07;34,21;5,86;9940;9960;20;12201;18035;5834
14748;06.09.2017;'12 - 13;35,92;26,85;9,07;11498;11692;194;13707;20491;6784
14749;06.09.2017;'13 - 14;29,88;23,25;6,63;12235;13175;940;15592;21870;6278
14750;06.09.2017;'14 - 15;27,9;19,88;8,02;12144;12941;797;17381;24064;6683
14751;06.09.2017;'15 - 16;23,81;18;5,81;10986;11581;595;18918;25405;6487
14752;06.09.2017;'16 - 17;22,06;13,75;8,31;8695;8639;-56;20530;26496;5966
14753;06.09.2017;'17 - 18;26,81;19,09;7,72;5651;5398;-253;21331;25628;4297
14754;06.09.2017;'18 - 19;29,65;26,29;3,36;2398;2117;-281;21077;24713;3636
14755;06.09.2017;'19 - 20;35,92;34,69;1,23;361;208;-153;20216;23523;3307
14756;06.09.2017;'20 - 21;35,96;35,8;0,16;2;0;-2;19198;22996;3798
14757;06.09.2017;'21 - 22;30,96;30,58;0,38;0;0;0;18510;21919;3409
14758;06.09.2017;'22 - 23;29,67;29,3;0,37;0;0;0;18049;20598;2549
14759;06.09.2017;'23 - 24;22,07;20,72;1,35;0;0;0;17784;20312;2528
14760;07.09.2017;'00 - 01;21,54;16,03;5,51;0;0;0;18809;20638;1829
14761;07.09.2017;'01 - 02;14,96;10,79;4,17;0;0;0;18509;19801;1292
14762;07.09.2017;'02 - 03;13,12;13,1;0,02;0;0;0;18291;18880;589
14763;07.09.2017;'03 - 04;11,76;13,5;-1,74;0;0;0;17874;17835;-39
14764;07.09.2017;'04 - 05;13,82;17,09;-3,27;0;0;0;17372;17136;-236
14765;07.09.2017;'05 - 06;22,01;23,89;-1,88;0;0;0;16851;16559;-292
14766;07.09.2017;'06 - 07;34,63;38,88;-4,25;34;27;-7;16337;16302;-35
14767;07.09.2017;'07 - 08;40,68;43,38;-2,7;941;900;-41;15853;16054;201
14768;07.09.2017;'08 - 09;39,94;43,79;-3,85;3707;3584;-123;15568;14638;-930
14769;07.09.2017;'09 - 10;39,95;43,87;-3,92;7229;7020;-209;15528;14644;-884
14770;07.09.2017;'10 - 11;37,48;41,61;-4,13;10362;10404;42;15636;14806;-830
14771;07.09.2017;'11 - 12;38,98;40,64;-1,66;12336;12462;126;15556;15306;-250
14772;07.09.2017;'12 - 13;37,41;38,81;-1,4;13192;13048;-144;15273;15290;17
14773;07.09.2017;'13 - 14;36,8;38,28;-1,48;13012;12566;-446;14560;14764;204
14774;07.09.2017;'14 - 15;36,11;36,68;-0,57;12086;12094;8;13807;13984;177
14775;07.09.2017;'15 - 16;36,73;36,97;-0,24;10426;10815;389;12970;13430;460
14776;07.09.2017;'16 - 17;37,71;34,66;3,05;8100;8878;778;12011;12871;860
14777;07.09.2017;'17 - 18;40,37;39,19;1,18;5188;5973;785;10701;11418;717
14778;07.09.2017;'18 - 19;42,67;45,73;-3,06;2137;2461;324;9136;9342;206
14779;07.09.2017;'19 - 20;45,22;49,54;-4,32;302;265;-37;7918;8518;600
14780;07.09.2017;'20 - 21;45,99;50,02;-4,03;1;0;-1;7454;9141;1687
14781;07.09.2017;'21 - 22;41,02;40,01;1,01;0;0;0;7649;9852;2203
14782;07.09.2017;'22 - 23;38,78;36,3;2,48;0;0;0;8287;10278;1991
14783;07.09.2017;'23 - 24;33,99;33,02;0,97;0;0;0;9278;11223;1945
14784;08.09.2017;'00 - 01;29,92;29,17;0,75;0;0;0;10605;12403;1798
14785;08.09.2017;'01 - 02;27,01;27,91;-0,9;0;0;0;11891;13654;1763
14786;08.09.2017;'02 - 03;23,95;23,47;0,48;0;0;0;13306;14542;1236
14787;08.09.2017;'03 - 04;19;18,65;0,35;0;0;0;14480;15096;616
14788;08.09.2017;'04 - 05;14,09;14,96;-0,87;0;0;0;15557;16018;461
14789;08.09.2017;'05 - 06;22,24;23,45;-1,21;0;0;0;16617;17650;1033
14790;08.09.2017;'06 - 07;32,96;30;2,96;30;24;-6;17872;19748;1876
14791;08.09.2017;'07 - 08;35,93;34,03;1,9;958;975;17;19324;21232;1908
14792;08.09.2017;'08 - 09;35,14;33,04;2,1;3573;3370;-203;20860;22538;1678
14793;08.09.2017;'09 - 10;31,02;33,85;-2,83;6641;6494;-147;22345;23515;1170
14794;08.09.2017;'10 - 11;29,91;28,46;1,45;9213;9375;162;23942;25417;1475
14795;08.09.2017;'11 - 12;22,88;19,32;3,56;10812;10808;-4;25409;27758;2349
14796;08.09.2017;'12 - 13;19,04;15,42;3,62;11464;10558;-906;26418;29417;2999
14797;08.09.2017;'13 - 14;17,99;16,43;1,56;11157;10226;-931;26991;29948;2957
14798;08.09.2017;'14 - 15;15,03;16,89;-1,86;10130;9749;-381;26620;29698;3078
14799;08.09.2017;'15 - 16;22,05;19,47;2,58;8491;8559;68;25125;27166;2041
14800;08.09.2017;'16 - 17;24,3;22,14;2,16;6496;6594;98;22876;24432;1556
14801;08.09.2017;'17 - 18;30,36;28,41;1,95;4107;4061;-46;20528;21750;1222
14802;08.09.2017;'18 - 19;33,98;35,08;-1,1;1641;1483;-158;18598;19844;1246
14803;08.09.2017;'19 - 20;35,97;36,42;-0,45;214;117;-97;16947;19288;2341
14804;08.09.2017;'20 - 21;37,31;36,4;0,91;1;0;-1;15785;18863;3078
14805;08.09.2017;'21 - 22;34;30,32;3,68;0;0;0;15313;18707;3394
14806;08.09.2017;'22 - 23;30,86;24,51;6,35;0;0;0;15160;18641;3481
14807;08.09.2017;'23 - 24;28,87;21,27;7,6;0;0;0;15219;18589;3370
14808;09.09.2017;'00 - 01;27,95;29,33;-1,38;0;0;0;16202;18716;2514
14809;09.09.2017;'01 - 02;21,85;25,7;-3,85;0;0;0;15689;18097;2408
14810;09.09.2017;'02 - 03;21,09;24,12;-3,03;0;0;0;15170;16842;1672
14811;09.09.2017;'03 - 04;21,03;23,02;-1,99;0;0;0;14421;15053;632
14812;09.09.2017;'04 - 05;21,08;23,81;-2,73;0;0;0;13775;13919;144
14813;09.09.2017;'05 - 06;25,23;27,92;-2,69;0;0;0;13230;12755;-475
14814;09.09.2017;'06 - 07;27,45;29,23;-1,78;25;20;-5;12658;12488;-170
14815;09.09.2017;'07 - 08;29,93;31,71;-1,78;802;775;-27;12156;12402;246
14816;09.09.2017;'08 - 09;34,1;34,27;-0,17;2898;2570;-328;11674;12472;798
14817;09.09.2017;'09 - 10;37,08;36,25;0,83;5322;4451;-871;11207;12608;1401
14818;09.09.2017;'10 - 11;37,17;35,9;1,27;7262;5680;-1582;10944;12854;1910
14819;09.09.2017;'11 - 12;38,68;35,55;3,13;8416;6915;-1501;10779;14058;3279
14820;09.09.2017;'12 - 13;36,26;32,16;4,1;8996;8059;-937;10613;15166;4553
14821;09.09.2017;'13 - 14;33,1;22,67;10,43;8991;8442;-549;10606;16065;5459
14822;09.09.2017;'14 - 15;29,88;17,81;12,07;8512;8416;-96;10403;15456;5053
14823;09.09.2017;'15 - 16;30,85;20,5;10,35;7474;7700;226;9749;13878;4129
14824;09.09.2017;'16 - 17;32,87;30,76;2,11;5789;5604;-185;8902;11926;3024
14825;09.09.2017;'17 - 18;34,54;36,37;-1,83;3617;3242;-375;7976;9897;1921
14826;09.09.2017;'18 - 19;36,21;38,35;-2,14;1410;1223;-187;6970;7986;1016
14827;09.09.2017;'19 - 20;39,08;40,39;-1,31;178;162;-16;6183;6870;687
14828;09.09.2017;'20 - 21;41,53;43,84;-2,31;1;0;-1;5835;6998;1163
14829;09.09.2017;'21 - 22;38,99;38,65;0,34;0;0;0;5621;7519;1898
14830;09.09.2017;'22 - 23;38,94;36,18;2,76;0;0;0;5434;7914;2480
14831;09.09.2017;'23 - 24;36,81;32,43;4,38;0;0;0;5147;7384;2237
14832;10.09.2017;'00 - 01;31,06;25,21;5,85;0;0;0;4866;6992;2126
14833;10.09.2017;'01 - 02;29,56;22,87;6,69;0;0;0;4558;6552;1994
14834;10.09.2017;'02 - 03;28,23;22,71;5,52;0;0;0;4460;6702;2242
14835;10.09.2017;'03 - 04;25,9;20,68;5,22;0;0;0;4349;6402;2053
14836;10.09.2017;'04 - 05;23,73;19,84;3,89;0;0;0;4324;5936;1612
14837;10.09.2017;'05 - 06;23,17;20,2;2,97;0;0;0;4366;6346;1980
14838;10.09.2017;'06 - 07;25,92;21,64;4,28;16;14;-2;4478;7082;2604
14839;10.09.2017;'07 - 08;26,08;20,66;5,42;696;714;18;4678;7340;2662
14840;10.09.2017;'08 - 09;29,89;20,86;9,03;3139;3119;-20;4819;6327;1508
14841;10.09.2017;'09 - 10;30,28;25,76;4,52;6506;6672;166;4978;5658;680
14842;10.09.2017;'10 - 11;29,8;25,11;4,69;9927;10632;705;5537;6424;887
14843;10.09.2017;'11 - 12;29,42;20,64;8,78;12680;13808;1128;6740;8357;1617
14844;10.09.2017;'12 - 13;24,8;15,08;9,72;14399;15456;1057;8368;10658;2290
14845;10.09.2017;'13 - 14;17,24;9,96;7,28;14785;16010;1225;9985;12228;2243
14846;10.09.2017;'14 - 15;8,93;5,72;3,21;14116;14610;494;11306;13609;2303
14847;10.09.2017;'15 - 16;9,85;4,04;5,81;12392;12935;543;12139;14906;2767
14848;10.09.2017;'16 - 17;10,51;-0,39;10,9;9696;10192;496;12783;16103;3320
14849;10.09.2017;'17 - 18;13,21;5,13;8,08;6126;6483;357;12985;16205;3220
14850;10.09.2017;'18 - 19;23,28;11,4;11,88;2409;2477;68;12794;14953;2159
14851;10.09.2017;'19 - 20;30,63;24,47;6,16;273;208;-65;12891;14300;1409
14852;10.09.2017;'20 - 21;29,7;27,63;2,07;0;0;0;13877;16263;2386
14853;10.09.2017;'21 - 22;22,56;13,65;8,91;0;0;0;15873;18845;2972
14854;10.09.2017;'22 - 23;18,05;4,99;13,06;0;0;0;17975;20976;3001
14855;10.09.2017;'23 - 24;9,4;-0,79;10,19;0;0;0;19736;23162;3426
14856;11.09.2017;'00 - 01;0,43;-0,71;1,14;0;0;0;21285;24025;2740
14857;11.09.2017;'01 - 02;0;-2,87;2,87;0;0;0;22356;24967;2611
14858;11.09.2017;'02 - 03;-0,07;-4,05;3,98;0;0;0;23344;25576;2232
14859;11.09.2017;'03 - 04;-2,32;-7,34;5,02;0;0;0;23660;26112;2452
14860;11.09.2017;'04 - 05;-2,77;-7,61;4,84;0;0;0;23988;26299;2311
14861;11.09.2017;'05 - 06;4,23;-4,21;8,44;0;0;0;23994;25932;1938
14862;11.09.2017;'06 - 07;23,29;17,63;5,66;22;19;-3;23737;25832;2095
14863;11.09.2017;'07 - 08;32,9;33,72;-0,82;944;1042;98;23206;25124;1918
14864;11.09.2017;'08 - 09;36,33;36,5;-0,17;3675;4063;388;22341;23780;1439
14865;11.09.2017;'09 - 10;36,02;35,19;0,83;6954;7660;706;21535;22579;1044
14866;11.09.2017;'10 - 11;31,49;28,23;3,26;9738;10336;598;21371;22411;1040
14867;11.09.2017;'11 - 12;33;27,34;5,66;11650;12052;402;21613;22403;790
14868;11.09.2017;'12 - 13;30,07;29,01;1,06;12550;12887;337;21960;23089;1129
14869;11.09.2017;'13 - 14;23,78;26,5;-2,72;12435;13257;822;22342;23478;1136
14870;11.09.2017;'14 - 15;23,06;20,72;2,34;11662;12862;1200;22713;24070;1357
14871;11.09.2017;'15 - 16;21,98;15,92;6,06;10012;11370;1358;22768;24033;1265
14872;11.09.2017;'16 - 17;27,52;17,69;9,83;7654;8912;1258;22344;23612;1268
14873;11.09.2017;'17 - 18;30,63;23,92;6,71;4837;5564;727;21782;23064;1282
14874;11.09.2017;'18 - 19;33,94;28,59;5,35;1861;2252;391;21154;21535;381
14875;11.09.2017;'19 - 20;37,75;34,81;2,94;201;186;-15;21064;21748;684
14876;11.09.2017;'20 - 21;34,69;35,16;-0,47;0;0;0;21619;22510;891
14877;11.09.2017;'21 - 22;30,04;29,83;0,21;0;0;0;22531;24411;1880
14878;11.09.2017;'22 - 23;19,93;22,6;-2,67;0;0;0;23432;25201;1769
14879;11.09.2017;'23 - 24;9,36;10,68;-1,32;0;0;0;23977;25213;1236
14880;12.09.2017;'00 - 01;10,75;9,91;0,84;0;0;0;26601;24594;-2007
14881;12.09.2017;'01 - 02;9,03;12,65;-3,62;0;0;0;25908;23654;-2254
14882;12.09.2017;'02 - 03;6,49;12,11;-5,62;0;0;0;24904;22092;-2812
14883;12.09.2017;'03 - 04;5,33;10,67;-5,34;0;0;0;23406;20438;-2968
14884;12.09.2017;'04 - 05;8,71;12,05;-3,34;0;0;0;22064;19074;-2990
14885;12.09.2017;'05 - 06;14,9;14,43;0,47;0;0;0;21087;18073;-3014
14886;12.09.2017;'06 - 07;34,91;38,74;-3,83;17;12;-5;20292;17809;-2483
14887;12.09.2017;'07 - 08;40;40,49;-0,49;862;882;20;19808;18462;-1346
14888;12.09.2017;'08 - 09;42,46;41,74;0,72;3560;3272;-288;19756;17779;-1977
14889;12.09.2017;'09 - 10;39,98;39,53;0,45;6820;6256;-564;20021;17965;-2056
14890;12.09.2017;'10 - 11;37,05;37,44;-0,39;9825;9672;-153;20751;19464;-1287
14891;12.09.2017;'11 - 12;36,65;37,12;-0,47;12059;11927;-132;21335;21486;151
14892;12.09.2017;'12 - 13;33,45;32,52;0,93;13275;12986;-289;21274;21375;101
14893;12.09.2017;'13 - 14;30,49;28,54;1,95;13843;13406;-437;20896;20966;70
14894;12.09.2017;'14 - 15;28,58;28,12;0,46;13684;12969;-715;20661;20485;-176
14895;12.09.2017;'15 - 16;29,62;23,87;5,75;12222;12277;55;20541;19184;-1357
14896;12.09.2017;'16 - 17;30,69;23,86;6,83;9507;10248;741;20298;18971;-1327
14897;12.09.2017;'17 - 18;35,25;27,09;8,16;5926;6529;603;19425;18779;-646
14898;12.09.2017;'18 - 19;41,49;35,41;6,08;2214;2412;198;17866;17296;-570
14899;12.09.2017;'19 - 20;45,89;39,23;6,66;222;183;-39;16597;16761;164
14900;12.09.2017;'20 - 21;45,52;39,63;5,89;0;0;0;16041;17094;1053
14901;12.09.2017;'21 - 22;36,94;32,85;4,09;0;0;0;16378;17797;1419
14902;12.09.2017;'22 - 23;34,11;32,93;1,18;0;0;0;16866;18097;1231
14903;12.09.2017;'23 - 24;28,1;24,37;3,73;0;0;0;17504;19350;1846
14904;13.09.2017;'00 - 01;19,02;4,87;14,15;0;0;0;18080;20356;2276
14905;13.09.2017;'01 - 02;12,08;-1,6;13,68;0;0;0;19047;21655;2608
14906;13.09.2017;'02 - 03;10,71;-10,23;20,94;0;0;0;20697;22678;1981
14907;13.09.2017;'03 - 04;5,48;-1,79;7,27;0;0;0;22404;23824;1420
14908;13.09.2017;'04 - 05;8,33;-4,91;13,24;0;0;0;24446;25756;1310
14909;13.09.2017;'05 - 06;14,01;1,61;12,4;0;0;0;27184;27973;789
14910;13.09.2017;'06 - 07;23,01;14,29;8,72;12;6;-6;29998;31118;1120
14911;13.09.2017;'07 - 08;28,72;9,1;19,62;560;683;123;32408;33643;1235
14912;13.09.2017;'08 - 09;23,07;9,24;13,83;2157;2438;281;34071;34628;557
14913;13.09.2017;'09 - 10;15,92;9,93;5,99;3929;3856;-73;35298;35332;34
14914;13.09.2017;'10 - 11;13,41;12,06;1,35;5769;5808;39;36549;36526;-23
14915;13.09.2017;'11 - 12;12,73;11,3;1,43;7542;8064;522;37353;37809;456
14916;13.09.2017;'12 - 13;10,74;6,13;4,61;8965;10052;1087;37834;37384;-450
14917;13.09.2017;'13 - 14;12,06;2,08;9,98;9532;11986;2454;37902;36932;-970
14918;13.09.2017;'14 - 15;10,1;-5,82;15,92;9301;11818;2517;37848;36106;-1742
14919;13.09.2017;'15 - 16;9,18;-6,3;15,48;8277;9504;1227;37534;35714;-1820
14920;13.09.2017;'16 - 17;9,16;0,67;8,49;6355;6850;495;37124;35466;-1658
14921;13.09.2017;'17 - 18;9,12;11,66;-2,54;3785;4198;413;36218;35019;-1199
14922;13.09.2017;'18 - 19;16,24;22,1;-5,86;1346;1461;115;35061;34264;-797
14923;13.09.2017;'19 - 20;16,03;27,91;-11,88;132;97;-35;33998;33071;-927
14924;13.09.2017;'20 - 21;16,07;30,01;-13,94;0;0;0;33219;30926;-2293
14925;13.09.2017;'21 - 22;12,06;26,92;-14,86;0;0;0;32355;29674;-2681
14926;13.09.2017;'22 - 23;10,67;27,62;-16,95;0;0;0;31969;27666;-4303
14927;13.09.2017;'23 - 24;8,6;26,41;-17,81;0;0;0;31385;27127;-4258
14928;14.09.2017;'00 - 01;-11,04;19,4;-30,44;0;0;0;32458;26686;-5772
14929;14.09.2017;'01 - 02;-4,92;18,93;-23,85;0;0;0;31741;26429;-5312
14930;14.09.2017;'02 - 03;-7,91;16,01;-23,92;0;0;0;31138;25953;-5185
14931;14.09.2017;'03 - 04;-7,1;12,35;-19,45;0;0;0;30136;25175;-4961
14932;14.09.2017;'04 - 05;-1,7;11,57;-13,27;0;0;0;29044;24508;-4536
14933;14.09.2017;'05 - 06;9,42;16,37;-6,95;0;0;0;27769;23798;-3971
14934;14.09.2017;'06 - 07;31,08;39,59;-8,51;11;4;-7;26465;24038;-2427
14935;14.09.2017;'07 - 08;35,47;43,14;-7,67;668;591;-77;25471;23257;-2214
14936;14.09.2017;'08 - 09;36,98;44,36;-7,38;2854;2730;-124;24932;23650;-1282
14937;14.09.2017;'09 - 10;35,03;40,82;-5,79;5456;4989;-467;25131;24042;-1089
14938;14.09.2017;'10 - 11;34,46;40,22;-5,76;7489;6290;-1199;26121;25342;-779
14939;14.09.2017;'11 - 12;34,37;41,47;-7,1;8819;7180;-1639;27079;26914;-165
14940;14.09.2017;'12 - 13;30,55;39,17;-8,62;9453;8258;-1195;27470;28459;989
14941;14.09.2017;'13 - 14;29,73;34,63;-4,9;9247;8185;-1062;27544;29483;1939
14942;14.09.2017;'14 - 15;25,86;29,02;-3,16;8551;8010;-541;27421;29776;2355
14943;14.09.2017;'15 - 16;27,27;29,25;-1,98;7364;7476;112;27224;30410;3186
14944;14.09.2017;'16 - 17;27,94;24,02;3,92;5570;5913;343;26997;30580;3583
14945;14.09.2017;'17 - 18;32,14;27,33;4,81;3397;3522;125;26412;29199;2787
14946;14.09.2017;'18 - 19;34,91;30,08;4,83;1200;1266;66;25590;27497;1907
14947;14.09.2017;'19 - 20;35,88;35,33;0,55;111;66;-45;25118;26648;1530
14948;14.09.2017;'20 - 21;36,09;34,91;1,18;0;0;0;24918;26752;1834
14949;14.09.2017;'21 - 22;34,45;27,12;7,33;0;0;0;24767;27426;2659
14950;14.09.2017;'22 - 23;26,66;22,32;4,34;0;0;0;24702;26720;2018
14951;14.09.2017;'23 - 24;19,03;15,47;3,56;0;0;0;24271;25751;1480
14952;15.09.2017;'00 - 01;20,53;12,17;8,36;0;0;0;24410;24381;-29
14953;15.09.2017;'01 - 02;12,28;18,55;-6,27;0;0;0;23268;23599;331
14954;15.09.2017;'02 - 03;14;16,24;-2,24;0;0;0;22337;22577;240
14955;15.09.2017;'03 - 04;16,69;15,9;0,79;0;0;0;21109;21228;119
14956;15.09.2017;'04 - 05;22,07;16,6;5,47;0;0;0;19818;20198;380
14957;15.09.2017;'05 - 06;29,6;29,58;0,02;0;0;0;18448;18589;141
14958;15.09.2017;'06 - 07;40,24;39,25;0,99;12;6;-6;17083;17628;545
14959;15.09.2017;'07 - 08;44,3;45,83;-1,53;991;955;-36;15907;16006;99
14960;15.09.2017;'08 - 09;44,8;46,99;-2,19;4566;4718;152;15040;14574;-466
14961;15.09.2017;'09 - 10;40,96;44,83;-3,87;9032;9622;590;14537;13413;-1124
14962;15.09.2017;'10 - 11;39,98;42,81;-2,83;12875;13597;722;14430;13770;-660
14963;15.09.2017;'11 - 12;38,96;40,49;-1,53;15200;16038;838;14243;14667;424
14964;15.09.2017;'12 - 13;36,69;36,38;0,31;16262;16291;29;13952;15030;1078
14965;15.09.2017;'13 - 14;33,05;33,52;-0,47;16210;15204;-1006;13513;14200;687
14966;15.09.2017;'14 - 15;36,4;34,49;1,91;15027;13895;-1132;12818;13037;219
14967;15.09.2017;'15 - 16;36,13;35,19;0,94;12771;12456;-315;11842;12761;919
14968;15.09.2017;'16 - 17;38,65;34,67;3,98;9539;9925;386;10731;11667;936
14969;15.09.2017;'17 - 18;42,51;37,08;5,43;5657;5963;306;9348;9623;275
14970;15.09.2017;'18 - 19;45,47;42,88;2,59;1901;2137;236;7947;7962;15
14971;15.09.2017;'19 - 20;48;43,62;4,38;154;133;-21;7133;7651;518
14972;15.09.2017;'20 - 21;47,95;43,44;4,51;0;0;0;6951;8214;1263
14973;15.09.2017;'21 - 22;42,05;40,24;1,81;0;0;0;7033;9250;2217
14974;15.09.2017;'22 - 23;37,91;36,44;1,47;0;0;0;7322;9054;1732
14975;15.09.2017;'23 - 24;31,4;29,9;1,5;0;0;0;7570;8892;1322
14976;16.09.2017;'00 - 01;33,95;31,33;2,62;0;0;0;7804;8472;668
14977;16.09.2017;'01 - 02;32;32,08;-0,08;0;0;0;7451;7882;431
14978;16.09.2017;'02 - 03;31,57;31,29;0,28;0;0;0;7155;7273;118
14979;16.09.2017;'03 - 04;31,01;30,46;0,55;0;0;0;6732;6360;-372
14980;16.09.2017;'04 - 05;30,82;28,75;2,07;0;0;0;6319;5806;-513
14981;16.09.2017;'05 - 06;31,44;30,74;0,7;0;0;0;5929;5497;-432
14982;16.09.2017;'06 - 07;31,94;34,22;-2,28;10;6;-4;5616;5037;-579
14983;16.09.2017;'07 - 08;34,7;36,84;-2,14;871;735;-136;5239;4336;-903
14984;16.09.2017;'08 - 09;40,38;40,77;-0,39;4073;3573;-500;4673;3384;-1289
14985;16.09.2017;'09 - 10;40,92;43,18;-2,26;8098;7284;-814;4113;2200;-1913
14986;16.09.2017;'10 - 11;40,63;44,1;-3,47;11558;10803;-755;3888;2021;-1867
14987;16.09.2017;'11 - 12;35,45;40,12;-4,67;13765;12550;-1215;3917;2324;-1593
14988;16.09.2017;'12 - 13;37,93;38,59;-0,66;14635;13273;-1362;3953;2616;-1337
14989;16.09.2017;'13 - 14;35,29;34,06;1,23;14298;13439;-859;3912;2564;-1348
14990;16.09.2017;'14 - 15;32,99;32,54;0,45;13020;12341;-679;3623;2175;-1448
14991;16.09.2017;'15 - 16;33,9;33,03;0,87;10928;10524;-404;3075;1885;-1190
14992;16.09.2017;'16 - 17;35,5;35,62;-0,12;8172;8166;-6;2532;1750;-782
14993;16.09.2017;'17 - 18;40,03;40,44;-0,41;4845;5062;217;2017;1613;-404
14994;16.09.2017;'18 - 19;44,64;43,98;0,66;1602;1616;14;1634;1529;-105
14995;16.09.2017;'19 - 20;48,01;47,07;0,94;125;76;-49;1394;1592;198
14996;16.09.2017;'20 - 21;46,7;49,85;-3,15;0;0;0;1366;1631;265
14997;16.09.2017;'21 - 22;43,54;46,49;-2,95;0;0;0;1528;1585;57
14998;16.09.2017;'22 - 23;40,33;43,3;-2,97;0;0;0;1711;1438;-273
14999;16.09.2017;'23 - 24;35,01;41,24;-6,23;0;0;0;1840;1392;-448
15000;17.09.2017;'00 - 01;32,27;37,52;-5,25;0;0;0;1511;1431;-80
15001;17.09.2017;'01 - 02;30,4;34,88;-4,48;0;0;0;1412;1470;58
15002;17.09.2017;'02 - 03;30,06;33,04;-2,98;0;0;0;1488;1296;-192
15003;17.09.2017;'03 - 04;29,43;33,66;-4,23;0;0;0;1403;983;-420
15004;17.09.2017;'04 - 05;29,18;31,84;-2,66;0;0;0;1217;816;-401
15005;17.09.2017;'05 - 06;29,38;32,93;-3,55;0;0;0;1118;704;-414
15006;17.09.2017;'06 - 07;29,98;32,79;-2,81;7;5;-2;1107;720;-387
15007;17.09.2017;'07 - 08;30,09;32,4;-2,31;806;770;-36;1102;772;-330
15008;17.09.2017;'08 - 09;32,04;36,54;-4,5;3991;3684;-307;957;776;-181
15009;17.09.2017;'09 - 10;32,59;37,31;-4,72;8241;7588;-653;738;707;-31
15010;17.09.2017;'10 - 11;32,16;33,62;-1,46;12172;12277;105;643;422;-221
15011;17.09.2017;'11 - 12;32,65;32,67;-0,02;15005;16708;1703;692;328;-364
15012;17.09.2017;'12 - 13;32,05;26,5;5,55;16268;18605;2337;809;460;-349
15013;17.09.2017;'13 - 14;30,31;24,26;6,05;15981;17688;1707;832;637;-195
15014;17.09.2017;'14 - 15;30,01;24,5;5,51;14659;15149;490;779;720;-59
15015;17.09.2017;'15 - 16;29,72;28,8;0,92;12438;12062;-376;727;791;64
15016;17.09.2017;'16 - 17;30,05;30,49;-0,44;9200;8536;-664;788;810;22
15017;17.09.2017;'17 - 18;32,15;35,55;-3,4;5261;5152;-109;873;871;-2
15018;17.09.2017;'18 - 19;41;45,61;-4,61;1614;1633;19;957;988;31
15019;17.09.2017;'19 - 20;45,09;49,3;-4,21;109;70;-39;1071;1150;79
15020;17.09.2017;'20 - 21;46,95;49,78;-2,83;0;0;0;1226;1280;54
15021;17.09.2017;'21 - 22;42,38;45,84;-3,46;0;0;0;1407;1353;-54
15022;17.09.2017;'22 - 23;38,27;42,91;-4,64;0;0;0;1544;1824;280
15023;17.09.2017;'23 - 24;33,09;37,75;-4,66;0;0;0;1645;2353;708
15024;18.09.2017;'00 - 01;32,77;32,57;0,2;0;0;0;1496;2252;756
15025;18.09.2017;'01 - 02;32,08;30,86;1,22;0;0;0;1709;2417;708
15026;18.09.2017;'02 - 03;32,1;30,74;1,36;0;0;0;2016;2389;373
15027;18.09.2017;'03 - 04;31,42;30,73;0,69;0;0;0;2112;2451;339
15028;18.09.2017;'04 - 05;32;30,6;1,4;0;0;0;2196;2416;220
15029;18.09.2017;'05 - 06;32,6;33,32;-0,72;0;0;0;2302;2355;53
15030;18.09.2017;'06 - 07;43,89;45,38;-1,49;5;4;-1;2413;2432;19
15031;18.09.2017;'07 - 08;51,06;53,16;-2,1;626;664;38;2504;2553;49
15032;18.09.2017;'08 - 09;53,23;51,73;1,5;3468;3420;-48;2379;2295;-84
15033;18.09.2017;'09 - 10;51,71;49,4;2,31;7246;7148;-98;2037;1671;-366
15034;18.09.2017;'10 - 11;51,59;48,88;2,71;10800;10552;-248;1829;1498;-331
15035;18.09.2017;'11 - 12;45,04;40,3;4,74;13568;13057;-511;1858;1714;-144
15036;18.09.2017;'12 - 13;41,09;39,37;1,72;15241;14513;-728;2039;1830;-209
15037;18.09.2017;'13 - 14;37,91;40,57;-2,66;15564;14907;-657;2268;2194;-74
15038;18.09.2017;'14 - 15;36,09;38,66;-2,57;14741;14032;-709;2352;2510;158
15039;18.09.2017;'15 - 16;41,88;40,61;1,27;12554;12539;-15;2284;2552;268
15040;18.09.2017;'16 - 17;43,92;40,99;2,93;9298;9108;-190;2204;2317;113
15041;18.09.2017;'17 - 18;45,61;46,72;-1,11;5309;5352;43;2074;2016;-58
15042;18.09.2017;'18 - 19;49,41;50,14;-0,73;1576;1639;63;1953;1782;-171
15043;18.09.2017;'19 - 20;52,89;51,51;1,38;94;56;-38;1942;2031;89
15044;18.09.2017;'20 - 21;53,14;51,46;1,68;0;0;0;2104;2464;360
15045;18.09.2017;'21 - 22;44,58;45,58;-1;0;0;0;2415;2666;251
15046;18.09.2017;'22 - 23;40,55;40,54;0,01;0;0;0;2651;2712;61
15047;18.09.2017;'23 - 24;33,2;35,61;-2,41;0;0;0;2816;2860;44
15048;19.09.2017;'00 - 01;33,1;32,02;1,08;0;0;0;2308;2901;593
15049;19.09.2017;'01 - 02;32,13;31,8;0,33;0;0;0;2322;2767;445
15050;19.09.2017;'02 - 03;31,28;29,35;1,93;0;0;0;2370;2667;297
15051;19.09.2017;'03 - 04;30,8;29,13;1,67;0;0;0;2205;2442;237
15052;19.09.2017;'04 - 05;31,07;29,35;1,72;0;0;0;2046;2255;209
15053;19.09.2017;'05 - 06;33,22;31,61;1,61;0;0;0;1928;2232;304
15054;19.09.2017;'06 - 07;40;40,17;-0,17;4;2;-2;1837;2180;343
15055;19.09.2017;'07 - 08;50,02;50,65;-0,63;575;560;-15;1696;2182;486
15056;19.09.2017;'08 - 09;53,76;53,61;0,15;3208;3040;-168;1447;1988;541
15057;19.09.2017;'09 - 10;51,1;52,19;-1,09;6811;6337;-474;1085;1229;144
15058;19.09.2017;'10 - 11;49,99;49,48;0,51;10136;9603;-533;851;1049;198
15059;19.09.2017;'11 - 12;49,37;49,73;-0,36;12520;12018;-502;920;1236;316
15060;19.09.2017;'12 - 13;44,9;43,95;0,95;13805;13297;-508;1094;1546;452
15061;19.09.2017;'13 - 14;43,9;41,13;2,77;13794;12828;-966;1326;2052;726
15062;19.09.2017;'14 - 15;39,8;37,91;1,89;12679;12032;-647;1624;2554;930
15063;19.09.2017;'15 - 16;38,36;36,91;1,45;10677;10441;-236;1960;3016;1056
15064;19.09.2017;'16 - 17;38,94;35,99;2,95;7898;7763;-135;2321;3259;938
15065;19.09.2017;'17 - 18;42,98;38,63;4,35;4505;4609;104;2617;3213;596
15066;19.09.2017;'18 - 19;46,26;42,66;3,6;1298;1417;119;2801;3662;861
15067;19.09.2017;'19 - 20;50,01;44,78;5,23;66;42;-24;3027;4681;1654
15068;19.09.2017;'20 - 21;47,96;45,21;2,75;0;0;0;3289;5756;2467
15069;19.09.2017;'21 - 22;40;37,28;2,72;0;0;0;3540;6549;3009
15070;19.09.2017;'22 - 23;37,34;35,17;2,17;0;0;0;3800;6974;3174
15071;19.09.2017;'23 - 24;35,74;31,78;3,96;0;0;0;4165;7110;2945
15072;20.09.2017;'00 - 01;29,97;31,26;-1,29;0;0;0;6824;7836;1012
15073;20.09.2017;'01 - 02;29,49;31,55;-2,06;0;0;0;7186;8610;1424
15074;20.09.2017;'02 - 03;28,47;30,4;-1,93;0;0;0;7629;8836;1207
15075;20.09.2017;'03 - 04;25,99;28,71;-2,72;0;0;0;7828;9056;1228
15076;20.09.2017;'04 - 05;26,56;27,61;-1,05;0;0;0;7895;8730;835
15077;20.09.2017;'05 - 06;31,05;29,73;1,32;0;0;0;7724;8329;605
15078;20.09.2017;'06 - 07;39,49;42,19;-2,7;2;2;0;7340;7870;530
15079;20.09.2017;'07 - 08;46,99;46,66;0,33;572;390;-182;6887;7522;635
15080;20.09.2017;'08 - 09;47,93;53,81;-5,88;3079;2210;-869;6201;6472;271
15081;20.09.2017;'09 - 10;44,99;52,34;-7,35;6367;5018;-1349;5366;4895;-471
15082;20.09.2017;'10 - 11;46,84;49,58;-2,74;9468;8041;-1427;4869;4423;-446
15083;20.09.2017;'11 - 12;43,88;45,87;-1,99;11943;10758;-1185;4827;5015;188
15084;20.09.2017;'12 - 13;37;40,11;-3,11;13286;12528;-758;5057;5733;676
15085;20.09.2017;'13 - 14;35,47;36,64;-1,17;13240;13114;-126;5296;6502;1206
15086;20.09.2017;'14 - 15;37,51;35,68;1,83;12196;11822;-374;5380;6106;726
15087;20.09.2017;'15 - 16;34,07;37,6;-3,53;10318;9570;-748;5103;5630;527
15088;20.09.2017;'16 - 17;40;38,5;1,5;7615;6764;-851;4654;5265;611
15089;20.09.2017;'17 - 18;43,94;43,77;0,17;4337;3794;-543;4052;4647;595
15090;20.09.2017;'18 - 19;48,93;47,69;1,24;1198;1162;-36;3403;3726;323
15091;20.09.2017;'19 - 20;52,02;49,97;2,05;61;34;-27;2966;3120;154
15092;20.09.2017;'20 - 21;51,03;46,95;4,08;0;0;0;2798;3478;680
15093;20.09.2017;'21 - 22;43,91;38,02;5,89;0;0;0;2833;3800;967
15094;20.09.2017;'22 - 23;39,44;37,52;1,92;0;0;0;2966;4062;1096
15095;20.09.2017;'23 - 24;34,61;31,66;2,95;0;0;0;3111;4482;1371
15096;21.09.2017;'00 - 01;32,61;32,2;0,41;0;0;0;3409;4991;1582
15097;21.09.2017;'01 - 02;30,8;29,05;1,75;0;0;0;3571;4876;1305
15098;21.09.2017;'02 - 03;29,66;27,25;2,41;0;0;0;3703;4486;783
15099;21.09.2017;'03 - 04;29,49;26,56;2,93;0;0;0;3564;4058;494
15100;21.09.2017;'04 - 05;29,98;28,68;1,3;0;0;0;3321;3665;344
15101;21.09.2017;'05 - 06;32,11;34,07;-1,96;0;0;0;3072;3338;266
15102;21.09.2017;'06 - 07;40;42,83;-2,83;2;2;0;2902;3006;104
15103;21.09.2017;'07 - 08;47,97;46,75;1,22;648;699;51;2753;2796;43
15104;21.09.2017;'08 - 09;50,97;47,26;3,71;3977;3663;-314;2410;2402;-8
15105;21.09.2017;'09 - 10;47,03;44,9;2,13;8700;7834;-866;1896;1528;-368
15106;21.09.2017;'10 - 11;43,47;44,47;-1;13135;12394;-741;1474;1014;-460
15107;21.09.2017;'11 - 12;39,48;38,96;0,52;16413;16214;-199;1238;1016;-222
15108;21.09.2017;'12 - 13;35,9;36,61;-0,71;18184;18452;268;1151;1125;-26
15109;21.09.2017;'13 - 14;35,27;35,3;-0,03;17954;18274;320;1081;1288;207
15110;21.09.2017;'14 - 15;34,55;34,67;-0,12;16159;16212;53;969;1158;189
15111;21.09.2017;'15 - 16;34,4;34,55;-0,15;13416;13441;25;849;961;112
15112;21.09.2017;'16 - 17;37,52;36,61;0,91;9882;9750;-132;812;848;36
15113;21.09.2017;'17 - 18;43,48;40,69;2,79;5533;5361;-172;875;791;-84
15114;21.09.2017;'18 - 19;48,73;45,41;3,32;1498;1450;-48;1087;851;-236
15115;21.09.2017;'19 - 20;52,77;46,97;5,8;67;29;-38;1453;1119;-334
15116;21.09.2017;'20 - 21;50,75;46,78;3,97;0;0;0;1887;1604;-283
15117;21.09.2017;'21 - 22;42,2;42,03;0,17;0;0;0;2299;1748;-551
15118;21.09.2017;'22 - 23;38,33;37,95;0,38;0;0;0;2627;1866;-761
15119;21.09.2017;'23 - 24;34,73;34,55;0,18;0;0;0;2787;1717;-1070
15120;22.09.2017;'00 - 01;32,24;31,88;0,36;0;0;0;2612;1502;-1110
15121;22.09.2017;'01 - 02;31,67;31,85;-0,18;0;0;0;2564;1323;-1241
15122;22.09.2017;'02 - 03;30,4;29,81;0,59;0;0;0;2607;1222;-1385
15123;22.09.2017;'03 - 04;30,02;29,49;0,53;0;0;0;2444;1122;-1322
15124;22.09.2017;'04 - 05;30,3;31,64;-1,34;0;0;0;2282;1052;-1230
15125;22.09.2017;'05 - 06;31,9;34,33;-2,43;0;0;0;2132;1095;-1037
15126;22.09.2017;'06 - 07;40,06;38,69;1,37;1;1;0;1997;1052;-945
15127;22.09.2017;'07 - 08;48,18;48,24;-0,06;593;595;2;1861;929;-932
15128;22.09.2017;'08 - 09;49,8;50,17;-0,37;3937;3423;-514;1616;800;-816
15129;22.09.2017;'09 - 10;49,71;49,19;0,52;8560;7224;-1336;1238;583;-655
15130;22.09.2017;'10 - 11;47,17;47,64;-0,47;12728;10773;-1955;939;414;-525
15131;22.09.2017;'11 - 12;45,34;46,15;-0,81;15790;13683;-2107;785;421;-364
15132;22.09.2017;'12 - 13;40,34;41,41;-1,07;17426;15940;-1486;731;432;-299
15133;22.09.2017;'13 - 14;38,07;38,06;0,01;17512;17078;-434;693;470;-223
15134;22.09.2017;'14 - 15;36,58;36,47;0,11;16223;16225;2;648;451;-197
15135;22.09.2017;'15 - 16;36,57;36,03;0,54;13630;13286;-344;626;384;-242
15136;22.09.2017;'16 - 17;37,31;37,06;0,25;9882;9486;-396;647;316;-331
15137;22.09.2017;'17 - 18;43,27;44,14;-0,87;5398;4956;-442;720;319;-401
15138;22.09.2017;'18 - 19;45,92;47,67;-1,75;1372;1203;-169;875;440;-435
15139;22.09.2017;'19 - 20;48,92;50,98;-2,06;47;18;-29;1124;590;-534
15140;22.09.2017;'20 - 21;47,21;49,65;-2,44;0;0;0;1371;732;-639
15141;22.09.2017;'21 - 22;43,3;46,13;-2,83;0;0;0;1508;782;-726
15142;22.09.2017;'22 - 23;39,51;42,87;-3,36;0;0;0;1558;772;-786
15143;22.09.2017;'23 - 24;37,95;35,86;2,09;0;0;0;1556;704;-852
15144;23.09.2017;'00 - 01;34,67;34,35;0,32;0;0;0;936;688;-248
15145;23.09.2017;'01 - 02;31,99;34,47;-2,48;0;0;0;953;708;-245
15146;23.09.2017;'02 - 03;31,94;33,65;-1,71;0;0;0;1111;606;-505
15147;23.09.2017;'03 - 04;31,91;34,12;-2,21;0;0;0;1076;584;-492
15148;23.09.2017;'04 - 05;31,43;33,5;-2,07;0;0;0;1049;626;-423
15149;23.09.2017;'05 - 06;31,81;33,67;-1,86;0;0;0;1027;719;-308
15150;23.09.2017;'06 - 07;33,4;36,06;-2,66;2;1;-1;991;793;-198
15151;23.09.2017;'07 - 08;39,03;39,79;-0,76;644;599;-45;970;720;-250
15152;23.09.2017;'08 - 09;41,54;41,96;-0,42;4137;3363;-774;840;729;-111
15153;23.09.2017;'09 - 10;42,93;44,41;-1,48;8840;7457;-1383;613;629;16
15154;23.09.2017;'10 - 11;41,91;44,69;-2,78;13205;11984;-1221;455;458;3
15155;23.09.2017;'11 - 12;39,9;42,22;-2,32;16494;15692;-802;447;419;-28
15156;23.09.2017;'12 - 13;31,91;33,56;-1,65;18073;17858;-215;559;446;-113
15157;23.09.2017;'13 - 14;32,17;32,44;-0,27;17634;17681;47;683;616;-67
15158;23.09.2017;'14 - 15;32,12;33,09;-0,97;15825;15528;-297;794;784;-10
15159;23.09.2017;'15 - 16;32;34,51;-2,51;13110;12400;-710;913;866;-47
15160;23.09.2017;'16 - 17;32,77;36,5;-3,73;9558;8704;-854;1077;980;-97
15161;23.09.2017;'17 - 18;37,22;41,68;-4,46;5283;4686;-597;1295;1104;-191
15162;23.09.2017;'18 - 19;42,44;47,93;-5,49;1315;1213;-102;1630;1330;-300
15163;23.09.2017;'19 - 20;45,2;51,06;-5,86;39;20;-19;2099;1980;-119
15164;23.09.2017;'20 - 21;44,93;48,29;-3,36;0;0;0;2516;2478;-38
15165;23.09.2017;'21 - 22;39,08;42,64;-3,56;0;0;0;2696;2663;-33
15166;23.09.2017;'22 - 23;35,79;38,22;-2,43;0;0;0;2727;2649;-78
15167;23.09.2017;'23 - 24;31,72;34,07;-2,35;0;0;0;2574;2422;-152
15168;24.09.2017;'00 - 01;31,76;34,82;-3,06;0;0;0;2460;2314;-146
15169;24.09.2017;'01 - 02;30,51;32,46;-1,95;0;0;0;2261;1963;-298
15170;24.09.2017;'02 - 03;31,03;31,98;-0,95;0;0;0;2195;1579;-616
15171;24.09.2017;'03 - 04;30,77;31,83;-1,06;0;0;0;2061;1500;-561
15172;24.09.2017;'04 - 05;30,55;32,55;-2;0;0;0;1971;1436;-535
15173;24.09.2017;'05 - 06;31,06;32,52;-1,46;0;0;0;1929;1442;-487
15174;24.09.2017;'06 - 07;31,82;33,26;-1,44;0;0;0;1914;1465;-449
15175;24.09.2017;'07 - 08;32,09;36,52;-4,43;340;312;-28;1904;1548;-356
15176;24.09.2017;'08 - 09;34,9;38,58;-3,68;2351;2207;-144;1796;1638;-158
15177;24.09.2017;'09 - 10;35,57;39,42;-3,85;5323;5460;137;1610;1426;-184
15178;24.09.2017;'10 - 11;35,25;37,16;-1,91;8237;9304;1067;1463;1052;-411
15179;24.09.2017;'11 - 12;35,61;36,22;-0,61;10446;12593;2147;1419;996;-423
15180;24.09.2017;'12 - 13;35,21;34,38;0,83;11595;14120;2525;1478;1260;-218
15181;24.09.2017;'13 - 14;32,71;31,49;1,22;11448;13471;2023;1559;1258;-301
15182;24.09.2017;'14 - 15;31,52;32,05;-0,53;10392;11747;1355;1650;1344;-306
15183;24.09.2017;'15 - 16;31,37;33,58;-2,21;8612;9490;878;1754;1499;-255
15184;24.09.2017;'16 - 17;31,62;34,55;-2,93;6150;6238;88;1918;1653;-265
15185;24.09.2017;'17 - 18;35,34;39,31;-3,97;3280;3102;-178;2138;1677;-461
15186;24.09.2017;'18 - 19;42,39;45,7;-3,31;775;805;30;2460;2102;-358
15187;24.09.2017;'19 - 20;46,94;47,16;-0,22;22;12;-10;2957;2739;-218
15188;24.09.2017;'20 - 21;44,99;47,82;-2,83;0;0;0;3518;3748;230
15189;24.09.2017;'21 - 22;42,2;46,16;-3,96;0;0;0;3946;4450;504
15190;24.09.2017;'22 - 23;41,08;42,39;-1,31;0;0;0;4241;4690;449
15191;24.09.2017;'23 - 24;32,45;39,2;-6,75;0;0;0;4413;4642;229
15192;25.09.2017;'00 - 01;32,97;36,35;-3,38;0;0;0;4072;4257;185
15193;25.09.2017;'01 - 02;31,69;33,86;-2,17;0;0;0;3986;4073;87
15194;25.09.2017;'02 - 03;31,1;33,12;-2,02;0;0;0;4007;3551;-456
15195;25.09.2017;'03 - 04;31,02;33,09;-2,07;0;0;0;3946;3164;-782
15196;25.09.2017;'04 - 05;30,5;33,86;-3,36;0;0;0;3925;2824;-1101
15197;25.09.2017;'05 - 06;32,49;35,14;-2,65;0;0;0;3960;2860;-1100
15198;25.09.2017;'06 - 07;44,42;46,87;-2,45;0;0;0;4083;2805;-1278
15199;25.09.2017;'07 - 08;52,44;53,23;-0,79;382;318;-64;4308;3123;-1185
15200;25.09.2017;'08 - 09;53,77;53,9;-0,13;2664;2329;-335;4453;3337;-1116
15201;25.09.2017;'09 - 10;52,4;54,15;-1,75;6092;5426;-666;4505;3545;-960
15202;25.09.2017;'10 - 11;51,1;52,87;-1,77;9462;9030;-432;4692;3864;-828
15203;25.09.2017;'11 - 12;48,95;50,16;-1,21;12122;11878;-244;4934;4029;-905
15204;25.09.2017;'12 - 13;44,93;44,69;0,24;13643;13682;39;5196;4468;-728
15205;25.09.2017;'13 - 14;42,4;43,65;-1,25;13667;13709;42;5422;4488;-934
15206;25.09.2017;'14 - 15;40,51;42,67;-2,16;12588;12202;-386;5534;4226;-1308
15207;25.09.2017;'15 - 16;42,01;46,5;-4,49;10598;10274;-324;5542;4382;-1160
15208;25.09.2017;'16 - 17;43,93;47,27;-3,34;7757;7493;-264;5748;4528;-1220
15209;25.09.2017;'17 - 18;46,13;47,96;-1,83;4202;4088;-114;6126;4336;-1790
15210;25.09.2017;'18 - 19;49,81;50,45;-0,64;956;1016;60;6689;4425;-2264
15211;25.09.2017;'19 - 20;52;53,16;-1,16;23;8;-15;7409;5016;-2393
15212;25.09.2017;'20 - 21;50,44;53,27;-2,83;0;0;0;8029;6000;-2029
15213;25.09.2017;'21 - 22;41,96;46;-4,04;0;0;0;8189;6383;-1806
15214;25.09.2017;'22 - 23;34,9;40,61;-5,71;0;0;0;8049;6398;-1651
15215;25.09.2017;'23 - 24;34,85;36,16;-1,31;0;0;0;7762;6026;-1736
15216;26.09.2017;'00 - 01;35,37;36,81;-1,44;0;0;0;6199;5622;-577
15217;26.09.2017;'01 - 02;32,42;35,11;-2,69;0;0;0;5747;5191;-556
15218;26.09.2017;'02 - 03;31,36;33,47;-2,11;0;0;0;5455;4778;-677
15219;26.09.2017;'03 - 04;31,33;32,2;-0,87;0;0;0;5271;4495;-776
15220;26.09.2017;'04 - 05;31,88;33,15;-1,27;0;0;0;5151;4307;-844
15221;26.09.2017;'05 - 06;33,61;37,03;-3,42;0;0;0;5126;3956;-1170
15222;26.09.2017;'06 - 07;42,52;44,47;-1,95;0;0;0;5263;3836;-1427
15223;26.09.2017;'07 - 08;51,78;56,24;-4,46;418;321;-97;5388;4112;-1276
15224;26.09.2017;'08 - 09;55,2;64,08;-8,88;3006;2430;-576;5392;4310;-1082
15225;26.09.2017;'09 - 10;50,81;57,63;-6,82;7025;5958;-1067;5332;4306;-1026
15226;26.09.2017;'10 - 11;46,03;49,15;-3,12;11070;9884;-1186;5433;4467;-966
15227;26.09.2017;'11 - 12;41,1;48,85;-7,75;14229;13212;-1017;5654;4782;-872
15228;26.09.2017;'12 - 13;36,09;44,25;-8,16;15928;15376;-552;5819;5248;-571
15229;26.09.2017;'13 - 14;35,13;39,06;-3,93;16008;15572;-436;5961;5303;-658
15230;26.09.2017;'14 - 15;34,83;38,66;-3,83;14776;14168;-608;6031;5292;-739
15231;26.09.2017;'15 - 16;35,9;42,41;-6,51;12375;11907;-468;5983;5518;-465
15232;26.09.2017;'16 - 17;39,53;46,57;-7,04;8866;8368;-498;5952;5824;-128
15233;26.09.2017;'17 - 18;46,05;49,55;-3,5;4645;4176;-469;6157;6188;31
15234;26.09.2017;'18 - 19;49,93;54,36;-4,43;1000;857;-143;6784;6871;87
15235;26.09.2017;'19 - 20;54,66;57,85;-3,19;19;9;-10;7683;7626;-57
15236;26.09.2017;'20 - 21;49,42;52,84;-3,42;0;0;0;8444;8508;64
15237;26.09.2017;'21 - 22;36,34;39,34;-3;0;0;0;8727;8945;218
15238;26.09.2017;'22 - 23;33,93;35,47;-1,54;0;0;0;8645;8605;-40
15239;26.09.2017;'23 - 24;35,43;35,75;-0,32;0;0;0;8237;8332;95
15240;27.09.2017;'00 - 01;33,41;32,96;0,45;0;0;0;7683;7270;-413
15241;27.09.2017;'01 - 02;32,12;36,02;-3,9;0;0;0;7284;6222;-1062
15242;27.09.2017;'02 - 03;32,03;34,69;-2,66;0;0;0;7010;5644;-1366
15243;27.09.2017;'03 - 04;31,56;35,27;-3,71;0;0;0;6704;5365;-1339
15244;27.09.2017;'04 - 05;32,14;35,41;-3,27;0;0;0;6450;5156;-1294
15245;27.09.2017;'05 - 06;33,7;40,64;-6,94;0;0;0;6410;5138;-1272
15246;27.09.2017;'06 - 07;45,07;50,48;-5,41;0;0;0;6520;5155;-1365
15247;27.09.2017;'07 - 08;54,4;58,33;-3,93;444;293;-151;6620;5264;-1356
15248;27.09.2017;'08 - 09;57;59,68;-2,68;3259;2276;-983;6531;5740;-791
15249;27.09.2017;'09 - 10;51,59;56,65;-5,06;7831;5574;-2257;6229;5750;-479
15250;27.09.2017;'10 - 11;46,1;50,74;-4,64;12437;9575;-2862;5959;5535;-424
15251;27.09.2017;'11 - 12;41,16;46,57;-5,41;16035;13356;-2679;5902;5321;-581
15252;27.09.2017;'12 - 13;34,43;41,04;-6,61;18097;16124;-1973;6003;5008;-995
15253;27.09.2017;'13 - 14;34,9;39,85;-4,95;18412;16994;-1418;6069;5114;-955
15254;27.09.2017;'14 - 15;34,42;38,13;-3,71;17110;15805;-1305;6047;4948;-1099
15255;27.09.2017;'15 - 16;35,96;38,64;-2,68;14313;13210;-1103;5960;5085;-875
15256;27.09.2017;'16 - 17;38,94;40,63;-1,69;10170;9272;-898;5970;5285;-685
15257;27.09.2017;'17 - 18;45,08;42,08;3;5252;4631;-621;6324;5378;-946
15258;27.09.2017;'18 - 19;49,99;51,87;-1,88;1076;920;-156;7201;5829;-1372
15259;27.09.2017;'19 - 20;54,86;54,55;0,31;17;4;-13;8318;7086;-1232
15260;27.09.2017;'20 - 21;47,99;49,86;-1,87;0;1;1;9278;8144;-1134
15261;27.09.2017;'21 - 22;42,95;43,37;-0,42;0;1;1;9699;8168;-1531
15262;27.09.2017;'22 - 23;38,43;41,6;-3,17;0;1;1;9785;7760;-2025
15263;27.09.2017;'23 - 24;32,94;38,43;-5,49;0;0;0;9646;7694;-1952
15264;28.09.2017;'00 - 01;32,08;35,53;-3,45;0;0;0;8032;7618;-414
15265;28.09.2017;'01 - 02;31,77;33,71;-1,94;0;0;0;7741;7362;-379
15266;28.09.2017;'02 - 03;31,58;30,1;1,48;0;0;0;7526;6944;-582
15267;28.09.2017;'03 - 04;31,01;28,24;2,77;0;0;0;7292;6477;-815
15268;28.09.2017;'04 - 05;31,05;29,87;1,18;0;0;0;7102;5885;-1217
15269;28.09.2017;'05 - 06;33,4;33,93;-0,53;0;0;0;7042;5866;-1176
15270;28.09.2017;'06 - 07;40,2;45;-4,8;0;0;0;7108;6070;-1038
15271;28.09.2017;'07 - 08;49,21;48,18;1,03;350;322;-28;7116;6319;-797
15272;28.09.2017;'08 - 09;49,43;48,91;0,52;2624;2433;-191;6839;6334;-505
15273;28.09.2017;'09 - 10;47,08;45,49;1,59;6162;5723;-439;6282;5730;-552
15274;28.09.2017;'10 - 11;45,27;41,28;3,99;9476;8630;-846;5756;4920;-836
15275;28.09.2017;'11 - 12;44,35;39,73;4,62;12022;11078;-944;5402;4350;-1052
15276;28.09.2017;'12 - 13;39,2;42,77;-3,57;13394;12303;-1091;5196;4088;-1108
15277;28.09.2017;'13 - 14;39,2;43,53;-4,33;13255;12649;-606;5010;4282;-728
15278;28.09.2017;'14 - 15;38,45;42,15;-3,7;11910;11629;-281;4765;4483;-282
15279;28.09.2017;'15 - 16;41,67;41,98;-0,31;9640;9331;-309;4457;4617;160
15280;28.09.2017;'16 - 17;44,12;44,11;0,01;6684;6591;-93;4295;4577;282
15281;28.09.2017;'17 - 18;46,93;50,44;-3,51;3355;3293;-62;4431;4605;174
15282;28.09.2017;'18 - 19;47,51;52,67;-5,16;638;612;-26;5004;4870;-134
15283;28.09.2017;'19 - 20;49,78;56,38;-6,6;10;1;-9;5796;5564;-232
15284;28.09.2017;'20 - 21;47,49;55,67;-8,18;0;0;0;6297;6006;-291
15285;28.09.2017;'21 - 22;38,5;44,96;-6,46;0;0;0;6458;6287;-171
15286;28.09.2017;'22 - 23;34,96;40,97;-6,01;0;0;0;6412;6385;-27
15287;28.09.2017;'23 - 24;32,96;38,65;-5,69;0;0;0;6227;6245;18
15288;29.09.2017;'00 - 01;33,85;36,72;-2,87;0;0;0;6041;5994;-47
15289;29.09.2017;'01 - 02;32,88;33,91;-1,03;0;0;0;5737;5609;-128
15290;29.09.2017;'02 - 03;31,5;34,05;-2,55;0;0;0;5543;4993;-550
15291;29.09.2017;'03 - 04;31,1;34,12;-3,02;0;0;0;5390;4763;-627
15292;29.09.2017;'04 - 05;30,97;35,15;-4,18;0;0;0;5274;4731;-543
15293;29.09.2017;'05 - 06;31,91;37,48;-5,57;0;0;0;5262;4891;-371
15294;29.09.2017;'06 - 07;40,67;44,68;-4,01;0;0;0;5378;4812;-566
15295;29.09.2017;'07 - 08;49,91;53,76;-3,85;337;352;15;5506;4842;-664
15296;29.09.2017;'08 - 09;51,2;54,93;-3,73;2691;2678;-13;5363;4755;-608
15297;29.09.2017;'09 - 10;49,99;52,88;-2,89;6451;6255;-196;4884;4070;-814
15298;29.09.2017;'10 - 11;47,99;51,59;-3,6;10271;10083;-188;4468;3232;-1236
15299;29.09.2017;'11 - 12;47,08;51,13;-4,05;13346;13022;-324;4381;3315;-1066
15300;29.09.2017;'12 - 13;38,65;41,15;-2,5;15072;14948;-124;4572;3785;-787
15301;29.09.2017;'13 - 14;39,13;38,11;1,02;15164;15216;52;4921;4387;-534
15302;29.09.2017;'14 - 15;36,86;36,42;0,44;13893;13933;40;5197;4933;-264
15303;29.09.2017;'15 - 16;38,45;35,7;2,75;11371;11441;70;5421;5381;-40
15304;29.09.2017;'16 - 17;41,23;40,96;0,27;7789;7744;-45;5770;6014;244
15305;29.09.2017;'17 - 18;45,17;45,54;-0,37;3813;3643;-170;6504;6925;421
15306;29.09.2017;'18 - 19;47,93;47,49;0,44;661;640;-21;7894;8470;576
15307;29.09.2017;'19 - 20;47,99;47,77;0,22;7;3;-4;9559;11391;1832
15308;29.09.2017;'20 - 21;39,1;40,19;-1,09;0;0;0;10858;14213;3355
15309;29.09.2017;'21 - 22;32,21;30,7;1,51;0;0;0;11640;15517;3877
15310;29.09.2017;'22 - 23;36,94;31,98;4,96;0;0;0;11987;15638;3651
15311;29.09.2017;'23 - 24;30,6;24,69;5,91;0;0;0;11845;13994;2149
15312;30.09.2017;'00 - 01;23,88;25,18;-1,3;0;0;0;11264;11898;634
15313;30.09.2017;'01 - 02;26,09;25,63;0,46;0;0;0;10295;10439;144
15314;30.09.2017;'02 - 03;26,65;26,09;0,56;0;0;0;9307;9079;-228
15315;30.09.2017;'03 - 04;28,73;25,81;2,92;0;0;0;8324;7870;-454
15316;30.09.2017;'04 - 05;29,03;26,72;2,31;0;0;0;7458;7246;-212
15317;30.09.2017;'05 - 06;30,02;24,97;5,05;0;0;0;6780;6514;-266
15318;30.09.2017;'06 - 07;31,96;28,2;3,76;0;0;0;6303;6069;-234
15319;30.09.2017;'07 - 08;38,6;32,07;6,53;355;400;45;5783;5541;-242
15320;30.09.2017;'08 - 09;39;38,94;0,06;2643;3078;435;5131;5370;239
15321;30.09.2017;'09 - 10;42,49;37,82;4,67;6096;6697;601;4277;4620;343
15322;30.09.2017;'10 - 11;42,57;37,62;4,95;9439;10299;860;3578;3654;76
15323;30.09.2017;'11 - 12;43,2;35,1;8,1;11951;13131;1180;3316;3507;191
15324;30.09.2017;'12 - 13;38,75;28,98;9,77;13231;14324;1093;3374;3764;390
15325;30.09.2017;'13 - 14;32,82;26,81;6,01;12967;13656;689;3616;4825;1209
15326;30.09.2017;'14 - 15;31,84;25,85;5,99;11518;11998;480;4004;6269;2265
15327;30.09.2017;'15 - 16;33;26,04;6,96;9095;9186;91;4558;7712;3154
15328;30.09.2017;'16 - 17;37,52;30,24;7,28;6007;5646;-361;5286;9048;3762
15329;30.09.2017;'17 - 18;41,77;33,38;8,39;2771;2331;-440;6012;11624;5612
15330;30.09.2017;'18 - 19;45,06;34,54;10,52;438;317;-121;6844;13435;6591
15331;30.09.2017;'19 - 20;48,25;35,03;13,22;4;3;-1;7913;14717;6804
15332;30.09.2017;'20 - 21;45,01;27,8;17,21;0;0;0;8710;14643;5933
15333;30.09.2017;'21 - 22;37,49;26;11,49;0;0;0;9095;13456;4361
15334;30.09.2017;'22 - 23;32,18;28,47;3,71;0;0;0;9175;11528;2353
15335;30.09.2017;'23 - 24;29,06;30,11;-1,05;0;0;0;8978;10362;1384
15336;01.10.2017;'00 - 01;12,95;26,05;-13,1;0;0;0;10598;9114;-1484
15337;01.10.2017;'01 - 02;14,84;23,64;-8,8;0;0;0;9783;8341;-1442
15338;01.10.2017;'02 - 03;19,05;22,57;-3,52;0;0;0;9042;7883;-1159
15339;01.10.2017;'03 - 04;22,15;21,61;0,54;0;0;0;8191;7270;-921
15340;01.10.2017;'04 - 05;22,9;20,31;2,59;0;0;0;7402;6748;-654
15341;01.10.2017;'05 - 06;23,1;21,1;2;0;0;0;6812;6348;-464
15342;01.10.2017;'06 - 07;25,66;21,28;4,38;0;0;0;6385;6037;-348
15343;01.10.2017;'07 - 08;27,4;23,59;3,81;166;140;-26;6077;5466;-611
15344;01.10.2017;'08 - 09;32,71;28,34;4,37;1679;1679;0;5559;4898;-661
15345;01.10.2017;'09 - 10;38,11;33,7;4,41;4374;4714;340;4890;4082;-808
15346;01.10.2017;'10 - 11;38,39;34,19;4,2;7279;8178;899;4424;3545;-879
15347;01.10.2017;'11 - 12;38,58;33,12;5,46;9893;11220;1327;4353;3715;-638
15348;01.10.2017;'12 - 13;38,29;31,87;6,42;11570;13229;1659;4736;4532;-204
15349;01.10.2017;'13 - 14;29,68;22,3;7,38;11975;13793;1818;5247;5597;350
15350;01.10.2017;'14 - 15;26,09;20,97;5,12;11285;12816;1531;5807;6685;878
15351;01.10.2017;'15 - 16;26,64;17,94;8,7;9554;10487;933;6282;7738;1456
15352;01.10.2017;'16 - 17;27,84;19,5;8,34;6763;6974;211;6755;8087;1332
15353;01.10.2017;'17 - 18;37;31,57;5,43;3384;3434;50;7383;7997;614
15354;01.10.2017;'18 - 19;46,13;43,92;2,21;630;530;-100;8482;9025;543
15355;01.10.2017;'19 - 20;49,9;52;-2,1;7;0;-7;10074;11626;1552
15356;01.10.2017;'20 - 21;45,98;45,45;0,53;0;0;0;11821;13921;2100
15357;01.10.2017;'21 - 22;31,95;34,87;-2,92;0;0;0;13596;15205;1609
15358;01.10.2017;'22 - 23;26,08;30,04;-3,96;0;0;0;15298;16348;1050
15359;01.10.2017;'23 - 24;13,94;17,58;-3,64;0;0;0;16844;17729;885
15360;02.10.2017;'00 - 01;18,64;16,06;2,58;0;0;0;16826;18422;1596
15361;02.10.2017;'01 - 02;12,9;14,68;-1,78;0;0;0;18134;19336;1202
15362;02.10.2017;'02 - 03;5,72;14,35;-8,63;0;0;0;19371;20534;1163
15363;02.10.2017;'03 - 04;0,34;5,94;-5,6;0;0;0;20479;21622;1143
15364;02.10.2017;'04 - 05;2,9;3,17;-0,27;0;0;0;21674;22016;342
15365;02.10.2017;'05 - 06;9,37;11,8;-2,43;0;0;0;22925;23570;645
15366;02.10.2017;'06 - 07;13,98;18,69;-4,71;0;0;0;24159;25674;1515
15367;02.10.2017;'07 - 08;21,32;23,24;-1,92;239;207;-32;25178;26727;1549
15368;02.10.2017;'08 - 09;21,38;24,59;-3,21;1781;1987;206;25538;26992;1454
15369;02.10.2017;'09 - 10;21,38;25,91;-4,53;3834;4269;435;25312;26646;1334
15370;02.10.2017;'10 - 11;20,29;26,75;-6,46;5455;6584;1129;25166;26817;1651
15371;02.10.2017;'11 - 12;25,29;24,69;0,6;6515;8077;1562;25230;26859;1629
15372;02.10.2017;'12 - 13;22,1;22,82;-0,72;7067;8766;1699;25591;26471;880
15373;02.10.2017;'13 - 14;14,82;18,41;-3,59;6741;8383;1642;25950;26819;869
15374;02.10.2017;'14 - 15;14,6;21,48;-6,88;5734;6982;1248;26210;26346;136
15375;02.10.2017;'15 - 16;19,3;25,74;-6,44;4359;5055;696;26080;25275;-805
15376;02.10.2017;'16 - 17;19,9;31,26;-11,36;2793;3328;535;25643;24399;-1244
15377;02.10.2017;'17 - 18;31,29;42,93;-11,64;1255;1500;245;24956;23356;-1600
15378;02.10.2017;'18 - 19;31,23;46,11;-14,88;214;206;-8;24137;23404;-733
15379;02.10.2017;'19 - 20;36,04;48,9;-12,86;1;0;-1;23562;23389;-173
15380;02.10.2017;'20 - 21;29,28;38,88;-9,6;0;0;0;23170;22908;-262
15381;02.10.2017;'21 - 22;22,68;33,74;-11,06;0;0;0;23034;22074;-960
15382;02.10.2017;'22 - 23;15,18;29,53;-14,35;0;0;0;22810;21055;-1755
15383;02.10.2017;'23 - 24;9,39;17,4;-8,01;0;0;0;22430;21000;-1430
15384;03.10.2017;'00 - 01;13,26;20,88;-7,62;0;0;0;20607;20814;207
15385;03.10.2017;'01 - 02;13,95;17,81;-3,86;0;0;0;19751;19992;241
15386;03.10.2017;'02 - 03;12,31;16,51;-4,2;0;0;0;18916;18333;-583
15387;03.10.2017;'03 - 04;15,09;18,73;-3,64;0;0;0;18032;17048;-984
15388;03.10.2017;'04 - 05;19,51;21,97;-2,46;0;0;0;17389;15782;-1607
15389;03.10.2017;'05 - 06;21,58;30,38;-8,8;0;0;0;16916;15466;-1450
15390;03.10.2017;'06 - 07;28,28;46,51;-18,23;0;0;0;16609;15900;-709
15391;03.10.2017;'07 - 08;31,41;45,22;-13,81;114;61;-53;16608;15994;-614
15392;03.10.2017;'08 - 09;35,95;43,07;-7,12;1288;1104;-184;16988;15581;-1407
15393;03.10.2017;'09 - 10;34,9;43,13;-8,23;3457;3284;-173;17535;16480;-1055
15394;03.10.2017;'10 - 11;32,03;41,12;-9,09;6047;6135;88;18418;17330;-1088
15395;03.10.2017;'11 - 12;32,69;40,76;-8,07;8745;8886;141;19363;19275;-88
15396;03.10.2017;'12 - 13;24,87;28,91;-4,04;10729;11391;662;20272;21006;734
15397;03.10.2017;'13 - 14;17,91;15,99;1,92;11386;12700;1314;21018;22446;1428
15398;03.10.2017;'14 - 15;11,09;5,49;5,6;11084;12558;1474;21672;23290;1618
15399;03.10.2017;'15 - 16;12,47;9,38;3,09;9649;11048;1399;21865;23187;1322
15400;03.10.2017;'16 - 17;16,63;13,05;3,58;6890;7938;1048;21480;22219;739
15401;03.10.2017;'17 - 18;27,62;22;5,62;3364;3880;516;20488;21180;692
15402;03.10.2017;'18 - 19;33,06;30,21;2,85;523;568;45;19290;19983;693
15403;03.10.2017;'19 - 20;39,54;37,57;1,97;4;0;-4;18494;20138;1644
15404;03.10.2017;'20 - 21;30,63;32,68;-2,05;0;0;0;18259;20331;2072
15405;03.10.2017;'21 - 22;30,66;32,96;-2,3;0;0;0;18481;20128;1647
15406;03.10.2017;'22 - 23;30,09;37;-6,91;0;0;0;18634;19929;1295
15407;03.10.2017;'23 - 24;22,08;28,22;-6,14;0;0;0;18574;19850;1276
15408;04.10.2017;'00 - 01;18,09;29,06;-10,97;0;0;0;18804;19096;292
15409;04.10.2017;'01 - 02;18,65;26,8;-8,15;0;0;0;18738;19163;425
15410;04.10.2017;'02 - 03;20,88;27,1;-6,22;0;0;0;18859;19162;303
15411;04.10.2017;'03 - 04;18,06;24,24;-6,18;0;0;0;18885;19020;135
15412;04.10.2017;'04 - 05;22,63;27,66;-5,03;0;0;0;18948;19456;508
15413;04.10.2017;'05 - 06;30;35,97;-5,97;0;0;0;19099;19792;693
15414;04.10.2017;'06 - 07;45,22;42,98;2,24;0;0;0;19537;20898;1361
15415;04.10.2017;'07 - 08;54,61;52,21;2,4;199;172;-27;20194;21838;1644
15416;04.10.2017;'08 - 09;55,93;46,43;9,5;2006;2295;289;20854;22400;1546
15417;04.10.2017;'09 - 10;44,2;37,92;6,28;5131;5490;359;21724;22718;994
15418;04.10.2017;'10 - 11;35,34;30,84;4,5;8167;7960;-207;23263;23920;657
15419;04.10.2017;'11 - 12;31,17;29,71;1,46;10576;10481;-95;25358;25790;432
15420;04.10.2017;'12 - 13;22,8;23,66;-0,86;11919;11624;-295;27343;28236;893
15421;04.10.2017;'13 - 14;19,96;14,49;5,47;11953;10924;-1029;28857;29702;845
15422;04.10.2017;'14 - 15;22,77;12,87;9,9;10871;9464;-1407;29749;30602;853
15423;04.10.2017;'15 - 16;25;17,89;7,11;8781;7831;-950;29799;30432;633
15424;04.10.2017;'16 - 17;25,06;16,63;8,43;5840;5429;-411;29316;30708;1392
15425;04.10.2017;'17 - 18;33,06;18,39;14,67;2571;2314;-257;28577;30240;1663
15426;04.10.2017;'18 - 19;33,8;21,8;12;365;282;-83;27998;30160;2162
15427;04.10.2017;'19 - 20;35,93;23,79;12,14;2;0;-2;27946;30486;2540
15428;04.10.2017;'20 - 21;30,26;22,38;7,88;0;0;0;28203;31917;3714
15429;04.10.2017;'21 - 22;22,1;13,1;9;0;0;0;28643;32700;4057
15430;04.10.2017;'22 - 23;20,62;12,02;8,6;0;0;0;29213;32130;2917
15431;04.10.2017;'23 - 24;0,49;-1,65;2,14;0;0;0;29609;31486;1877
15432;05.10.2017;'00 - 01;4,09;-1,26;5,35;0;0;0;28122;30056;1934
15433;05.10.2017;'01 - 02;2,09;-3,73;5,82;0;0;0;27824;28904;1080
15434;05.10.2017;'02 - 03;1,8;2,22;-0,42;0;0;0;27703;28945;1242
15435;05.10.2017;'03 - 04;8,91;8,75;0,16;0;0;0;27444;27851;407
15436;05.10.2017;'04 - 05;12,46;10,7;1,76;0;0;0;27273;26979;-294
15437;05.10.2017;'05 - 06;16,98;12,76;4,22;0;0;0;27403;26693;-710
15438;05.10.2017;'06 - 07;31,31;29,35;1,96;0;0;0;28097;26768;-1329
15439;05.10.2017;'07 - 08;35,84;41,4;-5,56;136;90;-46;29360;27176;-2184
15440;05.10.2017;'08 - 09;41,92;47,03;-5,11;1601;1519;-82;30647;28835;-1812
15441;05.10.2017;'09 - 10;31,04;35,83;-4,79;4199;4382;183;31800;30859;-941
15442;05.10.2017;'10 - 11;24,98;25,73;-0,75;6739;7210;471;33225;33749;524
15443;05.10.2017;'11 - 12;20,44;7,9;12,54;8616;9593;977;34299;36166;1867
15444;05.10.2017;'12 - 13;9,71;-8,51;18,22;9554;11075;1521;35209;37283;2074
15445;05.10.2017;'13 - 14;12,18;-20,18;32,36;9425;10804;1379;36409;37724;1315
15446;05.10.2017;'14 - 15;10,81;-15,91;26,72;8445;9650;1205;37057;36855;-202
15447;05.10.2017;'15 - 16;10,84;-3,83;14,67;6749;8434;1685;37169;34646;-2523
15448;05.10.2017;'16 - 17;10,89;6,39;4,5;4369;5264;895;36473;33264;-3209
15449;05.10.2017;'17 - 18;14,68;15,18;-0,5;1858;2010;152;35102;32429;-2673
15450;05.10.2017;'18 - 19;25;29,8;-4,8;265;254;-11;33452;31782;-1670
15451;05.10.2017;'19 - 20;29,96;30,24;-0,28;0;0;0;31879;30672;-1207
15452;05.10.2017;'20 - 21;26,08;27,98;-1,9;0;0;0;30628;30086;-542
15453;05.10.2017;'21 - 22;27,96;20,73;7,23;0;0;0;29576;30020;444
15454;05.10.2017;'22 - 23;10,84;11,52;-0,68;0;0;0;28882;29500;618
15455;05.10.2017;'23 - 24;11,81;13,04;-1,23;0;0;0;28374;28815;441
15456;06.10.2017;'00 - 01;0,95;11,74;-10,79;0;0;0;27878;27970;92
15457;06.10.2017;'01 - 02;9,88;13,95;-4,07;0;0;0;27468;27179;-289
15458;06.10.2017;'02 - 03;3,23;12,41;-9,18;0;0;0;27342;26788;-554
15459;06.10.2017;'03 - 04;0,43;10,41;-9,98;0;0;0;27153;26475;-678
15460;06.10.2017;'04 - 05;4,46;12,56;-8,1;0;0;0;27037;25977;-1060
15461;06.10.2017;'05 - 06;10,78;19,74;-8,96;0;0;0;26924;26062;-862
15462;06.10.2017;'06 - 07;31,08;38,09;-7,01;0;0;0;26779;26616;-163
15463;06.10.2017;'07 - 08;37,87;39,43;-1,56;135;115;-20;26504;26432;-72
15464;06.10.2017;'08 - 09;34,94;35,59;-0,65;1571;1790;219;26227;25706;-521
15465;06.10.2017;'09 - 10;33,98;35,62;-1,64;4255;4682;427;26134;25377;-757
15466;06.10.2017;'10 - 11;32,95;35,93;-2,98;6751;7191;440;26227;25107;-1120
15467;06.10.2017;'11 - 12;32,95;34,98;-2,03;8627;8764;137;26121;25812;-309
15468;06.10.2017;'12 - 13;32,13;34,89;-2,76;9568;9606;38;25744;26285;541
15469;06.10.2017;'13 - 14;30,35;32,96;-2,61;9687;9988;301;25299;26937;1638
15470;06.10.2017;'14 - 15;29,45;31,38;-1,93;9039;9574;535;24966;26617;1651
15471;06.10.2017;'15 - 16;29,28;30,74;-1,46;7594;8197;603;24623;25709;1086
15472;06.10.2017;'16 - 17;32,41;31,49;0,92;5255;5698;443;24019;24792;773
15473;06.10.2017;'17 - 18;36,9;33,88;3,02;2361;2460;99;22895;23724;829
15474;06.10.2017;'18 - 19;46,92;39,03;7,89;324;301;-23;21684;22280;596
15475;06.10.2017;'19 - 20;48,52;45,55;2,97;1;0;-1;20891;21984;1093
15476;06.10.2017;'20 - 21;42,04;36,51;5,53;0;0;0;20313;21764;1451
15477;06.10.2017;'21 - 22;35,1;32;3,1;0;0;0;19722;21500;1778
15478;06.10.2017;'22 - 23;30,6;29,28;1,32;0;0;0;19248;20276;1028
15479;06.10.2017;'23 - 24;26,87;29,52;-2,65;0;0;0;18958;19739;781
15480;07.10.2017;'00 - 01;13,85;16,22;-2,37;0;0;0;18444;19756;1312
15481;07.10.2017;'01 - 02;11,85;10,51;1,34;0;0;0;18278;19148;870
15482;07.10.2017;'02 - 03;10,72;10,73;-0,01;0;0;0;18376;18142;-234
15483;07.10.2017;'03 - 04;11,04;12,41;-1,37;0;0;0;18401;18527;126
15484;07.10.2017;'04 - 05;9;14,89;-5,89;0;0;0;18455;19313;858
15485;07.10.2017;'05 - 06;8,94;11,85;-2,91;0;0;0;18458;18932;474
15486;07.10.2017;'06 - 07;10,94;13,17;-2,23;0;0;0;18410;19764;1354
15487;07.10.2017;'07 - 08;12,21;9,49;2,72;84;71;-13;18489;20431;1942
15488;07.10.2017;'08 - 09;24,92;14,02;10,9;1117;1422;305;18981;21532;2551
15489;07.10.2017;'09 - 10;17,39;2,43;14,96;3269;3946;677;19958;22510;2552
15490;07.10.2017;'10 - 11;10,77;-0,06;10,83;5514;6366;852;21535;24387;2852
15491;07.10.2017;'11 - 12;11,21;-0,16;11,37;7198;8417;1219;23511;27091;3580
15492;07.10.2017;'12 - 13;3,57;-6,85;10,42;7916;8704;788;25577;29310;3733
15493;07.10.2017;'13 - 14;0;-8,06;8,06;7457;7864;407;27403;30920;3517
15494;07.10.2017;'14 - 15;-0,95;-5,9;4,95;6273;6727;454;28804;31825;3021
15495;07.10.2017;'15 - 16;-1,35;-3,39;2,04;4634;5063;429;29528;32521;2993
15496;07.10.2017;'16 - 17;-0,94;0,54;-1,48;2788;2778;-10;30168;33658;3490
15497;07.10.2017;'17 - 18;0,89;7,24;-6,35;1073;914;-159;30577;33936;3359
15498;07.10.2017;'18 - 19;8,3;10,41;-2,11;124;56;-68;30810;33952;3142
15499;07.10.2017;'19 - 20;10,12;10,82;-0,7;0;0;0;31207;34044;2837
15500;07.10.2017;'20 - 21;2,53;5,96;-3,43;0;0;0;31365;33526;2161
15501;07.10.2017;'21 - 22;3,08;3,91;-0,83;0;0;0;31013;32071;1058
15502;07.10.2017;'22 - 23;2,59;5,82;-3,23;0;0;0;30149;30179;30
15503;07.10.2017;'23 - 24;0,47;5,4;-4,93;0;0;0;28866;28891;25
15504;08.10.2017;'00 - 01;-0,96;5,75;-6,71;0;0;0;26522;26740;218
15505;08.10.2017;'01 - 02;-2,37;4,23;-6,6;0;0;0;25071;24434;-637
15506;08.10.2017;'02 - 03;-0,03;4,22;-4,25;0;0;0;23757;22786;-971
15507;08.10.2017;'03 - 04;-0,96;1,77;-2,73;0;0;0;22426;21941;-485
15508;08.10.2017;'04 - 05;-0,08;1,62;-1,7;0;0;0;21211;20619;-592
15509;08.10.2017;'05 - 06;8,76;4,33;4,43;0;0;0;19733;19144;-589
15510;08.10.2017;'06 - 07;2,52;7,34;-4,82;0;0;0;17841;18137;296
15511;08.10.2017;'07 - 08;12,19;8,64;3,55;50;35;-15;15926;16754;828
15512;08.10.2017;'08 - 09;27,97;21,46;6,51;829;913;84;14174;14985;811
15513;08.10.2017;'09 - 10;29,67;25,81;3,86;2504;3093;589;12659;12688;29
15514;08.10.2017;'10 - 11;32,48;28,24;4,24;4574;5674;1100;11589;11533;-56
15515;08.10.2017;'11 - 12;38,28;32,77;5,51;6592;7754;1162;11229;11326;97
15516;08.10.2017;'12 - 13;30,21;28,87;1,34;8096;9153;1057;11354;12088;734
15517;08.10.2017;'13 - 14;28,03;26,65;1,38;8730;9558;828;11621;12490;869
15518;08.10.2017;'14 - 15;26,26;24,45;1,81;8540;9146;606;11848;12850;1002
15519;08.10.2017;'15 - 16;21,85;22,8;-0,95;7308;7826;518;11660;12928;1268
15520;08.10.2017;'16 - 17;27,44;27,78;-0,34;4868;5413;545;11028;12453;1425
15521;08.10.2017;'17 - 18;32,46;31,89;0,57;2008;2251;243;10011;10499;488
15522;08.10.2017;'18 - 19;40,05;43,48;-3,43;224;188;-36;9094;8848;-246
15523;08.10.2017;'19 - 20;47,97;49,21;-1,24;0;0;0;8555;8339;-216
15524;08.10.2017;'20 - 21;43,92;46,12;-2,2;0;0;0;8160;8006;-154
15525;08.10.2017;'21 - 22;40,94;40,36;0,58;0;0;0;7786;7658;-128
15526;08.10.2017;'22 - 23;40,95;38,49;2,46;0;0;0;7410;7122;-288
15527;08.10.2017;'23 - 24;35,25;32,55;2,7;0;0;0;7055;6631;-424
15528;09.10.2017;'00 - 01;32,06;29,64;2,42;0;0;0;5270;6466;1196
15529;09.10.2017;'01 - 02;30,64;28,31;2,33;0;0;0;5142;6564;1422
15530;09.10.2017;'02 - 03;30,02;25,91;4,11;0;0;0;5196;6431;1235
15531;09.10.2017;'03 - 04;30,09;26,28;3,81;0;0;0;5318;6658;1340
15532;09.10.2017;'04 - 05;30,01;28,77;1,24;0;0;0;5455;6820;1365
15533;09.10.2017;'05 - 06;32;31,22;0,78;0;0;0;5564;6824;1260
15534;09.10.2017;'06 - 07;42,98;41,79;1,19;0;0;0;5580;6892;1312
15535;09.10.2017;'07 - 08;51,48;52,64;-1,16;102;91;-11;5469;7034;1565
15536;09.10.2017;'08 - 09;54,75;55,44;-0,69;1593;1686;93;5121;6726;1605
15537;09.10.2017;'09 - 10;51,14;47,05;4,09;4352;4762;410;4547;5604;1057
15538;09.10.2017;'10 - 11;51,14;44,37;6,77;6945;7895;950;4174;4742;568
15539;09.10.2017;'11 - 12;47,12;42,06;5,06;8839;10376;1537;4446;5463;1017
15540;09.10.2017;'12 - 13;41,21;35,34;5,87;9737;11399;1662;5123;6813;1690
15541;09.10.2017;'13 - 14;39,94;34,82;5,12;9425;10730;1305;5822;7970;2148
15542;09.10.2017;'14 - 15;40,06;35,2;4,86;8269;9262;993;6169;8062;1893
15543;09.10.2017;'15 - 16;41,41;37,74;3,67;6407;6884;477;6058;7416;1358
15544;09.10.2017;'16 - 17;43,79;40,16;3,63;4006;4035;29;5623;6547;924
15545;09.10.2017;'17 - 18;50,52;47,47;3,05;1516;1489;-27;5233;5755;522
15546;09.10.2017;'18 - 19;59,83;57,11;2,72;158;102;-56;5090;5592;502
15547;09.10.2017;'19 - 20;62,01;60,12;1,89;0;0;0;5191;6035;844
15548;09.10.2017;'20 - 21;46,36;47,5;-1,14;0;0;0;5390;6902;1512
15549;09.10.2017;'21 - 22;38,58;39,11;-0,53;0;0;0;5680;7568;1888
15550;09.10.2017;'22 - 23;37,22;36,97;0,25;0;0;0;6018;8205;2187
15551;09.10.2017;'23 - 24;32,93;31,77;1,16;0;0;0;6345;8244;1899
15552;10.10.2017;'00 - 01;30,22;32,19;-1,97;0;0;0;7600;8251;651
15553;10.10.2017;'01 - 02;29,96;31,63;-1,67;0;0;0;7871;8224;353
15554;10.10.2017;'02 - 03;30,19;32,69;-2,5;0;0;0;8221;8089;-132
15555;10.10.2017;'03 - 04;30;32,31;-2,31;0;0;0;8443;7664;-779
15556;10.10.2017;'04 - 05;30,74;32,05;-1,31;0;0;0;8702;7840;-862
15557;10.10.2017;'05 - 06;31,79;33,08;-1,29;0;0;0;8792;7779;-1013
15558;10.10.2017;'06 - 07;37,78;42,82;-5,04;0;0;0;8830;7993;-837
15559;10.10.2017;'07 - 08;48,85;56,98;-8,13;42;23;-19;9058;7966;-1092
15560;10.10.2017;'08 - 09;56,94;66,27;-9,33;700;680;-20;9701;8183;-1518
15561;10.10.2017;'09 - 10;55,61;70,79;-15,18;2213;2330;117;10862;8755;-2107
15562;10.10.2017;'10 - 11;43,07;59,76;-16,69;3780;4182;402;12284;9832;-2452
15563;10.10.2017;'11 - 12;42,36;49,32;-6,96;4973;5502;529;13973;11198;-2775
15564;10.10.2017;'12 - 13;40;44,43;-4,43;5553;6406;853;15729;13254;-2475
15565;10.10.2017;'13 - 14;38,3;41,56;-3,26;5328;6462;1134;17171;14684;-2487
15566;10.10.2017;'14 - 15;37,24;40,04;-2,8;4566;4958;392;18062;14997;-3065
15567;10.10.2017;'15 - 16;35,89;50,78;-14,89;3390;3352;-38;18133;15378;-2755
15568;10.10.2017;'16 - 17;35,37;43,99;-8,62;1988;1912;-76;18051;16206;-1845
15569;10.10.2017;'17 - 18;36,82;42,56;-5,74;728;763;35;17958;16470;-1488
15570;10.10.2017;'18 - 19;39,9;48,6;-8,7;82;64;-18;17893;17475;-418
15571;10.10.2017;'19 - 20;42,92;45,63;-2,71;0;0;0;18160;18323;163
15572;10.10.2017;'20 - 21;35,46;37,81;-2,35;0;0;0;18492;19501;1009
15573;10.10.2017;'21 - 22;33,03;33,75;-0,72;0;0;0;18693;20502;1809
15574;10.10.2017;'22 - 23;30,51;28,6;1,91;0;0;0;18526;20312;1786
15575;10.10.2017;'23 - 24;22,76;23,21;-0,45;0;0;0;18118;20370;2252
15576;11.10.2017;'00 - 01;22,04;16,32;5,72;0;0;0;17596;19706;2110
15577;11.10.2017;'01 - 02;21,31;14,9;6,41;0;0;0;16665;19009;2344
15578;11.10.2017;'02 - 03;22,79;17,26;5,53;0;0;0;16195;19055;2860
15579;11.10.2017;'03 - 04;23,09;16,1;6,99;0;0;0;16047;19071;3024
15580;11.10.2017;'04 - 05;27,05;19,06;7,99;0;0;0;16108;19620;3512
15581;11.10.2017;'05 - 06;29,83;19,82;10,01;0;0;0;16451;20218;3767
15582;11.10.2017;'06 - 07;38,93;27,5;11,43;0;0;0;17128;21137;4009
15583;11.10.2017;'07 - 08;47;31,88;15,12;50;45;-5;18056;20949;2893
15584;11.10.2017;'08 - 09;49,93;41,29;8,64;1019;1165;146;18892;21346;2454
15585;11.10.2017;'09 - 10;43,81;36,2;7,61;3301;3785;484;19606;21596;1990
15586;11.10.2017;'10 - 11;41;33,97;7,03;5786;6643;857;20603;22370;1767
15587;11.10.2017;'11 - 12;38,91;32,35;6,56;7869;9237;1368;21649;23232;1583
15588;11.10.2017;'12 - 13;31,89;26,63;5,26;9089;10172;1083;22374;23928;1554
15589;11.10.2017;'13 - 14;31,81;27,15;4,66;9193;9519;326;22657;24333;1676
15590;11.10.2017;'14 - 15;30,54;29,44;1,1;8432;8452;20;22491;23314;823
15591;11.10.2017;'15 - 16;31,7;33,11;-1,41;6861;7114;253;21743;21905;162
15592;11.10.2017;'16 - 17;36,35;38,42;-2,07;4483;4811;328;20725;21461;736
15593;11.10.2017;'17 - 18;41,18;41,69;-0,51;1741;1954;213;19987;20930;943
15594;11.10.2017;'18 - 19;42,98;43,65;-0,67;163;140;-23;19724;21030;1306
15595;11.10.2017;'19 - 20;46,49;46,75;-0,26;0;0;0;19955;21176;1221
15596;11.10.2017;'20 - 21;39,9;38,51;1,39;0;0;0;20492;21685;1193
15597;11.10.2017;'21 - 22;31,93;29,46;2,47;0;0;0;21327;22246;919
15598;11.10.2017;'22 - 23;29,58;27,44;2,14;0;0;0;22178;21736;-442
15599;11.10.2017;'23 - 24;22,09;25,47;-3,38;0;0;0;22932;22337;-595
15600;12.10.2017;'00 - 01;13,32;23,42;-10,1;0;0;0;23469;22958;-511
15601;12.10.2017;'01 - 02;12,66;21,26;-8,6;0;0;0;24043;23983;-60
15602;12.10.2017;'02 - 03;12,67;17,87;-5,2;0;0;0;25140;25458;318
15603;12.10.2017;'03 - 04;9,7;13,11;-3,41;0;0;0;26180;27051;871
15604;12.10.2017;'04 - 05;10,28;9,09;1,19;0;0;0;27144;27515;371
15605;12.10.2017;'05 - 06;11,17;11,74;-0,57;0;0;0;27756;27952;196
15606;12.10.2017;'06 - 07;28,04;24,54;3,5;0;0;0;28009;29482;1473
15607;12.10.2017;'07 - 08;38,09;32,24;5,85;66;50;-16;28380;30250;1870
15608;12.10.2017;'08 - 09;36,99;30,65;6,34;1548;1603;55;28839;29466;627
15609;12.10.2017;'09 - 10;30,54;24,99;5,55;4842;5073;231;29252;29148;-104
15610;12.10.2017;'10 - 11;21,49;14,73;6,76;8166;8460;294;29808;30056;248
15611;12.10.2017;'11 - 12;17,52;13,63;3,89;10776;10907;131;30645;30901;256
15612;12.10.2017;'12 - 13;12,78;11,19;1,59;12168;11653;-515;31261;31530;269
15613;12.10.2017;'13 - 14;13,54;14,17;-0,63;11910;11778;-132;31465;31691;226
15614;12.10.2017;'14 - 15;15,12;16,99;-1,87;10508;11110;602;31177;30622;-555
15615;12.10.2017;'15 - 16;21,62;23,61;-1,99;8282;9186;904;30083;29622;-461
15616;12.10.2017;'16 - 17;26,04;27,28;-1,24;5271;6054;783;28329;27503;-826
15617;12.10.2017;'17 - 18;34,93;36,85;-1,92;1923;2452;529;26161;23987;-2174
15618;12.10.2017;'18 - 19;42,05;45,05;-3;155;161;6;23623;21498;-2125
15619;12.10.2017;'19 - 20;46,32;50,59;-4,27;0;0;0;21552;20380;-1172
15620;12.10.2017;'20 - 21;40,98;44,55;-3,57;0;0;0;19880;20763;883
15621;12.10.2017;'21 - 22;42,94;41,33;1,61;0;0;0;18476;20387;1911
15622;12.10.2017;'22 - 23;38,96;34,36;4,6;0;0;0;17062;19083;2021
15623;12.10.2017;'23 - 24;31,37;25,83;5,54;0;0;0;15796;18333;2537
15624;13.10.2017;'00 - 01;30,53;27,66;2,87;0;0;0;15477;17520;2043
15625;13.10.2017;'01 - 02;29,38;27,27;2,11;0;0;0;14704;16736;2032
15626;13.10.2017;'02 - 03;28,34;28,24;0,1;0;0;0;14033;16051;2018
15627;13.10.2017;'03 - 04;28,46;27,95;0,51;0;0;0;13230;14766;1536
15628;13.10.2017;'04 - 05;29,03;28,37;0,66;0;0;0;12602;13995;1393
15629;13.10.2017;'05 - 06;31,47;31,79;-0,32;0;0;0;12110;13621;1511
15630;13.10.2017;'06 - 07;43,08;44,34;-1,26;0;0;0;11602;12914;1312
15631;13.10.2017;'07 - 08;59,93;59,1;0,83;56;57;1;11039;12195;1156
15632;13.10.2017;'08 - 09;64,82;63,25;1,57;1630;1802;172;10355;11748;1393
15633;13.10.2017;'09 - 10;50,81;50,07;0,74;5213;5410;197;9552;10584;1032
15634;13.10.2017;'10 - 11;46,46;45,37;1,09;8854;9598;744;8996;9477;481
15635;13.10.2017;'11 - 12;44,4;44,29;0,11;11699;13201;1502;9226;9500;274
15636;13.10.2017;'12 - 13;38,03;37,77;0,26;13272;15035;1763;10116;10689;573
15637;13.10.2017;'13 - 14;33,49;33,19;0,3;13369;14552;1183;11048;11923;875
15638;13.10.2017;'14 - 15;31,29;34,37;-3,08;12145;12938;793;11555;12436;881
15639;13.10.2017;'15 - 16;34,72;37,89;-3,17;9670;10128;458;11362;12115;753
15640;13.10.2017;'16 - 17;36,99;40,72;-3,73;6113;6338;225;10851;10873;22
15641;13.10.2017;'17 - 18;46,45;50,14;-3,69;2221;2346;125;10483;10028;-455
15642;13.10.2017;'18 - 19;55,9;65,46;-9,56;174;120;-54;10654;10552;-102
15643;13.10.2017;'19 - 20;49,9;65,3;-15,4;0;0;0;11240;11370;130
15644;13.10.2017;'20 - 21;39,27;45,16;-5,89;0;0;0;11949;12521;572
15645;13.10.2017;'21 - 22;35,21;41,06;-5,85;0;0;0;12741;13378;637
15646;13.10.2017;'22 - 23;31,66;38,5;-6,84;0;0;0;13508;13787;279
15647;13.10.2017;'23 - 24;29,63;38,35;-8,72;0;0;0;14090;14311;221
15648;14.10.2017;'00 - 01;28;32,17;-4,17;0;0;0;13998;14498;500
15649;14.10.2017;'01 - 02;26,99;31,67;-4,68;0;0;0;14164;14384;220
15650;14.10.2017;'02 - 03;27,41;31,69;-4,28;0;0;0;14377;14592;215
15651;14.10.2017;'03 - 04;26,4;31,11;-4,71;0;0;0;14391;14617;226
15652;14.10.2017;'04 - 05;26,17;31,28;-5,11;0;0;0;14389;14314;-75
15653;14.10.2017;'05 - 06;26,1;31,35;-5,25;0;0;0;14377;14392;15
15654;14.10.2017;'06 - 07;28;33,74;-5,74;0;0;0;14369;14804;435
15655;14.10.2017;'07 - 08;33,99;43,65;-9,66;59;43;-16;14315;14876;561
15656;14.10.2017;'08 - 09;39,42;46,25;-6,83;1946;1843;-103;14139;14741;602
15657;14.10.2017;'09 - 10;35,95;41,16;-5,21;6244;6083;-161;13831;14249;418
15658;14.10.2017;'10 - 11;28,04;31,01;-2,97;10659;11075;416;13631;13563;-68
15659;14.10.2017;'11 - 12;22,86;26,59;-3,73;14096;15324;1228;13652;13669;17
15660;14.10.2017;'12 - 13;26,07;23,29;2,78;15933;17609;1676;13694;13902;208
15661;14.10.2017;'13 - 14;12,67;9,92;2,75;16120;17874;1754;13569;13708;139
15662;14.10.2017;'14 - 15;13,31;12,05;1,26;14736;16373;1637;13077;13160;83
15663;14.10.2017;'15 - 16;26,42;24,33;2,09;11887;13136;1249;12068;12397;329
15664;14.10.2017;'16 - 17;31,44;33,25;-1,81;7613;8280;667;10928;10877;-51
15665;14.10.2017;'17 - 18;40,02;44,58;-4,56;2802;2869;67;10002;9936;-66
15666;14.10.2017;'18 - 19;49,71;57,78;-8,07;202;124;-78;9528;9838;310
15667;14.10.2017;'19 - 20;52,51;63,39;-10,88;0;0;0;9421;10379;958
15668;14.10.2017;'20 - 21;43,97;47,3;-3,33;0;0;0;9428;10645;1217
15669;14.10.2017;'21 - 22;40,03;43,95;-3,92;0;0;0;9220;10370;1150
15670;14.10.2017;'22 - 23;39,07;42,48;-3,41;0;0;0;8803;9486;683
15671;14.10.2017;'23 - 24;31,43;34,37;-2,94;0;0;0;8264;8902;638
15672;15.10.2017;'00 - 01;34,26;33,67;0,59;0;0;0;7135;8197;1062
15673;15.10.2017;'01 - 02;31,56;29,78;1,78;0;0;0;6677;7868;1191
15674;15.10.2017;'02 - 03;30,41;28,89;1,52;0;0;0;6378;7374;996
15675;15.10.2017;'03 - 04;29,27;29,05;0,22;0;0;0;6012;6834;822
15676;15.10.2017;'04 - 05;29,04;26,58;2,46;0;0;0;5750;6491;741
15677;15.10.2017;'05 - 06;28,91;27,74;1,17;0;0;0;5657;5804;147
15678;15.10.2017;'06 - 07;31,18;28,85;2,33;0;0;0;5768;5475;-293
15679;15.10.2017;'07 - 08;35,9;33,43;2,47;59;47;-12;5924;5593;-331
15680;15.10.2017;'08 - 09;34,22;36,07;-1,85;2253;2148;-105;5977;5854;-123
15681;15.10.2017;'09 - 10;33,24;32,09;1,15;7380;7123;-257;5800;6160;360
15682;15.10.2017;'10 - 11;31,58;32,52;-0,94;12634;12812;178;5471;5819;348
15683;15.10.2017;'11 - 12;30,97;29,63;1,34;16704;16969;265;5312;5270;-42
15684;15.10.2017;'12 - 13;22,77;23,53;-0,76;18956;19424;468;5613;4936;-677
15685;15.10.2017;'13 - 14;17,07;20,29;-3,22;19308;19902;594;6040;5374;-666
15686;15.10.2017;'14 - 15;22,44;25,49;-3,05;17780;18407;627;6447;5742;-705
15687;15.10.2017;'15 - 16;26,63;26,99;-0,36;14421;14700;279;6642;6168;-474
15688;15.10.2017;'16 - 17;28,03;29,79;-1,76;9260;9096;-164;6943;6369;-574
15689;15.10.2017;'17 - 18;39,38;39,4;-0,02;3352;2982;-370;7704;7111;-593
15690;15.10.2017;'18 - 19;45,05;47,85;-2,8;213;105;-108;9811;10387;576
15691;15.10.2017;'19 - 20;45,04;45,17;-0,13;0;0;0;12427;14193;1766
15692;15.10.2017;'20 - 21;31,75;35,77;-4,02;0;0;0;14381;16088;1707
15693;15.10.2017;'21 - 22;31,73;31,8;-0,07;0;0;0;15392;17554;2162
15694;15.10.2017;'22 - 23;29,09;29,86;-0,77;0;0;0;15745;18127;2382
15695;15.10.2017;'23 - 24;18,4;18,24;0,16;0;0;0;15562;18100;2538
15696;16.10.2017;'00 - 01;22,99;18,89;4,1;0;0;0;16051;17264;1213
15697;16.10.2017;'01 - 02;21,26;19,9;1,36;0;0;0;15461;16193;732
15698;16.10.2017;'02 - 03;21,86;25,45;-3,59;0;0;0;14877;15353;476
15699;16.10.2017;'03 - 04;21,79;21,68;0,11;0;0;0;14030;14306;276
15700;16.10.2017;'04 - 05;22,93;18,74;4,19;0;0;0;13213;13276;63
15701;16.10.2017;'05 - 06;28,9;29,04;-0,14;0;0;0;12552;12565;13
15702;16.10.2017;'06 - 07;42;45,07;-3,07;0;0;0;12103;11902;-201
15703;16.10.2017;'07 - 08;55,34;58,11;-2,77;54;48;-6;11659;11066;-593
15704;16.10.2017;'08 - 09;51,65;54,98;-3,33;2385;2284;-101;10852;10422;-430
15705;16.10.2017;'09 - 10;43,12;41,79;1,33;7798;7328;-470;9559;8918;-641
15706;16.10.2017;'10 - 11;37,3;36,6;0,7;13094;12794;-300;8001;6200;-1801
15707;16.10.2017;'11 - 12;33,16;34,73;-1,57;16949;17028;79;6843;4187;-2656
15708;16.10.2017;'12 - 13;32,26;36,09;-3,83;18900;19122;222;6381;3402;-2979
15709;16.10.2017;'13 - 14;31,68;35,32;-3,64;19109;19054;-55;6003;3242;-2761
15710;16.10.2017;'14 - 15;40,56;44,6;-4,04;17493;17132;-361;5378;3310;-2068
15711;16.10.2017;'15 - 16;42,5;45,26;-2,76;14087;13313;-774;4616;3652;-964
15712;16.10.2017;'16 - 17;44,62;47,39;-2,77;8965;7927;-1038;4211;4232;21
15713;16.10.2017;'17 - 18;50,9;54,97;-4,07;3099;2450;-649;4551;5653;1102
15714;16.10.2017;'18 - 19;63,47;57,41;6,06;168;74;-94;6096;9065;2969
15715;16.10.2017;'19 - 20;66,73;55,34;11,39;0;0;0;8327;12940;4613
15716;16.10.2017;'20 - 21;45,95;38,07;7,88;0;0;0;10578;15242;4664
15717;16.10.2017;'21 - 22;39,05;33,82;5,23;0;0;0;12141;15972;3831
15718;16.10.2017;'22 - 23;34,07;32,91;1,16;0;0;0;13252;16390;3138
15719;16.10.2017;'23 - 24;31,11;29,73;1,38;0;0;0;13895;16596;2701
15720;17.10.2017;'00 - 01;28,95;26,89;2,06;0;0;0;15509;16906;1397
15721;17.10.2017;'01 - 02;27,02;28,47;-1,45;0;0;0;15253;16644;1391
15722;17.10.2017;'02 - 03;26,99;28,28;-1,29;0;0;0;15031;15490;459
15723;17.10.2017;'03 - 04;27,04;30,81;-3,77;0;0;0;14541;14663;122
15724;17.10.2017;'04 - 05;28,06;29,89;-1,83;0;0;0;14063;14644;581
15725;17.10.2017;'05 - 06;30,57;33,07;-2,5;0;0;0;13748;14836;1088
15726;17.10.2017;'06 - 07;34,99;37,78;-2,79;0;0;0;13602;14707;1105
15727;17.10.2017;'07 - 08;46,16;50,86;-4,7;40;36;-4;13378;14240;862
15728;17.10.2017;'08 - 09;44,97;46,34;-1,37;2161;1995;-166;12951;13594;643
15729;17.10.2017;'09 - 10;36,95;36,88;0,07;7433;6646;-787;12241;12383;142
15730;17.10.2017;'10 - 11;33,46;35,24;-1,78;12674;11545;-1129;11120;10978;-142
15731;17.10.2017;'11 - 12;31,34;34,25;-2,91;16596;15288;-1308;10373;10163;-210
15732;17.10.2017;'12 - 13;29,24;33,29;-4,05;18675;17253;-1422;10602;9876;-726
15733;17.10.2017;'13 - 14;30,22;34,16;-3,94;18925;17343;-1582;11020;9802;-1218
15734;17.10.2017;'14 - 15;29,72;35,49;-5,77;17327;15576;-1751;11010;9522;-1488
15735;17.10.2017;'15 - 16;32,8;38,32;-5,52;13876;11901;-1975;10534;8990;-1544
15736;17.10.2017;'16 - 17;35,47;44,24;-8,77;8678;6858;-1820;9923;8537;-1386
15737;17.10.2017;'17 - 18;47,92;63,07;-15,15;2892;2060;-832;9397;8586;-811
15738;17.10.2017;'18 - 19;63,36;64,84;-1,48;144;55;-89;9465;9068;-397
15739;17.10.2017;'19 - 20;67,92;74,52;-6,6;0;0;0;9987;9333;-654
15740;17.10.2017;'20 - 21;47,38;54,64;-7,26;0;0;0;10115;9354;-761
15741;17.10.2017;'21 - 22;43,61;46,51;-2,9;0;0;0;9834;8824;-1010
15742;17.10.2017;'22 - 23;39,99;43,47;-3,48;0;0;0;9136;8665;-471
15743;17.10.2017;'23 - 24;36,79;35,39;1,4;0;0;0;8282;8564;282
15744;18.10.2017;'00 - 01;33,22;37,58;-4,36;0;0;0;7771;8092;321
15745;18.10.2017;'01 - 02;34,02;36,02;-2;0;0;0;7117;7104;-13
15746;18.10.2017;'02 - 03;34,02;34,9;-0,88;0;0;0;6577;6242;-335
15747;18.10.2017;'03 - 04;31,89;34,02;-2,13;0;0;0;5867;5804;-63
15748;18.10.2017;'04 - 05;31,81;35,31;-3,5;0;0;0;5242;5095;-147
15749;18.10.2017;'05 - 06;36,03;37,79;-1,76;0;0;0;4712;4590;-122
15750;18.10.2017;'06 - 07;49,87;53,29;-3,42;0;0;0;4299;4225;-74
15751;18.10.2017;'07 - 08;66;68,12;-2,12;24;18;-6;3886;3746;-140
15752;18.10.2017;'08 - 09;69,94;67,77;2,17;1554;1364;-190;3334;3193;-141
15753;18.10.2017;'09 - 10;67,91;65,57;2,34;5694;5023;-671;2601;2523;-78
15754;18.10.2017;'10 - 11;64,42;60,7;3,72;10259;9458;-801;1823;1612;-211
15755;18.10.2017;'11 - 12;63,08;56,21;6,87;14060;13631;-429;1298;970;-328
15756;18.10.2017;'12 - 13;47,93;47,85;0,08;16231;16051;-180;1139;641;-498
15757;18.10.2017;'13 - 14;45,97;51,61;-5,64;16519;16644;125;1030;526;-504
15758;18.10.2017;'14 - 15;46,07;50,07;-4;15128;15312;184;870;502;-368
15759;18.10.2017;'15 - 16;55,84;53,74;2,1;12041;11890;-151;728;578;-150
15760;18.10.2017;'16 - 17;62,65;63,65;-1;7456;6987;-469;772;632;-140
15761;18.10.2017;'17 - 18;65,66;68,1;-2,44;2441;2077;-364;1044;714;-330
15762;18.10.2017;'18 - 19;73,41;90,58;-17,17;122;45;-77;1732;1280;-452
15763;18.10.2017;'19 - 20;83,02;104,9;-21,88;0;0;0;2501;2019;-482
15764;18.10.2017;'20 - 21;66,84;68,43;-1,59;0;0;0;3025;2554;-471
15765;18.10.2017;'21 - 22;54,27;52,61;1,66;0;0;0;3345;2861;-484
15766;18.10.2017;'22 - 23;40,45;44,51;-4,06;0;0;0;3611;3024;-587
15767;18.10.2017;'23 - 24;36,94;41,23;-4,29;0;0;0;3767;3343;-424
15768;19.10.2017;'00 - 01;34,28;36,18;-1,9;0;0;0;3515;3692;177
15769;19.10.2017;'01 - 02;34,26;32,1;2,16;0;0;0;3625;3890;265
15770;19.10.2017;'02 - 03;33,59;30,51;3,08;0;0;0;3851;4250;399
15771;19.10.2017;'03 - 04;33,74;30,36;3,38;0;0;0;3760;4204;444
15772;19.10.2017;'04 - 05;34;30,77;3,23;0;0;0;3742;3987;245
15773;19.10.2017;'05 - 06;34,89;34,34;0,55;0;0;0;3814;3917;103
15774;19.10.2017;'06 - 07;53,71;52,23;1,48;0;0;0;3881;3899;18
15775;19.10.2017;'07 - 08;67,66;64,69;2,97;20;14;-6;3857;3781;-76
15776;19.10.2017;'08 - 09;68,54;66,96;1,58;1446;1374;-72;3708;3904;196
15777;19.10.2017;'09 - 10;67,82;60,05;7,77;5330;5442;112;3366;3918;552
15778;19.10.2017;'10 - 11;62,07;48,86;13,21;9629;9789;160;2992;3496;504
15779;19.10.2017;'11 - 12;49,97;43,75;6,22;13237;13291;54;2740;3260;520
15780;19.10.2017;'12 - 13;46,57;40,02;6,55;15298;15165;-133;2629;3266;637
15781;19.10.2017;'13 - 14;41,55;37,01;4,54;15737;15596;-141;2609;2966;357
15782;19.10.2017;'14 - 15;40,53;38,4;2,13;14567;14394;-173;2588;2756;168
15783;19.10.2017;'15 - 16;43,63;41,31;2,32;11586;11438;-148;2634;3050;416
15784;19.10.2017;'16 - 17;49,91;42,51;7,4;7113;6742;-371;3079;3604;525
15785;19.10.2017;'17 - 18;58,01;50,46;7,55;2228;1895;-333;4333;5496;1163
15786;19.10.2017;'18 - 19;61,27;70,3;-9,03;92;38;-54;6805;8832;2027
15787;19.10.2017;'19 - 20;54,3;55,37;-1,07;0;0;0;9700;11912;2212
15788;19.10.2017;'20 - 21;41,55;35,97;5,58;0;0;0;11722;13476;1754
15789;19.10.2017;'21 - 22;34,6;34,11;0,49;0;0;0;12686;13804;1118
15790;19.10.2017;'22 - 23;34,87;35,08;-0,21;0;0;0;13163;13567;404
15791;19.10.2017;'23 - 24;31,04;30,04;1;0;0;0;13279;13424;145
15792;20.10.2017;'00 - 01;29,62;33,35;-3,73;0;0;0;13316;13119;-197
15793;20.10.2017;'01 - 02;29,02;33,69;-4,67;0;0;0;13172;12786;-386
15794;20.10.2017;'02 - 03;29,06;33,25;-4,19;0;0;0;13077;12641;-436
15795;20.10.2017;'03 - 04;29,88;30,12;-0,24;0;0;0;12831;12635;-196
15796;20.10.2017;'04 - 05;30;31,43;-1,43;0;0;0;12661;12232;-429
15797;20.10.2017;'05 - 06;31,01;34,02;-3,01;0;0;0;12795;12214;-581
15798;20.10.2017;'06 - 07;39,91;43,34;-3,43;0;0;0;13224;13360;136
15799;20.10.2017;'07 - 08;47,05;45,77;1,28;15;10;-5;13713;14076;363
15800;20.10.2017;'08 - 09;51,28;48,12;3,16;1262;1082;-180;14158;15441;1283
15801;20.10.2017;'09 - 10;47;41,99;5,01;4450;3903;-547;14345;16044;1699
15802;20.10.2017;'10 - 11;43,14;36,44;6,7;7575;6872;-703;14230;15754;1524
15803;20.10.2017;'11 - 12;41,28;36,49;4,79;9793;9148;-645;14218;16049;1831
15804;20.10.2017;'12 - 13;37,59;33,4;4,19;10855;10688;-167;14363;16048;1685
15805;20.10.2017;'13 - 14;33,06;30,13;2,93;10612;10672;60;14719;16073;1354
15806;20.10.2017;'14 - 15;32,89;31,35;1,54;9325;9186;-139;14906;16099;1193
15807;20.10.2017;'15 - 16;32,61;32,3;0,31;7170;6756;-414;14746;15716;970
15808;20.10.2017;'16 - 17;33,04;30,21;2,83;4207;3643;-564;14619;15603;984
15809;20.10.2017;'17 - 18;44,61;36,91;7,7;1218;942;-276;14540;15239;699
15810;20.10.2017;'18 - 19;47,86;40,75;7,11;49;17;-32;14586;16295;1709
15811;20.10.2017;'19 - 20;46,94;40,69;6,25;0;0;0;14765;16946;2181
15812;20.10.2017;'20 - 21;38,98;33,8;5,18;0;0;0;14876;16751;1875
15813;20.10.2017;'21 - 22;41,84;33,11;8,73;0;0;0;14585;15974;1389
15814;20.10.2017;'22 - 23;35,86;33,19;2,67;0;0;0;14035;14532;497
15815;20.10.2017;'23 - 24;32,74;29,94;2,8;0;0;0;13342;13030;-312
15816;21.10.2017;'00 - 01;35;31,65;3,35;0;0;0;11760;11867;107
15817;21.10.2017;'01 - 02;32,52;32,08;0,44;0;0;0;10920;10964;44
15818;21.10.2017;'02 - 03;32,05;30,32;1,73;0;0;0;10349;10175;-174
15819;21.10.2017;'03 - 04;30,84;30,08;0,76;0;0;0;9806;9642;-164
15820;21.10.2017;'04 - 05;29,35;29,84;-0,49;0;0;0;9329;9507;178
15821;21.10.2017;'05 - 06;30,3;30,66;-0,36;0;0;0;9004;9213;209
15822;21.10.2017;'06 - 07;31,16;31,72;-0,56;0;0;0;9046;9831;785
15823;21.10.2017;'07 - 08;35,88;33,04;2,84;6;5;-1;9243;9969;726
15824;21.10.2017;'08 - 09;41,91;38,54;3,37;609;618;9;9254;10040;786
15825;21.10.2017;'09 - 10;46,07;43,2;2,87;2637;2583;-54;9071;10425;1354
15826;21.10.2017;'10 - 11;47,71;44,18;3,53;4946;5108;162;8914;10612;1698
15827;21.10.2017;'11 - 12;45,98;44,43;1,55;6894;7286;392;9112;10869;1757
15828;21.10.2017;'12 - 13;35;35,88;-0,88;7913;8342;429;9906;11313;1407
15829;21.10.2017;'13 - 14;31,02;33,46;-2,44;7479;7470;-9;10678;11186;508
15830;21.10.2017;'14 - 15;32,09;40,41;-8,32;6185;5885;-300;11123;11212;89
15831;21.10.2017;'15 - 16;32;39,17;-7,17;4445;4291;-154;11128;10894;-234
15832;21.10.2017;'16 - 17;32,09;41,88;-9,79;2480;2359;-121;11222;10530;-692
15833;21.10.2017;'17 - 18;36,56;46,72;-10,16;685;661;-24;11500;10225;-1275
15834;21.10.2017;'18 - 19;40,2;51;-10,8;28;18;-10;12092;11282;-810
15835;21.10.2017;'19 - 20;40,71;49,86;-9,15;0;0;0;12940;12298;-642
15836;21.10.2017;'20 - 21;31,75;40,61;-8,86;0;0;0;13700;13794;94
15837;21.10.2017;'21 - 22;28,59;34,09;-5,5;0;0;0;14487;15042;555
15838;21.10.2017;'22 - 23;27,5;30,43;-2,93;0;0;0;15346;15608;262
15839;21.10.2017;'23 - 24;15,48;22,51;-7,03;0;0;0;16243;16870;627
15840;22.10.2017;'00 - 01;19,1;21,48;-2,38;0;0;0;16424;17044;620
15841;22.10.2017;'01 - 02;19,03;17,81;1,22;0;0;0;17297;17840;543
15842;22.10.2017;'02 - 03;16,9;18;-1,1;0;0;0;18344;18715;371
15843;22.10.2017;'03 - 04;12,98;12,31;0,67;0;0;0;19184;19602;418
15844;22.10.2017;'04 - 05;9,24;8,67;0,57;0;0;0;19991;21120;1129
15845;22.10.2017;'05 - 06;5,23;3,48;1,75;0;0;0;20542;21945;1403
15846;22.10.2017;'06 - 07;9,86;-1,75;11,61;0;0;0;20890;22860;1970
15847;22.10.2017;'07 - 08;9,85;-2,78;12,63;5;3;-2;21234;22980;1746
15848;22.10.2017;'08 - 09;13,04;2,7;10,34;719;702;-17;21382;22439;1057
15849;22.10.2017;'09 - 10;12,9;10,4;2,5;3085;3148;63;21284;22028;744
15850;22.10.2017;'10 - 11;13,09;15,34;-2,25;5607;5581;-26;21334;22152;818
15851;22.10.2017;'11 - 12;14,3;13,36;0,94;7488;7292;-196;21384;21883;499
15852;22.10.2017;'12 - 13;13,58;13,98;-0,4;8293;7841;-452;20926;20247;-679
15853;22.10.2017;'13 - 14;13,44;22,37;-8,93;7968;7500;-468;20060;18438;-1622
15854;22.10.2017;'14 - 15;13,5;28,43;-14,93;6811;6222;-589;18847;16863;-1984
15855;22.10.2017;'15 - 16;23,39;32,52;-9,13;4959;4442;-517;17349;15544;-1805
15856;22.10.2017;'16 - 17;28,65;35,66;-7,01;2683;2595;-88;15867;14810;-1057
15857;22.10.2017;'17 - 18;34,45;36,6;-2,15;672;744;72;14620;14203;-417
15858;22.10.2017;'18 - 19;49,9;51,99;-2,09;22;10;-12;14058;14032;-26
15859;22.10.2017;'19 - 20;49,97;58,07;-8,1;0;0;0;13937;14300;363
15860;22.10.2017;'20 - 21;44,92;50,78;-5,86;0;0;0;13886;14386;500
15861;22.10.2017;'21 - 22;35,88;39,53;-3,65;0;0;0;13787;14114;327
15862;22.10.2017;'22 - 23;32,24;33,44;-1,2;0;0;0;13735;13315;-420
15863;22.10.2017;'23 - 24;29,05;31,35;-2,3;0;0;0;13579;12977;-602
15864;23.10.2017;'00 - 01;28,61;31,19;-2,58;0;0;0;13221;12804;-417
15865;23.10.2017;'01 - 02;27,86;26,34;1,52;0;0;0;13155;13010;-145
15866;23.10.2017;'02 - 03;26,43;25,8;0,63;0;0;0;13182;13660;478
15867;23.10.2017;'03 - 04;23,07;22,01;1,06;0;0;0;13105;13836;731
15868;23.10.2017;'04 - 05;22,22;17,32;4,9;0;0;0;13016;13797;781
15869;23.10.2017;'05 - 06;30,33;26,92;3,41;0;0;0;12948;13834;886
15870;23.10.2017;'06 - 07;42,36;39,53;2,83;0;0;0;13041;14215;1174
15871;23.10.2017;'07 - 08;50,21;48,1;2,11;4;2;-2;13179;14290;1111
15872;23.10.2017;'08 - 09;50;42,02;7,98;361;376;15;13130;14293;1163
15873;23.10.2017;'09 - 10;45,39;37,96;7,43;1625;1804;179;12884;14170;1286
15874;23.10.2017;'10 - 11;46,02;38,57;7,45;3043;3588;545;12834;13954;1120
15875;23.10.2017;'11 - 12;46,1;40,1;6;4075;4747;672;12670;14273;1603
15876;23.10.2017;'12 - 13;43,16;38,27;4,89;4594;5368;774;12288;13657;1369
15877;23.10.2017;'13 - 14;46,34;40,87;5,47;4620;5091;471;11904;12721;817
15878;23.10.2017;'14 - 15;46,74;42,72;4,02;4213;4137;-76;11200;11987;787
15879;23.10.2017;'15 - 16;46,01;45,29;0,72;3320;3043;-277;9957;10794;837
15880;23.10.2017;'16 - 17;46,08;46,55;-0,47;1878;1751;-127;8671;9580;909
15881;23.10.2017;'17 - 18;49,66;48,14;1,52;474;431;-43;7543;8254;711
15882;23.10.2017;'18 - 19;54,2;55,79;-1,59;14;5;-9;6846;7271;425
15883;23.10.2017;'19 - 20;53,91;59,03;-5,12;0;0;0;6466;7098;632
15884;23.10.2017;'20 - 21;50,12;51,87;-1,75;0;0;0;6141;7060;919
15885;23.10.2017;'21 - 22;45,48;44,94;0,54;0;0;0;5807;6784;977
15886;23.10.2017;'22 - 23;37,7;36,05;1,65;0;0;0;5432;6432;1000
15887;23.10.2017;'23 - 24;36;35,6;0,4;0;0;0;5109;6154;1045
15888;24.10.2017;'00 - 01;31,68;33,8;-2,12;0;0;0;5083;5608;525
15889;24.10.2017;'01 - 02;32,41;31,58;0,83;0;0;0;5010;5270;260
15890;24.10.2017;'02 - 03;32,09;32,91;-0,82;0;0;0;5230;5159;-71
15891;24.10.2017;'03 - 04;31,67;32,39;-0,72;0;0;0;5510;5319;-191
15892;24.10.2017;'04 - 05;32,07;33,98;-1,91;0;0;0;5791;5699;-92
15893;24.10.2017;'05 - 06;34,3;35,21;-0,91;0;0;0;6038;5904;-134
15894;24.10.2017;'06 - 07;43,56;49,13;-5,57;0;0;0;6233;6400;167
15895;24.10.2017;'07 - 08;46,59;52,12;-5,53;3;1;-2;6466;6938;472
15896;24.10.2017;'08 - 09;53,91;61,28;-7,37;277;415;138;6661;8199;1538
15897;24.10.2017;'09 - 10;48,42;54,42;-6;1204;2146;942;6850;8843;1993
15898;24.10.2017;'10 - 11;49,08;49,95;-0,87;2360;4311;1951;7188;9394;2206
15899;24.10.2017;'11 - 12;45,39;43,97;1,42;3340;6090;2750;7783;9504;1721
15900;24.10.2017;'12 - 13;38,58;37,66;0,92;3917;6896;2979;8627;10460;1833
15901;24.10.2017;'13 - 14;38,23;36,25;1,98;3835;6995;3160;9583;11204;1621
15902;24.10.2017;'14 - 15;36,99;34,33;2,66;3307;6576;3269;10219;11351;1132
15903;24.10.2017;'15 - 16;36,99;35,33;1,66;2385;4994;2609;10395;11868;1473
15904;24.10.2017;'16 - 17;36,1;36,49;-0,39;1227;2498;1271;10720;13108;2388
15905;24.10.2017;'17 - 18;39,68;39,91;-0,23;307;556;249;11458;14404;2946
15906;24.10.2017;'18 - 19;44,9;42,82;2,08;10;1;-9;12722;16199;3477
15907;24.10.2017;'19 - 20;39,56;36,79;2,77;0;0;0;14340;18127;3787
15908;24.10.2017;'20 - 21;33;33,4;-0,4;0;0;0;15805;18875;3070
15909;24.10.2017;'21 - 22;32,6;30,5;2,1;0;0;0;16967;19298;2331
15910;24.10.2017;'22 - 23;30,18;30,49;-0,31;0;0;0;17955;18701;746
15911;24.10.2017;'23 - 24;27,02;31,07;-4,05;0;0;0;18588;18384;-204
15912;25.10.2017;'00 - 01;15,78;25,35;-9,57;0;0;0;18628;18604;-24
15913;25.10.2017;'01 - 02;15,05;18;-2,95;0;0;0;18379;18458;79
15914;25.10.2017;'02 - 03;12,79;15,58;-2,79;0;0;0;18200;17980;-220
15915;25.10.2017;'03 - 04;13,99;16,35;-2,36;0;0;0;17859;17683;-176
15916;25.10.2017;'04 - 05;17,03;22,15;-5,12;0;0;0;17599;17640;41
15917;25.10.2017;'05 - 06;26,35;26,66;-0,31;0;0;0;17826;18341;515
15918;25.10.2017;'06 - 07;34,67;35,71;-1,04;0;0;0;18704;18689;-15
15919;25.10.2017;'07 - 08;44,84;39,89;4,95;1;0;-1;19708;19118;-590
15920;25.10.2017;'08 - 09;45;47,35;-2,35;326;418;92;20895;20229;-666
15921;25.10.2017;'09 - 10;43,94;44,04;-0,1;1710;2284;574;22099;21254;-845
15922;25.10.2017;'10 - 11;37,11;36,5;0,61;3736;4899;1163;23464;22784;-680
15923;25.10.2017;'11 - 12;31,57;32,17;-0,6;5822;7210;1388;24763;24477;-286
15924;25.10.2017;'12 - 13;29,79;28,95;0,84;7316;8470;1154;25506;25550;44
15925;25.10.2017;'13 - 14;29,66;29,88;-0,22;7682;8728;1046;26000;25550;-450
15926;25.10.2017;'14 - 15;30;30,11;-0,11;7149;8676;1527;25509;24590;-919
15927;25.10.2017;'15 - 16;31,05;32,72;-1,67;5641;6906;1265;23709;22736;-973
15928;25.10.2017;'16 - 17;34,03;33,55;0,48;3192;3906;714;21395;20072;-1323
15929;25.10.2017;'17 - 18;44,74;41,47;3,27;789;861;72;18868;17900;-968
15930;25.10.2017;'18 - 19;50,56;47,77;2,79;22;3;-19;16982;17060;78
15931;25.10.2017;'19 - 20;56,85;53,02;3,83;0;0;0;15599;16702;1103
15932;25.10.2017;'20 - 21;46,19;42,97;3,22;0;0;0;14507;16241;1734
15933;25.10.2017;'21 - 22;45,92;40,52;5,4;0;0;0;13635;15533;1898
15934;25.10.2017;'22 - 23;40,58;38,43;2,15;0;0;0;12666;14528;1862
15935;25.10.2017;'23 - 24;33,09;32,2;0,89;0;0;0;11780;13879;2099
15936;26.10.2017;'00 - 01;31,67;30,94;0,73;0;0;0;11707;13338;1631
15937;26.10.2017;'01 - 02;32,18;31,75;0,43;0;0;0;11127;13085;1958
15938;26.10.2017;'02 - 03;32,21;31,66;0,55;0;0;0;10743;13000;2257
15939;26.10.2017;'03 - 04;32,25;30,65;1,6;0;0;0;10383;12442;2059
15940;26.10.2017;'04 - 05;32,25;31,46;0,79;0;0;0;10134;11984;1850
15941;26.10.2017;'05 - 06;35,36;36,14;-0,78;0;0;0;10012;11199;1187
15942;26.10.2017;'06 - 07;45,25;48,18;-2,93;0;0;0;10056;10994;938
15943;26.10.2017;'07 - 08;55,93;54,69;1,24;3;1;-2;10124;11116;992
15944;26.10.2017;'08 - 09;56,93;49,06;7,87;539;464;-75;10169;11165;996
15945;26.10.2017;'09 - 10;51,9;44,04;7,86;2839;2554;-285;10214;11312;1098
15946;26.10.2017;'10 - 11;46,01;43,37;2,64;5836;5107;-729;10520;11211;691
15947;26.10.2017;'11 - 12;43,25;44,89;-1,64;8416;7620;-796;11281;12028;747
15948;26.10.2017;'12 - 13;38,3;42,22;-3,92;10068;9305;-763;12468;12902;434
15949;26.10.2017;'13 - 14;32,38;38,82;-6,44;10312;9681;-631;13594;13846;252
15950;26.10.2017;'14 - 15;33,07;38,35;-5,28;9221;8990;-231;14118;14755;637
15951;26.10.2017;'15 - 16;36,97;35,63;1,34;6916;6792;-124;13797;14610;813
15952;26.10.2017;'16 - 17;45,42;39,33;6,09;3766;3581;-185;13062;14153;1091
15953;26.10.2017;'17 - 18;48,91;44,67;4,24;910;738;-172;12577;13865;1288
15954;26.10.2017;'18 - 19;50,03;46,36;3,67;20;3;-17;12613;14250;1637
15955;26.10.2017;'19 - 20;50,93;45,97;4,96;0;1;1;13155;14530;1375
15956;26.10.2017;'20 - 21;40,99;38,88;2,11;0;1;1;13849;14957;1108
15957;26.10.2017;'21 - 22;34,97;37,26;-2,29;0;1;1;14405;15936;1531
15958;26.10.2017;'22 - 23;32,34;35,29;-2,95;0;0;0;14916;16064;1148
15959;26.10.2017;'23 - 24;30,92;31,99;-1,07;0;0;0;15444;16388;944
15960;27.10.2017;'00 - 01;22,48;33,06;-10,58;0;0;0;18157;17206;-951
15961;27.10.2017;'01 - 02;21,71;30,77;-9,06;0;0;0;18963;17797;-1166
15962;27.10.2017;'02 - 03;12,9;26,36;-13,46;0;0;0;19774;18762;-1012
15963;27.10.2017;'03 - 04;12,81;23,94;-11,13;0;0;0;20525;19623;-902
15964;27.10.2017;'04 - 05;19,04;23,31;-4,27;0;0;0;21291;20473;-818
15965;27.10.2017;'05 - 06;24,01;23,86;0,15;0;0;0;22019;21535;-484
15966;27.10.2017;'06 - 07;32;38,87;-6,87;0;0;0;22861;22884;23
15967;27.10.2017;'07 - 08;36,79;39,71;-2,92;1;0;-1;23671;23464;-207
15968;27.10.2017;'08 - 09;38,91;41,1;-2,19;351;308;-43;24178;23500;-678
15969;27.10.2017;'09 - 10;38,69;42,81;-4,12;2072;2120;48;24456;23260;-1196
15970;27.10.2017;'10 - 11;38,36;40,89;-2,53;4447;4834;387;24888;24293;-595
15971;27.10.2017;'11 - 12;33,52;33,81;-0,29;6801;6943;142;25559;25686;127
15972;27.10.2017;'12 - 13;28,51;29,3;-0,79;8590;8451;-139;26281;27558;1277
15973;27.10.2017;'13 - 14;25,97;25,46;0,51;9351;9568;217;26667;27536;869
15974;27.10.2017;'14 - 15;27,09;17,68;9,41;9057;8822;-235;26435;26549;114
15975;27.10.2017;'15 - 16;26,99;21,36;5,63;7302;6746;-556;25273;25324;51
15976;27.10.2017;'16 - 17;30,01;28,23;1,78;4105;3776;-329;23668;23396;-272
15977;27.10.2017;'17 - 18;37,8;36,1;1,7;969;796;-173;21893;21060;-833
15978;27.10.2017;'18 - 19;44,93;44,63;0,3;19;4;-15;20149;19544;-605
15979;27.10.2017;'19 - 20;46,93;45,21;1,72;0;1;1;18873;17705;-1168
15980;27.10.2017;'20 - 21;44,18;41,99;2,19;0;1;1;18107;17738;-369
15981;27.10.2017;'21 - 22;35,99;29,8;6,19;0;1;1;17839;18252;413
15982;27.10.2017;'22 - 23;32,04;23,67;8,37;0;0;0;18040;18407;367
15983;27.10.2017;'23 - 24;19,17;14,93;4,24;0;0;0;18569;19522;953
15984;28.10.2017;'00 - 01;16,04;11,49;4,55;0;0;0;21557;20406;-1151
15985;28.10.2017;'01 - 02;9,41;14,93;-5,52;0;0;0;22759;21714;-1045
15986;28.10.2017;'02 - 03;0,03;6,48;-6,45;0;0;0;24078;23265;-813
15987;28.10.2017;'03 - 04;-9,69;4,33;-14,02;0;0;0;25275;24701;-574
15988;28.10.2017;'04 - 05;-13,02;5,06;-18,08;0;0;0;26463;25774;-689
15989;28.10.2017;'05 - 06;-15,01;4,5;-19,51;0;0;0;27593;26810;-783
15990;28.10.2017;'06 - 07;-9,6;6,13;-15,73;0;0;0;28719;29086;367
15991;28.10.2017;'07 - 08;0,12;9,62;-9,5;1;0;-1;29949;30814;865
15992;28.10.2017;'08 - 09;0,12;7,39;-7,27;315;316;1;31286;31695;409
15993;28.10.2017;'09 - 10;5,41;6,87;-1,46;1778;1614;-164;32792;32976;184
15994;28.10.2017;'10 - 11;0,27;3,64;-3,37;3578;3143;-435;34450;34766;316
15995;28.10.2017;'11 - 12;0,11;5,27;-5,16;4896;4268;-628;35871;36562;691
15996;28.10.2017;'12 - 13;-0,1;-5,65;5,55;5503;4782;-721;36802;38020;1218
15997;28.10.2017;'13 - 14;-13,38;-12,11;-1,27;5265;4608;-657;37458;38382;924
15998;28.10.2017;'14 - 15;-31,42;-33,24;1,82;4353;3894;-459;37746;38343;597
15999;28.10.2017;'15 - 16;-17,03;-24,97;7,94;2990;2679;-311;37722;38527;805
16000;28.10.2017;'16 - 17;-4,02;-12,79;8,77;1480;1291;-189;37497;38356;859
16001;28.10.2017;'17 - 18;0,08;-9,51;9,59;332;204;-128;37318;38495;1177
16002;28.10.2017;'18 - 19;7,56;-5,95;13,51;7;0;-7;37380;38854;1474
16003;28.10.2017;'19 - 20;8,89;-11,54;20,43;0;0;0;37610;39231;1621
16004;28.10.2017;'20 - 21;0,23;-30,66;30,89;0;0;0;37922;39149;1227
16005;28.10.2017;'21 - 22;-38,19;-46,03;7,84;0;0;0;38265;38978;713
16006;28.10.2017;'22 - 23;-49,98;-57,7;7,72;0;0;0;38851;37810;-1041
16007;28.10.2017;'23 - 24;-70,09;-76,33;6,24;0;0;0;39417;36509;-2908
16008;29.10.2017;'00 - 01;-79,94;-80,87;0,93;0;0;0;40368;32698;-7670
16009;29.10.2017;'01 - 02;-83;-86,78;3,78;0;0;0;40366;30017;-10349
16010;29.10.2017;'02 - 03;-83,06;-90,45;7,39;0;0;0;40532;27867;-12665
16011;29.10.2017;'03 - 04;-83,03;-85,36;2,33;0;0;0;40347;26860;-13487
16012;29.10.2017;'04 - 05;-83,04;-78,63;-4,41;0;0;0;40136;28501;-11635
16013;29.10.2017;'05 - 06;-83,02;-77,72;-5,3;0;0;0;40103;30998;-9105
16014;29.10.2017;'06 - 07;-83,01;-73,31;-9,7;0;0;0;39986;31718;-8268
16015;29.10.2017;'07 - 08;-80;-53,05;-26,95;284;274;-10;39689;33321;-6368
16016;29.10.2017;'08 - 09;-79,96;-41,49;-38,47;1800;1834;34;39280;33737;-5543
16017;29.10.2017;'09 - 10;-76,02;-28,91;-47,11;3876;4047;171;38829;35713;-3116
16018;29.10.2017;'10 - 11;-67,08;-18,6;-48,48;6039;6399;360;38435;36335;-2100
16019;29.10.2017;'11 - 12;-81,95;-16,26;-65,69;7757;8672;915;37916;35803;-2113
16020;29.10.2017;'12 - 13;-67,07;-42,78;-24,29;8675;9543;868;37280;35161;-2119
16021;29.10.2017;'13 - 14;-80,07;-43,81;-36,26;8562;9367;805;36296;32975;-3321
16022;29.10.2017;'14 - 15;-79,95;-40,02;-39,93;6925;7330;405;34900;32988;-1912
16023;29.10.2017;'15 - 16;-76,06;-10,42;-65,64;3798;4014;216;33245;31166;-2079
16024;29.10.2017;'16 - 17;-0,92;14,66;-15,58;779;740;-39;31218;28716;-2502
16025;29.10.2017;'17 - 18;8,51;27,16;-18,65;12;2;-10;29377;28515;-862
16026;29.10.2017;'18 - 19;27,62;30,43;-2,81;0;0;0;28032;28332;300
16027;29.10.2017;'19 - 20;29,77;20,98;8,79;0;0;0;27049;27922;873
16028;29.10.2017;'20 - 21;22,06;8,96;13,1;0;0;0;26218;27292;1074
16029;29.10.2017;'21 - 22;17;-0,95;17,95;0;0;0;25419;26109;690
16030;29.10.2017;'22 - 23;12,44;6,49;5,95;0;0;0;24666;24613;-53
16031;29.10.2017;'23 - 24;-70,05;0,44;-70,49;0;0;0;24037;24093;56
16032;30.10.2017;'00 - 01;0,75;11,11;-10,36;0;0;0;24845;24026;-819
16033;30.10.2017;'01 - 02;0,01;6,9;-6,89;0;0;0;24484;23789;-695
16034;30.10.2017;'02 - 03;0,08;3,25;-3,17;0;0;0;24090;23147;-943
16035;30.10.2017;'03 - 04;4,05;3,99;0,06;0;0;0;23515;22467;-1048
16036;30.10.2017;'04 - 05;2,95;8,58;-5,63;0;0;0;22808;21738;-1070
16037;30.10.2017;'05 - 06;18,09;21,09;-3;0;0;0;22052;21719;-333
16038;30.10.2017;'06 - 07;28,42;30,86;-2,44;1;0;-1;21350;21350;0
16039;30.10.2017;'07 - 08;36,43;34,73;1,7;812;700;-112;20290;19810;-480
16040;30.10.2017;'08 - 09;33,48;29,73;3,75;4494;3912;-582;18979;17974;-1005
16041;30.10.2017;'09 - 10;30,38;33,4;-3,02;8694;7947;-747;17985;16048;-1937
16042;30.10.2017;'10 - 11;29,74;32,55;-2,81;11668;11360;-308;17756;15380;-2376
16043;30.10.2017;'11 - 12;29,46;28,96;0,5;12882;12753;-129;18139;16097;-2042
16044;30.10.2017;'12 - 13;29,7;24,1;5,6;12384;12130;-254;18502;17890;-612
16045;30.10.2017;'13 - 14;29,98;22,05;7,93;10629;9929;-700;18334;18729;395
16046;30.10.2017;'14 - 15;36,36;25,1;11,26;7765;7046;-719;17391;18171;780
16047;30.10.2017;'15 - 16;43,99;32,96;11,03;4072;3523;-549;16047;16996;949
16048;30.10.2017;'16 - 17;46,34;37,81;8,53;752;580;-172;14766;15448;682
16049;30.10.2017;'17 - 18;61;52,48;8,52;8;1;-7;14043;13764;-279
16050;30.10.2017;'18 - 19;70,09;56,57;13,52;0;0;0;13555;13337;-218
16051;30.10.2017;'19 - 20;51,98;43,71;8,27;0;0;0;13044;13126;82
16052;30.10.2017;'20 - 21;48,13;39,96;8,17;0;0;0;12461;12871;410
16053;30.10.2017;'21 - 22;47,18;36,11;11,07;0;0;0;11761;12427;666
16054;30.10.2017;'22 - 23;46,05;33,9;12,15;0;0;0;11153;11864;711
16055;30.10.2017;'23 - 24;41,97;25,45;16,52;0;0;0;10652;11946;1294
16056;31.10.2017;'00 - 01;30,08;24,68;5,4;0;0;0;9555;10964;1409
16057;31.10.2017;'01 - 02;30,89;24,69;6,2;0;0;0;9371;10605;1234
16058;31.10.2017;'02 - 03;30,01;23,21;6,8;0;0;0;9116;9916;800
16059;31.10.2017;'03 - 04;29,09;25,28;3,81;0;0;0;8776;9577;801
16060;31.10.2017;'04 - 05;30,29;29,28;1,01;0;0;0;8444;9449;1005
16061;31.10.2017;'05 - 06;32,24;35,27;-3,03;0;0;0;8279;9070;791
16062;31.10.2017;'06 - 07;38,94;40,28;-1,34;0;0;0;8295;8954;659
16063;31.10.2017;'07 - 08;37,9;40,24;-2,34;512;541;29;8331;8549;218
16064;31.10.2017;'08 - 09;41,09;37,53;3,56;2872;3426;554;8366;8501;135
16065;31.10.2017;'09 - 10;39,92;33,85;6,07;5567;6701;1134;8676;8233;-443
16066;31.10.2017;'10 - 11;37,98;30,15;7,83;7540;9126;1586;9340;8513;-827
16067;31.10.2017;'11 - 12;39,97;31,84;8,13;8352;10191;1839;10253;9365;-888
16068;31.10.2017;'12 - 13;36,95;30,45;6,5;7915;9642;1727;11237;10078;-1159
16069;31.10.2017;'13 - 14;34,14;28,75;5,39;6612;7994;1382;11856;10427;-1429
16070;31.10.2017;'14 - 15;35,65;31,59;4,06;4690;5673;983;11935;10178;-1757
16071;31.10.2017;'15 - 16;38,99;40,27;-1,28;2412;2939;527;11869;10256;-1613
16072;31.10.2017;'16 - 17;42,45;46,07;-3,62;503;534;31;11885;10312;-1573
16073;31.10.2017;'17 - 18;46,92;51,87;-4,95;6;0;-6;12131;10622;-1509
16074;31.10.2017;'18 - 19;47,36;53,62;-6,26;0;0;0;12607;11352;-1255
16075;31.10.2017;'19 - 20;44,31;51,55;-7,24;0;0;0;13119;12124;-995
16076;31.10.2017;'20 - 21;39;42,85;-3,85;0;0;0;13640;12564;-1076
16077;31.10.2017;'21 - 22;37,1;40;-2,9;0;0;0;14073;13445;-628
16078;31.10.2017;'22 - 23;34,98;40,1;-5,12;0;0;0;14458;14422;-36
16079;31.10.2017;'23 - 24;30,82;32,7;-1,88;0;0;0;14734;15024;290
16080;01.11.2017;'00 - 01;26,91;30,96;-4,05;0;0;0;15570;15424;-146
16081;01.11.2017;'01 - 02;23,06;30,78;-7,72;0;0;0;15900;15605;-295
16082;01.11.2017;'02 - 03;22,27;29,31;-7,04;0;0;0;16259;16219;-40
16083;01.11.2017;'03 - 04;22,97;28,2;-5,23;0;0;0;16459;16578;119
16084;01.11.2017;'04 - 05;26,66;29,24;-2,58;0;0;0;16547;16914;367
16085;01.11.2017;'05 - 06;27,03;29,95;-2,92;0;0;0;16617;16884;267
16086;01.11.2017;'06 - 07;29,07;32,53;-3,46;0;0;0;16674;16948;274
16087;01.11.2017;'07 - 08;31;33,36;-2,36;204;145;-59;16619;17077;458
16088;01.11.2017;'08 - 09;36,06;40,8;-4,74;1423;1146;-277;16586;17099;513
16089;01.11.2017;'09 - 10;35,16;43,19;-8,03;3376;2762;-614;16715;17250;535
16090;01.11.2017;'10 - 11;32,37;42,1;-9,73;5452;4495;-957;16894;16856;-38
16091;01.11.2017;'11 - 12;33,08;42,97;-9,89;6868;5885;-983;17090;16714;-376
16092;01.11.2017;'12 - 13;29,79;39,56;-9,77;7451;6864;-587;17180;16972;-208
16093;01.11.2017;'13 - 14;29,06;36,17;-7,11;7200;6894;-306;17083;16751;-332
16094;01.11.2017;'14 - 15;29,18;34,95;-5,77;5813;5477;-336;16819;16312;-507
16095;01.11.2017;'15 - 16;30,01;38,44;-8,43;3204;2874;-330;16505;16416;-89
16096;01.11.2017;'16 - 17;36,93;43,64;-6,71;677;504;-173;16470;17250;780
16097;01.11.2017;'17 - 18;42,49;46;-3,51;9;0;-9;16884;17837;953
16098;01.11.2017;'18 - 19;43,93;45,19;-1,26;0;0;0;17544;18445;901
16099;01.11.2017;'19 - 20;41,97;41,69;0,28;0;0;0;18166;18974;808
16100;01.11.2017;'20 - 21;36,52;31,96;4,56;0;0;0;18802;19292;490
16101;01.11.2017;'21 - 22;30,07;32,33;-2,26;0;0;0;19389;19741;352
16102;01.11.2017;'22 - 23;27,02;33,39;-6,37;0;0;0;19922;19576;-346
16103;01.11.2017;'23 - 24;18,97;26,22;-7,25;0;0;0;20405;19314;-1091
16104;02.11.2017;'00 - 01;20,18;25,24;-5,06;0;0;0;20820;19422;-1398
16105;02.11.2017;'01 - 02;12,62;27;-14,38;0;0;0;21250;19610;-1640
16106;02.11.2017;'02 - 03;12,61;25,04;-12,43;0;0;0;21530;19924;-1606
16107;02.11.2017;'03 - 04;10,96;18,6;-7,64;0;0;0;21616;20426;-1190
16108;02.11.2017;'04 - 05;14,04;19,96;-5,92;0;0;0;21475;20299;-1176
16109;02.11.2017;'05 - 06;25,97;31,13;-5,16;0;0;0;21173;19353;-1820
16110;02.11.2017;'06 - 07;35,05;42,31;-7,26;0;0;0;20790;19145;-1645
16111;02.11.2017;'07 - 08;45,9;48,52;-2,62;417;258;-159;20228;17801;-2427
16112;02.11.2017;'08 - 09;43,83;46,84;-3,01;3028;2416;-612;19442;16827;-2615
16113;02.11.2017;'09 - 10;35,59;44,99;-9,4;6617;5807;-810;18754;15298;-3456
16114;02.11.2017;'10 - 11;32,33;42,71;-10,38;9605;8823;-782;18675;14515;-4160
16115;02.11.2017;'11 - 12;32,36;40,78;-8,42;11235;10444;-791;19137;14874;-4263
16116;02.11.2017;'12 - 13;31,32;39,83;-8,51;10969;9938;-1031;19536;14966;-4570
16117;02.11.2017;'13 - 14;32,49;43,24;-10,75;9263;7491;-1772;19445;15008;-4437
16118;02.11.2017;'14 - 15;33,94;45,52;-11,58;6542;4438;-2104;18556;14343;-4213
16119;02.11.2017;'15 - 16;39,1;51,88;-12,78;3215;1704;-1511;17215;13084;-4131
16120;02.11.2017;'16 - 17;45,95;57,5;-11,55;564;185;-379;15833;11972;-3861
16121;02.11.2017;'17 - 18;51,91;63,32;-11,41;7;0;-7;14766;11330;-3436
16122;02.11.2017;'18 - 19;51,92;62,46;-10,54;0;0;0;14058;10882;-3176
16123;02.11.2017;'19 - 20;50,07;86,17;-36,1;0;0;0;13357;10125;-3232
16124;02.11.2017;'20 - 21;46,01;52,36;-6,35;0;0;0;12311;9234;-3077
16125;02.11.2017;'21 - 22;42,06;45,46;-3,4;0;0;0;11116;8354;-2762
16126;02.11.2017;'22 - 23;36,12;37,32;-1,2;0;0;0;9925;7435;-2490
16127;02.11.2017;'23 - 24;35,45;35,61;-0,16;0;0;0;8920;6472;-2448
16128;03.11.2017;'00 - 01;36,07;36,49;-0,42;0;0;0;6103;5468;-635
16129;03.11.2017;'01 - 02;36,09;37,16;-1,07;0;0;0;5457;4624;-833
16130;03.11.2017;'02 - 03;36,13;37,9;-1,77;0;0;0;4827;3866;-961
16131;03.11.2017;'03 - 04;36,09;37,98;-1,89;0;0;0;4227;3164;-1063
16132;03.11.2017;'04 - 05;38,24;43,25;-5,01;0;0;0;3746;2693;-1053
16133;03.11.2017;'05 - 06;40,66;41,69;-1,03;0;0;0;3343;2411;-932
16134;03.11.2017;'06 - 07;52,97;53,17;-0,2;0;0;0;3012;2351;-661
16135;03.11.2017;'07 - 08;61,74;54,72;7,02;233;171;-62;2663;2166;-497
16136;03.11.2017;'08 - 09;65,8;57,76;8,04;1834;1610;-224;2304;1954;-350
16137;03.11.2017;'09 - 10;62,18;58,85;3,33;4456;4208;-248;2048;1882;-166
16138;03.11.2017;'10 - 11;58,69;53,1;5,59;6860;7293;433;2031;1930;-101
16139;03.11.2017;'11 - 12;58,67;51,81;6,86;8319;9189;870;2311;2069;-242
16140;03.11.2017;'12 - 13;54,55;47,91;6,64;8580;9568;988;2685;2707;22
16141;03.11.2017;'13 - 14;51,5;46,76;4,74;7784;8702;918;2865;3010;145
16142;03.11.2017;'14 - 15;51,17;48,33;2,84;5937;6313;376;2853;3349;496
16143;03.11.2017;'15 - 16;56,64;53,34;3,3;3009;3220;211;3013;3712;699
16144;03.11.2017;'16 - 17;60,88;57,32;3,56;502;487;-15;3402;4462;1060
16145;03.11.2017;'17 - 18;66;61,94;4,06;3;0;-3;4176;5413;1237
16146;03.11.2017;'18 - 19;68,68;58,21;10,47;0;0;0;5207;6486;1279
16147;03.11.2017;'19 - 20;58,63;52,67;5,96;0;0;0;6143;7930;1787
16148;03.11.2017;'20 - 21;49,01;45,67;3,34;0;0;0;6894;9042;2148
16149;03.11.2017;'21 - 22;39,01;39,76;-0,75;0;0;0;7521;9551;2030
16150;03.11.2017;'22 - 23;36,11;39,59;-3,48;0;0;0;7901;10242;2341
16151;03.11.2017;'23 - 24;34,97;38,44;-3,47;0;0;0;8024;10410;2386
16152;04.11.2017;'00 - 01;36,16;36,05;0,11;0;0;0;9199;10503;1304
16153;04.11.2017;'01 - 02;35,06;35,03;0,03;0;0;0;8920;10446;1526
16154;04.11.2017;'02 - 03;34,42;33,08;1,34;0;0;0;8499;10003;1504
16155;04.11.2017;'03 - 04;33,61;31,55;2,06;0;0;0;8076;9326;1250
16156;04.11.2017;'04 - 05;33,4;33,17;0,23;0;0;0;7855;8840;985
16157;04.11.2017;'05 - 06;33,22;32,39;0,83;0;0;0;7941;8548;607
16158;04.11.2017;'06 - 07;33,73;32,3;1,43;0;0;0;8141;8679;538
16159;04.11.2017;'07 - 08;37,63;32,81;4,82;300;301;1;8155;9175;1020
16160;04.11.2017;'08 - 09;42,99;33,1;9,89;2463;2670;207;7979;9273;1294
16161;04.11.2017;'09 - 10;40,39;35,13;5,26;5811;5741;-70;7694;8606;912
16162;04.11.2017;'10 - 11;39,84;35,9;3,94;8787;8620;-167;7552;7429;-123
16163;04.11.2017;'11 - 12;37,02;36,51;0,51;10547;10246;-301;7783;6830;-953
16164;04.11.2017;'12 - 13;36,1;34,18;1,92;10764;10452;-312;8403;6855;-1548
16165;04.11.2017;'13 - 14;34,33;33;1,33;9516;9334;-182;9468;7692;-1776
16166;04.11.2017;'14 - 15;34,34;32,43;1,91;6892;6615;-277;11094;8901;-2193
16167;04.11.2017;'15 - 16;35,04;35,12;-0,08;3403;3014;-389;13310;11338;-1972
16168;04.11.2017;'16 - 17;37,03;36,3;0,73;553;365;-188;15920;14598;-1322
16169;04.11.2017;'17 - 18;43,94;42,76;1,18;4;0;-4;18566;18253;-313
16170;04.11.2017;'18 - 19;35,51;35,47;0,04;0;0;0;20938;20702;-236
16171;04.11.2017;'19 - 20;32,25;32,96;-0,71;0;0;0;22431;22251;-180
16172;04.11.2017;'20 - 21;28,83;28,39;0,44;0;0;0;22773;21874;-899
16173;04.11.2017;'21 - 22;26,77;24,69;2,08;0;0;0;22638;20889;-1749
16174;04.11.2017;'22 - 23;26,53;25,54;0,99;0;0;0;21828;20618;-1210
16175;04.11.2017;'23 - 24;20,65;21,91;-1,26;0;0;0;20235;20073;-162
16176;05.11.2017;'00 - 01;13,2;17,9;-4,7;0;0;0;19994;18182;-1812
16177;05.11.2017;'01 - 02;13,2;19,37;-6,17;0;0;0;18710;16487;-2223
16178;05.11.2017;'02 - 03;14,64;20,84;-6,2;0;0;0;16755;13660;-3095
16179;05.11.2017;'03 - 04;11,68;22,78;-11,1;0;0;0;14618;11968;-2650
16180;05.11.2017;'04 - 05;13,93;19,48;-5,55;0;0;0;12809;11548;-1261
16181;05.11.2017;'05 - 06;20,01;19,2;0,81;0;0;0;11578;11102;-476
16182;05.11.2017;'06 - 07;21,87;14,16;7,71;0;0;0;10619;10972;353
16183;05.11.2017;'07 - 08;24,6;15,27;9,33;244;264;20;9727;10254;527
16184;05.11.2017;'08 - 09;31,47;23,83;7,64;1492;1864;372;8814;9962;1148
16185;05.11.2017;'09 - 10;33,92;25,19;8,73;3097;3550;453;8133;9104;971
16186;05.11.2017;'10 - 11;36,54;30,04;6,5;4315;4413;98;7783;8666;883
16187;05.11.2017;'11 - 12;38,9;33,73;5,17;4792;4782;-10;7922;8363;441
16188;05.11.2017;'12 - 13;36,11;35,48;0,63;4492;4059;-433;8480;9061;581
16189;05.11.2017;'13 - 14;36,2;33,99;2,21;3602;3244;-358;8906;9074;168
16190;05.11.2017;'14 - 15;33,78;33,55;0,23;2315;2030;-285;8945;9382;437
16191;05.11.2017;'15 - 16;33,96;34;-0,04;1023;906;-117;9028;9788;760
16192;05.11.2017;'16 - 17;35;35,39;-0,39;170;149;-21;9000;10108;1108
16193;05.11.2017;'17 - 18;41,82;41,52;0,3;1;0;-1;9117;10702;1585
16194;05.11.2017;'18 - 19;41,74;34,62;7,12;0;0;0;9409;11267;1858
16195;05.11.2017;'19 - 20;42,82;32,66;10,16;0;0;0;9814;11909;2095
16196;05.11.2017;'20 - 21;40,91;32,41;8,5;0;0;0;9880;11765;1885
16197;05.11.2017;'21 - 22;39,59;31,91;7,68;0;0;0;9751;11725;1974
16198;05.11.2017;'22 - 23;38,87;33,99;4,88;0;0;0;9600;11128;1528
16199;05.11.2017;'23 - 24;35;30,67;4,33;0;0;0;9336;10978;1642
16200;06.11.2017;'00 - 01;31,74;27,6;4,14;0;0;0;8647;10398;1751
16201;06.11.2017;'01 - 02;33,73;26,26;7,47;0;0;0;8529;9944;1415
16202;06.11.2017;'02 - 03;33,02;23,76;9,26;0;0;0;8347;9644;1297
16203;06.11.2017;'03 - 04;27,61;23,63;3,98;0;0;0;8194;8733;539
16204;06.11.2017;'04 - 05;28,1;26,71;1,39;0;0;0;7917;7783;-134
16205;06.11.2017;'05 - 06;32,99;37,01;-4,02;0;0;0;7490;7103;-387
16206;06.11.2017;'06 - 07;44,83;48,24;-3,41;0;0;0;7020;6679;-341
16207;06.11.2017;'07 - 08;54,96;62,59;-7,63;140;138;-2;6280;5718;-562
16208;06.11.2017;'08 - 09;60,38;68,33;-7,95;1694;1638;-56;5301;4926;-375
16209;06.11.2017;'09 - 10;55,38;61,85;-6,47;4219;4093;-126;4362;3558;-804
16210;06.11.2017;'10 - 11;54,95;60,96;-6,01;6377;6458;81;3650;2456;-1194
16211;06.11.2017;'11 - 12;54,97;61,42;-6,45;7660;7666;6;3189;1832;-1357
16212;06.11.2017;'12 - 13;54,93;58,73;-3,8;7834;7569;-265;2915;1709;-1206
16213;06.11.2017;'13 - 14;55,91;58,72;-2,81;6972;6324;-648;2684;1722;-962
16214;06.11.2017;'14 - 15;55,93;60,49;-4,56;5112;4291;-821;2363;1654;-709
16215;06.11.2017;'15 - 16;57,85;63,1;-5,25;2486;1909;-577;2115;1539;-576
16216;06.11.2017;'16 - 17;62,56;69,23;-6,67;370;212;-158;1958;1582;-376
16217;06.11.2017;'17 - 18;78,28;96,4;-18,12;2;0;-2;1964;1758;-206
16218;06.11.2017;'18 - 19;89,93;102,73;-12,8;0;0;0;2058;1870;-188
16219;06.11.2017;'19 - 20;74,51;76,5;-1,99;0;0;0;2183;2069;-114
16220;06.11.2017;'20 - 21;55,02;52,19;2,83;0;0;0;2348;2274;-74
16221;06.11.2017;'21 - 22;50,61;47,81;2,8;0;0;0;2542;2477;-65
16222;06.11.2017;'22 - 23;39,11;39,8;-0,69;0;0;0;2761;3006;245
16223;06.11.2017;'23 - 24;37,1;38,09;-0,99;0;0;0;2972;3920;948
16224;07.11.2017;'00 - 01;36,63;30,21;6,42;0;0;0;3402;4464;1062
16225;07.11.2017;'01 - 02;35,05;30,29;4,76;0;0;0;3833;4722;889
16226;07.11.2017;'02 - 03;36,87;32,17;4,7;0;0;0;4096;5024;928
16227;07.11.2017;'03 - 04;36,02;30,74;5,28;0;0;0;4377;5464;1087
16228;07.11.2017;'04 - 05;37,04;32,12;4,92;0;0;0;4709;5863;1154
16229;07.11.2017;'05 - 06;34,43;30,03;4,4;0;0;0;5025;5829;804
16230;07.11.2017;'06 - 07;49,77;43,36;6,41;0;0;0;5365;5736;371
16231;07.11.2017;'07 - 08;59,26;53,24;6,02;122;88;-34;5530;6258;728
16232;07.11.2017;'08 - 09;64,37;56,49;7,88;1360;1092;-268;5364;6385;1021
16233;07.11.2017;'09 - 10;55,07;50,9;4,17;3550;2838;-712;5131;6398;1267
16234;07.11.2017;'10 - 11;54,94;53,09;1,85;5484;4472;-1012;5016;5762;746
16235;07.11.2017;'11 - 12;54,92;55,25;-0,33;6551;5391;-1160;5128;5386;258
16236;07.11.2017;'12 - 13;53,93;54,19;-0,26;6470;5346;-1124;5301;4982;-319
16237;07.11.2017;'13 - 14;54,94;56,82;-1,88;5512;4380;-1132;5399;4818;-581
16238;07.11.2017;'14 - 15;56,93;60,38;-3,45;3830;2635;-1195;5470;5353;-117
16239;07.11.2017;'15 - 16;66,75;68,1;-1,35;1681;986;-695;5716;5821;105
16240;07.11.2017;'16 - 17;65,58;73,93;-8,35;219;74;-145;6280;6374;94
16241;07.11.2017;'17 - 18;81,56;86,43;-4,87;1;0;-1;7120;7525;405
16242;07.11.2017;'18 - 19;82,3;85,64;-3,34;0;0;0;7875;8246;371
16243;07.11.2017;'19 - 20;64,2;59,03;5,17;0;0;0;8200;8148;-52
16244;07.11.2017;'20 - 21;53,94;48,87;5,07;0;0;0;7939;7687;-252
16245;07.11.2017;'21 - 22;46,94;45,61;1,33;0;0;0;7394;7433;39
16246;07.11.2017;'22 - 23;41,7;37,83;3,87;0;0;0;6670;7090;420
16247;07.11.2017;'23 - 24;37,86;33,93;3,93;0;0;0;5917;6555;638
16248;08.11.2017;'00 - 01;33,7;32,76;0,94;0;0;0;4671;5926;1255
16249;08.11.2017;'01 - 02;33,62;31,85;1,77;0;0;0;4268;5218;950
16250;08.11.2017;'02 - 03;33,64;33,48;0,16;0;0;0;3924;4750;826
16251;08.11.2017;'03 - 04;33,62;33,42;0,2;0;0;0;3637;4558;921
16252;08.11.2017;'04 - 05;35,53;33,6;1,93;0;0;0;3412;4278;866
16253;08.11.2017;'05 - 06;36,15;36,1;0,05;0;0;0;3300;4168;868
16254;08.11.2017;'06 - 07;54,07;51,38;2,69;0;0;0;3295;4047;752
16255;08.11.2017;'07 - 08;75,76;82,59;-6,83;113;106;-7;3193;4226;1033
16256;08.11.2017;'08 - 09;79,28;79,03;0,25;931;1025;94;2911;4014;1103
16257;08.11.2017;'09 - 10;77,07;75,58;1,49;2217;2350;133;2527;3395;868
16258;08.11.2017;'10 - 11;84,22;75,27;8,95;3328;3363;35;2208;2754;546
16259;08.11.2017;'11 - 12;84,98;77,89;7,09;3818;3668;-150;2034;2262;228
16260;08.11.2017;'12 - 13;83,8;76,37;7,43;3607;3254;-353;1891;1924;33
16261;08.11.2017;'13 - 14;88,19;81,3;6,89;2867;2462;-405;1734;1705;-29
16262;08.11.2017;'14 - 15;89,9;85,07;4,83;1814;1523;-291;1544;1625;81
16263;08.11.2017;'15 - 16;81,89;87,22;-5,33;729;543;-186;1517;1736;219
16264;08.11.2017;'16 - 17;88,2;95,4;-7,2;96;38;-58;1594;1738;144
16265;08.11.2017;'17 - 18;111,4;122,89;-11,49;0;0;0;1715;1864;149
16266;08.11.2017;'18 - 19;120;125,49;-5,49;0;0;0;1762;1933;171
16267;08.11.2017;'19 - 20;89,93;89,89;0,04;0;0;0;1678;1567;-111
16268;08.11.2017;'20 - 21;60,1;69,02;-8,92;0;0;0;1465;1274;-191
16269;08.11.2017;'21 - 22;52,32;54,15;-1,83;0;0;0;1240;1099;-141
16270;08.11.2017;'22 - 23;48,05;46,58;1,47;0;0;0;1045;1017;-28
16271;08.11.2017;'23 - 24;38,57;40,68;-2,11;0;0;0;889;822;-67
16272;09.11.2017;'00 - 01;38,61;35,02;3,59;0;0;0;606;693;87
16273;09.11.2017;'01 - 02;39,3;37,42;1,88;0;0;0;605;672;67
16274;09.11.2017;'02 - 03;38,48;37,13;1,35;0;0;0;607;760;153
16275;09.11.2017;'03 - 04;40,53;37,36;3,17;0;0;0;689;1022;333
16276;09.11.2017;'04 - 05;39,9;35,67;4,23;0;0;0;876;1541;665
16277;09.11.2017;'05 - 06;43,95;41,53;2,42;0;0;0;1210;2242;1032
16278;09.11.2017;'06 - 07;58,65;43,51;15,14;0;0;0;1727;3193;1466
16279;09.11.2017;'07 - 08;72,1;52,52;19,58;94;49;-45;2462;4405;1943
16280;09.11.2017;'08 - 09;84,73;56,55;28,18;865;564;-301;3375;5598;2223
16281;09.11.2017;'09 - 10;61,99;51,43;10,56;2241;1513;-728;4376;6510;2134
16282;09.11.2017;'10 - 11;61,37;54,72;6,65;3553;2322;-1231;5466;7381;1915
16283;09.11.2017;'11 - 12;60,69;55;5,69;4318;2801;-1517;6697;7939;1242
16284;09.11.2017;'12 - 13;55,12;58,17;-3,05;4337;2914;-1423;7927;8987;1060
16285;09.11.2017;'13 - 14;53,99;56,05;-2,06;3715;2586;-1129;8942;9533;591
16286;09.11.2017;'14 - 15;54,91;57,61;-2,7;2542;1774;-768;9514;10245;731
16287;09.11.2017;'15 - 16;55;57,13;-2,13;1081;708;-373;9861;11101;1240
16288;09.11.2017;'16 - 17;55,92;56,31;-0,39;142;58;-84;10262;12115;1853
16289;09.11.2017;'17 - 18;56,94;50,56;6,38;0;0;0;10673;12969;2296
16290;09.11.2017;'18 - 19;55,93;46,91;9,02;0;0;0;11350;13133;1783
16291;09.11.2017;'19 - 20;55;44,37;10,63;0;0;0;11994;14032;2038
16292;09.11.2017;'20 - 21;40,3;37,91;2,39;0;0;0;12480;15072;2592
16293;09.11.2017;'21 - 22;42,81;35,6;7,21;0;0;0;12989;15522;2533
16294;09.11.2017;'22 - 23;36,78;30,76;6,02;0;0;0;13545;15254;1709
16295;09.11.2017;'23 - 24;33,61;32,76;0,85;0;0;0;14092;15348;1256
16296;10.11.2017;'00 - 01;26,41;27,92;-1,51;0;0;0;14782;15914;1132
16297;10.11.2017;'01 - 02;25,35;30,1;-4,75;0;0;0;15534;16702;1168
16298;10.11.2017;'02 - 03;26,6;30,81;-4,21;0;0;0;16359;17525;1166
16299;10.11.2017;'03 - 04;27,31;30,92;-3,61;0;0;0;17070;17808;738
16300;10.11.2017;'04 - 05;27,1;29,29;-2,19;0;0;0;17890;18006;116
16301;10.11.2017;'05 - 06;28,92;32,43;-3,51;0;0;0;18844;18986;142
16302;10.11.2017;'06 - 07;40,15;44,48;-4,33;0;0;0;20090;20092;2
16303;10.11.2017;'07 - 08;51,2;53,78;-2,58;72;48;-24;21701;20596;-1105
16304;10.11.2017;'08 - 09;47,41;49,25;-1,84;628;511;-117;23633;21724;-1909
16305;10.11.2017;'09 - 10;38,61;47,46;-8,85;1494;1396;-98;25573;23329;-2244
16306;10.11.2017;'10 - 11;38,89;49,73;-10,84;2240;2156;-84;27291;25327;-1964
16307;10.11.2017;'11 - 12;38,79;50,1;-11,31;2536;2421;-115;28918;27279;-1639
16308;10.11.2017;'12 - 13;35,25;45,55;-10,3;2419;2181;-238;30442;29488;-954
16309;10.11.2017;'13 - 14;31,16;40,04;-8,88;2050;1871;-179;31361;30591;-770
16310;10.11.2017;'14 - 15;30,16;38,66;-8,5;1440;1392;-48;31653;30959;-694
16311;10.11.2017;'15 - 16;30,12;33,02;-2,9;637;734;97;31845;31991;146
16312;10.11.2017;'16 - 17;31,02;31,93;-0,91;81;76;-5;31783;33204;1421
16313;10.11.2017;'17 - 18;36,19;32,56;3,63;0;0;0;31502;32992;1490
16314;10.11.2017;'18 - 19;36,02;32,59;3,43;0;0;0;30992;32234;1242
16315;10.11.2017;'19 - 20;31,08;31,09;-0,01;0;0;0;30494;30838;344
16316;10.11.2017;'20 - 21;29,39;30,7;-1,31;0;0;0;29790;30264;474
16317;10.11.2017;'21 - 22;22,26;21,31;0,95;0;0;0;29058;30262;1204
16318;10.11.2017;'22 - 23;15,51;19,25;-3,74;0;0;0;28431;29510;1079
16319;10.11.2017;'23 - 24;11,46;13,92;-2,46;0;0;0;27720;29491;1771
16320;11.11.2017;'00 - 01;9,2;11,68;-2,48;0;0;0;30186;28616;-1570
16321;11.11.2017;'01 - 02;2,03;10,3;-8,27;0;0;0;29508;28115;-1393
16322;11.11.2017;'02 - 03;0,08;10,61;-10,53;0;0;0;28714;27360;-1354
16323;11.11.2017;'03 - 04;6,47;13,55;-7,08;0;0;0;27853;27100;-753
16324;11.11.2017;'04 - 05;11,27;17,54;-6,27;0;0;0;27168;27132;-36
16325;11.11.2017;'05 - 06;12,59;17;-4,41;0;0;0;26754;26052;-702
16326;11.11.2017;'06 - 07;9,63;16,96;-7,33;0;0;0;26615;25832;-783
16327;11.11.2017;'07 - 08;13,55;25,96;-12,41;138;77;-61;26506;25338;-1168
16328;11.11.2017;'08 - 09;20,1;31,27;-11,17;1321;1030;-291;26307;24824;-1483
16329;11.11.2017;'09 - 10;24,66;35,19;-10,53;2969;2449;-520;26289;25113;-1176
16330;11.11.2017;'10 - 11;21,47;34,71;-13,24;4017;3165;-852;26353;24838;-1515
16331;11.11.2017;'11 - 12;18,9;35,07;-16,17;4197;3287;-910;26327;24973;-1354
16332;11.11.2017;'12 - 13;21,03;33,19;-12,16;3601;3019;-582;25874;23968;-1906
16333;11.11.2017;'13 - 14;22,86;34,01;-11,15;2697;2552;-145;24912;22518;-2394
16334;11.11.2017;'14 - 15;28,2;37,07;-8,87;1635;1803;168;23580;20602;-2978
16335;11.11.2017;'15 - 16;30,48;38,49;-8,01;622;732;110;22069;19141;-2928
16336;11.11.2017;'16 - 17;35,81;42,81;-7;67;50;-17;20776;17974;-2802
16337;11.11.2017;'17 - 18;44,49;51,02;-6,53;0;0;0;19853;18036;-1817
16338;11.11.2017;'18 - 19;46,76;50,58;-3,82;0;0;0;19126;17223;-1903
16339;11.11.2017;'19 - 20;41,03;42,81;-1,78;0;0;0;18398;17476;-922
16340;11.11.2017;'20 - 21;35,92;27,59;8,33;0;0;0;17712;17468;-244
16341;11.11.2017;'21 - 22;35,82;23,28;12,54;0;0;0;17247;17592;345
16342;11.11.2017;'22 - 23;37,06;20,61;16,45;0;0;0;16948;17632;684
16343;11.11.2017;'23 - 24;28,29;14,07;14,22;0;0;0;16811;17285;474
16344;12.11.2017;'00 - 01;14,07;13,36;0,71;0;0;0;16888;17327;439
16345;12.11.2017;'01 - 02;15,99;13,36;2,63;0;0;0;16985;16983;-2
16346;12.11.2017;'02 - 03;13,8;21,04;-7,24;0;0;0;16861;16854;-7
16347;12.11.2017;'03 - 04;13,53;22,83;-9,3;0;0;0;16599;16397;-202
16348;12.11.2017;'04 - 05;15,25;20,19;-4,94;0;0;0;16170;15431;-739
16349;12.11.2017;'05 - 06;21,86;25,76;-3,9;0;0;0;15542;14301;-1241
16350;12.11.2017;'06 - 07;22,52;26,35;-3,83;0;0;0;14664;13058;-1606
16351;12.11.2017;'07 - 08;27,06;24,75;2,31;51;43;-8;13276;11385;-1891
16352;12.11.2017;'08 - 09;30,94;29,13;1,81;630;780;150;11609;9832;-1777
16353;12.11.2017;'09 - 10;33,03;32,09;0,94;1623;1926;303;10028;8030;-1998
16354;12.11.2017;'10 - 11;42,79;37,64;5,15;2454;2565;111;8753;6252;-2501
16355;12.11.2017;'11 - 12;47,65;43,05;4,6;2854;2908;54;8092;4864;-3228
16356;12.11.2017;'12 - 13;48,13;42,79;5,34;2727;2848;121;7695;4122;-3573
16357;12.11.2017;'13 - 14;44,28;42,9;1,38;2230;2318;88;7319;4657;-2662
16358;12.11.2017;'14 - 15;38,43;36,85;1,58;1427;1640;213;7312;5108;-2204
16359;12.11.2017;'15 - 16;37,8;36,69;1,11;568;656;88;7818;5218;-2600
16360;12.11.2017;'16 - 17;40,82;38,05;2,77;70;48;-22;8646;6260;-2386
16361;12.11.2017;'17 - 18;53,91;49,9;4,01;0;0;0;9540;7325;-2215
16362;12.11.2017;'18 - 19;53,94;49,76;4,18;0;0;0;10375;8054;-2321
16363;12.11.2017;'19 - 20;46,54;42,95;3,59;0;0;0;10994;8584;-2410
16364;12.11.2017;'20 - 21;39,59;40,86;-1,27;0;0;0;11414;9112;-2302
16365;12.11.2017;'21 - 22;33,11;36,72;-3,61;0;0;0;11859;10094;-1765
16366;12.11.2017;'22 - 23;33,17;37,87;-4,7;0;0;0;12290;10552;-1738
16367;12.11.2017;'23 - 24;29,73;27,58;2,15;0;0;0;12600;11252;-1348
16368;13.11.2017;'00 - 01;31,06;26,83;4,23;0;0;0;10274;11697;1423
16369;13.11.2017;'01 - 02;30,41;23,62;6,79;0;0;0;10680;11858;1178
16370;13.11.2017;'02 - 03;29,64;19,53;10,11;0;0;0;10870;11795;925
16371;13.11.2017;'03 - 04;29,66;22,2;7,46;0;0;0;10912;12096;1184
16372;13.11.2017;'04 - 05;29,79;22,6;7,19;0;0;0;10705;11970;1265
16373;13.11.2017;'05 - 06;31,68;26,83;4,85;0;0;0;10309;11713;1404
16374;13.11.2017;'06 - 07;42,76;37,77;4,99;0;0;0;9965;11153;1188
16375;13.11.2017;'07 - 08;54,9;49,72;5,18;72;29;-43;9389;10564;1175
16376;13.11.2017;'08 - 09;54,33;48,86;5,47;1092;834;-258;8731;9897;1166
16377;13.11.2017;'09 - 10;48,15;42,83;5,32;3220;2865;-355;8161;8759;598
16378;13.11.2017;'10 - 11;45,83;43,44;2,39;5191;5116;-75;7773;7782;9
16379;13.11.2017;'11 - 12;46,61;44,97;1,64;6515;6933;418;7622;7154;-468
16380;13.11.2017;'12 - 13;41,48;44,17;-2,69;6905;7497;592;7588;7593;5
16381;13.11.2017;'13 - 14;48,08;45,78;2,3;6274;6852;578;7531;7866;335
16382;13.11.2017;'14 - 15;50,81;47,9;2,91;4541;4765;224;7298;7804;506
16383;13.11.2017;'15 - 16;54,93;50,88;4,05;1977;1945;-32;7104;7738;634
16384;13.11.2017;'16 - 17;55,92;50,01;5,91;188;161;-27;7067;8422;1355
16385;13.11.2017;'17 - 18;70,08;51,63;18,45;0;0;0;7140;8798;1658
16386;13.11.2017;'18 - 19;62,3;43,94;18,36;0;0;0;7146;8580;1434
16387;13.11.2017;'19 - 20;57,73;43,36;14,37;0;0;0;6922;7657;735
16388;13.11.2017;'20 - 21;54,94;47,07;7,87;0;0;0;6218;6910;692
16389;13.11.2017;'21 - 22;49;45,36;3,64;0;0;0;5426;5549;123
16390;13.11.2017;'22 - 23;41;41,59;-0,59;0;0;0;4793;4625;-168
16391;13.11.2017;'23 - 24;36,55;36,84;-0,29;0;0;0;4452;4207;-245
16392;14.11.2017;'00 - 01;37,83;31,93;5,9;0;0;0;4700;4582;-118
16393;14.11.2017;'01 - 02;36,01;34,54;1,47;0;0;0;5036;5428;392
16394;14.11.2017;'02 - 03;34,03;32,66;1,37;0;0;0;5675;6818;1143
16395;14.11.2017;'03 - 04;33,54;31,73;1,81;0;0;0;6720;8850;2130
16396;14.11.2017;'04 - 05;33,9;31,6;2,3;0;0;0;8012;10350;2338
16397;14.11.2017;'05 - 06;34,04;34,23;-0,19;0;0;0;9445;10949;1504
16398;14.11.2017;'06 - 07;38,12;41,45;-3,33;0;0;0;10871;12168;1297
16399;14.11.2017;'07 - 08;43,52;47,33;-3,81;108;61;-47;12141;13246;1105
16400;14.11.2017;'08 - 09;49,58;50,02;-0,44;1440;1377;-63;13161;14003;842
16401;14.11.2017;'09 - 10;37,2;40,63;-3,43;3763;4059;296;14062;14547;485
16402;14.11.2017;'10 - 11;36,56;37,23;-0,67;5732;6498;766;14764;14368;-396
16403;14.11.2017;'11 - 12;36,19;38,14;-1,95;6817;7632;815;15211;15122;-89
16404;14.11.2017;'12 - 13;36,88;37,39;-0,51;6786;7269;483;15732;15698;-34
16405;14.11.2017;'13 - 14;36,6;37,96;-1,36;5773;6000;227;15857;15820;-37
16406;14.11.2017;'14 - 15;36,86;39,31;-2,45;3940;4042;102;15192;15799;607
16407;14.11.2017;'15 - 16;40,07;41,33;-1,26;1669;1685;16;14572;15489;917
16408;14.11.2017;'16 - 17;49,06;44,73;4,33;153;149;-4;14128;15337;1209
16409;14.11.2017;'17 - 18;51,71;45,78;5,93;0;0;0;13673;15128;1455
16410;14.11.2017;'18 - 19;52,94;44,35;8,59;0;0;0;13020;14640;1620
16411;14.11.2017;'19 - 20;51,25;44,28;6,97;0;0;0;12305;13333;1028
16412;14.11.2017;'20 - 21;44,92;40,49;4,43;0;0;0;11462;11817;355
16413;14.11.2017;'21 - 22;39,44;40,25;-0,81;0;0;0;10383;10260;-123
16414;14.11.2017;'22 - 23;37,6;42,47;-4,87;0;0;0;9404;9223;-181
16415;14.11.2017;'23 - 24;36,36;33,89;2,47;0;0;0;8590;8198;-392
16416;15.11.2017;'00 - 01;33,5;34,49;-0,99;0;0;0;8184;7892;-292
16417;15.11.2017;'01 - 02;34,06;39,48;-5,42;0;0;0;7537;7833;296
16418;15.11.2017;'02 - 03;33,42;37,27;-3,85;0;0;0;7004;7049;45
16419;15.11.2017;'03 - 04;35,62;34,89;0,73;0;0;0;6601;6596;-5
16420;15.11.2017;'04 - 05;33,74;35,87;-2,13;0;0;0;6277;6852;575
16421;15.11.2017;'05 - 06;37;40,91;-3,91;0;0;0;6015;6652;637
16422;15.11.2017;'06 - 07;58,5;61;-2,5;0;0;0;5848;6555;707
16423;15.11.2017;'07 - 08;77,4;85,64;-8,24;116;44;-72;5649;6380;731
16424;15.11.2017;'08 - 09;78,01;81,17;-3,16;1446;786;-660;5339;5709;370
16425;15.11.2017;'09 - 10;68,87;85,71;-16,84;3736;2262;-1474;4998;5640;642
16426;15.11.2017;'10 - 11;61,65;72,07;-10,42;5760;3672;-2088;4585;5082;497
16427;15.11.2017;'11 - 12;71,76;71,7;0,06;6959;4774;-2185;4102;4320;218
16428;15.11.2017;'12 - 13;64,1;67,23;-3,13;7188;5224;-1964;3633;3526;-107
16429;15.11.2017;'13 - 14;70,77;98,06;-27,29;6387;4658;-1729;3121;2868;-253
16430;15.11.2017;'14 - 15;72,81;74,5;-1,69;4500;3127;-1373;2545;2381;-164
16431;15.11.2017;'15 - 16;79,18;83,55;-4,37;1933;1189;-744;2162;1968;-194
16432;15.11.2017;'16 - 17;89,95;110,41;-20,46;189;66;-123;1997;1900;-97
16433;15.11.2017;'17 - 18;112,09;137,62;-25,53;0;0;0;2060;1904;-156
16434;15.11.2017;'18 - 19;124,29;168,49;-44,2;0;0;0;2131;1958;-173
16435;15.11.2017;'19 - 20;86,34;98,24;-11,9;0;0;0;2210;1926;-284
16436;15.11.2017;'20 - 21;76,13;74,8;1,33;0;0;0;2253;1969;-284
16437;15.11.2017;'21 - 22;62,01;65,71;-3,7;0;0;0;2268;2001;-267
16438;15.11.2017;'22 - 23;51,91;58,35;-6,44;0;0;0;2297;2107;-190
16439;15.11.2017;'23 - 24;39,03;56,26;-17,23;0;0;0;2320;2348;28
16440;16.11.2017;'00 - 01;37,04;37,71;-0,67;0;0;0;2669;2505;-164
16441;16.11.2017;'01 - 02;37,06;36,22;0,84;0;0;0;3054;2887;-167
16442;16.11.2017;'02 - 03;36,13;35,94;0,19;0;0;0;3425;3218;-207
16443;16.11.2017;'03 - 04;36,59;35;1,59;0;0;0;3867;3490;-377
16444;16.11.2017;'04 - 05;37,04;35,11;1,93;0;0;0;4343;3942;-401
16445;16.11.2017;'05 - 06;36,87;38,89;-2,02;0;0;0;4954;4095;-859
16446;16.11.2017;'06 - 07;51,61;52,86;-1,25;0;0;0;5755;4527;-1228
16447;16.11.2017;'07 - 08;61,89;71,8;-9,91;90;32;-58;6572;5256;-1316
16448;16.11.2017;'08 - 09;68,63;110,88;-42,25;1310;687;-623;7353;5852;-1501
16449;16.11.2017;'09 - 10;57,02;107,22;-50,2;3555;1829;-1726;7999;5918;-2081
16450;16.11.2017;'10 - 11;55,93;104,48;-48,55;5621;2851;-2770;8496;6320;-2176
16451;16.11.2017;'11 - 12;53,96;96,22;-42,26;6920;3705;-3215;8872;6633;-2239
16452;16.11.2017;'12 - 13;49,01;93,92;-44,91;7070;3716;-3354;9191;7084;-2107
16453;16.11.2017;'13 - 14;49,31;81,31;-32;6104;2984;-3120;9397;7424;-1973
16454;16.11.2017;'14 - 15;54;84,4;-30,4;4163;1744;-2419;9539;7573;-1966
16455;16.11.2017;'15 - 16;57,94;106,4;-48,46;1702;579;-1123;9863;8052;-1811
16456;16.11.2017;'16 - 17;56,16;126,41;-70,25;163;18;-145;10325;8777;-1548
16457;16.11.2017;'17 - 18;56,42;142,65;-86,23;0;0;0;10921;9993;-928
16458;16.11.2017;'18 - 19;53,93;86,63;-32,7;0;0;0;11559;11111;-448
16459;16.11.2017;'19 - 20;46,3;73,48;-27,18;0;0;0;11692;11565;-127
16460;16.11.2017;'20 - 21;37,03;49,38;-12,35;0;0;0;11246;11840;594
16461;16.11.2017;'21 - 22;38,03;46,23;-8,2;0;0;0;10632;11383;751
16462;16.11.2017;'22 - 23;38,15;40,13;-1,98;0;0;0;10042;10987;945
16463;16.11.2017;'23 - 24;35,07;40,34;-5,27;0;0;0;9259;10959;1700
16464;17.11.2017;'00 - 01;33,15;38,19;-5,04;0;0;0;10949;10605;-344
16465;17.11.2017;'01 - 02;32,72;36,09;-3,37;0;0;0;10418;9886;-532
16466;17.11.2017;'02 - 03;33,16;34,63;-1,47;0;0;0;9747;8726;-1021
16467;17.11.2017;'03 - 04;34,06;37,44;-3,38;0;0;0;9070;8074;-996
16468;17.11.2017;'04 - 05;34,05;36,48;-2,43;0;0;0;8437;7711;-726
16469;17.11.2017;'05 - 06;36,09;39,26;-3,17;0;0;0;7833;7241;-592
16470;17.11.2017;'06 - 07;46,83;51,46;-4,63;0;0;0;7306;6799;-507
16471;17.11.2017;'07 - 08;49,99;54,63;-4,64;37;22;-15;6905;6613;-292
16472;17.11.2017;'08 - 09;53,93;58,67;-4,74;1062;802;-260;6721;6554;-167
16473;17.11.2017;'09 - 10;49,99;51,12;-1,13;3265;2802;-463;6633;5918;-715
16474;17.11.2017;'10 - 11;49,97;48,94;1,03;5329;4897;-432;6573;5269;-1304
16475;17.11.2017;'11 - 12;49,97;49,34;0,63;6594;6477;-117;6531;4816;-1715
16476;17.11.2017;'12 - 13;49,09;50,52;-1,43;6768;6948;180;6695;5037;-1658
16477;17.11.2017;'13 - 14;46,55;47,64;-1,09;5856;5841;-15;7164;5362;-1802
16478;17.11.2017;'14 - 15;42,3;45,72;-3,42;3977;3764;-213;7857;6002;-1855
16479;17.11.2017;'15 - 16;49,95;50,66;-0,71;1529;1304;-225;8676;6417;-2259
16480;17.11.2017;'16 - 17;49,9;56,01;-6,11;103;62;-41;9613;7738;-1875
16481;17.11.2017;'17 - 18;49,91;56,53;-6,62;0;0;0;10674;9687;-987
16482;17.11.2017;'18 - 19;48,18;50,48;-2,3;0;0;0;11705;10633;-1072
16483;17.11.2017;'19 - 20;42,97;52,31;-9,34;0;0;0;12575;11437;-1138
16484;17.11.2017;'20 - 21;38,35;40,91;-2,56;0;0;0;13414;12141;-1273
16485;17.11.2017;'21 - 22;39,8;39,53;0,27;0;0;0;14273;12385;-1888
16486;17.11.2017;'22 - 23;36,15;39,38;-3,23;0;0;0;15076;12357;-2719
16487;17.11.2017;'23 - 24;32,41;36,63;-4,22;0;0;0;15781;13320;-2461
16488;18.11.2017;'00 - 01;27,78;35,22;-7,44;0;0;0;15205;14341;-864
16489;18.11.2017;'01 - 02;23,56;33,07;-9,51;0;0;0;16112;15244;-868
16490;18.11.2017;'02 - 03;20,04;24,09;-4,05;0;0;0;16979;16094;-885
16491;18.11.2017;'03 - 04;17,63;36,8;-19,17;0;0;0;17933;17284;-649
16492;18.11.2017;'04 - 05;13,33;26,24;-12,91;0;0;0;19035;18242;-793
16493;18.11.2017;'05 - 06;12,87;28,14;-15,27;0;0;0;20211;19413;-798
16494;18.11.2017;'06 - 07;16,12;27,9;-11,78;0;0;0;21385;21078;-307
16495;18.11.2017;'07 - 08;19,38;29,02;-9,64;31;20;-11;22488;22361;-127
16496;18.11.2017;'08 - 09;27,97;36,28;-8,31;872;725;-147;23540;23835;295
16497;18.11.2017;'09 - 10;28,61;33,22;-4,61;2752;2336;-416;24750;24886;136
16498;18.11.2017;'10 - 11;28,08;32,83;-4,75;4550;3609;-941;26220;27007;787
16499;18.11.2017;'11 - 12;14,97;27,44;-12,47;5631;3795;-1836;27808;28729;921
16500;18.11.2017;'12 - 13;18,19;28,87;-10,68;5616;3436;-2180;29479;31062;1583
16501;18.11.2017;'13 - 14;13,01;25,38;-12,37;4713;2714;-1999;30239;31128;889
16502;18.11.2017;'14 - 15;18,46;31,59;-13,13;3150;1646;-1504;29914;30432;518
16503;18.11.2017;'15 - 16;24,84;31,01;-6,17;1215;576;-639;29056;29922;866
16504;18.11.2017;'16 - 17;28,33;34,04;-5,71;97;23;-74;28366;29903;1537
16505;18.11.2017;'17 - 18;29,77;33,96;-4,19;0;0;0;28005;29353;1348
16506;18.11.2017;'18 - 19;29,7;32,82;-3,12;0;0;0;27736;28754;1018
16507;18.11.2017;'19 - 20;24,03;25,96;-1,93;0;0;0;27580;28326;746
16508;18.11.2017;'20 - 21;13,06;20,86;-7,8;0;0;0;27552;27274;-278
16509;18.11.2017;'21 - 22;12,69;18,27;-5,58;0;0;0;27639;26920;-719
16510;18.11.2017;'22 - 23;11,38;19,73;-8,35;0;0;0;27660;26334;-1326
16511;18.11.2017;'23 - 24;0,41;18,87;-18,46;0;0;0;27686;26374;-1312
16512;19.11.2017;'00 - 01;0,37;15,73;-15,36;0;0;0;27827;26708;-1119
16513;19.11.2017;'01 - 02;4,33;11,56;-7,23;0;0;0;28020;26773;-1247
16514;19.11.2017;'02 - 03;2,91;9,67;-6,76;0;0;0;28239;26782;-1457
16515;19.11.2017;'03 - 04;2,17;9,16;-6,99;0;0;0;28587;27282;-1305
16516;19.11.2017;'04 - 05;2,14;12,77;-10,63;0;0;0;28978;27876;-1102
16517;19.11.2017;'05 - 06;0,03;11,22;-11,19;0;0;0;29466;28620;-846
16518;19.11.2017;'06 - 07;-0,03;9,79;-9,82;0;0;0;29959;29492;-467
16519;19.11.2017;'07 - 08;0,04;9,07;-9,03;24;12;-12;30482;30173;-309
16520;19.11.2017;'08 - 09;5,08;4,46;0,62;735;750;15;30979;30324;-655
16521;19.11.2017;'09 - 10;23,49;20,15;3,34;2597;2761;164;31570;30681;-889
16522;19.11.2017;'10 - 11;12,77;24,27;-11,5;4495;4683;188;32234;31168;-1066
16523;19.11.2017;'11 - 12;21,94;23,53;-1,59;5730;5580;-150;32711;31526;-1185
16524;19.11.2017;'12 - 13;12,5;20,63;-8,13;6002;5509;-493;33051;31641;-1410
16525;19.11.2017;'13 - 14;9,09;13,22;-4,13;5359;4928;-431;33048;31460;-1588
16526;19.11.2017;'14 - 15;5,09;11,29;-6,2;3819;3183;-636;32592;31450;-1142
16527;19.11.2017;'15 - 16;9,63;18,45;-8,82;1534;1180;-354;31796;31940;144
16528;19.11.2017;'16 - 17;5,99;19,1;-13,11;118;65;-53;31020;32664;1644
16529;19.11.2017;'17 - 18;23,14;23,56;-0,42;0;0;0;30303;32677;2374
16530;19.11.2017;'18 - 19;21,94;22,81;-0,87;0;0;0;29748;32564;2816
16531;19.11.2017;'19 - 20;13,3;15,61;-2,31;0;0;0;29027;31891;2864
16532;19.11.2017;'20 - 21;12,62;12,09;0,53;0;0;0;28107;31066;2959
16533;19.11.2017;'21 - 22;11,38;9,86;1,52;0;0;0;27076;29967;2891
16534;19.11.2017;'22 - 23;13,95;9,71;4,24;0;0;0;26017;28962;2945
16535;19.11.2017;'23 - 24;12,21;6,92;5,29;0;0;0;25188;27864;2676
16536;20.11.2017;'00 - 01;12,59;-3,89;16,48;0;0;0;24543;26395;1852
16537;20.11.2017;'01 - 02;12,51;-8,1;20,61;0;0;0;23554;25224;1670
16538;20.11.2017;'02 - 03;10,49;-11,68;22,17;0;0;0;22356;23010;654
16539;20.11.2017;'03 - 04;11;-5,46;16,46;0;0;0;21197;21830;633
16540;20.11.2017;'04 - 05;14,96;8,15;6,81;0;0;0;20107;19800;-307
16541;20.11.2017;'05 - 06;23,81;31,3;-7,49;0;0;0;19122;19145;23
16542;20.11.2017;'06 - 07;39,94;41,79;-1,85;0;0;0;18212;18771;559
16543;20.11.2017;'07 - 08;41,99;49,49;-7,5;21;14;-7;17165;18618;1453
16544;20.11.2017;'08 - 09;43,92;46,35;-2,43;484;558;74;16289;17494;1205
16545;20.11.2017;'09 - 10;43,91;53,1;-9,19;1525;1798;273;15681;16258;577
16546;20.11.2017;'10 - 11;43,68;52,32;-8,64;2406;2762;356;15303;15193;-110
16547;20.11.2017;'11 - 12;43,94;52,72;-8,78;2779;3126;347;15339;14902;-437
16548;20.11.2017;'12 - 13;44,36;52,57;-8,21;2579;2813;234;15579;14975;-604
16549;20.11.2017;'13 - 14;49,05;53,6;-4,55;1988;2174;186;15521;14258;-1263
16550;20.11.2017;'14 - 15;53,46;58,9;-5,44;1157;1275;118;15034;13525;-1509
16551;20.11.2017;'15 - 16;50,99;62,42;-11,43;386;392;6;14505;13330;-1175
16552;20.11.2017;'16 - 17;59,3;72,02;-12,72;33;10;-23;14240;13246;-994
16553;20.11.2017;'17 - 18;66,02;94,45;-28,43;0;0;0;14143;13571;-572
16554;20.11.2017;'18 - 19;53,38;91,99;-38,61;0;0;0;14121;13496;-625
16555;20.11.2017;'19 - 20;47,93;59,9;-11,97;0;0;0;14089;13190;-899
16556;20.11.2017;'20 - 21;43,95;45,89;-1,94;0;0;0;13872;12904;-968
16557;20.11.2017;'21 - 22;38,63;39,58;-0,95;0;0;0;13641;12371;-1270
16558;20.11.2017;'22 - 23;38,76;37,22;1,54;0;0;0;13256;11922;-1334
16559;20.11.2017;'23 - 24;34,97;37,15;-2,18;0;0;0;12690;11636;-1054
16560;21.11.2017;'00 - 01;36,03;31,76;4,27;0;0;0;11269;11615;346
16561;21.11.2017;'01 - 02;35,46;31,14;4,32;0;0;0;10797;11521;724
16562;21.11.2017;'02 - 03;35,63;30,24;5,39;0;0;0;10477;11474;997
16563;21.11.2017;'03 - 04;35,73;31,28;4,45;0;0;0;10175;10949;774
16564;21.11.2017;'04 - 05;35,42;34,48;0,94;0;0;0;9844;10750;906
16565;21.11.2017;'05 - 06;37,92;34,56;3,36;0;0;0;9587;10746;1159
16566;21.11.2017;'06 - 07;46,51;38,12;8,39;0;0;0;9458;10910;1452
16567;21.11.2017;'07 - 08;67,86;56,72;11,14;8;6;-2;9317;10921;1604
16568;21.11.2017;'08 - 09;72,63;59,56;13,07;232;266;34;9202;10938;1736
16569;21.11.2017;'09 - 10;54,99;49,23;5,76;744;964;220;9125;10945;1820
16570;21.11.2017;'10 - 11;54,26;46,96;7,3;1255;1604;349;9060;10454;1394
16571;21.11.2017;'11 - 12;64,03;50,09;13,94;1542;1970;428;9030;10276;1246
16572;21.11.2017;'12 - 13;55,27;49,86;5,41;1584;2198;614;9090;10093;1003
16573;21.11.2017;'13 - 14;64,91;54,84;10,07;1398;2156;758;9229;10092;863
16574;21.11.2017;'14 - 15;62,65;56,68;5,97;961;1536;575;9483;10544;1061
16575;21.11.2017;'15 - 16;62,65;57,58;5,07;378;530;152;9977;11034;1057
16576;21.11.2017;'16 - 17;62,65;59,33;3,32;35;10;-25;10881;11919;1038
16577;21.11.2017;'17 - 18;68,05;72,27;-4,22;0;0;0;12358;12812;454
16578;21.11.2017;'18 - 19;57,46;62,71;-5,25;0;0;0;13977;14142;165
16579;21.11.2017;'19 - 20;43,99;48,77;-4,78;0;0;0;15386;15924;538
16580;21.11.2017;'20 - 21;35,42;41,67;-6,25;0;0;0;17017;18138;1121
16581;21.11.2017;'21 - 22;32,64;37,39;-4,75;0;0;0;18609;19549;940
16582;21.11.2017;'22 - 23;31,31;36,98;-5,67;0;0;0;19723;20424;701
16583;21.11.2017;'23 - 24;29,69;31,86;-2,17;0;0;0;20483;21449;966
16584;22.11.2017;'00 - 01;27,15;16,24;10,91;0;0;0;21691;22587;896
16585;22.11.2017;'01 - 02;15,7;12,27;3,43;0;0;0;22753;24319;1566
16586;22.11.2017;'02 - 03;10,7;7,42;3,28;0;0;0;23831;25442;1611
16587;22.11.2017;'03 - 04;10,96;5,79;5,17;0;0;0;24872;26680;1808
16588;22.11.2017;'04 - 05;10,75;3,65;7,1;0;0;0;25827;27144;1317
16589;22.11.2017;'05 - 06;20,24;9,35;10,89;0;0;0;26678;27422;744
16590;22.11.2017;'06 - 07;29,92;17,17;12,75;0;0;0;27426;28134;708
16591;22.11.2017;'07 - 08;37,37;30,48;6,89;37;24;-13;27827;26974;-853
16592;22.11.2017;'08 - 09;35,72;32,33;3,39;1177;1234;57;27783;26080;-1703
16593;22.11.2017;'09 - 10;32,49;33,82;-1,33;3502;3744;242;27626;25211;-2415
16594;22.11.2017;'10 - 11;31,98;35,29;-3,31;5680;6335;655;27106;24190;-2916
16595;22.11.2017;'11 - 12;31,8;37,55;-5,75;7103;8286;1183;26187;22844;-3343
16596;22.11.2017;'12 - 13;31,03;35,26;-4,23;7558;9214;1656;24906;21601;-3305
16597;22.11.2017;'13 - 14;31,3;35,8;-4,5;6901;8628;1727;23452;20137;-3315
16598;22.11.2017;'14 - 15;32,56;38,56;-6;4997;6151;1154;22132;18540;-3592
16599;22.11.2017;'15 - 16;41,43;42,75;-1,32;2130;2412;282;21115;17143;-3972
16600;22.11.2017;'16 - 17;50,06;57,96;-7,9;170;119;-51;20897;18688;-2209
16601;22.11.2017;'17 - 18;61,26;66,53;-5,27;0;0;0;21562;21603;41
16602;22.11.2017;'18 - 19;50,93;48,5;2,43;0;0;0;22416;23903;1487
16603;22.11.2017;'19 - 20;43,97;36,08;7,89;0;0;0;23225;25418;2193
16604;22.11.2017;'20 - 21;39,99;30,79;9,2;0;0;0;23939;26547;2608
16605;22.11.2017;'21 - 22;33,7;23,46;10,24;0;0;0;24721;27337;2616
16606;22.11.2017;'22 - 23;29,56;19,02;10,54;0;0;0;25447;27018;1571
16607;22.11.2017;'23 - 24;20,6;10,99;9,61;0;0;0;26024;27573;1549
16608;23.11.2017;'00 - 01;9,67;13,3;-3,63;0;0;0;27564;28286;722
16609;23.11.2017;'01 - 02;12,76;21,1;-8,34;0;0;0;27947;28442;495
16610;23.11.2017;'02 - 03;9,64;20,73;-11,09;0;0;0;28416;28458;42
16611;23.11.2017;'03 - 04;9,47;14,91;-5,44;0;0;0;29020;28812;-208
16612;23.11.2017;'04 - 05;9,46;15,33;-5,87;0;0;0;29735;29778;43
16613;23.11.2017;'05 - 06;12,77;18,35;-5,58;0;0;0;30637;30995;358
16614;23.11.2017;'06 - 07;17,1;17,14;-0,04;0;0;0;31544;32328;784
16615;23.11.2017;'07 - 08;32,93;26,58;6,35;47;29;-18;32317;32596;279
16616;23.11.2017;'08 - 09;31,09;25,21;5,88;1693;1749;56;32864;33098;234
16617;23.11.2017;'09 - 10;29,96;14,88;15,08;5150;5185;35;33359;33075;-284
16618;23.11.2017;'10 - 11;24,03;10,28;13,75;7878;7302;-576;33747;33196;-551
16619;23.11.2017;'11 - 12;16,24;16,11;0,13;9050;8030;-1020;33973;33470;-503
16620;23.11.2017;'12 - 13;12,75;17,26;-4,51;8725;7764;-961;34082;33938;-144
16621;23.11.2017;'13 - 14;16,63;22,09;-5,46;7176;6387;-789;34037;34156;119
16622;23.11.2017;'14 - 15;26,23;29,45;-3,22;4611;4165;-446;33736;33620;-116
16623;23.11.2017;'15 - 16;30,76;32,6;-1,84;1689;1384;-305;33157;32484;-673
16624;23.11.2017;'16 - 17;31,95;33,31;-1,36;106;52;-54;32370;32244;-126
16625;23.11.2017;'17 - 18;37,97;35,81;2,16;0;0;0;31394;30842;-552
16626;23.11.2017;'18 - 19;37,57;30,75;6,82;0;0;0;30511;30450;-61
16627;23.11.2017;'19 - 20;36,98;34,54;2,44;0;0;0;29737;29584;-153
16628;23.11.2017;'20 - 21;33,94;30;3,94;0;0;0;28500;28912;412
16629;23.11.2017;'21 - 22;29,34;27,54;1,8;0;0;0;27103;27733;630
16630;23.11.2017;'22 - 23;27,41;27,21;0,2;0;0;0;25297;26029;732
16631;23.11.2017;'23 - 24;24,05;20,3;3,75;0;0;0;23207;24249;1042
16632;24.11.2017;'00 - 01;26,93;26,2;0,73;0;0;0;20837;22239;1402
16633;24.11.2017;'01 - 02;27,75;31,19;-3,44;0;0;0;19698;20208;510
16634;24.11.2017;'02 - 03;28,04;32,82;-4,78;0;0;0;18066;18689;623
16635;24.11.2017;'03 - 04;27,1;30,22;-3,12;0;0;0;16544;17515;971
16636;24.11.2017;'04 - 05;28,22;28,72;-0,5;0;0;0;15328;16999;1671
16637;24.11.2017;'05 - 06;35,66;26,05;9,61;0;0;0;14656;16636;1980
16638;24.11.2017;'06 - 07;49,01;39,92;9,09;0;0;0;14322;16348;2026
16639;24.11.2017;'07 - 08;49,07;38,62;10,45;34;25;-9;14253;16713;2460
16640;24.11.2017;'08 - 09;48;38,42;9,58;1164;1080;-84;14292;17597;3305
16641;24.11.2017;'09 - 10;46,92;37,11;9,81;3443;3336;-107;14550;17856;3306
16642;24.11.2017;'10 - 11;45,43;37,75;7,68;5218;5440;222;14766;17593;2827
16643;24.11.2017;'11 - 12;46,5;38,47;8,03;6076;6356;280;14908;17330;2422
16644;24.11.2017;'12 - 13;39,57;37,3;2,27;5881;5980;99;14890;15700;810
16645;24.11.2017;'13 - 14;41,13;41,46;-0,33;4809;4938;129;14559;14416;-143
16646;24.11.2017;'14 - 15;43,13;44,37;-1,24;3020;2566;-454;13728;12532;-1196
16647;24.11.2017;'15 - 16;44,91;46,79;-1,88;1060;706;-354;12673;10705;-1968
16648;24.11.2017;'16 - 17;46,94;54,07;-7,13;63;14;-49;11601;9994;-1607
16649;24.11.2017;'17 - 18;53,97;66,81;-12,84;0;0;0;10559;9316;-1243
16650;24.11.2017;'18 - 19;56,24;67,3;-11,06;0;0;0;9589;8736;-853
16651;24.11.2017;'19 - 20;55,97;61,51;-5,54;0;0;0;8637;8259;-378
16652;24.11.2017;'20 - 21;48;45,59;2,41;0;0;0;7687;7632;-55
16653;24.11.2017;'21 - 22;47,98;43,2;4,78;0;0;0;6926;6475;-451
16654;24.11.2017;'22 - 23;47,98;42,82;5,16;0;0;0;6264;5800;-464
16655;24.11.2017;'23 - 24;40,99;34,61;6,38;0;0;0;5801;5056;-745
16656;25.11.2017;'00 - 01;39,89;35,71;4,18;0;0;0;5144;4981;-163
16657;25.11.2017;'01 - 02;36,19;35,06;1,13;0;0;0;4709;4873;164
16658;25.11.2017;'02 - 03;34,49;32,6;1,89;0;0;0;4283;4692;409
16659;25.11.2017;'03 - 04;36,2;31,8;4,4;0;0;0;4002;4394;392
16660;25.11.2017;'04 - 05;38;33,49;4,51;0;0;0;3815;4594;779
16661;25.11.2017;'05 - 06;35,86;33,07;2,79;0;0;0;3788;4818;1030
16662;25.11.2017;'06 - 07;35,03;36,04;-1,01;0;0;0;3956;5400;1444
16663;25.11.2017;'07 - 08;42,37;38,33;4,04;12;9;-3;4089;5804;1715
16664;25.11.2017;'08 - 09;49,95;43,37;6,58;400;307;-93;4255;6517;2262
16665;25.11.2017;'09 - 10;49,94;42,71;7,23;1309;1118;-191;4550;7182;2632
16666;25.11.2017;'10 - 11;51,97;42,43;9,54;2161;2145;-16;4985;7682;2697
16667;25.11.2017;'11 - 12;53,51;42,66;10,85;2624;2853;229;5593;7600;2007
16668;25.11.2017;'12 - 13;49,96;41,49;8,47;2559;2834;275;6435;7574;1139
16669;25.11.2017;'13 - 14;46,98;39,87;7,11;2093;2208;115;7346;8617;1271
16670;25.11.2017;'14 - 15;38,98;39,04;-0,06;1373;1466;93;8346;9604;1258
16671;25.11.2017;'15 - 16;35,29;37,12;-1,83;513;586;73;9422;10568;1146
16672;25.11.2017;'16 - 17;39,56;42,33;-2,77;39;26;-13;10349;12068;1719
16673;25.11.2017;'17 - 18;44,26;45,75;-1,49;0;0;0;11176;12748;1572
16674;25.11.2017;'18 - 19;38,41;39,99;-1,58;0;0;0;12015;13385;1370
16675;25.11.2017;'19 - 20;37,93;36,66;1,27;0;0;0;13037;14460;1423
16676;25.11.2017;'20 - 21;36,12;32,49;3,63;0;0;0;13894;15400;1506
16677;25.11.2017;'21 - 22;32,12;27,43;4,69;0;0;0;14584;16227;1643
16678;25.11.2017;'22 - 23;30,09;24,95;5,14;0;0;0;15371;16954;1583
16679;25.11.2017;'23 - 24;27,58;17,94;9,64;0;0;0;16069;17993;1924
16680;26.11.2017;'00 - 01;19,21;11,25;7,96;0;0;0;17108;19516;2408
16681;26.11.2017;'01 - 02;12,59;8,13;4,46;0;0;0;18192;21104;2912
16682;26.11.2017;'02 - 03;11,56;6,29;5,27;0;0;0;19390;22220;2830
16683;26.11.2017;'03 - 04;11,45;11,47;-0,02;0;0;0;20548;23508;2960
16684;26.11.2017;'04 - 05;15,74;11,64;4,1;0;0;0;21651;24116;2465
16685;26.11.2017;'05 - 06;12,85;11,67;1,18;0;0;0;22561;24506;1945
16686;26.11.2017;'06 - 07;11,41;14,84;-3,43;0;0;0;23304;25438;2134
16687;26.11.2017;'07 - 08;9,77;13,95;-4,18;14;5;-9;23911;25434;1523
16688;26.11.2017;'08 - 09;19,36;16,71;2,65;853;631;-222;24335;25014;679
16689;26.11.2017;'09 - 10;11,58;23,05;-11,47;3007;2180;-827;25070;24726;-344
16690;26.11.2017;'10 - 11;19,95;24,36;-4,41;4904;3826;-1078;25977;24915;-1062
16691;26.11.2017;'11 - 12;21,6;29,44;-7,84;5841;4812;-1029;26951;25343;-1608
16692;26.11.2017;'12 - 13;11,48;25,89;-14,41;5766;4704;-1062;27742;25873;-1869
16693;26.11.2017;'13 - 14;11,49;23,58;-12,09;4868;3615;-1253;27944;25632;-2312
16694;26.11.2017;'14 - 15;15,75;26,25;-10,5;3237;2082;-1155;27534;25127;-2407
16695;26.11.2017;'15 - 16;15,55;27,92;-12,37;1152;696;-456;26581;24838;-1743
16696;26.11.2017;'16 - 17;23,6;32,43;-8,83;67;35;-32;26059;25362;-697
16697;26.11.2017;'17 - 18;29,17;32,96;-3,79;0;0;0;25996;26084;88
16698;26.11.2017;'18 - 19;29,43;33,45;-4,02;0;0;0;26216;26512;296
16699;26.11.2017;'19 - 20;29,51;31,01;-1,5;0;0;0;26317;26548;231
16700;26.11.2017;'20 - 21;29,07;30,21;-1,14;0;0;0;26206;26680;474
16701;26.11.2017;'21 - 22;29,01;29,28;-0,27;0;0;0;25982;25900;-82
16702;26.11.2017;'22 - 23;28,37;31,19;-2,82;0;0;0;25717;24974;-743
16703;26.11.2017;'23 - 24;21,94;30,16;-8,22;0;0;0;25363;24618;-745
16704;27.11.2017;'00 - 01;11,47;18,34;-6,87;0;0;0;23846;24858;1012
16705;27.11.2017;'01 - 02;14,95;15;-0,05;0;0;0;23483;24758;1275
16706;27.11.2017;'02 - 03;17,06;13,77;3,29;0;0;0;23236;24359;1123
16707;27.11.2017;'03 - 04;13,06;13,33;-0,27;0;0;0;23133;24170;1037
16708;27.11.2017;'04 - 05;10,02;11,27;-1,25;0;0;0;23288;24484;1196
16709;27.11.2017;'05 - 06;20,96;11,68;9,28;0;0;0;23811;25468;1657
16710;27.11.2017;'06 - 07;40,1;33,35;6,75;0;0;0;24538;26430;1892
16711;27.11.2017;'07 - 08;36,12;35,37;0,75;11;4;-7;25812;27192;1380
16712;27.11.2017;'08 - 09;40,06;41,46;-1,4;635;572;-63;27179;28233;1054
16713;27.11.2017;'09 - 10;36,04;37,86;-1,82;2188;2366;178;28843;29514;671
16714;27.11.2017;'10 - 11;34,06;33,05;1,01;3526;4263;737;30214;31027;813
16715;27.11.2017;'11 - 12;34,73;30,04;4,69;4054;4835;781;31395;32792;1397
16716;27.11.2017;'12 - 13;31,1;28,91;2,19;3781;4504;723;32548;34147;1599
16717;27.11.2017;'13 - 14;32,38;29,71;2,67;2840;3174;334;32881;34820;1939
16718;27.11.2017;'14 - 15;33,33;31,54;1,79;1667;1722;55;32668;35178;2510
16719;27.11.2017;'15 - 16;34,82;33,33;1,49;555;529;-26;32304;35566;3262
16720;27.11.2017;'16 - 17;35,7;30,23;5,47;35;14;-21;31825;35520;3695
16721;27.11.2017;'17 - 18;40,32;35,87;4,45;0;0;0;31194;35272;4078
16722;27.11.2017;'18 - 19;36,7;32,32;4,38;0;0;0;30537;34874;4337
16723;27.11.2017;'19 - 20;35,26;30,43;4,83;0;0;0;29754;35006;5252
16724;27.11.2017;'20 - 21;35,95;28,33;7,62;0;0;0;29118;34368;5250
16725;27.11.2017;'21 - 22;30,93;22,42;8,51;0;0;0;28527;33361;4834
16726;27.11.2017;'22 - 23;30;19,13;10,87;0;0;0;27929;32358;4429
16727;27.11.2017;'23 - 24;15,87;9,86;6,01;0;0;0;27564;32334;4770
16728;28.11.2017;'00 - 01;22,5;9,37;13,13;0;0;0;29717;32049;2332
16729;28.11.2017;'01 - 02;16,07;5,77;10,3;0;0;0;29548;31358;1810
16730;28.11.2017;'02 - 03;15,46;7,22;8,24;0;0;0;29414;30457;1043
16731;28.11.2017;'03 - 04;16,29;8,91;7,38;0;0;0;29205;29982;777
16732;28.11.2017;'04 - 05;22,04;16,38;5,66;0;0;0;28817;28768;-49
16733;28.11.2017;'05 - 06;24,7;23,75;0,95;0;0;0;28244;27997;-247
16734;28.11.2017;'06 - 07;34,01;36,65;-2,64;0;0;0;27722;27172;-550
16735;28.11.2017;'07 - 08;40,13;49,3;-9,17;5;2;-3;27375;27149;-226
16736;28.11.2017;'08 - 09;37,78;45,33;-7,55;434;401;-33;27057;26772;-285
16737;28.11.2017;'09 - 10;36,39;39,56;-3,17;1770;1814;44;26489;25566;-923
16738;28.11.2017;'10 - 11;35,84;38,81;-2,97;3204;3224;20;25835;24814;-1021
16739;28.11.2017;'11 - 12;36,05;39,07;-3,02;4155;3930;-225;25210;23312;-1898
16740;28.11.2017;'12 - 13;39,91;40,56;-0,65;4304;4163;-141;24337;21642;-2695
16741;28.11.2017;'13 - 14;45,07;45,05;0,02;3685;3365;-320;22704;20707;-1997
16742;28.11.2017;'14 - 15;48,59;48,51;0,08;2395;2050;-345;20429;19408;-1021
16743;28.11.2017;'15 - 16;52,94;49,13;3,81;797;683;-114;18206;17719;-487
16744;28.11.2017;'16 - 17;51,97;50,29;1,68;47;26;-21;16638;16948;310
16745;28.11.2017;'17 - 18;59,7;53,6;6,1;0;0;0;15745;16801;1056
16746;28.11.2017;'18 - 19;52,98;48,64;4,34;0;0;0;14830;16478;1648
16747;28.11.2017;'19 - 20;51,32;45,81;5,51;0;0;0;13757;15899;2142
16748;28.11.2017;'20 - 21;49,99;42,37;7,62;0;0;0;12719;15298;2579
16749;28.11.2017;'21 - 22;36,59;36,65;-0,06;0;0;0;11748;14570;2822
16750;28.11.2017;'22 - 23;36,64;34,62;2,02;0;0;0;10931;13212;2281
16751;28.11.2017;'23 - 24;35,01;32,07;2,94;0;0;0;10111;11973;1862
16752;29.11.2017;'00 - 01;36,56;30,81;5,75;0;0;0;8532;10929;2397
16753;29.11.2017;'01 - 02;36,79;29,66;7,13;0;0;0;7712;9711;1999
16754;29.11.2017;'02 - 03;35,56;29,08;6,48;0;0;0;7028;8966;1938
16755;29.11.2017;'03 - 04;35,06;30,37;4,69;0;0;0;6404;8527;2123
16756;29.11.2017;'04 - 05;36,17;30,6;5,57;0;0;0;5836;8153;2317
16757;29.11.2017;'05 - 06;38,97;32,47;6,5;0;0;0;5328;7380;2052
16758;29.11.2017;'06 - 07;57,72;49,4;8,32;0;0;0;4828;6525;1697
16759;29.11.2017;'07 - 08;84,97;75,49;9,48;4;3;-1;4305;5883;1578
16760;29.11.2017;'08 - 09;88,52;86,85;1,67;612;570;-42;3804;5532;1728
16761;29.11.2017;'09 - 10;90,1;88,47;1,63;2398;2325;-73;3331;4747;1416
16762;29.11.2017;'10 - 11;88,33;86,8;1,53;4159;4072;-87;2871;3292;421
16763;29.11.2017;'11 - 12;86;87,15;-1,15;5193;5174;-19;2550;2523;-27
16764;29.11.2017;'12 - 13;82,18;85,88;-3,7;5220;5106;-114;2324;2225;-99
16765;29.11.2017;'13 - 14;82,4;84,71;-2,31;4292;3964;-328;2111;2185;74
16766;29.11.2017;'14 - 15;89,21;83,71;5,5;2681;2239;-442;1939;2076;137
16767;29.11.2017;'15 - 16;90,4;82,7;7,7;868;681;-187;1874;2011;137
16768;29.11.2017;'16 - 17;97,8;85,78;12,02;50;21;-29;1892;2198;306
16769;29.11.2017;'17 - 18;118,49;116,07;2,42;0;0;0;2031;2325;294
16770;29.11.2017;'18 - 19;110,36;96,66;13,7;0;0;0;2205;2279;74
16771;29.11.2017;'19 - 20;85,56;82,19;3,37;0;0;0;2313;2388;75
16772;29.11.2017;'20 - 21;77,34;67,05;10,29;0;0;0;2349;2295;-54
16773;29.11.2017;'21 - 22;64,27;56,91;7,36;0;0;0;2394;2244;-150
16774;29.11.2017;'22 - 23;55,57;52,1;3,47;0;0;0;2493;2088;-405
16775;29.11.2017;'23 - 24;47,71;44,13;3,58;0;0;0;2581;2074;-507
16776;30.11.2017;'00 - 01;45,94;41,99;3,95;0;0;0;2210;2026;-184
16777;30.11.2017;'01 - 02;38,2;39,69;-1,49;0;0;0;2260;2062;-198
16778;30.11.2017;'02 - 03;36,97;42,84;-5,87;0;0;0;2327;2218;-109
16779;30.11.2017;'03 - 04;36,1;41,74;-5,64;0;0;0;2445;2586;141
16780;30.11.2017;'04 - 05;38,47;42,85;-4,38;0;0;0;2630;2459;-171
16781;30.11.2017;'05 - 06;42,72;44,14;-1,42;0;0;0;2744;2668;-76
16782;30.11.2017;'06 - 07;53,99;52,61;1,38;0;0;0;2814;2801;-13
16783;30.11.2017;'07 - 08;83,75;69,05;14,7;2;0;-2;2877;2966;89
16784;30.11.2017;'08 - 09;88,16;76,02;12,14;278;273;-5;2817;2766;-51
16785;30.11.2017;'09 - 10;85,25;77,73;7,52;1358;1410;52;2748;2766;18
16786;30.11.2017;'10 - 11;86,79;78,74;8,05;2721;2534;-187;2716;2824;108
16787;30.11.2017;'11 - 12;86,7;80;6,7;3511;2904;-607;2741;2504;-237
16788;30.11.2017;'12 - 13;84,07;82,81;1,26;3547;2809;-738;2777;2390;-387
16789;30.11.2017;'13 - 14;83,34;83,35;-0,01;2924;2374;-550;2751;2392;-359
16790;30.11.2017;'14 - 15;82,81;81,55;1,26;1785;1525;-260;2596;2336;-260
16791;30.11.2017;'15 - 16;84,22;79,82;4,4;560;474;-86;2523;2587;64
16792;30.11.2017;'16 - 17;86,06;86,57;-0,51;35;11;-24;2503;3067;564
16793;30.11.2017;'17 - 18;100,12;95,31;4,81;0;0;0;2671;3414;743
16794;30.11.2017;'18 - 19;95,1;80,11;14,99;0;0;0;2961;3449;488
16795;30.11.2017;'19 - 20;87,24;71,64;15,6;0;0;0;3158;3250;92
16796;30.11.2017;'20 - 21;68,5;63,59;4,91;0;0;0;3256;3126;-130
16797;30.11.2017;'21 - 22;51,96;50,87;1,09;0;0;0;3387;2832;-555
16798;30.11.2017;'22 - 23;38,45;40,85;-2,4;0;0;0;3559;2829;-730
16799;30.11.2017;'23 - 24;36,67;38,8;-2,13;0;0;0;3709;2898;-811
16800;01.12.2017;'00 - 01;35,82;34,6;1,22;0;0;0;3736;3199;-537
16801;01.12.2017;'01 - 02;38,59;35,38;3,21;0;0;0;3820;3170;-650
16802;01.12.2017;'02 - 03;37,18;35,16;2,02;0;0;0;3921;3000;-921
16803;01.12.2017;'03 - 04;37;35,07;1,93;0;0;0;4054;2911;-1143
16804;01.12.2017;'04 - 05;37,42;36,93;0,49;0;0;0;4201;2876;-1325
16805;01.12.2017;'05 - 06;36,14;36,82;-0,68;0;0;0;4341;2808;-1533
16806;01.12.2017;'06 - 07;55,97;55,29;0,68;0;0;0;4496;2506;-1990
16807;01.12.2017;'07 - 08;81,69;77,94;3,75;4;1;-3;4600;2414;-2186
16808;01.12.2017;'08 - 09;75,01;73,42;1,59;475;412;-63;4531;2471;-2060
16809;01.12.2017;'09 - 10;72,89;72,02;0,87;2301;1674;-627;4389;2374;-2015
16810;01.12.2017;'10 - 11;70,38;69,88;0,5;4255;3048;-1207;4070;2029;-2041
16811;01.12.2017;'11 - 12;74,87;75,14;-0,27;5406;4150;-1256;3613;1963;-1650
16812;01.12.2017;'12 - 13;74,91;74,27;0,64;5439;3957;-1482;3181;1630;-1551
16813;01.12.2017;'13 - 14;73,18;72,79;0,39;4506;3260;-1246;2859;1579;-1280
16814;01.12.2017;'14 - 15;72,5;69,94;2,56;2847;2068;-779;2725;1911;-814
16815;01.12.2017;'15 - 16;74,42;66,69;7,73;947;676;-271;2735;2104;-631
16816;01.12.2017;'16 - 17;76,6;66,13;10,47;44;20;-24;2768;2300;-468
16817;01.12.2017;'17 - 18;85,69;73,64;12,05;0;0;0;2788;2298;-490
16818;01.12.2017;'18 - 19;82,57;62,59;19,98;0;0;0;2770;2297;-473
16819;01.12.2017;'19 - 20;77,38;58,47;18,91;0;0;0;2627;1961;-666
16820;01.12.2017;'20 - 21;61,95;54,23;7,72;0;0;0;2372;1802;-570
16821;01.12.2017;'21 - 22;52,93;44,18;8,75;0;0;0;2162;1662;-500
16822;01.12.2017;'22 - 23;41,58;38,37;3,21;0;0;0;2031;1584;-447
16823;01.12.2017;'23 - 24;37,94;37,24;0,7;0;0;0;2007;1408;-599
16824;02.12.2017;'00 - 01;39,9;36,98;2,92;0;0;0;1527;1265;-262
16825;02.12.2017;'01 - 02;39,02;35,52;3,5;0;0;0;1604;1262;-342
16826;02.12.2017;'02 - 03;37,89;36,45;1,44;0;0;0;1679;1296;-383
16827;02.12.2017;'03 - 04;37,82;36,07;1,75;0;0;0;1834;1424;-410
16828;02.12.2017;'04 - 05;34,7;35,69;-0,99;0;0;0;2132;1528;-604
16829;02.12.2017;'05 - 06;36,75;35,97;0,78;0;0;0;2526;1697;-829
16830;02.12.2017;'06 - 07;34,07;36,85;-2,78;0;0;0;2927;2100;-827
16831;02.12.2017;'07 - 08;37,01;41,17;-4,16;5;0;-5;3325;2433;-892
16832;02.12.2017;'08 - 09;46,17;48,83;-2,66;642;352;-290;3724;2911;-813
16833;02.12.2017;'09 - 10;46,1;51,16;-5,06;2808;1627;-1181;4193;3267;-926
16834;02.12.2017;'10 - 11;42,33;52,36;-10,03;5268;2896;-2372;4635;3808;-827
16835;02.12.2017;'11 - 12;44,02;54,36;-10,34;6807;3522;-3285;5077;4551;-526
16836;02.12.2017;'12 - 13;40;52,9;-12,9;6964;3451;-3513;5548;5042;-506
16837;02.12.2017;'13 - 14;37,28;51,55;-14,27;5807;2731;-3076;6067;5780;-287
16838;02.12.2017;'14 - 15;38,21;51,09;-12,88;3687;1492;-2195;6576;6102;-474
16839;02.12.2017;'15 - 16;46,13;51,73;-5,6;1246;382;-864;7150;6402;-748
16840;02.12.2017;'16 - 17;47,96;52,78;-4,82;64;6;-58;7763;6725;-1038
16841;02.12.2017;'17 - 18;47,95;55,14;-7,19;0;0;0;8473;7248;-1225
16842;02.12.2017;'18 - 19;42,99;53,21;-10,22;0;0;0;9168;7766;-1402
16843;02.12.2017;'19 - 20;39,37;45,37;-6;0;0;0;9693;8316;-1377
16844;02.12.2017;'20 - 21;36,79;39,52;-2,73;0;0;0;10054;8890;-1164
16845;02.12.2017;'21 - 22;38,52;37,84;0,68;0;0;0;10415;8945;-1470
16846;02.12.2017;'22 - 23;39,92;41,36;-1,44;0;0;0;10751;8952;-1799
16847;02.12.2017;'23 - 24;35,68;39,62;-3,94;0;0;0;11052;9540;-1512
16848;03.12.2017;'00 - 01;33,17;35,13;-1,96;0;0;0;11180;10289;-891
16849;03.12.2017;'01 - 02;31,93;31,91;0,02;0;0;0;11597;10740;-857
16850;03.12.2017;'02 - 03;30,43;29,65;0,78;0;0;0;11948;11067;-881
16851;03.12.2017;'03 - 04;28,3;27,42;0,88;0;0;0;12360;11598;-762
16852;03.12.2017;'04 - 05;30,44;30,67;-0,23;0;0;0;12739;12436;-303
16853;03.12.2017;'05 - 06;29,87;28,39;1,48;0;0;0;12971;13500;529
16854;03.12.2017;'06 - 07;29,81;24,35;5,46;0;0;0;13228;14360;1132
16855;03.12.2017;'07 - 08;27,72;22,31;5,41;2;1;-1;13604;14118;514
16856;03.12.2017;'08 - 09;29,95;27,65;2,3;592;280;-312;14048;14338;290
16857;03.12.2017;'09 - 10;33,08;34,19;-1,11;2263;1311;-952;14516;14780;264
16858;03.12.2017;'10 - 11;34,85;37,2;-2,35;3800;2290;-1510;14834;15347;513
16859;03.12.2017;'11 - 12;36,91;38,28;-1,37;4618;2790;-1828;15064;16094;1030
16860;03.12.2017;'12 - 13;37;34,46;2,54;4534;2677;-1857;15353;17190;1837
16861;03.12.2017;'13 - 14;32,92;29,12;3,8;3653;1932;-1721;15626;17667;2041
16862;03.12.2017;'14 - 15;34,06;28,63;5,43;2217;946;-1271;15870;17588;1718
16863;03.12.2017;'15 - 16;34,29;29,75;4,54;675;182;-493;16162;17692;1530
16864;03.12.2017;'16 - 17;36,97;28,75;8,22;26;2;-24;16535;17826;1291
16865;03.12.2017;'17 - 18;39,36;32,66;6,7;0;0;0;16938;17893;955
16866;03.12.2017;'18 - 19;39;33,86;5,14;0;0;0;17352;17977;625
16867;03.12.2017;'19 - 20;37,06;31,64;5,42;0;0;0;17657;18270;613
16868;03.12.2017;'20 - 21;36,03;31,17;4,86;0;0;0;17960;18642;682
16869;03.12.2017;'21 - 22;33,95;30,17;3,78;0;0;0;18323;19044;721
16870;03.12.2017;'22 - 23;33,98;30,25;3,73;0;0;0;18750;19458;708
16871;03.12.2017;'23 - 24;28,25;28,99;-0,74;0;0;0;19274;19657;383
16872;04.12.2017;'00 - 01;12,05;19,41;-7,36;0;0;0;20270;20208;-62
16873;04.12.2017;'01 - 02;17,69;23,92;-6,23;0;0;0;20673;20261;-412
16874;04.12.2017;'02 - 03;15,31;19,62;-4,31;0;0;0;21093;20521;-572
16875;04.12.2017;'03 - 04;12,75;22,52;-9,77;0;0;0;21614;21082;-532
16876;04.12.2017;'04 - 05;17,18;28,43;-11,25;0;0;0;22085;21616;-469
16877;04.12.2017;'05 - 06;25,05;32,74;-7,69;0;0;0;22507;22067;-440
16878;04.12.2017;'06 - 07;33,19;40,62;-7,43;0;0;0;22762;21854;-908
16879;04.12.2017;'07 - 08;38,56;50,96;-12,4;1;0;-1;22764;21570;-1194
16880;04.12.2017;'08 - 09;42,9;52,32;-9,42;184;108;-76;22547;21249;-1298
16881;04.12.2017;'09 - 10;38,29;50,72;-12,43;949;749;-200;22204;20435;-1769
16882;04.12.2017;'10 - 11;37,06;50,03;-12,97;1815;1494;-321;21895;20074;-1821
16883;04.12.2017;'11 - 12;38,94;52,69;-13,75;2379;2114;-265;21638;19326;-2312
16884;04.12.2017;'12 - 13;36,36;51,86;-15,5;2436;2472;36;21395;18994;-2401
16885;04.12.2017;'13 - 14;39,45;53,69;-14,24;1948;2149;201;20936;18729;-2207
16886;04.12.2017;'14 - 15;43,97;55,24;-11,27;1110;1320;210;20068;17947;-2121
16887;04.12.2017;'15 - 16;46,14;56,78;-10,64;297;336;39;19195;17352;-1843
16888;04.12.2017;'16 - 17;50,96;56,2;-5,24;13;5;-8;18430;17066;-1364
16889;04.12.2017;'17 - 18;51,04;53,65;-2,61;0;0;0;17874;17323;-551
16890;04.12.2017;'18 - 19;48,85;52,33;-3,48;0;0;0;17390;17996;606
16891;04.12.2017;'19 - 20;45,6;48,49;-2,89;0;0;0;16923;18629;1706
16892;04.12.2017;'20 - 21;42,38;42,12;0,26;0;0;0;16480;19560;3080
16893;04.12.2017;'21 - 22;39,83;34,47;5,36;0;0;0;16239;20354;4115
16894;04.12.2017;'22 - 23;33,53;28,57;4,96;0;0;0;16415;21543;5128
16895;04.12.2017;'23 - 24;30,03;26,08;3,95;0;0;0;16988;21936;4948
16896;05.12.2017;'00 - 01;28,69;22,25;6,44;0;0;0;19100;22314;3214
16897;05.12.2017;'01 - 02;28,01;23,66;4,35;0;0;0;19718;22289;2571
16898;05.12.2017;'02 - 03;26,88;24,02;2,86;0;0;0;20088;22343;2255
16899;05.12.2017;'03 - 04;27,93;24,84;3,09;0;0;0;20456;22357;1901
16900;05.12.2017;'04 - 05;28,23;26,96;1,27;0;0;0;20776;22847;2071
16901;05.12.2017;'05 - 06;30,73;27,63;3,1;0;0;0;21014;23205;2191
16902;05.12.2017;'06 - 07;35,39;32,41;2,98;0;0;0;21301;23611;2310
16903;05.12.2017;'07 - 08;39,69;35,95;3,74;1;0;-1;21620;24438;2818
16904;05.12.2017;'08 - 09;40,05;37,91;2,14;156;155;-1;21956;24919;2963
16905;05.12.2017;'09 - 10;40,36;36,05;4,31;746;890;144;22496;24792;2296
16906;05.12.2017;'10 - 11;47,59;38,5;9,09;1548;1804;256;23056;24606;1550
16907;05.12.2017;'11 - 12;46,78;38,33;8,45;2149;2270;121;23573;25118;1545
16908;05.12.2017;'12 - 13;44,07;37,7;6,37;2222;2435;213;24006;25423;1417
16909;05.12.2017;'13 - 14;42,45;36,77;5,68;1829;1947;118;24200;25748;1548
16910;05.12.2017;'14 - 15;39,97;36,36;3,61;1125;1130;5;24275;25975;1700
16911;05.12.2017;'15 - 16;39,05;37,45;1,6;383;315;-68;24235;26629;2394
16912;05.12.2017;'16 - 17;39,05;34,17;4,88;22;7;-15;24404;27210;2806
16913;05.12.2017;'17 - 18;43,96;37,5;6,46;0;0;0;24801;27378;2577
16914;05.12.2017;'18 - 19;40,04;40,47;-0,43;0;0;0;25245;27535;2290
16915;05.12.2017;'19 - 20;46,04;41,74;4,3;0;0;0;25599;27676;2077
16916;05.12.2017;'20 - 21;35,35;35,14;0,21;0;0;0;25915;28068;2153
16917;05.12.2017;'21 - 22;30,03;27,13;2,9;0;0;0;26249;27744;1495
16918;05.12.2017;'22 - 23;28,06;24,92;3,14;0;0;0;26584;27140;556
16919;05.12.2017;'23 - 24;13,45;20,33;-6,88;0;0;0;26879;27182;303
16920;06.12.2017;'00 - 01;14,34;17,56;-3,22;0;0;0;27789;27255;-534
16921;06.12.2017;'01 - 02;12,34;16,45;-4,11;0;0;0;28062;27388;-674
16922;06.12.2017;'02 - 03;9,71;15,09;-5,38;0;0;0;28269;27310;-959
16923;06.12.2017;'03 - 04;12,7;14,89;-2,19;0;0;0;28394;27294;-1100
16924;06.12.2017;'04 - 05;14,04;19,09;-5,05;0;0;0;28442;27776;-666
16925;06.12.2017;'05 - 06;13,27;19,54;-6,27;0;0;0;28448;28036;-412
16926;06.12.2017;'06 - 07;29,57;32,83;-3,26;0;0;0;28521;28656;135
16927;06.12.2017;'07 - 08;38,24;40,28;-2,04;1;0;-1;28572;28458;-114
16928;06.12.2017;'08 - 09;37,59;41,71;-4,12;217;96;-121;28491;28130;-361
16929;06.12.2017;'09 - 10;39,13;41,94;-2,81;1021;564;-457;28515;27716;-799
16930;06.12.2017;'10 - 11;38,22;46,41;-8,19;2024;1210;-814;28595;27618;-977
16931;06.12.2017;'11 - 12;34,6;45,15;-10,55;2758;1610;-1148;28648;27676;-972
16932;06.12.2017;'12 - 13;34,59;45,75;-11,16;2893;1665;-1228;28542;27288;-1254
16933;06.12.2017;'13 - 14;36,48;46,9;-10,42;2456;1411;-1045;28143;26886;-1257
16934;06.12.2017;'14 - 15;39,81;49,04;-9,23;1549;828;-721;27492;26341;-1151
16935;06.12.2017;'15 - 16;39;46,17;-7,17;520;228;-292;26557;25816;-741
16936;06.12.2017;'16 - 17;40,9;47,97;-7,07;25;6;-19;25688;25151;-537
16937;06.12.2017;'17 - 18;45,69;52,74;-7,05;0;0;0;25155;25081;-74
16938;06.12.2017;'18 - 19;41,96;48,73;-6,77;0;0;0;24876;24967;91
16939;06.12.2017;'19 - 20;39,95;45,51;-5,56;0;0;0;24656;24233;-423
16940;06.12.2017;'20 - 21;39,01;42,17;-3,16;0;0;0;24520;24010;-510
16941;06.12.2017;'21 - 22;38,98;39,5;-0,52;0;0;0;24482;24259;-223
16942;06.12.2017;'22 - 23;31,97;37,16;-5,19;0;0;0;24465;23816;-649
16943;06.12.2017;'23 - 24;27,95;32,21;-4,26;0;0;0;24501;24166;-335
16944;07.12.2017;'00 - 01;30,47;32,14;-1,67;0;0;0;24373;24429;56
16945;07.12.2017;'01 - 02;29,43;32,81;-3,38;0;0;0;24498;24478;-20
16946;07.12.2017;'02 - 03;26,57;26,87;-0,3;0;0;0;24549;24456;-93
16947;07.12.2017;'03 - 04;27,36;24,05;3,31;0;0;0;24665;24616;-49
16948;07.12.2017;'04 - 05;30,01;28,22;1,79;0;0;0;24986;25245;259
16949;07.12.2017;'05 - 06;32,07;30,06;2,01;0;0;0;25594;25658;64
16950;07.12.2017;'06 - 07;44,72;41,46;3,26;0;0;0;26325;26614;289
16951;07.12.2017;'07 - 08;51,98;46,46;5,52;2;0;-2;27122;27726;604
16952;07.12.2017;'08 - 09;48,53;43,57;4,96;675;494;-181;27910;28583;673
16953;07.12.2017;'09 - 10;43,85;41,9;1,95;3390;2958;-432;28653;29300;647
16954;07.12.2017;'10 - 11;38,55;35,69;2,86;6551;6119;-432;29235;30311;1076
16955;07.12.2017;'11 - 12;33,1;30,85;2,25;8653;8748;95;29723;30964;1241
16956;07.12.2017;'12 - 13;30,04;27,37;2,67;8955;9650;695;30237;31390;1153
16957;07.12.2017;'13 - 14;31,06;24,97;6,09;7505;8304;799;31015;32210;1195
16958;07.12.2017;'14 - 15;32,06;23,51;8,55;4735;5138;403;32185;32806;621
16959;07.12.2017;'15 - 16;37,23;27,67;9,56;1531;1556;25;33651;34237;586
16960;07.12.2017;'16 - 17;38,53;33,74;4,79;54;27;-27;35040;35512;472
16961;07.12.2017;'17 - 18;39,73;34,22;5,51;0;0;0;36028;37150;1122
16962;07.12.2017;'18 - 19;37,49;33,77;3,72;0;0;0;36555;37872;1317
16963;07.12.2017;'19 - 20;32,07;30,41;1,66;0;0;0;36464;37516;1052
16964;07.12.2017;'20 - 21;28,06;23,68;4,38;0;0;0;35718;36592;874
16965;07.12.2017;'21 - 22;27,5;19,64;7,86;0;0;0;34746;34830;84
16966;07.12.2017;'22 - 23;26,42;17,04;9,38;0;0;0;33612;32563;-1049
16967;07.12.2017;'23 - 24;22,61;17,14;5,47;0;0;0;32189;31675;-514
16968;08.12.2017;'00 - 01;13,45;10,59;2,86;0;0;0;29905;31421;1516
16969;08.12.2017;'01 - 02;12,2;10,63;1,57;0;0;0;28694;30288;1594
16970;08.12.2017;'02 - 03;10,5;10,13;0,37;0;0;0;27613;28780;1167
16971;08.12.2017;'03 - 04;18,93;11,8;7,13;0;0;0;26509;27918;1409
16972;08.12.2017;'04 - 05;24,56;12,79;11,77;0;0;0;25719;27581;1862
16973;08.12.2017;'05 - 06;23,05;11,27;11,78;0;0;0;25011;26868;1857
16974;08.12.2017;'06 - 07;35,88;18,22;17,66;0;0;0;24479;27532;3053
16975;08.12.2017;'07 - 08;37,7;23,41;14,29;1;0;-1;24352;27007;2655
16976;08.12.2017;'08 - 09;46,04;30,27;15,77;303;323;20;24522;26563;2041
16977;08.12.2017;'09 - 10;43,93;32,43;11,5;1695;1881;186;25055;26128;1073
16978;08.12.2017;'10 - 11;37,99;30,75;7,24;3360;3425;65;25969;27243;1274
16979;08.12.2017;'11 - 12;41,51;33,24;8,27;4427;4008;-419;27109;28998;1889
16980;08.12.2017;'12 - 13;34,21;29,36;4,85;4539;4389;-150;27935;28684;749
16981;08.12.2017;'13 - 14;32,1;30,64;1,46;3836;3829;-7;28156;27739;-417
16982;08.12.2017;'14 - 15;32,17;37,44;-5,27;2423;2081;-342;27791;27518;-273
16983;08.12.2017;'15 - 16;37,98;37,81;0,17;748;556;-192;27272;27096;-176
16984;08.12.2017;'16 - 17;41,57;37,93;3,64;28;12;-16;26905;26492;-413
16985;08.12.2017;'17 - 18;40,73;37,46;3,27;0;0;0;26896;27103;207
16986;08.12.2017;'18 - 19;39,96;36,44;3,52;0;0;0;27137;26632;-505
16987;08.12.2017;'19 - 20;38,57;34,86;3,71;0;0;0;27418;26359;-1059
16988;08.12.2017;'20 - 21;32,32;34,14;-1,82;0;0;0;27569;26076;-1493
16989;08.12.2017;'21 - 22;28;32,43;-4,43;0;0;0;27709;25670;-2039
16990;08.12.2017;'22 - 23;23,1;32,21;-9,11;0;0;0;27983;25420;-2563
16991;08.12.2017;'23 - 24;9,29;18,67;-9,38;0;0;0;28338;25964;-2374
16992;09.12.2017;'00 - 01;15,03;14,88;0,15;0;0;0;27805;27171;-634
16993;09.12.2017;'01 - 02;12,51;10,45;2,06;0;0;0;28338;28319;-19
16994;09.12.2017;'02 - 03;10,31;7,29;3,02;0;0;0;28781;28744;-37
16995;09.12.2017;'03 - 04;9,26;2,32;6,94;0;0;0;29130;28874;-256
16996;09.12.2017;'04 - 05;9,12;7,42;1,7;0;0;0;29497;28747;-750
16997;09.12.2017;'05 - 06;8,92;7,74;1,18;0;0;0;29771;28294;-1477
16998;09.12.2017;'06 - 07;10,06;9,16;0,9;0;0;0;29951;29046;-905
16999;09.12.2017;'07 - 08;12,15;16,41;-4,26;0;0;0;29847;30074;227
17000;09.12.2017;'08 - 09;12,41;12,69;-0,28;222;112;-110;29579;30262;683
17001;09.12.2017;'09 - 10;18,07;13,87;4,2;1311;790;-521;29476;31053;1577
17002;09.12.2017;'10 - 11;18,96;16,42;2,54;2679;1648;-1031;29440;30778;1338
17003;09.12.2017;'11 - 12;16,25;19,09;-2,84;3662;2217;-1445;29670;31175;1505
17004;09.12.2017;'12 - 13;15,03;18,58;-3,55;3976;2653;-1323;30087;31052;965
17005;09.12.2017;'13 - 14;12,39;14,42;-2,03;3489;2536;-953;30144;30586;442
17006;09.12.2017;'14 - 15;12,53;14,94;-2,41;2285;1787;-498;29757;30103;346
17007;09.12.2017;'15 - 16;19,41;17,46;1,95;778;592;-186;29158;29215;57
17008;09.12.2017;'16 - 17;26,51;28,82;-2,31;31;9;-22;28934;29048;114
17009;09.12.2017;'17 - 18;31,67;34,6;-2,93;0;0;0;29064;29241;177
17010;09.12.2017;'18 - 19;28,45;30,41;-1,96;0;0;0;29351;29031;-320
17011;09.12.2017;'19 - 20;24,56;29,35;-4,79;0;0;0;29517;29539;22
17012;09.12.2017;'20 - 21;15,8;13,36;2,44;0;0;0;29500;30292;792
17013;09.12.2017;'21 - 22;13,01;7,08;5,93;0;0;0;29246;30327;1081
17014;09.12.2017;'22 - 23;15,04;8,29;6,75;0;0;0;28925;29352;427
17015;09.12.2017;'23 - 24;10,16;6,98;3,18;0;0;0;28500;29662;1162
17016;10.12.2017;'00 - 01;14,31;-1,37;15,68;0;0;0;26683;29503;2820
17017;10.12.2017;'01 - 02;10,92;-2,23;13,15;0;0;0;26250;28904;2654
17018;10.12.2017;'02 - 03;10,17;-4,47;14,64;0;0;0;26060;27857;1797
17019;10.12.2017;'03 - 04;12,09;0,51;11,58;0;0;0;25459;26316;857
17020;10.12.2017;'04 - 05;15,06;4;11,06;0;0;0;24456;25615;1159
17021;10.12.2017;'05 - 06;12,23;3,49;8,74;0;0;0;23172;24265;1093
17022;10.12.2017;'06 - 07;12,28;6,19;6,09;0;0;0;22051;23035;984
17023;10.12.2017;'07 - 08;20,68;14,49;6,19;1;0;-1;21289;21989;700
17024;10.12.2017;'08 - 09;27,85;27,7;0,15;383;444;61;21023;21230;207
17025;10.12.2017;'09 - 10;28,56;29,09;-0,53;1783;1724;-59;21005;20820;-185
17026;10.12.2017;'10 - 11;29,15;28,78;0,37;3039;2472;-567;21218;21124;-94
17027;10.12.2017;'11 - 12;29,57;32,16;-2,59;3505;2219;-1286;21435;21153;-282
17028;10.12.2017;'12 - 13;29,26;33,82;-4,56;3091;1616;-1475;21813;21024;-789
17029;10.12.2017;'13 - 14;28,24;37,58;-9,34;1966;962;-1004;22780;21878;-902
17030;10.12.2017;'14 - 15;25,07;34,28;-9,21;908;401;-507;24768;23906;-862
17031;10.12.2017;'15 - 16;9,12;28,47;-19,35;214;80;-134;27133;26526;-607
17032;10.12.2017;'16 - 17;9,19;27,79;-18,6;8;4;-4;29039;28423;-616
17033;10.12.2017;'17 - 18;17,42;33,51;-16,09;0;0;0;30267;29556;-711
17034;10.12.2017;'18 - 19;15,02;33,07;-18,05;0;0;0;30982;30697;-285
17035;10.12.2017;'19 - 20;12,05;26,96;-14,91;0;0;0;31301;31528;227
17036;10.12.2017;'20 - 21;12,27;21,44;-9,17;0;0;0;31077;31354;277
17037;10.12.2017;'21 - 22;12,16;20,35;-8,19;0;0;0;30735;30650;-85
17038;10.12.2017;'22 - 23;14,81;19,91;-5,1;0;0;0;30197;29141;-1056
17039;10.12.2017;'23 - 24;12,13;17,74;-5,61;0;0;0;29121;28640;-481
17040;11.12.2017;'00 - 01;15,03;22,2;-7,17;0;0;0;27893;27313;-580
17041;11.12.2017;'01 - 02;10,87;21,55;-10,68;0;0;0;26540;25767;-773
17042;11.12.2017;'02 - 03;12,59;20,87;-8,28;0;0;0;24011;22802;-1209
17043;11.12.2017;'03 - 04;11,75;20,81;-9,06;0;0;0;20933;20248;-685
17044;11.12.2017;'04 - 05;12,78;19,79;-7,01;0;0;0;17757;17066;-691
17045;11.12.2017;'05 - 06;23,22;29,67;-6,45;0;0;0;15006;13727;-1279
17046;11.12.2017;'06 - 07;47,95;48,32;-0,37;0;0;0;12152;11205;-947
17047;11.12.2017;'07 - 08;62;60,83;1,17;0;0;0;10037;11001;964
17048;11.12.2017;'08 - 09;63,01;56,73;6,28;145;88;-57;9041;10739;1698
17049;11.12.2017;'09 - 10;60,2;52,13;8,07;829;556;-273;8488;10202;1714
17050;11.12.2017;'10 - 11;62,93;49,21;13,72;1604;1010;-594;8196;10204;2008
17051;11.12.2017;'11 - 12;61,95;50,14;11,81;1990;1106;-884;8145;10689;2544
17052;11.12.2017;'12 - 13;64,98;54,56;10,42;1935;1132;-803;8442;11428;2986
17053;11.12.2017;'13 - 14;58,23;48,53;9,7;1533;925;-608;9024;12599;3575
17054;11.12.2017;'14 - 15;53,84;46,07;7,77;907;628;-279;10181;14636;4455
17055;11.12.2017;'15 - 16;51,91;42,6;9,31;267;218;-49;11886;16143;4257
17056;11.12.2017;'16 - 17;53,38;43,08;10,3;11;6;-5;13914;18386;4472
17057;11.12.2017;'17 - 18;51,87;44,72;7,15;0;0;0;16039;19547;3508
17058;11.12.2017;'18 - 19;47,4;45;2,4;0;0;0;17719;20056;2337
17059;11.12.2017;'19 - 20;39,68;40,05;-0,37;0;0;0;18859;22072;3213
17060;11.12.2017;'20 - 21;40,7;38,78;1,92;0;0;0;19400;23314;3914
17061;11.12.2017;'21 - 22;34,43;29,57;4,86;0;0;0;19681;23345;3664
17062;11.12.2017;'22 - 23;31,95;30,29;1,66;0;0;0;19895;22812;2917
17063;11.12.2017;'23 - 24;27,35;24,1;3,25;0;0;0;20032;23053;3021
17064;12.12.2017;'00 - 01;24,52;16,9;7,62;0;0;0;23340;24068;728
17065;12.12.2017;'01 - 02;22,21;12,2;10,01;0;0;0;23942;24866;924
17066;12.12.2017;'02 - 03;14,58;5,67;8,91;0;0;0;24725;26016;1291
17067;12.12.2017;'03 - 04;12,31;6,74;5,57;0;0;0;25729;26621;892
17068;12.12.2017;'04 - 05;14,2;7,56;6,64;0;0;0;26647;27062;415
17069;12.12.2017;'05 - 06;26,14;21,67;4,47;0;0;0;27503;27916;413
17070;12.12.2017;'06 - 07;30,89;31,56;-0,67;0;0;0;28304;29562;1258
17071;12.12.2017;'07 - 08;32,32;33,37;-1,05;0;0;0;28628;30591;1963
17072;12.12.2017;'08 - 09;35,19;35,6;-0,41;148;134;-14;28434;30085;1651
17073;12.12.2017;'09 - 10;34,7;36,55;-1,85;886;936;50;28129;29760;1631
17074;12.12.2017;'10 - 11;34,75;35,66;-0,91;1800;2000;200;27547;28988;1441
17075;12.12.2017;'11 - 12;35,75;38,6;-2,85;2413;2717;304;26648;28106;1458
17076;12.12.2017;'12 - 13;36,92;38,09;-1,17;2575;3025;450;25517;26186;669
17077;12.12.2017;'13 - 14;39,9;39,84;0,06;2240;2492;252;24120;24063;-57
17078;12.12.2017;'14 - 15;43,16;42,49;0,67;1426;1446;20;22516;22996;480
17079;12.12.2017;'15 - 16;45;42,89;2,11;452;486;34;20784;22950;2166
17080;12.12.2017;'16 - 17;46,09;40,59;5,5;22;14;-8;19375;22639;3264
17081;12.12.2017;'17 - 18;50,95;39,13;11,82;0;0;0;18573;22699;4126
17082;12.12.2017;'18 - 19;46,95;37,01;9,94;0;0;0;17949;22202;4253
17083;12.12.2017;'19 - 20;46,08;35,61;10,47;0;0;0;17543;21012;3469
17084;12.12.2017;'20 - 21;46,1;35,53;10,57;0;0;0;17325;19860;2535
17085;12.12.2017;'21 - 22;40,95;30,48;10,47;0;0;0;17294;18764;1470
17086;12.12.2017;'22 - 23;36,74;29,36;7,38;0;0;0;17569;18157;588
17087;12.12.2017;'23 - 24;27,96;24,68;3,28;0;0;0;17956;19149;1193
17088;13.12.2017;'00 - 01;22,55;28,19;-5,64;0;0;0;22390;19851;-2539
17089;13.12.2017;'01 - 02;20;33,06;-13,06;0;0;0;22951;20238;-2713
17090;13.12.2017;'02 - 03;15,96;29,49;-13,53;0;0;0;23721;20756;-2965
17091;13.12.2017;'03 - 04;12,74;25,3;-12,56;0;0;0;24477;21375;-3102
17092;13.12.2017;'04 - 05;14,2;25,1;-10,9;0;0;0;25313;22381;-2932
17093;13.12.2017;'05 - 06;18,02;28,9;-10,88;0;0;0;26255;23519;-2736
17094;13.12.2017;'06 - 07;32,93;46,28;-13,35;0;0;0;27480;25824;-1656
17095;13.12.2017;'07 - 08;34,19;43,76;-9,57;1;0;-1;29125;27948;-1177
17096;13.12.2017;'08 - 09;38,27;42,7;-4,43;528;578;50;30451;28976;-1475
17097;13.12.2017;'09 - 10;34,45;39,01;-4,56;2751;3255;504;31421;29991;-1430
17098;13.12.2017;'10 - 11;30,97;35,29;-4,32;4976;6246;1270;31897;30402;-1495
17099;13.12.2017;'11 - 12;29,83;31,05;-1,22;6147;8327;2180;32363;31098;-1265
17100;13.12.2017;'12 - 13;29,7;29,28;0,42;5878;8436;2558;32788;32476;-312
17101;13.12.2017;'13 - 14;29,98;27,44;2,54;4455;6343;1888;32860;32661;-199
17102;13.12.2017;'14 - 15;32,44;29,87;2,57;2485;3066;581;32512;32610;98
17103;13.12.2017;'15 - 16;32,91;34,24;-1,33;692;622;-70;32292;32646;354
17104;13.12.2017;'16 - 17;34,49;34,8;-0,31;28;7;-21;32201;33372;1171
17105;13.12.2017;'17 - 18;34,46;37,4;-2,94;0;0;0;32435;33778;1343
17106;13.12.2017;'18 - 19;33,94;35,21;-1,27;0;0;0;32558;34210;1652
17107;13.12.2017;'19 - 20;32,75;32,71;0,04;0;0;0;32686;34636;1950
17108;13.12.2017;'20 - 21;29,1;31,36;-2,26;0;0;0;33043;34374;1331
17109;13.12.2017;'21 - 22;22,62;23,02;-0,4;0;0;0;33347;34784;1437
17110;13.12.2017;'22 - 23;20,05;21,72;-1,67;0;0;0;33306;34279;973
17111;13.12.2017;'23 - 24;8,45;10,8;-2,35;0;0;0;32972;34662;1690
17112;14.12.2017;'00 - 01;8,84;3,26;5,58;0;0;0;33107;34544;1437
17113;14.12.2017;'01 - 02;8,8;4,27;4,53;0;0;0;32648;34306;1658
17114;14.12.2017;'02 - 03;8,84;3,41;5,43;0;0;0;32153;34300;2147
17115;14.12.2017;'03 - 04;9,01;-9,18;18,19;0;0;0;32295;34624;2329
17116;14.12.2017;'04 - 05;10,79;3,4;7,39;0;0;0;32348;33648;1300
17117;14.12.2017;'05 - 06;14,44;15,86;-1,42;0;0;0;32179;32432;253
17118;14.12.2017;'06 - 07;32,63;33,49;-0,86;0;0;0;31991;32063;72
17119;14.12.2017;'07 - 08;45,94;51,22;-5,28;0;0;0;32058;31402;-656
17120;14.12.2017;'08 - 09;42,14;46,95;-4,81;278;185;-93;32389;31247;-1142
17121;14.12.2017;'09 - 10;33,84;43,36;-9,52;1663;1406;-257;32908;31469;-1439
17122;14.12.2017;'10 - 11;32,06;40,67;-8,61;3321;3293;-28;33788;32312;-1476
17123;14.12.2017;'11 - 12;31,82;36,58;-4,76;4325;4457;132;34184;32763;-1421
17124;14.12.2017;'12 - 13;31,54;33,81;-2,27;4304;4884;580;34134;32948;-1186
17125;14.12.2017;'13 - 14;31,46;35,02;-3,56;3407;3909;502;33285;31873;-1412
17126;14.12.2017;'14 - 15;32,53;35,89;-3,36;1989;2222;233;31712;30199;-1513
17127;14.12.2017;'15 - 16;36,43;39,67;-3,24;596;662;66;29927;28419;-1508
17128;14.12.2017;'16 - 17;38,43;43,06;-4,63;26;12;-14;28088;27418;-670
17129;14.12.2017;'17 - 18;49,94;49,02;0,92;0;0;0;26085;26058;-27
17130;14.12.2017;'18 - 19;51,55;50,25;1,3;0;0;0;24179;23573;-606
17131;14.12.2017;'19 - 20;48,06;49,6;-1,54;0;0;0;22327;21696;-631
17132;14.12.2017;'20 - 21;41,9;46,79;-4,89;0;0;0;20567;20284;-283
17133;14.12.2017;'21 - 22;39,31;41,14;-1,83;0;0;0;18820;18120;-700
17134;14.12.2017;'22 - 23;34,94;39,28;-4,34;0;0;0;17366;16598;-768
17135;14.12.2017;'23 - 24;28,96;33,56;-4,6;0;0;0;16091;15012;-1079
17136;15.12.2017;'00 - 01;32,01;35,6;-3,59;0;0;0;14232;13674;-558
17137;15.12.2017;'01 - 02;30,93;37,62;-6,69;0;0;0;13372;12214;-1158
17138;15.12.2017;'02 - 03;29;36,12;-7,12;0;0;0;12911;11368;-1543
17139;15.12.2017;'03 - 04;28,97;34,34;-5,37;0;0;0;12535;10860;-1675
17140;15.12.2017;'04 - 05;29,57;34,97;-5,4;0;0;0;11997;10624;-1373
17141;15.12.2017;'05 - 06;33,17;38,89;-5,72;0;0;0;11322;9808;-1514
17142;15.12.2017;'06 - 07;46,95;48,8;-1,85;0;0;0;10870;9660;-1210
17143;15.12.2017;'07 - 08;57,17;60,95;-3,78;0;0;0;10480;9354;-1126
17144;15.12.2017;'08 - 09;54,31;62,61;-8,3;339;172;-167;10105;9155;-950
17145;15.12.2017;'09 - 10;53,93;67,51;-13,58;1912;1559;-353;9823;8487;-1336
17146;15.12.2017;'10 - 11;52,09;65,09;-13;3724;3488;-236;9592;7981;-1611
17147;15.12.2017;'11 - 12;52,51;63,23;-10,72;4893;4788;-105;9406;7845;-1561
17148;15.12.2017;'12 - 13;48,49;54,36;-5,87;5080;4986;-94;9222;7798;-1424
17149;15.12.2017;'13 - 14;47,92;52,85;-4,93;4240;3724;-516;8840;7312;-1528
17150;15.12.2017;'14 - 15;48,93;56,67;-7,74;2600;2182;-418;8148;6345;-1803
17151;15.12.2017;'15 - 16;52,94;63,33;-10,39;794;730;-64;7595;5556;-2039
17152;15.12.2017;'16 - 17;60,92;66,25;-5,33;31;24;-7;7454;4905;-2549
17153;15.12.2017;'17 - 18;74,54;76,02;-1,48;0;0;0;7753;4591;-3162
17154;15.12.2017;'18 - 19;59,32;71;-11,68;0;0;0;8309;4028;-4281
17155;15.12.2017;'19 - 20;53,91;71,03;-17,12;0;0;0;8937;4038;-4899
17156;15.12.2017;'20 - 21;50,13;65,99;-15,86;0;0;0;9502;4344;-5158
17157;15.12.2017;'21 - 22;42,23;49,8;-7,57;0;0;0;10132;4604;-5528
17158;15.12.2017;'22 - 23;37,04;47,05;-10,01;0;0;0;10731;4973;-5758
17159;15.12.2017;'23 - 24;33,23;40,95;-7,72;0;0;0;11312;4926;-6386
17160;16.12.2017;'00 - 01;35,07;34,96;0,11;0;0;0;6191;5642;-549
17161;16.12.2017;'01 - 02;33,08;32,54;0,54;0;0;0;6769;5837;-932
17162;16.12.2017;'02 - 03;32,96;32,44;0,52;0;0;0;7321;6935;-386
17163;16.12.2017;'03 - 04;31,96;32,12;-0,16;0;0;0;7919;6884;-1035
17164;16.12.2017;'04 - 05;32;33,46;-1,46;0;0;0;8551;7575;-976
17165;16.12.2017;'05 - 06;31,76;34,17;-2,41;0;0;0;9147;8263;-884
17166;16.12.2017;'06 - 07;31,58;33,86;-2,28;0;0;0;9845;9204;-641
17167;16.12.2017;'07 - 08;31,39;35,59;-4,2;0;0;0;10337;9322;-1015
17168;16.12.2017;'08 - 09;34,01;38,06;-4,05;142;134;-8;10727;10014;-713
17169;16.12.2017;'09 - 10;41,56;40,63;0,93;990;1092;102;11279;9774;-1505
17170;16.12.2017;'10 - 11;44,34;41,48;2,86;2192;2467;275;11624;9906;-1718
17171;16.12.2017;'11 - 12;44,03;43,95;0,08;3042;3356;314;11963;9854;-2109
17172;16.12.2017;'12 - 13;41,69;43,61;-1,92;3255;3662;407;12417;10716;-1701
17173;16.12.2017;'13 - 14;38,1;39,19;-1,09;2820;2985;165;12948;11034;-1914
17174;16.12.2017;'14 - 15;36,48;38,94;-2,46;1809;1692;-117;13415;12251;-1164
17175;16.12.2017;'15 - 16;40;43,41;-3,41;563;501;-62;13828;12636;-1192
17176;16.12.2017;'16 - 17;46,17;45,27;0,9;27;15;-12;14230;14050;-180
17177;16.12.2017;'17 - 18;48,93;43,35;5,58;0;0;0;14666;14674;8
17178;16.12.2017;'18 - 19;46,9;42,37;4,53;0;0;0;15104;15708;604
17179;16.12.2017;'19 - 20;42;37,37;4,63;0;0;0;15450;15729;279
17180;16.12.2017;'20 - 21;39;35,18;3,82;0;0;0;15554;15400;-154
17181;16.12.2017;'21 - 22;33,62;31,7;1,92;0;0;0;15498;15754;256
17182;16.12.2017;'22 - 23;33,01;32,54;0,47;0;0;0;15389;15292;-97
17183;16.12.2017;'23 - 24;29,02;29,12;-0,1;0;0;0;15207;15352;145
17184;17.12.2017;'00 - 01;28,9;26,05;2,85;0;0;0;14542;15227;685
17185;17.12.2017;'01 - 02;28,2;21,43;6,77;0;0;0;14175;14993;818
17186;17.12.2017;'02 - 03;28,2;19,48;8,72;0;0;0;13649;14319;670
17187;17.12.2017;'03 - 04;27,94;16,2;11,74;0;0;0;13033;14120;1087
17188;17.12.2017;'04 - 05;28,21;16,85;11,36;0;0;0;12431;13729;1298
17189;17.12.2017;'05 - 06;28,38;13,14;15,24;0;0;0;11705;12746;1041
17190;17.12.2017;'06 - 07;28,58;15,9;12,68;0;0;0;10983;11498;515
17191;17.12.2017;'07 - 08;29,4;21,38;8,02;0;0;0;10186;10192;6
17192;17.12.2017;'08 - 09;31,38;32,29;-0,91;115;60;-55;9265;8932;-333
17193;17.12.2017;'09 - 10;34,78;36,99;-2,21;959;767;-192;8428;7680;-748
17194;17.12.2017;'10 - 11;38,12;41,99;-3,87;2426;1962;-464;7704;6560;-1144
17195;17.12.2017;'11 - 12;43,64;46,25;-2,61;3450;2737;-713;7262;5820;-1442
17196;17.12.2017;'12 - 13;41,57;47,13;-5,56;3725;2912;-813;6945;5424;-1521
17197;17.12.2017;'13 - 14;40,02;43,63;-3,61;3246;2470;-776;6861;5145;-1716
17198;17.12.2017;'14 - 15;39,08;44,84;-5,76;2056;1350;-706;7082;5268;-1814
17199;17.12.2017;'15 - 16;41,5;45,33;-3,83;607;354;-253;7652;5922;-1730
17200;17.12.2017;'16 - 17;45,74;49,73;-3,99;25;8;-17;8781;7406;-1375
17201;17.12.2017;'17 - 18;46,96;52,73;-5,77;0;0;0;10270;9757;-513
17202;17.12.2017;'18 - 19;45,91;50,86;-4,95;0;0;0;11705;11128;-577
17203;17.12.2017;'19 - 20;42,91;47,28;-4,37;0;0;0;13089;11836;-1253
17204;17.12.2017;'20 - 21;36,42;45,75;-9,33;0;0;0;14426;12224;-2202
17205;17.12.2017;'21 - 22;32,92;41,43;-8,51;0;0;0;15798;13012;-2786
17206;17.12.2017;'22 - 23;30,66;40,74;-10,08;0;0;0;17016;13644;-3372
17207;17.12.2017;'23 - 24;28,59;35,62;-7,03;0;0;0;18060;14326;-3734
17208;18.12.2017;'00 - 01;30,43;33,95;-3,52;0;0;0;14905;15045;140
17209;18.12.2017;'01 - 02;29,9;32,69;-2,79;0;0;0;15186;15014;-172
17210;18.12.2017;'02 - 03;28,15;31,93;-3,78;0;0;0;15034;14892;-142
17211;18.12.2017;'03 - 04;27,39;28,42;-1,03;0;0;0;14910;14102;-808
17212;18.12.2017;'04 - 05;28,71;30,79;-2,08;0;0;0;14107;12478;-1629
17213;18.12.2017;'05 - 06;33,73;34,11;-0,38;0;0;0;12402;10420;-1982
17214;18.12.2017;'06 - 07;46,2;50,21;-4,01;0;0;0;11044;8620;-2424
17215;18.12.2017;'07 - 08;63,95;72,22;-8,27;0;0;0;9982;7106;-2876
17216;18.12.2017;'08 - 09;64,42;71,41;-6,99;174;116;-58;9063;6070;-2993
17217;18.12.2017;'09 - 10;64,08;71,66;-7,58;1177;1055;-122;8216;4912;-3304
17218;18.12.2017;'10 - 11;64,28;71,19;-6,91;2380;2465;85;7430;3550;-3880
17219;18.12.2017;'11 - 12;69,65;73,49;-3,84;3143;3472;329;6759;2137;-4622
17220;18.12.2017;'12 - 13;68,23;74,6;-6,37;3286;3616;330;6220;1596;-4624
17221;18.12.2017;'13 - 14;69,97;75,87;-5,9;2770;2974;204;5908;1660;-4248
17222;18.12.2017;'14 - 15;69,49;77,56;-8,07;1695;1783;88;5822;1601;-4221
17223;18.12.2017;'15 - 16;71,32;79,49;-8,17;475;413;-62;5933;1681;-4252
17224;18.12.2017;'16 - 17;73,5;80,69;-7,19;19;3;-16;6095;1828;-4267
17225;18.12.2017;'17 - 18;79,72;87,46;-7,74;0;0;0;6355;2146;-4209
17226;18.12.2017;'18 - 19;75,84;82,29;-6,45;0;0;0;6579;2564;-4015
17227;18.12.2017;'19 - 20;68,87;77,33;-8,46;0;0;0;6727;2740;-3987
17228;18.12.2017;'20 - 21;63,31;69,01;-5,7;0;0;0;6696;3340;-3356
17229;18.12.2017;'21 - 22;56,58;59,11;-2,53;0;0;0;6613;3974;-2639
17230;18.12.2017;'22 - 23;45,03;47,27;-2,24;0;0;0;6586;4280;-2306
17231;18.12.2017;'23 - 24;37,29;37,76;-0,47;0;0;0;6566;4247;-2319
17232;19.12.2017;'00 - 01;44,34;40,3;4,04;0;0;0;4738;3885;-853
17233;19.12.2017;'01 - 02;38,07;38,37;-0,3;0;0;0;4824;3787;-1037
17234;19.12.2017;'02 - 03;37,59;37,45;0,14;0;0;0;4747;3539;-1208
17235;19.12.2017;'03 - 04;36,5;36,71;-0,21;0;0;0;4734;3521;-1213
17236;19.12.2017;'04 - 05;38,89;39,74;-0,85;0;0;0;4661;3775;-886
17237;19.12.2017;'05 - 06;41,01;43,85;-2,84;0;0;0;4554;4040;-514
17238;19.12.2017;'06 - 07;53,67;51,88;1,79;0;0;0;4518;4464;-54
17239;19.12.2017;'07 - 08;68,17;66,88;1,29;0;0;0;4497;4830;333
17240;19.12.2017;'08 - 09;76,91;69,17;7,74;121;69;-52;4450;5258;808
17241;19.12.2017;'09 - 10;77,06;68,93;8,13;721;606;-115;4499;5224;725
17242;19.12.2017;'10 - 11;75,3;66,41;8,89;1524;1322;-202;4422;4888;466
17243;19.12.2017;'11 - 12;74;65,79;8,21;2086;1802;-284;4298;4505;207
17244;19.12.2017;'12 - 13;70,85;67;3,85;2129;2004;-125;4312;4387;75
17245;19.12.2017;'13 - 14;70,57;66,13;4,44;1720;1729;9;4402;4716;314
17246;19.12.2017;'14 - 15;70,2;64,42;5,78;1005;969;-36;4555;4747;192
17247;19.12.2017;'15 - 16;70,32;62,17;8,15;298;286;-12;4752;4558;-194
17248;19.12.2017;'16 - 17;75,82;71,07;4,75;17;6;-11;4842;4420;-422
17249;19.12.2017;'17 - 18;78,28;72,07;6,21;0;0;0;4804;4336;-468
17250;19.12.2017;'18 - 19;75,16;71,27;3,89;0;0;0;4735;4256;-479
17251;19.12.2017;'19 - 20;75,06;72,77;2,29;0;0;0;4727;3901;-826
17252;19.12.2017;'20 - 21;66,29;66,3;-0,01;0;0;0;4650;3558;-1092
17253;19.12.2017;'21 - 22;52,01;54,75;-2,74;0;0;0;4541;3623;-918
17254;19.12.2017;'22 - 23;48,86;50,61;-1,75;0;0;0;4383;3424;-959
17255;19.12.2017;'23 - 24;41,18;43,38;-2,2;0;0;0;4131;2916;-1215
17256;20.12.2017;'00 - 01;44,47;48,42;-3,95;0;0;0;2963;2425;-538
17257;20.12.2017;'01 - 02;40,1;42,37;-2,27;0;0;0;2661;1906;-755
17258;20.12.2017;'02 - 03;37,83;38,73;-0,9;0;0;0;2439;1556;-883
17259;20.12.2017;'03 - 04;37,27;41,33;-4,06;0;0;0;2283;1402;-881
17260;20.12.2017;'04 - 05;40,85;42,14;-1,29;0;0;0;2164;1453;-711
17261;20.12.2017;'05 - 06;45,79;45,76;0,03;0;0;0;1995;1570;-425
17262;20.12.2017;'06 - 07;57,35;51,01;6,34;0;0;0;1811;1589;-222
17263;20.12.2017;'07 - 08;75,98;72,11;3,87;0;0;0;1721;1331;-390
17264;20.12.2017;'08 - 09;76,7;68,92;7,78;89;56;-33;1739;1398;-341
17265;20.12.2017;'09 - 10;76,69;67,15;9,54;571;526;-45;1854;1408;-446
17266;20.12.2017;'10 - 11;76,61;64,5;12,11;1200;1283;83;1976;1572;-404
17267;20.12.2017;'11 - 12;76,56;63,27;13,29;1660;1892;232;2166;1873;-293
17268;20.12.2017;'12 - 13;76,35;61,43;14,92;1809;2005;196;2456;2081;-375
17269;20.12.2017;'13 - 14;76,03;60,5;15,53;1585;1703;118;2793;2593;-200
17270;20.12.2017;'14 - 15;74,89;60,89;14;1008;1041;33;3075;3229;154
17271;20.12.2017;'15 - 16;72,05;60,33;11,72;320;289;-31;3462;3763;301
17272;20.12.2017;'16 - 17;76,06;64,28;11,78;14;4;-10;3944;4332;388
17273;20.12.2017;'17 - 18;79,3;67,4;11,9;0;0;0;4493;4931;438
17274;20.12.2017;'18 - 19;77,26;60,43;16,83;0;0;0;5033;5684;651
17275;20.12.2017;'19 - 20;75,96;57,75;18,21;0;0;0;5612;6197;585
17276;20.12.2017;'20 - 21;64,16;51,79;12,37;0;0;0;6217;6838;621
17277;20.12.2017;'21 - 22;46,03;41,41;4,62;0;0;0;6868;7642;774
17278;20.12.2017;'22 - 23;42,01;42,13;-0,12;0;0;0;7456;8379;923
17279;20.12.2017;'23 - 24;37,63;39,81;-2,18;0;0;0;7955;8845;890
17280;21.12.2017;'00 - 01;33,09;36,02;-2,93;0;0;0;9894;9308;-586
17281;21.12.2017;'01 - 02;35,26;34,91;0,35;0;0;0;10381;10096;-285
17282;21.12.2017;'02 - 03;31,88;31,33;0,55;0;0;0;10610;10918;308
17283;21.12.2017;'03 - 04;33,04;29,76;3,28;0;0;0;10776;10857;81
17284;21.12.2017;'04 - 05;33,6;32,27;1,33;0;0;0;10947;10785;-162
17285;21.12.2017;'05 - 06;35,05;30,64;4,41;0;0;0;11092;11082;-10
17286;21.12.2017;'06 - 07;35,19;31,45;3,74;0;0;0;11117;10945;-172
17287;21.12.2017;'07 - 08;45,94;42,63;3,31;0;0;0;11063;10671;-392
17288;21.12.2017;'08 - 09;49,9;46,23;3,67;52;42;-10;11004;10832;-172
17289;21.12.2017;'09 - 10;50;45,76;4,24;410;409;-1;11018;11075;57
17290;21.12.2017;'10 - 11;51,03;45,59;5,44;938;1037;99;11044;11277;233
17291;21.12.2017;'11 - 12;54,48;44,94;9,54;1313;1644;331;11141;11562;421
17292;21.12.2017;'12 - 13;55,96;43,39;12,57;1402;1842;440;11248;11501;253
17293;21.12.2017;'13 - 14;49,99;42,29;7,7;1184;1406;222;11200;11207;7
17294;21.12.2017;'14 - 15;46,15;40,67;5,48;712;749;37;10899;11047;148
17295;21.12.2017;'15 - 16;46,86;40,53;6,33;201;183;-18;10586;10467;-119
17296;21.12.2017;'16 - 17;51,93;43,42;8,51;9;1;-8;10313;10319;6
17297;21.12.2017;'17 - 18;50,95;45,71;5,24;0;0;0;10094;10737;643
17298;21.12.2017;'18 - 19;51,03;44,76;6,27;0;0;0;10022;10794;772
17299;21.12.2017;'19 - 20;46,02;40,63;5,39;0;0;0;10013;10647;634
17300;21.12.2017;'20 - 21;35,83;37,75;-1,92;0;0;0;10099;10340;241
17301;21.12.2017;'21 - 22;36,26;37,2;-0,94;0;0;0;10321;10301;-20
17302;21.12.2017;'22 - 23;38,72;36,66;2,06;0;0;0;10602;10280;-322
17303;21.12.2017;'23 - 24;34,84;32,72;2,12;0;0;0;10854;10483;-371
17304;22.12.2017;'00 - 01;27,76;28,74;-0,98;0;0;0;10921;10816;-105
17305;22.12.2017;'01 - 02;26,45;25,29;1,16;0;0;0;11132;10335;-797
17306;22.12.2017;'02 - 03;26,2;27,41;-1,21;0;0;0;10958;10030;-928
17307;22.12.2017;'03 - 04;26,36;26,6;-0,24;0;0;0;10504;9855;-649
17308;22.12.2017;'04 - 05;27,59;20,9;6,69;0;0;0;9913;9666;-247
17309;22.12.2017;'05 - 06;31,93;27,29;4,64;0;0;0;9199;9062;-137
17310;22.12.2017;'06 - 07;38,61;35,29;3,32;0;0;0;8482;8120;-362
17311;22.12.2017;'07 - 08;47,52;48,99;-1,47;0;0;0;7944;7482;-462
17312;22.12.2017;'08 - 09;48;49,36;-1,36;73;63;-10;7591;7265;-326
17313;22.12.2017;'09 - 10;50;51,19;-1,19;559;632;73;7546;7240;-306
17314;22.12.2017;'10 - 11;48,99;49,93;-0,94;1286;1392;106;7720;6963;-757
17315;22.12.2017;'11 - 12;46,55;47,32;-0,77;1822;2020;198;8147;7211;-936
17316;22.12.2017;'12 - 13;47,86;44,1;3,76;2004;2232;228;8773;7676;-1097
17317;22.12.2017;'13 - 14;46,96;40,41;6,55;1782;2008;226;9445;7857;-1588
17318;22.12.2017;'14 - 15;39;37,42;1,58;1149;1326;177;9904;8237;-1667
17319;22.12.2017;'15 - 16;39,37;38,29;1,08;339;388;49;10319;8861;-1458
17320;22.12.2017;'16 - 17;46,06;39,57;6,49;14;4;-10;10635;9141;-1494
17321;22.12.2017;'17 - 18;47,34;40,86;6,48;0;0;0;10780;9766;-1014
17322;22.12.2017;'18 - 19;41,5;38,86;2,64;0;0;0;10781;10081;-700
17323;22.12.2017;'19 - 20;40,66;37,46;3,2;0;0;0;10654;10097;-557
17324;22.12.2017;'20 - 21;42,91;37,97;4,94;0;0;0;10528;10641;113
17325;22.12.2017;'21 - 22;42,06;32,42;9,64;0;0;0;10558;11593;1035
17326;22.12.2017;'22 - 23;37,4;30,37;7,03;0;0;0;10871;12730;1859
17327;22.12.2017;'23 - 24;30,62;20,97;9,65;0;0;0;11594;13884;2290
17328;23.12.2017;'00 - 01;26,33;11,71;14,62;0;0;0;14739;14980;241
17329;23.12.2017;'01 - 02;17,72;9,74;7,98;0;0;0;15941;16342;401
17330;23.12.2017;'02 - 03;11,8;6,9;4,9;0;0;0;17300;18333;1033
17331;23.12.2017;'03 - 04;11,3;3,75;7,55;0;0;0;18755;20679;1924
17332;23.12.2017;'04 - 05;12,4;-1,74;14,14;0;0;0;20361;22786;2425
17333;23.12.2017;'05 - 06;8,4;-4,77;13,17;0;0;0;21889;25109;3220
17334;23.12.2017;'06 - 07;9,71;-17,38;27,09;0;0;0;23473;27126;3653
17335;23.12.2017;'07 - 08;10,71;-9,5;20,21;0;0;0;24898;28505;3607
17336;23.12.2017;'08 - 09;14,78;0,73;14,05;78;60;-18;26035;29748;3713
17337;23.12.2017;'09 - 10;18,79;4,21;14,58;513;556;43;27117;31043;3926
17338;23.12.2017;'10 - 11;20,08;6,33;13,75;1134;1167;33;28205;32383;4178
17339;23.12.2017;'11 - 12;14,74;6,19;8,55;1611;1722;111;29222;33766;4544
17340;23.12.2017;'12 - 13;14,77;5,14;9,63;1776;1979;203;30192;34353;4161
17341;23.12.2017;'13 - 14;10,87;2,41;8,46;1565;1654;89;30938;34897;3959
17342;23.12.2017;'14 - 15;5,65;2,78;2,87;1015;986;-29;31375;35383;4008
17343;23.12.2017;'15 - 16;10,04;7,06;2,98;362;320;-42;31699;35813;4114
17344;23.12.2017;'16 - 17;12,91;11,77;1,14;19;6;-13;32033;35957;3924
17345;23.12.2017;'17 - 18;22,01;16,28;5,73;0;0;0;32453;35944;3491
17346;23.12.2017;'18 - 19;18,08;15,41;2,67;0;0;0;32877;36057;3180
17347;23.12.2017;'19 - 20;10,84;8,72;2,12;0;0;0;33216;36555;3339
17348;23.12.2017;'20 - 21;0,4;0,99;-0,59;0;0;0;33357;36598;3241
17349;23.12.2017;'21 - 22;-0,03;1,88;-1,91;0;0;0;33451;36364;2913
17350;23.12.2017;'22 - 23;-0,09;2,84;-2,93;0;0;0;33418;35296;1878
17351;23.12.2017;'23 - 24;-12,12;-2,19;-9,93;0;0;0;33324;34852;1528
17352;24.12.2017;'00 - 01;-40,84;-31,17;-9,67;0;0;0;34106;34185;79
17353;24.12.2017;'01 - 02;-43,18;-44,17;0,99;0;0;0;33731;34233;502
17354;24.12.2017;'02 - 03;-55,99;-56,26;0,27;0;0;0;33393;32836;-557
17355;24.12.2017;'03 - 04;-49,99;-63,37;13,38;0;0;0;32836;32017;-819
17356;24.12.2017;'04 - 05;-40,14;-61,86;21,72;0;0;0;32203;32160;-43
17357;24.12.2017;'05 - 06;-36,05;-53,67;17,62;0;0;0;31566;32360;794
17358;24.12.2017;'06 - 07;-42,93;-53,63;10,7;0;0;0;30960;32266;1306
17359;24.12.2017;'07 - 08;-9,94;-37,91;27,97;0;0;0;30621;32849;2228
17360;24.12.2017;'08 - 09;2,13;-23,7;25,83;90;74;-16;30545;34816;4271
17361;24.12.2017;'09 - 10;5,07;-12,42;17,49;588;555;-33;30614;35461;4847
17362;24.12.2017;'10 - 11;5,03;-6,39;11,42;1261;1336;75;31012;35632;4620
17363;24.12.2017;'11 - 12;6,82;-5,44;12,26;1749;1963;214;31732;36044;4312
17364;24.12.2017;'12 - 13;2,17;-7,05;9,22;1905;2158;253;32391;36101;3710
17365;24.12.2017;'13 - 14;2,93;-7,38;10,31;1689;2006;317;32745;35638;2893
17366;24.12.2017;'14 - 15;0,1;-1,53;1,63;1135;1363;228;32713;35207;2494
17367;24.12.2017;'15 - 16;1,09;1,42;-0,33;428;482;54;32493;34866;2373
17368;24.12.2017;'16 - 17;6,75;3,84;2,91;27;12;-15;32263;34576;2313
17369;24.12.2017;'17 - 18;11,08;8,41;2,67;0;0;0;32114;34159;2045
17370;24.12.2017;'18 - 19;2,85;1,7;1,15;0;0;0;32046;34348;2302
17371;24.12.2017;'19 - 20;1,8;1,62;0,18;0;0;0;31931;34446;2515
17372;24.12.2017;'20 - 21;-4,94;-18,61;13,67;0;0;0;31609;33593;1984
17373;24.12.2017;'21 - 22;-6,74;-28,47;21,73;0;0;0;31081;33542;2461
17374;24.12.2017;'22 - 23;0,08;-24,2;24,28;0;0;0;30424;32766;2342
17375;24.12.2017;'23 - 24;0,06;-22,69;22,75;0;0;0;29706;31931;2225
17376;25.12.2017;'00 - 01;-4,98;-7,31;2,33;0;0;0;29666;30575;909
17377;25.12.2017;'01 - 02;-32,58;-10,19;-22,39;0;0;0;28751;29603;852
17378;25.12.2017;'02 - 03;-19,79;-7,51;-12,28;0;0;0;28197;28385;188
17379;25.12.2017;'03 - 04;-11,9;-4,36;-7,54;0;0;0;27675;27445;-230
17380;25.12.2017;'04 - 05;-4,96;-0,34;-4,62;0;0;0;27208;27132;-76
17381;25.12.2017;'05 - 06;-4,83;-0,25;-4,58;0;0;0;26656;26604;-52
17382;25.12.2017;'06 - 07;-61,41;-24,43;-36,98;0;0;0;26110;26195;85
17383;25.12.2017;'07 - 08;-4,97;4,66;-9,63;0;0;0;25717;26451;734
17384;25.12.2017;'08 - 09;0,07;8,56;-8,49;166;91;-75;25360;26820;1460
17385;25.12.2017;'09 - 10;9,94;16,77;-6,83;1082;707;-375;25072;26339;1267
17386;25.12.2017;'10 - 11;19,9;19,76;0,14;2356;1842;-514;24765;26184;1419
17387;25.12.2017;'11 - 12;22,01;22,65;-0,64;3401;2807;-594;24409;25742;1333
17388;25.12.2017;'12 - 13;18,35;20,19;-1,84;3887;3378;-509;23884;25224;1340
17389;25.12.2017;'13 - 14;15,99;13,02;2,97;3617;3392;-225;23123;24174;1051
17390;25.12.2017;'14 - 15;12,97;11,44;1,53;2590;2554;-36;22139;22899;760
17391;25.12.2017;'15 - 16;17,97;14,5;3,47;1041;969;-72;21112;21926;814
17392;25.12.2017;'16 - 17;17,99;16,09;1,9;52;25;-27;20532;20988;456
17393;25.12.2017;'17 - 18;26,45;25,64;0,81;0;0;0;20524;20680;156
17394;25.12.2017;'18 - 19;27,41;27,08;0,33;0;0;0;20712;21086;374
17395;25.12.2017;'19 - 20;27,59;27,68;-0,09;0;0;0;20911;21240;329
17396;25.12.2017;'20 - 21;25,64;27,11;-1,47;0;0;0;21108;21711;603
17397;25.12.2017;'21 - 22;22,09;24,22;-2,13;0;0;0;21336;22586;1250
17398;25.12.2017;'22 - 23;22,17;23,32;-1,15;0;0;0;21522;22028;506
17399;25.12.2017;'23 - 24;22;21,81;0,19;0;0;0;21748;22730;982
17400;26.12.2017;'00 - 01;5,06;18,36;-13,3;0;0;0;23376;23638;262
17401;26.12.2017;'01 - 02;5,06;9,11;-4,05;0;0;0;24130;24538;408
17402;26.12.2017;'02 - 03;-1,44;5,09;-6,53;0;0;0;25447;25104;-343
17403;26.12.2017;'03 - 04;-6,94;9,17;-16,11;0;0;0;26885;26546;-339
17404;26.12.2017;'04 - 05;-9,65;6,48;-16,13;0;0;0;28501;27623;-878
17405;26.12.2017;'05 - 06;-9,89;7,77;-17,66;0;0;0;30037;28746;-1291
17406;26.12.2017;'06 - 07;-11,88;7,06;-18,94;0;0;0;31525;30768;-757
17407;26.12.2017;'07 - 08;-3,24;11,98;-15,22;0;0;0;33102;32525;-577
17408;26.12.2017;'08 - 09;-9,78;10;-19,78;395;259;-136;34365;33819;-546
17409;26.12.2017;'09 - 10;0;9,37;-9,37;2604;2244;-360;35183;35037;-146
17410;26.12.2017;'10 - 11;-24,33;3,75;-28,08;5086;4822;-264;35769;35084;-685
17411;26.12.2017;'11 - 12;-31,69;0,75;-32,44;6531;6502;-29;36241;34997;-1244
17412;26.12.2017;'12 - 13;-52,82;-3,76;-49,06;6652;7046;394;36453;34807;-1646
17413;26.12.2017;'13 - 14;-53,42;-5,08;-48,34;5561;5734;173;35883;34642;-1241
17414;26.12.2017;'14 - 15;-18;0,24;-18,24;3597;3254;-343;34535;33944;-591
17415;26.12.2017;'15 - 16;-0,48;11,03;-11,51;1222;1033;-189;32804;32749;-55
17416;26.12.2017;'16 - 17;5,49;15,42;-9,93;47;29;-18;31250;32578;1328
17417;26.12.2017;'17 - 18;10,66;15,93;-5,27;0;0;0;30244;31158;914
17418;26.12.2017;'18 - 19;13,35;19,89;-6,54;0;0;0;29310;30155;845
17419;26.12.2017;'19 - 20;11,19;15,96;-4,77;0;0;0;28295;29471;1176
17420;26.12.2017;'20 - 21;19;19,4;-0,4;0;0;0;27013;28084;1071
17421;26.12.2017;'21 - 22;18,06;12,52;5,54;0;0;0;25609;26502;893
17422;26.12.2017;'22 - 23;22,02;16,59;5,43;0;0;0;24137;24117;-20
17423;26.12.2017;'23 - 24;13,46;13,97;-0,51;0;0;0;22648;22802;154
17424;27.12.2017;'00 - 01;25,37;15,57;9,8;0;0;0;20507;21657;1150
17425;27.12.2017;'01 - 02;15,09;2,13;12,96;0;0;0;19395;20750;1355
17426;27.12.2017;'02 - 03;13,93;2,12;11,81;0;0;0;19013;19458;445
17427;27.12.2017;'03 - 04;13,48;9,78;3,7;0;0;0;19161;20008;847
17428;27.12.2017;'04 - 05;12,74;8,3;4,44;0;0;0;19738;21128;1390
17429;27.12.2017;'05 - 06;13,29;2,2;11,09;0;0;0;20577;21838;1261
17430;27.12.2017;'06 - 07;20,03;12,39;7,64;0;0;0;21482;23561;2079
17431;27.12.2017;'07 - 08;28,62;26,04;2,58;0;0;0;22120;24658;2538
17432;27.12.2017;'08 - 09;32;26,44;5,56;225;106;-119;22181;24441;2260
17433;27.12.2017;'09 - 10;34,91;27,69;7,22;1406;1051;-355;21663;23553;1890
17434;27.12.2017;'10 - 11;35,3;34,34;0,96;2767;2526;-241;20358;22301;1943
17435;27.12.2017;'11 - 12;42,46;37,37;5,09;3545;3518;-27;18396;19927;1531
17436;27.12.2017;'12 - 13;46,11;39,97;6,14;3472;4040;568;16254;16605;351
17437;27.12.2017;'13 - 14;46,01;42,05;3,96;2802;3131;329;14330;13561;-769
17438;27.12.2017;'14 - 15;46,4;44,8;1,6;1696;1649;-47;12634;11344;-1290
17439;27.12.2017;'15 - 16;46,48;49,81;-3,33;540;491;-49;11476;10004;-1472
17440;27.12.2017;'16 - 17;50,9;54,9;-4;22;18;-4;10909;9367;-1542
17441;27.12.2017;'17 - 18;56,09;55,1;0,99;0;0;0;10867;9715;-1152
17442;27.12.2017;'18 - 19;57,57;55,15;2,42;0;0;0;10960;10298;-662
17443;27.12.2017;'19 - 20;51,33;47,19;4,14;0;0;0;11143;10782;-361
17444;27.12.2017;'20 - 21;42,4;41,35;1,05;0;0;0;11450;10888;-562
17445;27.12.2017;'21 - 22;40;39,02;0,98;0;0;0;11943;11013;-930
17446;27.12.2017;'22 - 23;42,24;39,21;3,03;0;0;0;12368;11938;-430
17447;27.12.2017;'23 - 24;31,27;28,48;2,79;0;0;0;12863;13199;336
17448;28.12.2017;'00 - 01;28,87;16,99;11,88;0;0;0;9504;14170;4666
17449;28.12.2017;'01 - 02;28,12;11,17;16,95;0;0;0;10185;13695;3510
17450;28.12.2017;'02 - 03;27,2;19,04;8,16;0;0;0;10878;13987;3109
17451;28.12.2017;'03 - 04;26;18,71;7,29;0;0;0;11559;15174;3615
17452;28.12.2017;'04 - 05;26,33;8,53;17,8;0;0;0;12236;15063;2827
17453;28.12.2017;'05 - 06;28,89;12,76;16,13;0;0;0;12819;15662;2843
17454;28.12.2017;'06 - 07;30,74;12,58;18,16;0;0;0;13603;16372;2769
17455;28.12.2017;'07 - 08;35,98;19,26;16,72;0;0;0;14248;17308;3060
17456;28.12.2017;'08 - 09;38,43;27,69;10,74;57;44;-13;14869;18265;3396
17457;28.12.2017;'09 - 10;39,93;30,66;9,27;546;604;58;15564;18926;3362
17458;28.12.2017;'10 - 11;40,12;31,71;8,41;1426;1773;347;16469;19113;2644
17459;28.12.2017;'11 - 12;39,97;31,06;8,91;2185;2922;737;17615;19475;1860
17460;28.12.2017;'12 - 13;40,16;30,61;9,55;2537;3387;850;18794;20331;1537
17461;28.12.2017;'13 - 14;39,24;29,66;9,58;2370;2943;573;19351;21642;2291
17462;28.12.2017;'14 - 15;36,42;26,13;10,29;1654;1827;173;19395;22435;3040
17463;28.12.2017;'15 - 16;40,03;25,03;15;601;632;31;19376;22512;3136
17464;28.12.2017;'16 - 17;42,98;28,52;14,46;32;30;-2;19695;23235;3540
17465;28.12.2017;'17 - 18;43,01;28,58;14,43;0;0;0;20549;24478;3929
17466;28.12.2017;'18 - 19;42,16;27,19;14,97;0;0;0;21582;25859;4277
17467;28.12.2017;'19 - 20;34,93;14,68;20,25;0;0;0;22613;26896;4283
17468;28.12.2017;'20 - 21;25,06;4,92;20,14;0;0;0;23316;27278;3962
17469;28.12.2017;'21 - 22;19,99;1,56;18,43;0;0;0;23735;27824;4089
17470;28.12.2017;'22 - 23;19,22;-1,61;20,83;0;0;0;23915;26994;3079
17471;28.12.2017;'23 - 24;5,86;-3,72;9,58;0;0;0;23990;26810;2820
17472;29.12.2017;'00 - 01;9,73;-4,65;14,38;0;0;0;25105;27090;1985
17473;29.12.2017;'01 - 02;0,72;-4,08;4,8;0;0;0;25063;27523;2460
17474;29.12.2017;'02 - 03;-0,93;-9,26;8,33;0;0;0;25140;27413;2273
17475;29.12.2017;'03 - 04;1,07;-7,2;8,27;0;0;0;25145;26580;1435
17476;29.12.2017;'04 - 05;1;1,03;-0,03;0;0;0;24885;25754;869
17477;29.12.2017;'05 - 06;2,91;7,89;-4,98;0;0;0;24329;24488;159
17478;29.12.2017;'06 - 07;3,6;8,2;-4,6;0;0;0;23718;24285;567
17479;29.12.2017;'07 - 08;15,97;11,78;4,19;0;0;0;23039;24767;1728
17480;29.12.2017;'08 - 09;29,69;19,56;10,13;231;122;-109;22422;24151;1729
17481;29.12.2017;'09 - 10;30,2;20,8;9,4;1892;1422;-470;21941;23148;1207
17482;29.12.2017;'10 - 11;29,83;22,42;7,41;4266;3919;-347;21711;21913;202
17483;29.12.2017;'11 - 12;29,47;24,27;5,2;5993;6210;217;21700;21661;-39
17484;29.12.2017;'12 - 13;29,2;21,95;7,25;6468;7386;918;21438;21684;246
17485;29.12.2017;'13 - 14;29,45;18,75;10,7;5570;6210;640;20729;21719;990
17486;29.12.2017;'14 - 15;30,02;19,59;10,43;3632;3642;10;19847;21802;1955
17487;29.12.2017;'15 - 16;31;21,92;9,08;1306;934;-372;19384;21620;2236
17488;29.12.2017;'16 - 17;32,98;26,98;6;58;9;-49;19881;23178;3297
17489;29.12.2017;'17 - 18;34,95;25,9;9,05;0;0;0;21096;25484;4388
17490;29.12.2017;'18 - 19;32,79;23,71;9,08;0;0;0;22638;26450;3812
17491;29.12.2017;'19 - 20;30,23;23,87;6,36;0;0;0;23678;26377;2699
17492;29.12.2017;'20 - 21;28,49;25,79;2,7;0;0;0;23952;25622;1670
17493;29.12.2017;'21 - 22;26,51;23,92;2,59;0;0;0;23723;25374;1651
17494;29.12.2017;'22 - 23;26,9;20,47;6,43;0;0;0;23138;24630;1492
17495;29.12.2017;'23 - 24;15,06;15,33;-0,27;0;0;0;22445;24578;2133
17496;30.12.2017;'00 - 01;16,4;11,32;5,08;0;0;0;21844;24076;2232
17497;30.12.2017;'01 - 02;13,33;9,8;3,53;0;0;0;21533;24151;2618
17498;30.12.2017;'02 - 03;13,25;9,28;3,97;0;0;0;21457;23988;2531
17499;30.12.2017;'03 - 04;12,04;7,98;4,06;0;0;0;21169;22740;1571
17500;30.12.2017;'04 - 05;11,45;12,99;-1,54;0;0;0;20980;22351;1371
17501;30.12.2017;'05 - 06;8,49;10,28;-1,79;0;0;0;20952;23024;2072
17502;30.12.2017;'06 - 07;9,83;6,29;3,54;0;0;0;20958;24732;3774
17503;30.12.2017;'07 - 08;12,07;4,04;8,03;0;0;0;21173;25275;4102
17504;30.12.2017;'08 - 09;13,41;7,79;5,62;58;65;7;21712;26341;4629
17505;30.12.2017;'09 - 10;16,09;4,95;11,14;418;518;100;22355;27034;4679
17506;30.12.2017;'10 - 11;18,8;0,28;18,52;895;1109;214;23139;27484;4345
17507;30.12.2017;'11 - 12;17,03;3,42;13,61;1161;1532;371;24108;28279;4171
17508;30.12.2017;'12 - 13;17,67;1,21;16,46;1144;1606;462;25059;28896;3837
17509;30.12.2017;'13 - 14;15,51;0,92;14,59;947;1313;366;25922;29928;4006
17510;30.12.2017;'14 - 15;17,61;0,41;17,2;626;929;303;27216;30832;3616
17511;30.12.2017;'15 - 16;13,22;2,13;11,09;220;378;158;29033;32218;3185
17512;30.12.2017;'16 - 17;14,02;5,17;8,85;16;17;1;30460;33924;3464
17513;30.12.2017;'17 - 18;16,78;7,34;9,44;0;0;0;31849;35728;3879
17514;30.12.2017;'18 - 19;16,01;5,11;10,9;0;0;0;33334;37216;3882
17515;30.12.2017;'19 - 20;16,18;2,32;13,86;0;0;0;34124;37901;3777
17516;30.12.2017;'20 - 21;11,13;2,58;8,55;0;0;0;34490;38128;3638
17517;30.12.2017;'21 - 22;4,62;-0,38;5;0;0;0;34545;38086;3541
17518;30.12.2017;'22 - 23;4,71;0,02;4,69;0;0;0;34215;36243;2028
17519;30.12.2017;'23 - 24;-0,27;-0,13;-0,14;0;0;0;33561;34444;883
17520;31.12.2017;'00 - 01;-2,04;2,61;-4,65;0;0;0;33428;32304;-1124
17521;31.12.2017;'01 - 02;-4,99;7,06;-12,05;0;0;0;31523;30419;-1104
17522;31.12.2017;'02 - 03;-0,59;12,64;-13,23;0;0;0;29867;27533;-2334
17523;31.12.2017;'03 - 04;-3,71;10,91;-14,62;0;0;0;27775;23920;-3855
17524;31.12.2017;'04 - 05;0,08;10,75;-10,67;0;0;0;25681;21531;-4150
17525;31.12.2017;'05 - 06;1,16;10,66;-9,5;0;0;0;24343;21962;-2381
17526;31.12.2017;'06 - 07;-0,86;9,84;-10,7;0;0;0;24009;22920;-1089
17527;31.12.2017;'07 - 08;4,09;5,53;-1,44;0;0;0;24489;23844;-645
17528;31.12.2017;'08 - 09;4,17;5,76;-1,59;143;125;-18;25906;25477;-429
17529;31.12.2017;'09 - 10;4,21;6,11;-1,9;877;1190;313;28099;27999;-100
17530;31.12.2017;'10 - 11;9,05;1,92;7,13;1916;2846;930;30346;30902;556
17531;31.12.2017;'11 - 12;9,2;-1,99;11,19;2681;3963;1282;32489;33568;1079
17532;31.12.2017;'12 - 13;4,45;-5,93;10,38;3007;4034;1027;34310;35903;1593
17533;31.12.2017;'13 - 14;2,04;-7,07;9,11;2866;3698;832;35233;36623;1390
17534;31.12.2017;'14 - 15;0,06;-3,93;3,99;2127;2780;653;35334;37017;1683
17535;31.12.2017;'15 - 16;0,36;-5,19;5,55;911;1264;353;34895;36322;1427
17536;31.12.2017;'16 - 17;1,46;-1,34;2,8;66;80;14;34142;35752;1610
17537;31.12.2017;'17 - 18;6,14;8,16;-2,02;0;0;0;33343;34478;1135
17538;31.12.2017;'18 - 19;9,96;11,64;-1,68;0;0;0;32241;32045;-196
17539;31.12.2017;'19 - 20;7,92;20,64;-12,72;0;0;0;31401;30688;-713
17540;31.12.2017;'20 - 21;4,06;10,63;-6,57;0;0;0;30872;29758;-1114
17541;31.12.2017;'21 - 22;5,3;3,86;1,44;0;0;0;30561;29988;-573
17542;31.12.2017;'22 - 23;1,86;5,37;-3,51;0;0;0;30490;30355;-135
17543;31.12.2017;'23 - 24;-0,92;3,65;-4,57;0;0;0;30492;30594;102
