dateTime;day_ahead_price;intraday_price;price_diff;solar_capacity;solar_generation_actual;solar_profile;solar_generation_forecast;solar_forecast_error;wind_capacity;wind_generation_actual;wind_profile;wind_generation_forecast;wind_forecast_error
2016-01-01 00:00:00;23,86;29,34;-5,48;39021;0;0;0;0;44325;8648;0.1951;6033;2615
2016-01-01 01:00:00;22,39;24,28;-1,89;39021;0;0;0;0;44325;8579;0.1936;7421;1158
2016-01-01 02:00:00;20,59;25,26;-4,67;39021;0;0;0;0;44325;8542;0.1928;7266;1276
2016-01-01 03:00:00;16,81;20,24;-3,43;39021;0;0;0;0;44325;8443;0.1905;7180;1263
2016-01-01 04:00:00;17,41;21,94;-4,53;39021;0;0;0;0;44325;8295;0.1871;7016;1279
2016-01-01 05:00:00;17,02;23,5;-6,48;39021;0;0;0;0;44325;7319;0.1651;6787;532
2016-01-01 06:00:00;15,86;21,87;-6,01;39021;0;0;0;0;44325;6574;0.1483;6492;82
2016-01-01 07:00:00;18,16;25,13;-6,97;39021;0;0;0;0;44325;5624;0.1269;6058;-434
2016-01-01 08:00:00;17,73;24,52;-6,79;39021;137;0.0035;137;0;44325;4644;0.1048;5510;-866
2016-01-01 09:00:00;19,77;23,67;-3,9;39021;964;0.0248;1010;-46;44325;3733;0.0842;4924;-1191
2016-01-01 10:00:00;23,75;25,64;-1,89;39021;2522;0.0646;2451;71;44325;2776;0.0626;4172;-1396
2016-01-01 11:00:00;26,03;27,8;-1,77;39021;3768;0.0966;3815;-47;44325;1830;0.0413;3423;-1593
2016-01-01 12:00:00;27,06;29,75;-2,69;39021;4121;0.1056;4382;-261;44325;1287;0.029;2787;-1500
2016-01-01 13:00:00;26,59;28,45;-1,86;39021;3717;0.0952;3986;-269;44325;790;0.0178;2328;-1538
2016-01-01 14:00:00;25,0;26,42;-1,42;39021;2442;0.0626;2658;-216;44325;496;0.0112;1937;-1441
2016-01-01 15:00:00;24,43;28,25;-3,82;39021;841;0.0216;979;-138;44325;405;0.0091;1609;-1204
2016-01-01 16:00:00;28,87;32,49;-3,62;39021;51;0.0013;51;0;44325;665;0.015;1568;-903
2016-01-01 17:00:00;37,44;40,98;-3,54;39021;0;0;0;0;44325;1298;0.0293;1673;-375
2016-01-01 18:00:00;37,41;39,48;-2,07;39021;0;0;0;0;44325;2146;0.0484;1798;348
2016-01-01 19:00:00;35,34;34,34;1,0;39021;0;0;0;0;44325;3371;0.0761;2070;1301
2016-01-01 20:00:00;33,07;31,09;1,98;39021;0;0;0;0;44325;4383;0.0989;2725;1658
2016-01-01 21:00:00;29,52;27,17;2,35;39021;0;0;0;0;44325;5409;0.122;3182;2227
2016-01-01 22:00:00;30,1;27,59;2,51;39021;0;0;0;0;44325;6180;0.1394;3567;2613
2016-01-01 23:00:00;24,57;21,6;2,97;39021;0;0;0;0;44325;6958;0.157;3885;3073
2016-02-01 00:00:00;22,2;14,36;7,84;39022;0;0;0;0;44325;7462;0.1683;6397;1065
2016-02-01 01:00:00;16,57;13,48;3,09;39022;0;0;0;0;44325;8763;0.1977;7411;1352
2016-02-01 02:00:00;15,35;10,16;5,19;39022;0;0;0;0;44325;10716;0.2418;8610;2106
2016-02-01 03:00:00;12,77;7,77;5,0;39022;0;0;0;0;44325;11949;0.2696;9904;2045
2016-02-01 04:00:00;11,27;6,45;4,82;39022;0;0;0;0;44325;13451;0.3034;11359;2092
2016-02-01 05:00:00;11,91;6,38;5,53;39022;0;0;0;0;44325;14640;0.3303;12607;2033
2016-02-01 06:00:00;12,62;3,01;9,61;39022;0;0;0;0;44325;15480;0.3492;13859;1621
2016-02-01 07:00:00;13,83;6,98;6,85;39022;0;0;1;-1;44325;16062;0.3624;15165;897
2016-02-01 08:00:00;16,12;9,37;6,75;39022;106;0.0027;153;-47;44325;16588;0.3742;16305;283
2016-02-01 09:00:00;18,12;11,83;6,29;39022;593;0.0152;940;-347;44325;17324;0.3909;17458;-134
2016-02-01 10:00:00;19,59;18,85;0,74;39022;1341;0.0344;2047;-706;44325;17888;0.4035;18304;-416
2016-02-01 11:00:00;21,07;27,29;-6,22;39022;1866;0.0478;2911;-1045;44325;18265;0.4121;18733;-468
2016-02-01 12:00:00;22,54;29,36;-6,82;39022;2043;0.0524;3094;-1051;44325;18329;0.4135;19105;-776
2016-02-01 13:00:00;19,79;28,6;-8,81;39022;1869;0.0479;2601;-732;44325;18394;0.415;19475;-1081
2016-02-01 14:00:00;16,9;30,22;-13,32;39022;1178;0.0302;1628;-450;44325;18540;0.4182;20000;-1460
2016-02-01 15:00:00;16,97;27,73;-10,76;39022;382;0.0098;563;-181;44325;18754;0.4231;20642;-1888
2016-02-01 16:00:00;19,25;28,75;-9,5;39022;28;0.0007;34;-6;44325;19192;0.433;21140;-1948
2016-02-01 17:00:00;28,01;38,96;-10,95;39022;0;0;0;0;44325;19913;0.4492;21661;-1748
2016-02-01 18:00:00;28,36;41,66;-13,3;39022;0;0;0;0;44325;20215;0.456;22029;-1814
2016-02-01 19:00:00;26,56;38,3;-11,74;39022;0;0;0;0;44325;20108;0.4536;22119;-2011
2016-02-01 20:00:00;17,38;31,65;-14,27;39022;0;0;0;0;44325;19693;0.4443;21881;-2188
2016-02-01 21:00:00;15,83;29,08;-13,25;39022;0;0;0;0;44325;19202;0.4332;21525;-2323
2016-02-01 22:00:00;16,97;32,61;-15,64;39022;0;0;0;0;44325;18460;0.4165;21297;-2837
2016-02-01 23:00:00;15,31;25,18;-9,87;39022;0;0;0;0;44325;18772;0.4235;20946;-2174
2016-03-01 00:00:00;6,99;20,44;-13,45;39022;0;0;0;0;44325;18924;0.427;20522;-1598
2016-03-01 01:00:00;-0,01;15,81;-15,82;39022;0;0;0;0;44325;18596;0.4195;20481;-1885
2016-03-01 02:00:00;0,23;17,87;-17,64;39022;0;0;0;0;44325;18600;0.4196;20434;-1834
2016-03-01 03:00:00;4,51;15,08;-10,57;39022;0;0;0;0;44325;18440;0.416;20265;-1825
2016-03-01 04:00:00;4,12;11,55;-7,43;39022;0;0;0;0;44325;18281;0.4124;20091;-1810
2016-03-01 05:00:00;6,76;14,16;-7,4;39022;0;0;0;0;44325;18302;0.4129;19910;-1608
2016-03-01 06:00:00;0,75;14,69;-13,94;39022;0;0;0;0;44325;18422;0.4156;19785;-1363
2016-03-01 07:00:00;4,27;14,02;-9,75;39022;0;0;1;-1;44325;18190;0.4104;19670;-1480
2016-03-01 08:00:00;9,11;20,93;-11,82;39022;66;0.0017;131;-65;44325;17751;0.4004;19571;-1820
2016-03-01 09:00:00;15,92;25,0;-9,08;39022;638;0.0164;943;-305;44325;17202;0.3881;19505;-2303
2016-03-01 10:00:00;17,06;27,33;-10,27;39022;1648;0.0422;2097;-449;44325;16685;0.3764;19248;-2563
2016-03-01 11:00:00;19,28;29,2;-9,92;39022;2621;0.0672;3095;-474;44325;15632;0.3527;18646;-3014
2016-03-01 12:00:00;20,25;26,54;-6,29;39022;3051;0.0782;3553;-502;44325;14568;0.3286;17990;-3422
2016-03-01 13:00:00;17,66;25,77;-8,11;39022;2909;0.0745;3313;-404;44325;14358;0.3239;17589;-3231
2016-03-01 14:00:00;18,49;24,03;-5,54;39022;1880;0.0482;2332;-452;44325;14313;0.3229;17373;-3060
2016-03-01 15:00:00;16,51;22,31;-5,8;39022;658;0.0168;943;-285;44325;14881;0.3357;17320;-2439
2016-03-01 16:00:00;18,76;26,72;-7,96;39022;48;0.0012;76;-28;44325;15377;0.3469;17567;-2190
2016-03-01 17:00:00;22,21;38,84;-16,63;39022;0;0;3;-3;44325;16306;0.3679;17978;-1672
2016-03-01 18:00:00;26,76;41,61;-14,85;39022;0;0;0;0;44325;17294;0.3902;18445;-1151
2016-03-01 19:00:00;27,08;38,94;-11,86;39022;0;0;0;0;44325;17648;0.3982;18751;-1103
2016-03-01 20:00:00;25,33;38,03;-12,7;39022;0;0;0;0;44325;17745;0.4004;18773;-1028
2016-03-01 21:00:00;22,11;32,32;-10,21;39022;0;0;0;0;44325;17589;0.3968;18734;-1145
2016-03-01 22:00:00;20,91;33,33;-12,42;39022;0;0;0;0;44325;16955;0.3826;18795;-1840
2016-03-01 23:00:00;14,43;30,73;-16,3;39022;0;0;0;0;44325;16746;0.3778;18768;-2022
2016-04-01 00:00:00;13,78;23,63;-9,85;39033;0;0;0;0;44325;16415;0.3704;20345;-3930
2016-04-01 01:00:00;12,77;24,03;-11,26;39033;0;0;0;0;44325;15686;0.3539;20175;-4489
2016-04-01 02:00:00;10,56;22,8;-12,24;39033;0;0;0;0;44325;15040;0.3393;19888;-4848
2016-04-01 03:00:00;3,87;19,33;-15,46;39033;0;0;0;0;44325;14410;0.3251;19409;-4999
2016-04-01 04:00:00;3,2;16,23;-13,03;39033;0;0;0;0;44325;13623;0.3074;18962;-5339
2016-04-01 05:00:00;8,67;24,19;-15,52;39033;0;0;0;0;44325;13175;0.2972;18591;-5416
2016-04-01 06:00:00;18,01;37,74;-19,73;39033;0;0;0;0;44325;13284;0.2997;18237;-4953
2016-04-01 07:00:00;28,52;45,73;-17,21;39033;0;0;1;-1;44325;13091;0.2954;17904;-4813
2016-04-01 08:00:00;34,74;48,78;-14,04;39033;71;0.0018;99;-28;44325;12873;0.2904;17578;-4705
2016-04-01 09:00:00;33,46;47,22;-13,76;39033;533;0.0137;709;-176;44325;12206;0.2754;17147;-4941
2016-04-01 10:00:00;33,24;47,98;-14,74;39033;1350;0.0346;1573;-223;44325;11458;0.2585;16345;-4887
2016-04-01 11:00:00;35,09;48,73;-13,64;39033;1998;0.0512;2235;-237;44325;10580;0.2387;15262;-4682
2016-04-01 12:00:00;35,0;48,48;-13,48;39033;2231;0.0571;2497;-266;44325;10173;0.2295;14273;-4100
2016-04-01 13:00:00;35,0;49,27;-14,27;39033;2005;0.0514;2298;-293;44325;9772;0.2205;13401;-3629
2016-04-01 14:00:00;34,94;50,87;-15,93;39033;1298;0.0332;1571;-273;44325;9753;0.22;12785;-3032
2016-04-01 15:00:00;34,92;50,8;-15,88;39033;536;0.0137;635;-99;44325;10014;0.2259;12244;-2230
2016-04-01 16:00:00;38,0;51,52;-13,52;39033;58;0.0015;55;3;44325;10292;0.2322;11901;-1609
2016-04-01 17:00:00;41,21;58,2;-16,99;39033;0;0;0;0;44325;10920;0.2464;11867;-947
2016-04-01 18:00:00;42,95;56,2;-13,25;39033;0;0;0;0;44325;11096;0.2503;11926;-830
2016-04-01 19:00:00;41,96;53,17;-11,21;39033;0;0;0;0;44325;10861;0.245;11918;-1057
2016-04-01 20:00:00;34,94;44,74;-9,8;39033;0;0;0;0;44325;10690;0.2412;11779;-1089
2016-04-01 21:00:00;30,66;39,72;-9,06;39033;0;0;0;0;44325;10284;0.232;11568;-1284
2016-04-01 22:00:00;30,0;38,23;-8,23;39033;0;0;0;0;44325;9974;0.225;11344;-1370
2016-04-01 23:00:00;23,9;31,15;-7,25;39033;0;0;0;0;44325;9676;0.2183;11096;-1420
2016-05-01 00:00:00;25,03;26,98;-1,95;39035;0;0;0;0;44325;9529;0.215;11547;-2018
2016-05-01 01:00:00;24,42;27,03;-2,61;39035;0;0;0;0;44325;9304;0.2099;11515;-2211
2016-05-01 02:00:00;22,34;25,34;-3,0;39035;0;0;0;0;44325;9205;0.2077;11626;-2421
2016-05-01 03:00:00;21,5;21,79;-0,29;39035;0;0;0;0;44325;9191;0.2073;11630;-2439
2016-05-01 04:00:00;20,0;24,64;-4,64;39035;0;0;0;0;44325;9260;0.2089;11611;-2351
2016-05-01 05:00:00;23,53;28,13;-4,6;39035;0;0;0;0;44325;9387;0.2118;11628;-2241
2016-05-01 06:00:00;28,96;35,45;-6,49;39035;0;0;0;0;44325;9378;0.2116;11726;-2348
2016-05-01 07:00:00;38,32;44,65;-6,33;39035;0;0;2;-2;44325;9323;0.2104;11817;-2494
2016-05-01 08:00:00;41,45;44,25;-2,8;39035;75;0.002;131;-56;44325;9250;0.2087;11868;-2618
2016-05-01 09:00:00;40,72;44,67;-3,95;39035;603;0.0155;856;-253;44325;9086;0.205;11782;-2696
2016-05-01 10:00:00;40,66;45,37;-4,71;39035;1670;0.0428;1875;-205;44325;8797;0.1985;11583;-2786
2016-05-01 11:00:00;40,33;44,41;-4,08;39035;2497;0.064;2700;-203;44325;8369;0.1888;11379;-3010
2016-05-01 12:00:00;38,25;42,57;-4,32;39035;2936;0.0752;2968;-32;44325;8088;0.1824;11231;-3143
2016-05-01 13:00:00;36,98;39,63;-2,65;39035;2423;0.0621;2646;-223;44325;7892;0.1781;11158;-3266
2016-05-01 14:00:00;34,91;38,64;-3,73;39035;1610;0.0412;1813;-203;44325;7972;0.1798;11233;-3261
2016-05-01 15:00:00;33,5;41,92;-8,42;39035;673;0.0172;741;-68;44325;8052;0.1817;11433;-3381
2016-05-01 16:00:00;35,1;50,09;-14,99;39035;62;0.0016;68;-6;44325;8112;0.183;11507;-3395
2016-05-01 17:00:00;42,44;58,72;-16,28;39035;0;0;2;-2;44325;8368;0.1888;11530;-3162
2016-05-01 18:00:00;42,94;58,14;-15,2;39035;0;0;0;0;44325;8622;0.1945;11492;-2870
2016-05-01 19:00:00;41,74;54,55;-12,81;39035;0;0;0;0;44325;8527;0.1924;11468;-2941
2016-05-01 20:00:00;36,47;46,6;-10,13;39035;0;0;0;0;44325;8410;0.1897;11493;-3083
2016-05-01 21:00:00;33,01;40,38;-7,37;39035;0;0;0;0;44325;8185;0.1846;11499;-3314
2016-05-01 22:00:00;31,75;37,22;-5,47;39035;0;0;0;0;44325;7999;0.1804;11404;-3405
2016-05-01 23:00:00;26,99;35,91;-8,92;39035;0;0;0;0;44325;7968;0.1798;11204;-3236
2016-06-01 00:00:00;26,62;29,21;-2,59;39036;0;0;0;0;44335;7723;0.1742;9587;-1864
2016-06-01 01:00:00;25,58;28,77;-3,19;39036;0;0;0;0;44335;7566;0.1706;9330;-1764
2016-06-01 02:00:00;24,59;27,85;-3,26;39036;0;0;0;0;44335;7264;0.1638;9098;-1834
2016-06-01 03:00:00;22,5;24,37;-1,87;39036;0;0;0;0;44335;7212;0.1627;8900;-1688
2016-06-01 04:00:00;23,16;25,65;-2,49;39036;0;0;0;0;44335;7163;0.1616;8828;-1665
2016-06-01 05:00:00;24,99;29,5;-4,51;39036;0;0;0;0;44335;7366;0.1661;8815;-1449
2016-06-01 06:00:00;26,62;31,85;-5,23;39036;0;0;0;0;44335;7206;0.1626;8877;-1671
2016-06-01 07:00:00;28,03;34,36;-6,33;39036;0;0;2;-2;44335;7265;0.1639;8859;-1594
2016-06-01 08:00:00;29,34;32,95;-3,61;39036;127;0.0032;151;-24;44335;7169;0.1617;8777;-1608
2016-06-01 09:00:00;32,94;37,14;-4,2;39036;770;0.0197;974;-204;44335;6806;0.1535;8656;-1850
2016-06-01 10:00:00;37,71;41,12;-3,41;39036;1818;0.0466;2129;-311;44335;6636;0.1497;8410;-1774
2016-06-01 11:00:00;40,08;43,43;-3,35;39036;2721;0.0697;3128;-407;44335;6272;0.1415;8082;-1810
2016-06-01 12:00:00;40,73;44,42;-3,69;39036;2820;0.0722;3436;-616;44335;5672;0.1279;7613;-1941
2016-06-01 13:00:00;38,26;44,28;-6,02;39036;2326;0.0596;3040;-714;44335;5346;0.1206;7188;-1842
2016-06-01 14:00:00;35,44;42,68;-7,24;39036;1463;0.0375;2033;-570;44335;5177;0.1168;6949;-1772
2016-06-01 15:00:00;36,92;45,32;-8,4;39036;510;0.013;809;-299;44335;5347;0.1206;6920;-1573
2016-06-01 16:00:00;41,28;46,84;-5,56;39036;40;0.001;73;-33;44335;5586;0.126;7007;-1421
2016-06-01 17:00:00;44,95;50,51;-5,56;39036;0;0;2;-2;44335;6018;0.1357;7098;-1080
2016-06-01 18:00:00;46,9;53,42;-6,52;39036;0;0;0;0;44335;6242;0.1408;7186;-944
2016-06-01 19:00:00;43,95;48,17;-4,22;39036;0;0;0;0;44335;6465;0.1458;7194;-729
2016-06-01 20:00:00;39,94;41,03;-1,09;39036;0;0;0;0;44335;6603;0.1489;7143;-540
2016-06-01 21:00:00;32,4;35,65;-3,25;39036;0;0;0;0;44335;6434;0.1451;7111;-677
2016-06-01 22:00:00;33,51;36,94;-3,43;39036;0;0;0;0;44335;6437;0.1452;7267;-830
2016-06-01 23:00:00;30,11;33,11;-3,0;39036;0;0;0;0;44335;6372;0.1437;7524;-1152
2016-07-01 00:00:00;26,41;24,69;1,72;39039;0;0;0;0;44335;6420;0.1448;7849;-1429
2016-07-01 01:00:00;26,05;24,47;1,58;39039;0;0;0;0;44335;6509;0.1468;8036;-1527
2016-07-01 02:00:00;24,93;25,31;-0,38;39039;0;0;0;0;44335;6713;0.1514;8486;-1773
2016-07-01 03:00:00;22,39;21,5;0,89;39039;0;0;0;0;44335;6943;0.1566;8978;-2035
2016-07-01 04:00:00;22,32;22,26;0,06;39039;0;0;0;0;44335;7062;0.1593;9486;-2424
2016-07-01 05:00:00;24,2;24,18;0,02;39039;0;0;0;0;44335;7098;0.1601;10102;-3004
2016-07-01 06:00:00;31,0;29,87;1,13;39039;0;0;0;0;44335;7575;0.1708;10803;-3228
2016-07-01 07:00:00;42,47;39,51;2,96;39039;0;0;2;-2;44335;8400;0.1895;11481;-3081
2016-07-01 08:00:00;42,97;41,1;1,87;39039;150;0.0038;168;-18;44335;9167;0.2068;12432;-3265
2016-07-01 09:00:00;41,93;35,86;6,07;39039;1205;0.0309;1031;174;44335;10482;0.2364;13396;-2914
2016-07-01 10:00:00;41,62;31,72;9,9;39039;2839;0.0727;2033;806;44335;11005;0.2482;14229;-3224
2016-07-01 11:00:00;41,5;31,65;9,85;39039;3898;0.0998;2687;1211;44335;10906;0.246;14959;-4053
2016-07-01 12:00:00;40,66;31,54;9,12;39039;3342;0.0856;2630;712;44335;10983;0.2477;15707;-4724
2016-07-01 13:00:00;40,33;33,17;7,16;39039;1982;0.0508;2057;-75;44335;11398;0.2571;16548;-5150
2016-07-01 14:00:00;36,51;36,45;0,06;39039;914;0.0234;1241;-327;44335;12438;0.2806;17534;-5096
2016-07-01 15:00:00;33,49;35,56;-2,07;39039;282;0.0072;480;-198;44335;13858;0.3126;18413;-4555
2016-07-01 16:00:00;34,19;34,5;-0,31;39039;26;0.0006;39;-13;44335;15102;0.3406;18852;-3750
2016-07-01 17:00:00;40,66;35,69;4,97;39039;0;0;0;0;44335;16114;0.3635;18830;-2716
2016-07-01 18:00:00;40,8;38,01;2,79;39039;0;0;0;0;44335;17594;0.3968;19081;-1487
2016-07-01 19:00:00;37,19;35,47;1,72;39039;0;0;0;0;44335;18522;0.4178;18928;-406
2016-07-01 20:00:00;31,94;31,06;0,88;39039;0;0;0;0;44335;19609;0.4423;18391;1218
2016-07-01 21:00:00;27,01;26,68;0,33;39039;0;0;0;0;44335;20734;0.4676;18346;2388
2016-07-01 22:00:00;27,52;24,14;3,38;39039;0;0;0;0;44335;21372;0.4821;18499;2873
2016-07-01 23:00:00;23,4;18,59;4,81;39039;0;0;0;0;44335;21563;0.4864;18665;2898
2016-08-01 00:00:00;12,12;26,13;-14,01;39041;0;0;0;0;44338;22456;0.5065;22592;-136
2016-08-01 01:00:00;17,23;23,63;-6,4;39041;0;0;0;0;44338;22810;0.5144;23248;-438
2016-08-01 02:00:00;13,9;20,41;-6,51;39041;0;0;0;0;44338;22868;0.5157;23343;-475
2016-08-01 03:00:00;12,11;20,57;-8,46;39041;0;0;0;0;44338;23458;0.529;24123;-665
2016-08-01 04:00:00;12,99;15,22;-2,23;39041;0;0;0;0;44338;23700;0.5346;24963;-1263
2016-08-01 05:00:00;16,98;11,67;5,31;39041;0;0;0;0;44338;24682;0.5566;25376;-694
2016-08-01 06:00:00;22,02;20,22;1,8;39041;0;0;0;0;44338;25880;0.5837;25487;393
2016-08-01 07:00:00;28,4;25,32;3,08;39041;0;0;4;-4;44338;26073;0.588;25309;764
2016-08-01 08:00:00;29,31;27,81;1,5;39041;339;0.0087;352;-13;44338;26408;0.5956;24975;1433
2016-08-01 09:00:00;26,6;26,82;-0,22;39041;2815;0.0721;2624;191;44338;26070;0.588;24599;1471
2016-08-01 10:00:00;25,55;22,08;3,47;39041;6242;0.1599;5446;796;44338;25515;0.5755;24073;1442
2016-08-01 11:00:00;25,76;21,25;4,51;39041;8735;0.2238;7704;1031;44338;25106;0.5662;22965;2141
2016-08-01 12:00:00;25,13;16,92;8,21;39041;9116;0.2335;8423;693;44338;23671;0.5339;21369;2302
2016-08-01 13:00:00;25,58;19,95;5,63;39041;7362;0.1886;7515;-153;44338;21322;0.4809;19785;1537
2016-08-01 14:00:00;27,6;25,96;1,64;39041;4492;0.1151;5208;-716;44338;18643;0.4205;18190;453
2016-08-01 15:00:00;32,08;31,97;0,11;39041;1750;0.0448;2086;-336;44338;16149;0.3642;16772;-623
2016-08-01 16:00:00;37,16;42,61;-5,45;39041;118;0.003;116;2;44338;15412;0.3476;15764;-352
2016-08-01 17:00:00;45,0;48,1;-3,1;39041;0;0;0;0;44338;14731;0.3322;15302;-571
2016-08-01 18:00:00;46,97;48,32;-1,35;39041;0;0;0;0;44338;13577;0.3062;14870;-1293
2016-08-01 19:00:00;40,09;42,89;-2,8;39041;0;0;0;0;44338;12775;0.2881;14476;-1701
2016-08-01 20:00:00;34,61;38,08;-3,47;39041;0;0;0;0;44338;11888;0.2681;13587;-1699
2016-08-01 21:00:00;31,52;32,84;-1,32;39041;0;0;0;0;44338;11230;0.2533;12433;-1203
2016-08-01 22:00:00;32,5;32,07;0,43;39041;0;0;0;0;44338;10311;0.2326;11183;-872
2016-08-01 23:00:00;26,01;31,45;-5,44;39041;0;0;0;0;44338;9782;0.2206;9976;-194
2016-09-01 00:00:00;26,1;27,17;-1,07;39041;0;0;0;0;44338;8815;0.1988;7203;1612
2016-09-01 01:00:00;25,1;25,45;-0,35;39041;0;0;0;0;44338;8121;0.1831;6367;1754
2016-09-01 02:00:00;24,3;26,08;-1,78;39041;0;0;0;0;44338;7671;0.173;5681;1990
2016-09-01 03:00:00;23,23;23,93;-0,7;39041;0;0;0;0;44338;7198;0.1623;5192;2006
2016-09-01 04:00:00;21,96;23,12;-1,16;39041;0;0;0;0;44338;7355;0.1659;5058;2297
2016-09-01 05:00:00;22,45;22,48;-0,03;39041;0;0;0;0;44338;7094;0.16;5105;1989
2016-09-01 06:00:00;23,07;24,06;-0,99;39041;0;0;0;0;44338;7464;0.1683;5296;2168
2016-09-01 07:00:00;25,0;24,67;0,33;39041;0;0;2;-2;44338;7537;0.17;5614;1923
2016-09-01 08:00:00;32,11;27,98;4,13;39041;196;0.005;113;83;44338;7807;0.1761;5944;1863
2016-09-01 09:00:00;37,12;28,57;8,55;39041;1554;0.0398;816;738;44338;7990;0.1802;6104;1886
2016-09-01 10:00:00;36,13;28,12;8,01;39041;3446;0.0882;2240;1206;44338;7728;0.1743;5984;1744
2016-09-01 11:00:00;35,76;25,53;10,23;39041;5002;0.1281;3656;1346;44338;6464;0.1458;5572;892
2016-09-01 12:00:00;34,06;26,81;7,25;39041;5171;0.1324;4087;1084;44338;5640;0.1272;5206;434
2016-09-01 13:00:00;31,54;28,12;3,42;39041;4453;0.114;3640;813;44338;5292;0.1194;5234;58
2016-09-01 14:00:00;27,92;27,26;0,66;39041;2900;0.0743;2461;439;44338;5173;0.1167;5657;-484
2016-09-01 15:00:00;27,0;29,17;-2,17;39041;1078;0.0276;990;88;44338;6124;0.1382;6322;-198
2016-09-01 16:00:00;30,5;32,26;-1,76;39041;91;0.0024;65;26;44338;7979;0.18;7202;777
2016-09-01 17:00:00;36,99;36,33;0,66;39041;0;0;0;0;44338;9648;0.2176;8085;1563
2016-09-01 18:00:00;36,8;33,83;2,97;39041;0;0;0;0;44338;10718;0.2418;8823;1895
2016-09-01 19:00:00;35,0;29,3;5,7;39041;0;0;0;0;44338;11450;0.2582;9277;2173
2016-09-01 20:00:00;29,0;27,98;1,02;39041;0;0;0;0;44338;11629;0.2623;9569;2060
2016-09-01 21:00:00;25,01;26,09;-1,08;39041;0;0;0;0;44338;11666;0.2631;9980;1686
2016-09-01 22:00:00;25,1;25,55;-0,45;39041;0;0;0;0;44338;12193;0.275;10436;1757
2016-09-01 23:00:00;22,28;24,09;-1,81;39041;0;0;0;0;44338;12602;0.2842;10860;1742
2016-10-01 00:00:00;15,58;17,03;-1,45;39041;0;0;0;0;44338;13086;0.2952;11711;1375
2016-10-01 01:00:00;19,05;15,65;3,4;39041;0;0;0;0;44338;13590;0.3065;12260;1330
2016-10-01 02:00:00;16,87;11,05;5,82;39041;0;0;0;0;44338;14377;0.3243;12807;1570
2016-10-01 03:00:00;12,75;9,83;2,92;39041;0;0;0;0;44338;15121;0.341;13318;1803
2016-10-01 04:00:00;10,81;9,25;1,56;39041;0;0;0;0;44338;15188;0.3426;13770;1418
2016-10-01 05:00:00;10,85;8,9;1,95;39041;0;0;0;0;44338;15749;0.3552;14421;1328
2016-10-01 06:00:00;9,85;8,4;1,45;39041;0;0;0;0;44338;16646;0.3754;14889;1757
2016-10-01 07:00:00;11,92;9,52;2,4;39041;0;0;3;-3;44338;17234;0.3887;15332;1902
2016-10-01 08:00:00;15,44;12,5;2,94;39041;178;0.0046;165;13;44338;17175;0.3873;15903;1272
2016-10-01 09:00:00;18,99;18,72;0,27;39041;1196;0.0306;1160;36;44338;16838;0.3798;16020;818
2016-10-01 10:00:00;19,66;24,59;-4,93;39041;2311;0.0592;2698;-387;44338;16607;0.3746;15944;663
2016-10-01 11:00:00;21,59;25,55;-3,96;39041;3154;0.0808;4058;-904;44338;16256;0.3666;15332;924
2016-10-01 12:00:00;21,83;26,89;-5,06;39041;3805;0.0975;4500;-695;44338;15297;0.345;14519;778
2016-10-01 13:00:00;20,82;24,38;-3,56;39041;3940;0.1009;4172;-232;44338;14348;0.3236;13475;873
2016-10-01 14:00:00;20,06;21,91;-1,85;39041;3009;0.0771;3052;-43;44338;13428;0.3029;12144;1284
2016-10-01 15:00:00;21,45;22,51;-1,06;39041;1226;0.0314;1312;-86;44338;12548;0.283;11175;1373
2016-10-01 16:00:00;23,92;25,23;-1,31;39041;81;0.002;107;-26;44338;12871;0.2903;10559;2312
2016-10-01 17:00:00;27,93;29,3;-1,37;39041;0;0;0;0;44338;13438;0.3031;10357;3081
2016-10-01 18:00:00;35,0;33,15;1,85;39041;0;0;0;0;44338;13767;0.3105;10385;3382
2016-10-01 19:00:00;33,0;30,23;2,77;39041;0;0;0;0;44338;14325;0.3231;10442;3883
2016-10-01 20:00:00;30,03;21,52;8,51;39041;0;0;0;0;44338;13727;0.3096;10488;3239
2016-10-01 21:00:00;26,06;15,76;10,3;39041;0;0;0;0;44338;12371;0.279;10415;1956
2016-10-01 22:00:00;26,93;22,11;4,82;39041;0;0;0;0;44338;11575;0.261;10359;1216
2016-10-01 23:00:00;23,12;23,09;0,03;39041;0;0;0;0;44338;11273;0.2542;9972;1301
2016-11-01 00:00:00;21,95;20,21;1,74;39043;0;0;0;0;44340;10728;0.242;9992;736
2016-11-01 01:00:00;20,04;17,1;2,94;39043;0;0;0;0;44340;10013;0.2258;9365;648
2016-11-01 02:00:00;19,78;13,49;6,29;39043;0;0;0;0;44340;9387;0.2117;8830;557
2016-11-01 03:00:00;19,36;14,12;5,24;39043;0;0;0;0;44340;8030;0.1811;8231;-201
2016-11-01 04:00:00;19,56;14,73;4,83;39043;0;0;0;0;44340;7316;0.165;7503;-187
2016-11-01 05:00:00;21,67;17,47;4,2;39043;0;0;0;0;44340;6474;0.146;6780;-306
2016-11-01 06:00:00;28,5;24,77;3,73;39043;0;0;0;0;44340;6188;0.1396;6207;-19
2016-11-01 07:00:00;41,61;32,35;9,26;39043;0;0;2;-2;44340;6382;0.1439;5956;426
2016-11-01 08:00:00;45,93;39,84;6,09;39043;90;0.0023;142;-52;44340;6817;0.1538;5895;922
2016-11-01 09:00:00;44,0;35,26;8,74;39043;544;0.014;900;-356;44340;7204;0.1625;5751;1453
2016-11-01 10:00:00;41,94;31,6;10,34;39043;1343;0.0344;1919;-576;44340;7137;0.161;5649;1488
2016-11-01 11:00:00;41,96;32,03;9,93;39043;1989;0.0509;2666;-677;44340;6793;0.1532;5451;1342
2016-11-01 12:00:00;42,33;32,7;9,63;39043;2238;0.0573;2815;-577;44340;6240;0.1407;5300;940
2016-11-01 13:00:00;42,1;30,57;11,53;39043;1994;0.0511;2412;-418;44340;6038;0.1362;5409;629
2016-11-01 14:00:00;39,88;31,71;8,17;39043;1296;0.0332;1717;-421;44340;6398;0.1443;5800;598
2016-11-01 15:00:00;37,5;32,82;4,68;39043;595;0.0152;801;-206;44340;7476;0.1686;6281;1195
2016-11-01 16:00:00;37,95;31,11;6,84;39043;88;0.0022;78;10;44340;8467;0.191;6890;1577
2016-11-01 17:00:00;44,69;32,82;11,87;39043;1;0;0;1;44340;9729;0.2194;7657;2072
2016-11-01 18:00:00;42,88;33,12;9,76;39043;0;0;0;0;44340;10479;0.2363;8491;1988
2016-11-01 19:00:00;40,0;29,2;10,8;39043;0;0;0;0;44340;10726;0.2419;8953;1773
2016-11-01 20:00:00;33,09;25,99;7,1;39043;0;0;0;0;44340;10824;0.2441;8913;1911
2016-11-01 21:00:00;27,93;22,54;5,39;39043;0;0;0;0;44340;10748;0.2424;8833;1915
2016-11-01 22:00:00;28,0;24,24;3,76;39043;0;0;0;0;44340;10604;0.2392;8602;2002
2016-11-01 23:00:00;24,14;16,89;7,25;39043;0;0;0;0;44340;10300;0.2322;8375;1925
2016-12-01 00:00:00;21,51;16,19;5,32;39045;0;0;0;0;44346;10106;0.2279;9183;923
2016-12-01 01:00:00;19,81;14,43;5,38;39045;0;0;0;0;44346;9849;0.2221;9041;808
2016-12-01 02:00:00;19,1;13,1;6,0;39045;0;0;0;0;44346;9681;0.2183;8910;771
2016-12-01 03:00:00;15,74;10,96;4,78;39045;0;0;0;0;44346;9863;0.2224;8789;1074
2016-12-01 04:00:00;15,54;11,53;4,01;39045;0;0;0;0;44346;10305;0.2324;8598;1707
2016-12-01 05:00:00;20,19;13,52;6,67;39045;0;0;0;0;44346;10822;0.244;8643;2179
2016-12-01 06:00:00;24,38;20,03;4,35;39045;0;0;0;0;44346;11436;0.2579;8973;2463
2016-12-01 07:00:00;35,92;31,89;4,03;39045;1;0;3;-2;44346;11621;0.262;9240;2381
2016-12-01 08:00:00;40,5;33,86;6,64;39045;131;0.0034;156;-25;44346;11797;0.266;9335;2462
2016-12-01 09:00:00;41,0;35,25;5,75;39045;791;0.0202;902;-111;44346;12120;0.2733;9470;2650
2016-12-01 10:00:00;38,66;31,37;7,29;39045;1756;0.045;1868;-112;44346;12748;0.2874;9664;3084
2016-12-01 11:00:00;36,46;30,1;6,36;39045;2538;0.065;2657;-119;44346;12975;0.2926;9898;3077
2016-12-01 12:00:00;35,0;31,06;3,94;39045;3142;0.0805;2921;221;44346;13248;0.2987;10150;3098
2016-12-01 13:00:00;33,3;29,13;4,17;39045;3137;0.0804;2754;383;44346;13553;0.3056;10134;3419
2016-12-01 14:00:00;32,21;28,93;3,28;39045;2428;0.0622;2070;358;44346;13435;0.303;9851;3584
2016-12-01 15:00:00;33,0;27,99;5,01;39045;1092;0.028;973;119;44346;12850;0.2898;9535;3315
2016-12-01 16:00:00;36,08;31,12;4,96;39045;116;0.003;111;5;44346;13023;0.2936;9628;3395
2016-12-01 17:00:00;41,94;37,08;4,86;39045;2;0;0;2;44346;13584;0.3063;10253;3331
2016-12-01 18:00:00;40,33;39,04;1,29;39045;0;0;0;0;44346;13919;0.3138;10805;3114
2016-12-01 19:00:00;29,69;32,73;-3,04;39045;0;0;0;0;44346;14524;0.3275;11107;3417
2016-12-01 20:00:00;26,05;26,3;-0,25;39045;0;0;0;0;44346;15350;0.3461;11596;3754
2016-12-01 21:00:00;24,76;27,3;-2,54;39045;0;0;0;0;44346;15537;0.3504;11932;3605
2016-12-01 22:00:00;24,03;29,03;-5,0;39045;0;0;0;0;44346;15507;0.3497;12229;3278
2016-12-01 23:00:00;21,51;24,68;-3,17;39045;0;0;0;0;44346;15597;0.3517;12508;3089
2016-01-13 00:00:00;21,0;26,41;-5,41;39047;0;0;0;0;44353;15809;0.3565;14174;1635
2016-01-13 01:00:00;19,66;22,51;-2,85;39047;0;0;0;0;44353;16090;0.3628;14015;2075
2016-01-13 02:00:00;18,13;19,18;-1,05;39047;0;0;0;0;44353;16516;0.3724;14082;2434
2016-01-13 03:00:00;15,3;14,59;0,71;39047;0;0;0;0;44353;17244;0.3888;14110;3134
2016-01-13 04:00:00;18,05;16,91;1,14;39047;0;0;0;0;44353;17520;0.395;14317;3203
2016-01-13 05:00:00;20,83;18,84;1,99;39047;0;0;0;0;44353;18230;0.411;14769;3461
2016-01-13 06:00:00;24,1;28,93;-4,83;39047;0;0;0;0;44353;19194;0.4328;15140;4054
2016-01-13 07:00:00;27,87;26,04;1,83;39047;0;0;2;-2;44353;19309;0.4354;15148;4161
2016-01-13 08:00:00;29,98;32,03;-2,05;39047;118;0.003;109;9;44353;18275;0.412;14830;3445
2016-01-13 09:00:00;30,73;33,49;-2,76;39047;642;0.0164;622;20;44353;17223;0.3883;14393;2830
2016-01-13 10:00:00;31,45;32,34;-0,89;39047;1551;0.0397;1437;114;44353;16594;0.3742;13869;2725
2016-01-13 11:00:00;33,56;32,15;1,41;39047;2258;0.0578;2176;82;44353;15837;0.3571;13598;2239
2016-01-13 12:00:00;33,99;32,16;1,83;39047;2580;0.0661;2545;35;44353;15398;0.3472;13226;2172
2016-01-13 13:00:00;34,09;33,48;0,61;39047;2376;0.0608;2448;-72;44353;14673;0.3308;12600;2073
2016-01-13 14:00:00;34,02;34,14;-0,12;39047;1778;0.0455;1800;-22;44353;13976;0.3151;11802;2174
2016-01-13 15:00:00;37,44;34,41;3,03;39047;774;0.0198;819;-45;44353;13336;0.3007;10957;2379
2016-01-13 16:00:00;39,58;37,03;2,55;39047;86;0.0022;103;-17;44353;13012;0.2934;10088;2924
2016-01-13 17:00:00;43,0;42,26;0,74;39047;2;0;0;2;44353;12136;0.2736;9339;2797
2016-01-13 18:00:00;42,22;39,79;2,43;39047;0;0;0;0;44353;10898;0.2457;8671;2227
2016-01-13 19:00:00;38,86;42,28;-3,42;39047;0;0;0;0;44353;9909;0.2234;8021;1888
2016-01-13 20:00:00;29,62;33,11;-3,49;39047;0;0;0;0;44353;9212;0.2077;7720;1492
2016-01-13 21:00:00;26,97;28,37;-1,4;39047;0;0;0;0;44353;8514;0.1919;7525;989
2016-01-13 22:00:00;25,88;26,49;-0,61;39047;0;0;0;0;44353;8676;0.1956;7310;1366
2016-01-13 23:00:00;23,52;24,19;-0,67;39047;0;0;0;0;44353;9194;0.2073;7121;2073
2016-01-14 00:00:00;24,29;28,14;-3,85;39051;0;0;0;0;44363;9833;0.2216;9043;790
2016-01-14 01:00:00;23,06;24,44;-1,38;39051;0;0;0;0;44363;9532;0.2148;9084;448
2016-01-14 02:00:00;22,22;22,26;-0,04;39051;0;0;0;0;44363;9152;0.2063;8786;366
2016-01-14 03:00:00;22,03;22,7;-0,67;39051;0;0;0;0;44363;8990;0.2026;8331;659
2016-01-14 04:00:00;22,53;22,19;0,34;39051;0;0;0;0;44363;8285;0.1868;8086;199
2016-01-14 05:00:00;23,9;27,8;-3,9;39051;0;0;0;0;44363;8370;0.1887;8010;360
2016-01-14 06:00:00;29,99;30,67;-0,68;39051;0;0;0;0;44363;9000;0.2028;8202;798
2016-01-14 07:00:00;44,07;38,38;5,69;39051;0;0;7;-7;44363;9734;0.2194;8539;1195
2016-01-14 08:00:00;44,99;44,73;0,26;39051;472;0.0121;442;30;44363;10273;0.2316;8862;1411
2016-01-14 09:00:00;41,39;39,93;1,46;39051;2984;0.0764;2652;332;44363;10525;0.2372;9300;1225
2016-01-14 10:00:00;34,95;30,5;4,45;39051;6185;0.1584;5317;868;44363;10369;0.2337;9641;728
2016-01-14 11:00:00;33,18;29,11;4,07;39051;8841;0.2264;7208;1633;44363;10483;0.2363;9789;694
2016-01-14 12:00:00;31,17;26,36;4,81;39051;9829;0.2517;7488;2341;44363;10506;0.2368;9797;709
2016-01-14 13:00:00;33,52;27,2;6,32;39051;8555;0.2191;6275;2280;44363;10268;0.2314;9427;841
2016-01-14 14:00:00;39,97;31,62;8,35;39051;5652;0.1447;4053;1599;44363;9868;0.2224;9154;714
2016-01-14 15:00:00;42,99;37,69;5,3;39051;1911;0.049;1731;180;44363;9567;0.2157;9051;516
2016-01-14 16:00:00;42,34;41,79;0,55;39051;119;0.003;181;-62;44363;9721;0.2191;9249;472
2016-01-14 17:00:00;45,5;43,0;2,5;39051;2;0;0;2;44363;10369;0.2337;9610;759
2016-01-14 18:00:00;41,06;40,12;0,94;39051;0;0;0;0;44363;11076;0.2496;9797;1279
2016-01-14 19:00:00;40,02;39,4;0,62;39051;0;0;0;0;44363;10633;0.2397;9762;871
2016-01-14 20:00:00;38,34;34,16;4,18;39051;0;0;0;0;44363;10494;0.2366;9471;1023
2016-01-14 21:00:00;30,86;31,2;-0,34;39051;0;0;0;0;44363;10391;0.2342;9010;1381
2016-01-14 22:00:00;28,16;27,24;0,92;39051;0;0;0;0;44363;9926;0.2238;8568;1358
2016-01-14 23:00:00;25,73;25,95;-0,22;39051;0;0;0;0;44363;9744;0.2196;8264;1480
2016-01-15 00:00:00;24,58;23,34;1,24;39053;0;0;0;0;44363;9660;0.2177;8588;1072
2016-01-15 01:00:00;25,03;24,3;0,73;39053;0;0;0;0;44363;9733;0.2194;8348;1385
2016-01-15 02:00:00;24,36;23,52;0,84;39053;0;0;0;0;44363;9642;0.2174;8228;1414
2016-01-15 03:00:00;23,5;22,46;1,04;39053;0;0;0;0;44363;9479;0.2137;8180;1299
2016-01-15 04:00:00;22,94;24,06;-1,12;39053;0;0;0;0;44363;9575;0.2158;7949;1626
2016-01-15 05:00:00;23,17;21,42;1,75;39053;0;0;0;0;44363;9534;0.2149;7740;1794
2016-01-15 06:00:00;26,35;21,92;4,43;39053;0;0;0;0;44363;9762;0.22;7680;2082
2016-01-15 07:00:00;40,9;38,14;2,76;39053;0;0;3;-3;44363;9618;0.2168;7724;1894
2016-01-15 08:00:00;45,21;38,9;6,31;39053;130;0.0034;155;-25;44363;9335;0.2104;7648;1687
2016-01-15 09:00:00;45,46;43,23;2,23;39053;668;0.0171;855;-187;44363;8549;0.1927;7726;823
2016-01-15 10:00:00;45,99;45,58;0,41;39053;1221;0.0313;1784;-563;44363;7845;0.1768;7768;77
2016-01-15 11:00:00;46,95;45,2;1,75;39053;1679;0.043;2513;-834;44363;6973;0.1572;7737;-764
2016-01-15 12:00:00;44,0;45,43;-1,43;39053;1800;0.0461;2756;-956;44363;6298;0.142;7656;-1358
2016-01-15 13:00:00;42,05;45,96;-3,91;39053;1637;0.0419;2479;-842;44363;5759;0.1298;7503;-1744
2016-01-15 14:00:00;39,99;44,83;-4,84;39053;1053;0.027;1724;-671;44363;5160;0.1163;7244;-2084
2016-01-15 15:00:00;37,65;45,62;-7,97;39053;448;0.0115;784;-336;44363;4644;0.1047;6782;-2138
2016-01-15 16:00:00;38,0;47,56;-9,56;39053;52;0.0013;101;-49;44363;4236;0.0955;6345;-2109
2016-01-15 17:00:00;45,26;49,42;-4,16;39053;2;0;2;0;44363;3936;0.0887;5942;-2006
2016-01-15 18:00:00;48,04;49,44;-1,4;39053;0;0;0;0;44363;3818;0.0861;5559;-1741
2016-01-15 19:00:00;44,36;44,67;-0,31;39053;0;0;0;0;44363;3529;0.0796;5079;-1550
2016-01-15 20:00:00;34,38;35,5;-1,12;39053;0;0;0;0;44363;3075;0.0694;4595;-1520
2016-01-15 21:00:00;29,34;35,83;-6,49;39053;0;0;0;0;44363;2934;0.0662;4032;-1098
2016-01-15 22:00:00;27,17;33,6;-6,43;39053;0;0;0;0;44363;2625;0.0592;3519;-894
2016-01-15 23:00:00;25,02;29,34;-4,32;39053;0;0;0;0;44363;2326;0.0524;3101;-775
2016-01-16 00:00:00;27,13;28,48;-1,35;39053;0;0;0;0;44363;2187;0.0493;2145;42
2016-01-16 01:00:00;26,37;28,2;-1,83;39053;0;0;0;0;44363;2093;0.0472;1925;168
2016-01-16 02:00:00;25,58;28,32;-2,74;39053;0;0;0;0;44363;2006;0.0452;2036;-30
2016-01-16 03:00:00;24,73;25,33;-0,6;39053;0;0;0;0;44363;2180;0.0491;2301;-121
2016-01-16 04:00:00;24,08;25,92;-1,84;39053;0;0;0;0;44363;2436;0.0549;2559;-123
2016-01-16 05:00:00;25,32;25,24;0,08;39053;0;0;0;0;44363;2602;0.0586;2669;-67
2016-01-16 06:00:00;24,77;26,66;-1,89;39053;0;0;0;0;44363;2766;0.0624;2924;-158
2016-01-16 07:00:00;25,03;25,88;-0,85;39053;0;0;4;-4;44363;3258;0.0735;3283;-25
2016-01-16 08:00:00;27,55;29,72;-2,17;39053;96;0.0025;256;-160;44363;4115;0.0928;3811;304
2016-01-16 09:00:00;32,4;29,27;3,13;39053;541;0.0138;1352;-811;44363;4726;0.1065;4305;421
2016-01-16 10:00:00;34,21;33,79;0,42;39053;1106;0.0284;2758;-1652;44363;5118;0.1154;4381;737
2016-01-16 11:00:00;33,23;38,46;-5,23;39053;1594;0.0408;3885;-2291;44363;5931;0.1337;4326;1605
2016-01-16 12:00:00;29,16;34,4;-5,24;39053;1786;0.0457;4275;-2489;44363;6466;0.1458;4531;1935
2016-01-16 13:00:00;26,31;29,51;-3,2;39053;1674;0.0428;3942;-2268;44363;7099;0.16;4920;2179
2016-01-16 14:00:00;25,47;29,41;-3,94;39053;1263;0.0324;2892;-1629;44363;7727;0.1742;5496;2231
2016-01-16 15:00:00;25,6;28,93;-3,33;39053;617;0.0158;1400;-783;44363;7948;0.1792;6033;1915
2016-01-16 16:00:00;30,15;29,24;0,91;39053;95;0.0024;208;-113;44363;7788;0.1755;6267;1521
2016-01-16 17:00:00;39,77;39,03;0,74;39053;2;0;12;-10;44363;7948;0.1792;6420;1528
2016-01-16 18:00:00;40,03;38,75;1,28;39053;0;0;0;0;44363;8048;0.1814;6623;1425
2016-01-16 19:00:00;30,99;30,39;0,6;39053;0;0;0;0;44363;8223;0.1854;6899;1324
2016-01-16 20:00:00;26,19;23,78;2,41;39053;0;0;0;0;44363;8343;0.1881;7140;1203
2016-01-16 21:00:00;25,9;24,26;1,64;39053;0;0;0;0;44363;8475;0.191;7403;1072
2016-01-16 22:00:00;25,53;25,62;-0,09;39053;0;0;0;0;44363;8733;0.1968;7411;1322
2016-01-16 23:00:00;24,12;22,58;1,54;39053;0;0;0;0;44363;8873;0.2;7346;1527
2016-01-17 00:00:00;20,86;26,65;-5,79;39054;0;0;0;0;44363;8831;0.199;7930;901
2016-01-17 01:00:00;20,25;25,05;-4,8;39054;0;0;0;0;44363;8726;0.1967;7923;803
2016-01-17 02:00:00;20,76;23,94;-3,18;39054;0;0;0;0;44363;8456;0.1906;7957;499
2016-01-17 03:00:00;20,97;22,57;-1,6;39054;0;0;0;0;44363;8266;0.1863;7743;523
2016-01-17 04:00:00;20,89;22,78;-1,89;39054;0;0;0;0;44363;7966;0.1796;7237;729
2016-01-17 05:00:00;20,94;21,39;-0,45;39054;0;0;0;0;44363;7637;0.1721;6706;931
2016-01-17 06:00:00;19,64;22,23;-2,59;39054;0;0;0;0;44363;7495;0.169;6071;1424
2016-01-17 07:00:00;22,35;21,1;1,25;39054;0;0;0;0;44363;6884;0.1552;5398;1486
2016-01-17 08:00:00;23,52;22,42;1,1;39054;96;0.0025;143;-47;44363;5737;0.1293;4555;1182
2016-01-17 09:00:00;26,54;28,46;-1,92;39054;486;0.0125;1087;-601;44363;4770;0.1075;3900;870
2016-01-17 10:00:00;30,11;31,97;-1,86;39054;977;0.025;2571;-1594;44363;4060;0.0915;3268;792
2016-01-17 11:00:00;36,29;33,92;2,37;39054;1516;0.0388;3955;-2439;44363;3350;0.0755;2720;630
2016-01-17 12:00:00;32,44;35,12;-2,68;39054;1933;0.0495;4701;-2768;44363;2878;0.0649;2211;667
2016-01-17 13:00:00;26,93;29,59;-2,66;39054;1777;0.0455;4465;-2688;44363;2724;0.0614;1820;904
2016-01-17 14:00:00;26,19;29,12;-2,93;39054;1259;0.0322;3406;-2147;44363;2530;0.057;1598;932
2016-01-17 15:00:00;27,07;28,61;-1,54;39054;595;0.0152;1713;-1118;44363;2310;0.0521;1444;866
2016-01-17 16:00:00;31,94;28,45;3,49;39054;94;0.0024;223;-129;44363;2319;0.0523;1429;890
2016-01-17 17:00:00;39,49;38,13;1,36;39054;1;0;3;-2;44363;2079;0.0469;1447;632
2016-01-17 18:00:00;42,8;37,9;4,9;39054;0;0;0;0;44363;1968;0.0444;1437;531
2016-01-17 19:00:00;39,23;36,02;3,21;39054;0;0;0;0;44363;1862;0.042;1490;372
2016-01-17 20:00:00;33,3;34,0;-0,7;39054;0;0;0;0;44363;1741;0.0392;1529;212
2016-01-17 21:00:00;27,04;28,4;-1,36;39054;0;0;0;0;44363;1996;0.045;1628;368
2016-01-17 22:00:00;27,05;29,13;-2,08;39054;0;0;0;0;44363;2354;0.0531;1783;571
2016-01-17 23:00:00;24,99;27,63;-2,64;39054;0;0;0;0;44363;2563;0.0578;1972;591
2016-01-18 00:00:00;23,96;23,77;0,19;39056;0;0;0;0;44366;2678;0.0604;3285;-607
2016-01-18 01:00:00;23,47;25,13;-1,66;39056;0;0;0;0;44366;2789;0.0629;3416;-627
2016-01-18 02:00:00;23,56;25,23;-1,67;39056;0;0;0;0;44366;2592;0.0584;3540;-948
2016-01-18 03:00:00;23,48;22,47;1,01;39056;0;0;0;0;44366;2734;0.0616;3548;-814
2016-01-18 04:00:00;23,51;22,4;1,11;39056;0;0;0;0;44366;2519;0.0568;3466;-947
2016-01-18 05:00:00;24,25;23,06;1,19;39056;0;0;0;0;44366;2244;0.0506;3338;-1094
2016-01-18 06:00:00;27,61;27,67;-0,06;39056;0;0;0;0;44366;2195;0.0495;3180;-985
2016-01-18 07:00:00;46,01;49,35;-3,34;39056;0;0;0;0;44366;2498;0.0563;3144;-646
2016-01-18 08:00:00;49,98;51,78;-1,8;39056;128;0.0033;191;-63;44366;2836;0.0639;3374;-538
2016-01-18 09:00:00;50,54;53,92;-3,38;39056;864;0.0222;1541;-677;44366;3110;0.0701;3662;-552
2016-01-18 10:00:00;49,91;50,77;-0,86;39056;1970;0.0504;3643;-1673;44366;3117;0.0703;3762;-645
2016-01-18 11:00:00;48,44;50,13;-1,69;39056;3101;0.0794;5613;-2512;44366;2724;0.0614;3530;-806
2016-01-18 12:00:00;46,93;52,45;-5,52;39056;3938;0.1008;6458;-2520;44366;2912;0.0657;3190;-278
2016-01-18 13:00:00;46,32;50,73;-4,41;39056;4136;0.1059;6081;-1945;44366;3300;0.0744;2990;310
2016-01-18 14:00:00;45,76;47,63;-1,87;39056;3360;0.086;4620;-1260;44366;3480;0.0784;2806;674
2016-01-18 15:00:00;49,53;48,95;0,58;39056;1706;0.0437;2486;-780;44366;3502;0.0789;2826;676
2016-01-18 16:00:00;49,66;49,23;0,43;39056;216;0.0055;355;-139;44366;3658;0.0824;3007;651
2016-01-18 17:00:00;62,55;61,36;1,19;39056;2;0;3;-1;44366;4168;0.0939;3284;884
2016-01-18 18:00:00;56,07;52,71;3,36;39056;0;0;0;0;44366;4628;0.1043;3588;1040
2016-01-18 19:00:00;47,18;46,76;0,42;39056;0;0;0;0;44366;5206;0.1174;3781;1425
2016-01-18 20:00:00;35,09;34,74;0,35;39056;0;0;0;0;44366;5464;0.1232;3938;1526
2016-01-18 21:00:00;26,95;28,28;-1,33;39056;0;0;0;0;44366;5678;0.128;4011;1667
2016-01-18 22:00:00;26,94;29,18;-2,24;39056;0;0;0;0;44366;5890;0.1327;4028;1862
2016-01-18 23:00:00;25,09;25,96;-0,87;39056;0;0;0;0;44366;6150;0.1386;4050;2100
2016-01-19 00:00:00;31,95;31,08;0,87;39057;0;0;0;0;44373;6575;0.1481;5852;723
2016-01-19 01:00:00;32,16;30,89;1,27;39057;0;0;0;0;44373;6670;0.1503;5896;774
2016-01-19 02:00:00;28,97;27,26;1,71;39057;0;0;0;0;44373;6634;0.1495;6051;583
2016-01-19 03:00:00;30,01;28,88;1,13;39057;0;0;0;0;44373;6747;0.1521;6293;454
2016-01-19 04:00:00;30,45;29,63;0,82;39057;0;0;0;0;44373;6940;0.1564;6507;433
2016-01-19 05:00:00;27,01;29,07;-2,06;39057;0;0;0;0;44373;7392;0.1666;6627;765
2016-01-19 06:00:00;31,9;30,1;1,8;39057;0;0;0;0;44373;7908;0.1782;6857;1051
2016-01-19 07:00:00;54,1;53,08;1,02;39057;0;0;1;-1;44373;8304;0.1872;7071;1233
2016-01-19 08:00:00;64,9;63,61;1,29;39057;202;0.0052;182;20;44373;8551;0.1927;7084;1467
2016-01-19 09:00:00;65,35;61,78;3,57;39057;1297;0.0332;1220;77;44373;7806;0.176;6916;890
2016-01-19 10:00:00;61,31;49,53;11,78;39057;2702;0.0692;2807;-105;44373;7267;0.1638;6392;875
2016-01-19 11:00:00;61,43;48,31;13,12;39057;3871;0.0991;4358;-487;44373;6382;0.1438;5697;685
2016-01-19 12:00:00;58,98;49,63;9,35;39057;4413;0.113;5120;-707;44373;5768;0.13;5131;637
2016-01-19 13:00:00;58,53;47,41;11,12;39057;3926;0.1006;4845;-919;44373;5718;0.1288;4910;808
2016-01-19 14:00:00;55,81;46,16;9,65;39057;2860;0.0732;3624;-764;44373;6049;0.1363;4937;1112
2016-01-19 15:00:00;55,5;48,01;7,49;39057;1335;0.0342;1940;-605;44373;5881;0.1326;4998;883
2016-01-19 16:00:00;56,21;50,71;5,5;39057;174;0.0045;277;-103;44373;6365;0.1434;5228;1137
2016-01-19 17:00:00;70,07;63,21;6,86;39057;2;0;2;0;44373;6878;0.155;5512;1366
2016-01-19 18:00:00;74,97;59,95;15,02;39057;0;0;0;0;44373;7558;0.1704;5744;1814
2016-01-19 19:00:00;57,56;47,96;9,6;39057;0;0;0;0;44373;7957;0.1793;5819;2138
2016-01-19 20:00:00;48,24;33,76;14,48;39057;0;0;0;0;44373;7758;0.1748;5613;2145
2016-01-19 21:00:00;37,98;28,32;9,66;39057;0;0;0;0;44373;7618;0.1717;5271;2347
2016-01-19 22:00:00;33,67;24,63;9,04;39057;0;0;0;0;44373;7434;0.1675;4982;2452
2016-01-19 23:00:00;29,79;22,33;7,46;39057;0;0;0;0;44373;7168;0.1616;4850;2318
2016-01-20 00:00:00;26,05;31,3;-5,25;39059;0;0;0;0;44385;6819;0.1536;8321;-1502
2016-01-20 01:00:00;26,17;33,23;-7,06;39059;0;0;0;0;44385;6799;0.1532;8205;-1406
2016-01-20 02:00:00;26,42;34,09;-7,67;39059;0;0;0;0;44385;6452;0.1454;8092;-1640
2016-01-20 03:00:00;25,36;32,49;-7,13;39059;0;0;0;0;44385;6552;0.1476;7940;-1388
2016-01-20 04:00:00;25,76;30,98;-5,22;39059;0;0;0;0;44385;6640;0.1496;7746;-1106
2016-01-20 05:00:00;26,54;29,21;-2,67;39059;0;0;0;0;44385;6230;0.1404;7489;-1259
2016-01-20 06:00:00;32,7;36,41;-3,71;39059;0;0;0;0;44385;6298;0.1419;7197;-899
2016-01-20 07:00:00;55,08;58,39;-3,31;39059;0;0;1;-1;44385;6159;0.1388;6841;-682
2016-01-20 08:00:00;61,08;65,17;-4,09;39059;136;0.0035;176;-40;44385;6024;0.1357;6356;-332
2016-01-20 09:00:00;58,43;62,18;-3,75;39059;663;0.017;1024;-361;44385;5824;0.1312;5889;-65
2016-01-20 10:00:00;58,97;64,51;-5,54;39059;1439;0.0368;2027;-588;44385;5073;0.1143;5406;-333
2016-01-20 11:00:00;56,14;60,21;-4,07;39059;2196;0.0562;3140;-944;44385;4800;0.1081;4906;-106
2016-01-20 12:00:00;58,6;58,95;-0,35;39059;2690;0.0689;3688;-998;44385;4485;0.101;4449;36
2016-01-20 13:00:00;57,58;55,47;2,11;39059;2998;0.0768;3561;-563;44385;4362;0.0983;4109;253
2016-01-20 14:00:00;54,95;52,79;2,16;39059;2477;0.0634;2728;-251;44385;4196;0.0945;3872;324
2016-01-20 15:00:00;52,42;53,21;-0,79;39059;1370;0.0351;1452;-82;44385;4066;0.0916;3698;368
2016-01-20 16:00:00;72,01;60,06;11,95;39059;268;0.0069;252;16;44385;4088;0.0921;3636;452
2016-01-20 17:00:00;92,75;75,92;16,83;39059;2;0;4;-2;44385;4120;0.0928;3764;356
2016-01-20 18:00:00;79,09;64,44;14,65;39059;0;0;0;0;44385;4018;0.0905;3913;105
2016-01-20 19:00:00;70,03;59,49;10,54;39059;0;0;0;0;44385;4006;0.0903;3882;124
2016-01-20 20:00:00;50,1;55,3;-5,2;39059;0;0;0;0;44385;3661;0.0825;3661;0
2016-01-20 21:00:00;40,06;44,72;-4,66;39059;0;0;0;0;44385;3216;0.0725;3357;-141
2016-01-20 22:00:00;33,52;39,5;-5,98;39059;0;0;0;0;44385;2770;0.0624;3090;-320
2016-01-20 23:00:00;29,63;29,67;-0,04;39059;0;0;0;0;44385;2511;0.0566;2823;-312
2016-01-21 00:00:00;29,65;30,07;-0,42;39061;0;0;0;0;44391;2342;0.0528;2538;-196
2016-01-21 01:00:00;27,82;28,69;-0,87;39061;0;0;0;0;44391;2035;0.0458;2397;-362
2016-01-21 02:00:00;26,65;26,99;-0,34;39061;0;0;0;0;44391;1797;0.0405;2269;-472
2016-01-21 03:00:00;26,96;27,47;-0,51;39061;0;0;0;0;44391;1628;0.0367;2128;-500
2016-01-21 04:00:00;27,47;29,38;-1,91;39061;0;0;0;0;44391;1432;0.0322;1970;-538
2016-01-21 05:00:00;29,09;34,38;-5,29;39061;0;0;0;0;44391;1410;0.0318;1874;-464
2016-01-21 06:00:00;40,78;49,64;-8,86;39061;0;0;0;0;44391;1444;0.0325;1800;-356
2016-01-21 07:00:00;70,01;87,23;-17,22;39061;0;0;1;-1;44391;1562;0.0352;1700;-138
2016-01-21 08:00:00;85,05;94,16;-9,11;39061;117;0.003;158;-41;44391;1621;0.0365;1625;-4
2016-01-21 09:00:00;83,54;89,69;-6,15;39061;720;0.0184;1100;-380;44391;1652;0.0372;1557;95
2016-01-21 10:00:00;74,94;80,85;-5,91;39061;1702;0.0436;2297;-595;44391;1605;0.0362;1545;60
2016-01-21 11:00:00;70,12;74,37;-4,25;39061;2923;0.0748;3671;-748;44391;1699;0.0383;1632;67
2016-01-21 12:00:00;59,91;60,53;-0,62;39061;3954;0.1012;4523;-569;44391;1587;0.0357;1641;-54
2016-01-21 13:00:00;57,69;54,37;3,32;39061;4241;0.1086;4574;-333;44391;1680;0.0378;1649;31
2016-01-21 14:00:00;57,99;54,47;3,52;39061;3396;0.087;3667;-271;44391;1551;0.0349;1686;-135
2016-01-21 15:00:00;61,05;67,13;-6,08;39061;1909;0.0489;2066;-157;44391;1394;0.0314;1694;-300
2016-01-21 16:00:00;57,43;69,44;-12,01;39061;370;0.0095;351;19;44391;1430;0.0322;1840;-410
2016-01-21 17:00:00;77,13;114,7;-37,57;39061;3;0.0001;9;-6;44391;1681;0.0379;2113;-432
2016-01-21 18:00:00;86,01;110,61;-24,6;39061;0;0;0;0;44391;2142;0.0482;2442;-300
2016-01-21 19:00:00;60,13;84,01;-23,88;39061;0;0;0;0;44391;2507;0.0565;2762;-255
2016-01-21 20:00:00;50,09;59,58;-9,49;39061;0;0;0;0;44391;2841;0.064;3075;-234
2016-01-21 21:00:00;35,47;40,49;-5,02;39061;0;0;0;0;44391;2952;0.0665;3321;-369
2016-01-21 22:00:00;30,36;37,31;-6,95;39061;0;0;0;0;44391;3004;0.0676;3525;-521
2016-01-21 23:00:00;26,97;32,13;-5,16;39061;0;0;0;0;44391;3224;0.0726;3707;-483
2016-01-22 00:00:00;28,05;31,95;-3,9;39063;0;0;0;0;44412;3354;0.0755;3498;-144
2016-01-22 01:00:00;27,92;33,47;-5,55;39063;0;0;0;0;44412;3441;0.0775;3651;-210
2016-01-22 02:00:00;26,78;31,5;-4,72;39063;0;0;0;0;44412;3424;0.0771;3887;-463
2016-01-22 03:00:00;26,57;32,29;-5,72;39063;0;0;0;0;44412;3532;0.0795;4228;-696
2016-01-22 04:00:00;27,02;32,28;-5,26;39063;0;0;0;0;44412;3730;0.084;4631;-901
2016-01-22 05:00:00;28,07;34,68;-6,61;39063;0;0;0;0;44412;4004;0.0901;5110;-1106
2016-01-22 06:00:00;30,82;42,48;-11,66;39063;0;0;0;0;44412;4308;0.097;5719;-1411
2016-01-22 07:00:00;48,46;53,73;-5,27;39063;0;0;2;-2;44412;4954;0.1116;6514;-1560
2016-01-22 08:00:00;52,5;58,22;-5,72;39063;335;0.0086;308;27;44412;5882;0.1325;7390;-1508
2016-01-22 09:00:00;48,66;54,04;-5,38;39063;2097;0.0537;1953;144;44412;6469;0.1456;8109;-1640
2016-01-22 10:00:00;45,11;49,71;-4,6;39063;4390;0.1124;3802;588;44412;6489;0.1461;8338;-1849
2016-01-22 11:00:00;44,96;44,38;0,58;39063;6234;0.1596;5646;588;44412;6114;0.1377;8024;-1910
2016-01-22 12:00:00;42,06;38,24;3,82;39063;6960;0.1782;6348;612;44412;5821;0.1311;7655;-1834
2016-01-22 13:00:00;37,02;36,71;0,31;39063;6725;0.1722;5907;818;44412;5964;0.1343;7824;-1860
2016-01-22 14:00:00;32,27;35,99;-3,72;39063;5293;0.1355;4405;888;44412;6442;0.1451;8514;-2072
2016-01-22 15:00:00;32,65;38,03;-5,38;39063;2707;0.0693;2266;441;44412;7692;0.1732;9727;-2035
2016-01-22 16:00:00;32,84;41,11;-8,27;39063;450;0.0115;359;91;44412;9992;0.225;11266;-1274
2016-01-22 17:00:00;34,83;45,17;-10,34;39063;6;0.0002;5;1;44412;12934;0.2912;12984;-50
2016-01-22 18:00:00;28,3;36,75;-8,45;39063;0;0;0;0;44412;15214;0.3426;14706;508
2016-01-22 19:00:00;26,88;29,89;-3,01;39063;0;0;0;0;44412;15944;0.359;15725;219
2016-01-22 20:00:00;25,46;28,56;-3,1;39063;0;0;0;0;44412;16267;0.3663;16070;197
2016-01-22 21:00:00;24,88;27,88;-3,0;39063;0;0;0;0;44412;15776;0.3552;15928;-152
2016-01-22 22:00:00;24,28;27,8;-3,52;39063;0;0;0;0;44412;15034;0.3385;15749;-715
2016-01-22 23:00:00;22,63;26,74;-4,11;39063;0;0;0;0;44412;14262;0.3211;15548;-1286
2016-01-23 00:00:00;24,44;26,01;-1,57;39064;0;0;0;0;44412;13088;0.2947;13248;-160
2016-01-23 01:00:00;24,02;28,1;-4,08;39064;0;0;0;0;44412;11936;0.2688;12364;-428
2016-01-23 02:00:00;23,03;27,88;-4,85;39064;0;0;0;0;44412;10903;0.2455;11768;-865
2016-01-23 03:00:00;22,99;29,21;-6,22;39064;0;0;0;0;44412;10683;0.2406;11361;-678
2016-01-23 04:00:00;22,68;26,57;-3,89;39064;0;0;0;0;44412;10570;0.238;10974;-404
2016-01-23 05:00:00;22,44;23,49;-1,05;39064;0;0;0;0;44412;11178;0.2517;10939;239
2016-01-23 06:00:00;21,46;23,55;-2,09;39064;0;0;0;0;44412;11944;0.2689;10941;1003
2016-01-23 07:00:00;23,35;24,83;-1,48;39064;0;0;1;-1;44412;12382;0.2788;11074;1308
2016-01-23 08:00:00;24,68;24,57;0,11;39064;50;0.0013;55;-5;44412;12812;0.2885;11438;1374
2016-01-23 09:00:00;28,9;24,88;4,02;39064;399;0.0102;367;32;44412;13353;0.3007;11619;1734
2016-01-23 10:00:00;31,32;26,48;4,84;39064;972;0.0249;901;71;44412;12898;0.2904;11471;1427
2016-01-23 11:00:00;34,75;28,56;6,19;39064;1720;0.044;1497;223;44412;11954;0.2692;11001;953
2016-01-23 12:00:00;34,39;31,02;3,37;39064;2250;0.0576;1808;442;44412;12182;0.2743;10535;1647
2016-01-23 13:00:00;30,45;25,99;4,46;39064;2244;0.0574;1782;462;44412;12240;0.2756;10253;1987
2016-01-23 14:00:00;28,04;24,08;3,96;39064;1810;0.0463;1386;424;44412;12079;0.272;9903;2176
2016-01-23 15:00:00;29,1;23,58;5,52;39064;980;0.0251;734;246;44412;11705;0.2636;9561;2144
2016-01-23 16:00:00;29,7;26,84;2,86;39064;206;0.0053;142;64;44412;12347;0.278;9323;3024
2016-01-23 17:00:00;36,97;33,91;3,06;39064;3;0.0001;0;3;44412;12193;0.2746;9298;2895
2016-01-23 18:00:00;42,6;31,05;11,55;39064;0;0;0;0;44412;11267;0.2537;9319;1948
2016-01-23 19:00:00;35,83;26,13;9,7;39064;0;0;0;0;44412;11248;0.2533;9369;1879
2016-01-23 20:00:00;28,84;22,45;6,39;39064;0;0;0;0;44412;11502;0.259;9296;2206
2016-01-23 21:00:00;25,4;21,45;3,95;39064;0;0;0;0;44412;10594;0.2385;9092;1502
2016-01-23 22:00:00;26,27;23,56;2,71;39064;0;0;0;0;44412;10684;0.2406;8860;1824
2016-01-23 23:00:00;27,06;24,02;3,04;39064;0;0;0;0;44412;10650;0.2398;8665;1985
2016-01-24 00:00:00;24,08;22,39;1,69;39064;0;0;0;0;44412;10535;0.2372;9820;715
2016-01-24 01:00:00;23,99;23,33;0,66;39064;0;0;0;0;44412;10120;0.2278;9458;662
2016-01-24 02:00:00;24,83;21,93;2,9;39064;0;0;0;0;44412;9829;0.2213;9237;592
2016-01-24 03:00:00;23,24;20,26;2,98;39064;0;0;0;0;44412;9755;0.2196;8986;769
2016-01-24 04:00:00;22,54;19,13;3,41;39064;0;0;0;0;44412;9922;0.2234;8795;1127
2016-01-24 05:00:00;23,41;17,86;5,55;39064;0;0;0;0;44412;9343;0.2104;8724;619
2016-01-24 06:00:00;21,41;19,32;2,09;39064;0;0;0;0;44412;9229;0.2078;8675;554
2016-01-24 07:00:00;21,4;21,14;0,26;39064;0;0;2;-2;44412;9028;0.2033;8649;379
2016-01-24 08:00:00;22,12;21,33;0,79;39064;179;0.0046;135;44;44412;8927;0.201;8673;254
2016-01-24 09:00:00;24,63;21,98;2,65;39064;912;0.0234;673;239;44412;8941;0.2013;8625;316
2016-01-24 10:00:00;27,05;22,92;4,13;39064;1952;0.05;1372;580;44412;9137;0.2058;8535;602
2016-01-24 11:00:00;32,66;23,8;8,86;39064;2903;0.0743;1953;950;44412;9184;0.2068;8386;798
2016-01-24 12:00:00;28,94;21,16;7,78;39064;3501;0.0896;2237;1264;44412;8602;0.1937;8222;380
2016-01-24 13:00:00;26,04;20,53;5,51;39064;3580;0.0916;2118;1462;44412;8702;0.1959;7988;714
2016-01-24 14:00:00;24,84;20,99;3,85;39064;2676;0.0685;1562;1114;44412;8447;0.1902;7760;687
2016-01-24 15:00:00;23,99;21,84;2,15;39064;1418;0.0363;789;629;44412;8656;0.1949;7625;1031
2016-01-24 16:00:00;25,04;24,09;0,95;39064;285;0.0073;153;132;44412;9800;0.2207;7643;2157
2016-01-24 17:00:00;32,88;30,77;2,11;39064;4;0.0001;0;4;44412;11357;0.2557;8059;3298
2016-01-24 18:00:00;36,09;32,83;3,26;39064;0;0;0;0;44412;12349;0.278;8620;3729
2016-01-24 19:00:00;35,87;29,06;6,81;39064;0;0;0;0;44412;13103;0.2951;9084;4019
2016-01-24 20:00:00;31,7;25,4;6,3;39064;0;0;0;0;44412;14080;0.317;9297;4783
2016-01-24 21:00:00;26,0;20,19;5,81;39064;0;0;0;0;44412;14663;0.3302;9429;5234
2016-01-24 22:00:00;27,09;18,59;8,5;39064;0;0;0;0;44412;14628;0.3294;9384;5244
2016-01-24 23:00:00;22,44;15,16;7,28;39064;0;0;0;0;44412;14571;0.3281;9408;5163
2016-01-25 00:00:00;20,07;18,82;1,25;39067;0;0;0;0;44421;14322;0.3224;12805;1517
2016-01-25 01:00:00;19,65;17,12;2,53;39067;0;0;0;0;44421;14318;0.3223;12649;1669
2016-01-25 02:00:00;19,68;17,05;2,63;39067;0;0;0;0;44421;13945;0.314;12458;1487
2016-01-25 03:00:00;19,98;15,89;4,09;39067;0;0;0;0;44421;13843;0.3116;12275;1568
2016-01-25 04:00:00;20,33;17,41;2,92;39067;0;0;0;0;44421;13358;0.3007;12028;1330
2016-01-25 05:00:00;21,32;21,44;-0,12;39067;0;0;0;0;44421;13026;0.2932;11729;1297
2016-01-25 06:00:00;25,01;25,58;-0,57;39067;0;0;0;0;44421;12509;0.2816;11364;1145
2016-01-25 07:00:00;34,94;36,8;-1,86;39067;0;0;2;-2;44421;11962;0.2693;11048;914
2016-01-25 08:00:00;35,0;39,28;-4,28;39067;178;0.0046;194;-16;44421;11340;0.2553;10753;587
2016-01-25 09:00:00;36,04;38,39;-2,35;39067;1126;0.0288;1052;74;44421;10903;0.2454;10524;379
2016-01-25 10:00:00;36,62;36,64;-0,02;39067;2782;0.0712;2399;383;44421;10400;0.2341;10206;194
2016-01-25 11:00:00;35,6;34,59;1,01;39067;5160;0.1321;3857;1303;44421;9988;0.2248;9641;347
2016-01-25 12:00:00;34,75;30,84;3,91;39067;6942;0.1777;4910;2032;44421;9490;0.2136;8957;533
2016-01-25 13:00:00;32,26;27,45;4,81;39067;7364;0.1885;5283;2081;44421;9015;0.203;8437;578
2016-01-25 14:00:00;30,61;28,32;2,29;39067;6011;0.1539;4517;1494;44421;8838;0.199;8188;650
2016-01-25 15:00:00;29,73;29,67;0,06;39067;3418;0.0875;2681;737;44421;9042;0.2035;8103;939
2016-01-25 16:00:00;31,17;31,81;-0,64;39067;793;0.0203;572;221;44421;9933;0.2236;8464;1469
2016-01-25 17:00:00;34,96;35,69;-0,73;39067;8;0.0002;1;7;44421;12158;0.2737;9247;2911
2016-01-25 18:00:00;36,33;31,27;5,06;39067;0;0;0;0;44421;13805;0.3108;10165;3640
2016-01-25 19:00:00;31,96;30,69;1,27;39067;0;0;0;0;44421;14240;0.3206;11187;3053
2016-01-25 20:00:00;26,8;28,31;-1,51;39067;0;0;0;0;44421;15004;0.3378;12137;2867
2016-01-25 21:00:00;25,32;27,93;-2,61;39067;0;0;0;0;44421;16136;0.3632;13176;2960
2016-01-25 22:00:00;23,93;28,65;-4,72;39067;0;0;0;0;44421;16781;0.3778;14300;2481
2016-01-25 23:00:00;18,11;21,29;-3,18;39067;0;0;0;0;44421;17747;0.3995;15526;2221
2016-01-26 00:00:00;20,23;22,0;-1,77;39069;0;0;0;0;44428;18747;0.422;17245;1502
2016-01-26 01:00:00;18,02;14,82;3,2;39069;0;0;0;0;44428;19518;0.4393;18030;1488
2016-01-26 02:00:00;15,9;7,17;8,73;39069;0;0;0;0;44428;19580;0.4407;18645;935
2016-01-26 03:00:00;15,91;12,42;3,49;39069;0;0;0;0;44428;19225;0.4327;19041;184
2016-01-26 04:00:00;17,1;16,74;0,36;39069;0;0;0;0;44428;18846;0.4242;19106;-260
2016-01-26 05:00:00;21,8;25,38;-3,58;39069;0;0;0;0;44428;17893;0.4027;18865;-972
2016-01-26 06:00:00;27,09;32,01;-4,92;39069;0;0;0;0;44428;17494;0.3938;18362;-868
2016-01-26 07:00:00;34,13;39,0;-4,87;39069;0;0;7;-7;44428;16872;0.3797;17409;-537
2016-01-26 08:00:00;38,11;39,72;-1,61;39069;388;0.0099;410;-22;44428;16324;0.3674;16261;63
2016-01-26 09:00:00;32,31;30,05;2,26;39069;2040;0.0522;1955;85;44428;15472;0.3483;15168;304
2016-01-26 10:00:00;29,99;27,49;2,5;39069;4673;0.1196;3995;678;44428;14800;0.3331;14302;498
2016-01-26 11:00:00;29,55;26,05;3,5;39069;7296;0.1867;5820;1476;44428;14228;0.3203;13783;445
2016-01-26 12:00:00;28,52;21,69;6,83;39069;8774;0.2246;6766;2008;44428;14373;0.3235;13546;827
2016-01-26 13:00:00;29,33;22,03;7,3;39069;8202;0.21;6565;1637;44428;14705;0.331;13449;1256
2016-01-26 14:00:00;27,97;22,21;5,76;39069;6159;0.1577;5142;1017;44428;15111;0.3401;13342;1769
2016-01-26 15:00:00;30,09;24,51;5,58;39069;3420;0.0875;2852;568;44428;16500;0.3714;13497;3003
2016-01-26 16:00:00;30,62;24,34;6,28;39069;726;0.0186;601;125;44428;18790;0.4229;14456;4334
2016-01-26 17:00:00;32,87;25,21;7,66;39069;8;0.0002;2;6;44428;21511;0.4842;16261;5250
2016-01-26 18:00:00;29,27;25,12;4,15;39069;0;0;0;0;44428;24311;0.5472;18511;5800
2016-01-26 19:00:00;24,94;23,34;1,6;39069;0;0;0;0;44428;26444;0.5952;20695;5749
2016-01-26 20:00:00;23,17;20,67;2,5;39069;0;0;0;0;44428;27858;0.627;22440;5418
2016-01-26 21:00:00;21,66;18,7;2,96;39069;0;0;0;0;44428;28508;0.6417;23810;4698
2016-01-26 22:00:00;20,24;14,58;5,66;39069;0;0;0;0;44428;28830;0.6489;25122;3708
2016-01-26 23:00:00;13,43;10,15;3,28;39069;0;0;0;0;44428;28931;0.6512;26239;2692
2016-01-27 00:00:00;10,97;10,37;0,6;39070;0;0;0;0;44434;28542;0.6424;29034;-492
2016-01-27 01:00:00;3,18;6,55;-3,37;39070;0;0;0;0;44434;27815;0.626;29355;-1540
2016-01-27 02:00:00;0,05;11,69;-11,64;39070;0;0;0;0;44434;27534;0.6196;29439;-1905
2016-01-27 03:00:00;0,13;12,24;-12,11;39070;0;0;0;0;44434;27406;0.6168;29307;-1901
2016-01-27 04:00:00;8,82;16,3;-7,48;39070;0;0;0;0;44434;27292;0.6142;29022;-1730
2016-01-27 05:00:00;13,3;23,3;-10,0;39070;0;0;0;0;44434;26777;0.6026;28746;-1969
2016-01-27 06:00:00;17,33;27,09;-9,76;39070;0;0;0;0;44434;26992;0.6074;28340;-1348
2016-01-27 07:00:00;22,97;35,9;-12,93;39070;2;0;6;-4;44434;26978;0.6072;28020;-1042
2016-01-27 08:00:00;23,93;32,73;-8,8;39070;322;0.0082;335;-13;44434;26584;0.5983;27861;-1277
2016-01-27 09:00:00;28,95;32,03;-3,08;39070;1510;0.0387;1374;136;44434;26108;0.5876;27733;-1625
2016-01-27 10:00:00;29,94;32,75;-2,81;39070;3226;0.0826;2702;524;44434;26273;0.5913;27633;-1360
2016-01-27 11:00:00;25,55;31,13;-5,58;39070;5157;0.132;3788;1369;44434;26995;0.6075;27518;-523
2016-01-27 12:00:00;24,12;23,92;0,2;39070;5511;0.141;4173;1338;44434;27513;0.6192;27347;166
2016-01-27 13:00:00;22,95;20,81;2,14;39070;4300;0.11;3888;412;44434;27523;0.6194;27311;212
2016-01-27 14:00:00;20,95;20,18;0,77;39070;2789;0.0714;2987;-198;44434;27370;0.616;27252;118
2016-01-27 15:00:00;23,91;23,53;0,38;39070;1398;0.0358;1667;-269;44434;27322;0.6149;27116;206
2016-01-27 16:00:00;23,97;24,86;-0,89;39070;292;0.0075;425;-133;44434;27532;0.6196;27090;442
2016-01-27 17:00:00;28,93;28,16;0,77;39070;7;0.0002;2;5;44434;27679;0.6229;27109;570
2016-01-27 18:00:00;30,98;31,5;-0,52;39070;0;0;0;0;44434;27916;0.6282;27212;704
2016-01-27 19:00:00;29,07;28,92;0,15;39070;0;0;0;0;44434;28453;0.6404;27585;868
2016-01-27 20:00:00;21,5;21,19;0,31;39070;0;0;0;0;44434;28925;0.651;27745;1180
2016-01-27 21:00:00;19,06;14,02;5,04;39070;0;0;0;0;44434;28776;0.6476;27559;1217
2016-01-27 22:00:00;16,34;15,33;1,01;39070;0;0;0;0;44434;28438;0.64;26863;1575
2016-01-27 23:00:00;13,96;16,4;-2,44;39070;0;0;0;0;44434;28116;0.6327;25780;2336
2016-01-28 00:00:00;14,5;12,37;2,13;39072;0;0;0;0;44449;27246;0.613;27076;170
2016-01-28 01:00:00;12,83;11,44;1,39;39072;0;0;0;0;44449;26090;0.587;26091;-1
2016-01-28 02:00:00;12,88;11,82;1,06;39072;0;0;0;0;44449;25343;0.5702;24845;498
2016-01-28 03:00:00;12,14;14,57;-2,43;39072;0;0;0;0;44449;25443;0.5724;23676;1767
2016-01-28 04:00:00;13,2;12,97;0,23;39072;0;0;0;0;44449;26041;0.5858;22777;3264
2016-01-28 05:00:00;17,39;9,48;7,91;39072;0;0;0;0;44449;26284;0.5914;22234;4050
2016-01-28 06:00:00;23,41;15,51;7,9;39072;0;0;0;0;44449;26359;0.593;21773;4586
2016-01-28 07:00:00;28,49;24,5;3,99;39072;1;0;8;-7;44449;25506;0.5738;21131;4375
2016-01-28 08:00:00;30,96;29,67;1,29;39072;398;0.0102;360;38;44449;23400;0.5264;20334;3066
2016-01-28 09:00:00;29,97;30,55;-0,58;39072;1697;0.0434;1695;2;44449;20935;0.471;19469;1466
2016-01-28 10:00:00;29,07;32,95;-3,88;39072;3970;0.1016;3505;465;44449;20029;0.4506;18685;1344
2016-01-28 11:00:00;25,21;29,66;-4,45;39072;6327;0.1619;5161;1166;44449;19400;0.4364;17925;1475
2016-01-28 12:00:00;24,01;25,73;-1,72;39072;7593;0.1944;6035;1558;44449;19448;0.4375;16952;2496
2016-01-28 13:00:00;25,56;24,79;0,77;39072;7267;0.186;5989;1278;44449;17982;0.4045;15773;2209
2016-01-28 14:00:00;26,73;27,79;-1,06;39072;5746;0.1471;4847;899;44449;16382;0.3686;14226;2156
2016-01-28 15:00:00;31,02;33,82;-2,8;39072;3018;0.0772;2680;338;44449;13862;0.3118;12778;1084
2016-01-28 16:00:00;33,58;38,36;-4,78;39072;586;0.015;512;74;44449;12070;0.2716;12085;-15
2016-01-28 17:00:00;39,05;45,37;-6,32;39072;12;0.0003;1;11;44449;11582;0.2606;12370;-788
2016-01-28 18:00:00;46,02;52,58;-6,56;39072;0;0;0;0;44449;12935;0.291;13221;-286
2016-01-28 19:00:00;36,56;41,89;-5,33;39072;0;0;0;0;44449;14030;0.3156;14333;-303
2016-01-28 20:00:00;32,12;36,96;-4,84;39072;0;0;0;0;44449;15163;0.3411;15169;-6
2016-01-28 21:00:00;27,45;27,27;0,18;39072;0;0;0;0;44449;16139;0.3631;15734;405
2016-01-28 22:00:00;26,31;26,27;0,04;39072;0;0;0;0;44449;16162;0.3636;16058;104
2016-01-28 23:00:00;20,79;25,55;-4,76;39072;0;0;0;0;44449;16338;0.3676;16324;14
2016-01-29 00:00:00;21,1;24,7;-3,6;39077;0;0;0;0;44457;16844;0.3789;16908;-64
2016-01-29 01:00:00;19,53;25,43;-5,9;39077;0;0;0;0;44457;17479;0.3932;17604;-125
2016-01-29 02:00:00;19,06;22,24;-3,18;39077;0;0;0;0;44457;18572;0.4178;18700;-128
2016-01-29 03:00:00;18,08;14,97;3,11;39077;0;0;0;0;44457;19934;0.4484;19934;0
2016-01-29 04:00:00;15,96;10,76;5,2;39077;0;0;0;0;44457;21325;0.4797;21110;215
2016-01-29 05:00:00;18,01;10,09;7,92;39077;0;0;0;0;44457;22625;0.5089;22194;431
2016-01-29 06:00:00;26,0;20,72;5,28;39077;0;0;0;0;44457;24499;0.551;23222;1277
2016-01-29 07:00:00;34,89;27,55;7,34;39077;2;0;16;-14;44457;25848;0.5814;24345;1503
2016-01-29 08:00:00;36,06;28,82;7,24;39077;558;0.0143;552;6;44457;26616;0.5987;25548;1068
2016-01-29 09:00:00;34,94;23,75;11,19;39077;3346;0.0856;2482;864;44457;26763;0.602;26685;78
2016-01-29 10:00:00;29,91;18,48;11,43;39077;6770;0.1733;4821;1949;44457;27827;0.6259;27555;272
2016-01-29 11:00:00;25,43;7,42;18,01;39077;8836;0.2261;6736;2100;44457;28690;0.6454;28321;369
2016-01-29 12:00:00;21,83;5,01;16,82;39077;9364;0.2396;7529;1835;44457;29495;0.6634;28898;597
2016-01-29 13:00:00;20,03;4,19;15,84;39077;8776;0.2246;7183;1593;44457;29640;0.6667;29458;182
2016-01-29 14:00:00;19,1;4,37;14,73;39077;7008;0.1794;5672;1336;44457;29767;0.6696;29986;-219
2016-01-29 15:00:00;19,39;5,72;13,67;39077;3906;0.1;3256;650;44457;30245;0.6803;30490;-245
2016-01-29 16:00:00;22,54;7,12;15,42;39077;941;0.0241;822;119;44457;30768;0.6921;30628;140
2016-01-29 17:00:00;27,43;14,74;12,69;39077;12;0.0003;5;7;44457;30664;0.6898;30513;151
2016-01-29 18:00:00;25,99;16,78;9,21;39077;0;0;0;0;44457;30760;0.6919;30294;466
2016-01-29 19:00:00;25,18;18,38;6,8;39077;0;0;0;0;44457;30601;0.6883;29996;605
2016-01-29 20:00:00;21,11;11,6;9,51;39077;0;0;0;0;44457;30456;0.6851;29788;668
2016-01-29 21:00:00;17,08;6,01;11,07;39077;0;0;0;0;44457;30378;0.6833;29759;619
2016-01-29 22:00:00;14,6;6,69;7,91;39077;0;0;0;0;44457;29262;0.6582;29788;-526
2016-01-29 23:00:00;10,29;3,83;6,46;39077;0;0;0;0;44457;29223;0.6574;29913;-690
2016-01-30 00:00:00;14,08;9,39;4,69;39077;0;0;0;0;44457;28908;0.6502;30190;-1282
2016-01-30 01:00:00;8,4;2,59;5,81;39077;0;0;0;0;44457;29125;0.6551;30695;-1570
2016-01-30 02:00:00;0,79;1,3;-0,51;39077;0;0;0;0;44457;29182;0.6564;31085;-1903
2016-01-30 03:00:00;0,0;-2,5;2,5;39077;0;0;0;0;44457;29380;0.6609;31313;-1933
2016-01-30 04:00:00;-0,02;-2,57;2,55;39077;0;0;0;0;44457;30016;0.6751;31419;-1403
2016-01-30 05:00:00;-0,04;-6,56;6,52;39077;0;0;0;0;44457;30230;0.68;31332;-1102
2016-01-30 06:00:00;-2,97;-4,86;1,89;39077;0;0;0;0;44457;31789;0.715;31231;558
2016-01-30 07:00:00;8,51;-2,99;11,5;39077;4;0.0001;18;-14;44457;32090;0.7218;31173;917
2016-01-30 08:00:00;12,42;8,05;4,37;39077;635;0.0162;552;83;44457;32413;0.7291;30928;1485
2016-01-30 09:00:00;13,78;8,39;5,39;39077;2671;0.0684;2030;641;44457;31782;0.7149;30432;1350
2016-01-30 10:00:00;14,22;5,29;8,93;39077;4706;0.1204;3698;1008;44457;30788;0.6925;29749;1039
2016-01-30 11:00:00;14,69;9,36;5,33;39077;5693;0.1457;4874;819;44457;29990;0.6746;28826;1164
2016-01-30 12:00:00;14,27;10,71;3,56;39077;5320;0.1361;5102;218;44457;28881;0.6497;27573;1308
2016-01-30 13:00:00;14,6;15,56;-0,96;39077;4371;0.1118;4514;-143;44457;27798;0.6253;26500;1298
2016-01-30 14:00:00;14,28;19,81;-5,53;39077;2817;0.0721;3258;-441;44457;27678;0.6226;25464;2214
2016-01-30 15:00:00;15,37;18,77;-3,4;39077;1384;0.0354;1786;-402;44457;26752;0.6018;24539;2213
2016-01-30 16:00:00;16,03;19,65;-3,62;39077;293;0.0075;475;-182;44457;25540;0.5745;23910;1630
2016-01-30 17:00:00;18,67;24,79;-6,12;39077;8;0.0002;4;4;44457;25128;0.5652;23335;1793
2016-01-30 18:00:00;27,78;32,0;-4,22;39077;0;0;0;0;44457;25553;0.5748;23042;2511
2016-01-30 19:00:00;22,16;26,5;-4,34;39077;0;0;0;0;44457;25352;0.5702;22797;2555
2016-01-30 20:00:00;18,53;18,4;0,13;39077;0;0;0;0;44457;25704;0.5782;22557;3147
2016-01-30 21:00:00;16,21;14,5;1,71;39077;0;0;0;0;44457;25382;0.5709;22528;2854
2016-01-30 22:00:00;15,49;16,71;-1,22;39077;0;0;0;0;44457;24279;0.5461;22915;1364
2016-01-30 23:00:00;12,0;17,33;-5,33;39077;0;0;0;0;44457;24644;0.5543;23462;1182
2016-01-31 00:00:00;8,43;16,36;-7,93;39078;0;0;0;0;44457;24338;0.5474;27106;-2768
2016-01-31 01:00:00;3,04;10,19;-7,15;39078;0;0;0;0;44457;24500;0.5511;27343;-2843
2016-01-31 02:00:00;5,09;12,89;-7,8;39078;0;0;0;0;44457;24771;0.5572;27323;-2552
2016-01-31 03:00:00;0,85;9,85;-9,0;39078;0;0;0;0;44457;24614;0.5536;27200;-2586
2016-01-31 04:00:00;-0,27;8,59;-8,86;39078;0;0;0;0;44457;24742;0.5566;26999;-2257
2016-01-31 05:00:00;0,03;10,16;-10,13;39078;0;0;0;0;44457;24956;0.5614;26591;-1635
2016-01-31 06:00:00;0,08;8,99;-8,91;39078;0;0;0;0;44457;25184;0.5665;25985;-801
2016-01-31 07:00:00;6,04;11,6;-5,56;39078;3;0.0001;16;-13;44457;24304;0.5467;25194;-890
2016-01-31 08:00:00;8,33;16,06;-7,73;39078;487;0.0124;464;23;44457;23348;0.5252;24465;-1117
2016-01-31 09:00:00;10,59;18,14;-7,55;39078;1849;0.0473;1835;14;44457;22886;0.5148;23933;-1047
2016-01-31 10:00:00;11,91;17,74;-5,83;39078;3194;0.0818;3260;-66;44457;22920;0.5156;23874;-954
2016-01-31 11:00:00;14,68;19,35;-4,67;39078;3797;0.0972;4133;-336;44457;23001;0.5174;24228;-1227
2016-01-31 12:00:00;16,18;20,17;-3,99;39078;3858;0.0988;4115;-257;44457;22836;0.5136;24216;-1380
2016-01-31 13:00:00;12,5;19,25;-6,75;39078;3234;0.0828;3376;-142;44457;22051;0.496;23553;-1502
2016-01-31 14:00:00;13,96;17,9;-3,94;39078;2235;0.0572;2276;-41;44457;20347;0.4577;22143;-1796
2016-01-31 15:00:00;13,89;18,0;-4,11;39078;1058;0.0271;1152;-94;44457;18223;0.4099;20459;-2236
2016-01-31 16:00:00;16,08;19,28;-3,2;39078;234;0.006;279;-45;44457;16996;0.3823;18931;-1935
2016-01-31 17:00:00;21,44;26,14;-4,7;39078;8;0.0002;3;5;44457;16310;0.3668;17919;-1609
2016-01-31 18:00:00;26,28;27,78;-1,5;39078;0;0;0;0;44457;16277;0.3662;17180;-903
2016-01-31 19:00:00;25,48;27,64;-2,16;39078;0;0;0;0;44457;16489;0.3709;16777;-288
2016-01-31 20:00:00;21,34;21,52;-0,18;39078;0;0;0;0;44457;15947;0.3587;16424;-477
2016-01-31 21:00:00;18,04;21,71;-3,67;39078;0;0;0;0;44457;15440;0.3473;15959;-519
2016-01-31 22:00:00;18,79;21,77;-2,98;39078;0;0;0;0;44457;15268;0.3434;15334;-66
2016-01-31 23:00:00;16,45;19,33;-2,88;39078;0;0;0;0;44457;14553;0.3274;14604;-51
2016-01-02 00:00:00;16,31;15,53;0,78;39080;0;0;0;0;44465;14064;0.3163;13004;1060
2016-01-02 01:00:00;14,42;12,24;2,18;39080;0;0;0;0;44465;13730;0.3088;12053;1677
2016-01-02 02:00:00;15,07;11,39;3,68;39080;0;0;0;0;44465;13145;0.2956;11216;1929
2016-01-02 03:00:00;13,27;10,55;2,72;39080;0;0;0;0;44465;12450;0.28;10547;1903
2016-01-02 04:00:00;13,87;13,67;0,2;39080;0;0;0;0;44465;11930;0.2683;10292;1638
2016-01-02 05:00:00;14,26;19,88;-5,62;39080;0;0;0;0;44465;12058;0.2712;10915;1143
2016-01-02 06:00:00;23,93;34,42;-10,49;39080;0;0;0;0;44465;12123;0.2726;12065;58
2016-01-02 07:00:00;35,9;42,23;-6,33;39080;2;0;5;-3;44465;12819;0.2883;13782;-963
2016-01-02 08:00:00;37,99;40,89;-2,9;39080;181;0.0046;180;1;44465;15324;0.3446;16548;-1224
2016-01-02 09:00:00;36,05;35,16;0,89;39080;946;0.0242;736;210;44465;17706;0.3982;19748;-2042
2016-01-02 10:00:00;33,34;28,78;4,56;39080;1799;0.046;1459;340;44465;20348;0.4576;22911;-2563
2016-01-02 11:00:00;29,24;25,42;3,82;39080;2332;0.0597;2031;301;44465;22670;0.5098;26096;-3426
2016-01-02 12:00:00;24,99;28,43;-3,44;39080;2660;0.068;2365;295;44465;25496;0.5734;28854;-3358
2016-01-02 13:00:00;21,96;24,35;-2,39;39080;2748;0.0703;2393;355;44465;27799;0.6252;30888;-3089
2016-01-02 14:00:00;18,34;23,94;-5,6;39080;2255;0.0577;2072;183;44465;29928;0.6731;32182;-2254
2016-01-02 15:00:00;17,97;23,15;-5,18;39080;1441;0.0369;1307;134;44465;31317;0.7043;32966;-1649
2016-01-02 16:00:00;18,24;19,73;-1,49;39080;408;0.0105;372;36;44465;31939;0.7183;33218;-1279
2016-01-02 17:00:00;23,37;27,13;-3,76;39080;11;0.0003;6;5;44465;31914;0.7177;33159;-1245
2016-01-02 18:00:00;23,95;27,2;-3,25;39080;0;0;0;0;44465;32235;0.725;33169;-934
2016-01-02 19:00:00;22,65;28,19;-5,54;39080;0;0;0;0;44465;32928;0.7405;33165;-237
2016-01-02 20:00:00;17,75;20,0;-2,25;39080;0;0;0;0;44465;32724;0.736;33581;-857
2016-01-02 21:00:00;14,63;15,63;-1,0;39080;0;0;0;0;44465;32541;0.7318;33355;-814
2016-01-02 22:00:00;14,16;14,54;-0,38;39080;0;0;0;0;44465;31794;0.7151;33199;-1405
2016-01-02 23:00:00;8,44;8,3;0,14;39080;0;0;0;0;44465;31636;0.7115;33074;-1438
2016-02-02 00:00:00;4,06;4,48;-0,42;39081;0;0;0;0;44467;31215;0.702;33053;-1838
2016-02-02 01:00:00;0,3;0,55;-0,25;39081;0;0;0;0;44467;30705;0.6905;33043;-2338
2016-02-02 02:00:00;-2,66;0,21;-2,87;39081;0;0;0;0;44467;30330;0.682;33005;-2675
2016-02-02 03:00:00;-1,92;-0,52;-1,4;39081;0;0;0;0;44467;30124;0.6774;32839;-2715
2016-02-02 04:00:00;0,09;-0,15;0,24;39081;0;0;0;0;44467;29534;0.6642;32620;-3086
2016-02-02 05:00:00;9,52;5,64;3,88;39081;0;0;0;0;44467;29690;0.6677;32345;-2655
2016-02-02 06:00:00;15,68;19,87;-4,19;39081;0;0;0;0;44467;30366;0.6829;32036;-1670
2016-02-02 07:00:00;22,92;35,79;-12,87;39081;4;0.0001;16;-12;44467;29804;0.6702;31853;-2049
2016-02-02 08:00:00;22,99;31,16;-8,17;39081;440;0.0112;444;-4;44467;29322;0.6594;31807;-2485
2016-02-02 09:00:00;22,15;30,02;-7,87;39081;1739;0.0445;1577;162;44467;29118;0.6548;31850;-2732
2016-02-02 10:00:00;22,16;28,79;-6,63;39081;3165;0.081;2940;225;44467;29054;0.6534;31821;-2767
2016-02-02 11:00:00;22,53;27,12;-4,59;39081;4488;0.1148;4019;469;44467;29110;0.6546;31706;-2596
2016-02-02 12:00:00;22,08;24,15;-2,07;39081;4979;0.1274;4419;560;44467;28598;0.6431;31539;-2941
2016-02-02 13:00:00;22,09;24,99;-2,9;39081;4387;0.1122;4421;-34;44467;28287;0.6362;31548;-3261
2016-02-02 14:00:00;22,19;25,69;-3,5;39081;3490;0.0893;3559;-69;44467;27882;0.627;31506;-3624
2016-02-02 15:00:00;23,35;25,67;-2,32;39081;2108;0.0539;2059;49;44467;27441;0.6171;31209;-3768
2016-02-02 16:00:00;23,31;27,0;-3,69;39081;571;0.0146;599;-28;44467;27414;0.6165;30762;-3348
2016-02-02 17:00:00;28,42;34,77;-6,35;39081;16;0.0004;12;4;44467;28224;0.6347;30452;-2228
2016-02-02 18:00:00;29,99;34,04;-4,05;39081;0;0;0;0;44467;28388;0.6384;30384;-1996
2016-02-02 19:00:00;24,61;30,33;-5,72;39081;0;0;0;0;44467;29349;0.66;30642;-1293
2016-02-02 20:00:00;22,51;26,77;-4,26;39081;0;0;0;0;44467;29300;0.6589;30537;-1237
2016-02-02 21:00:00;17,59;23,4;-5,81;39081;0;0;0;0;44467;29058;0.6535;30375;-1317
2016-02-02 22:00:00;14,18;20,82;-6,64;39081;0;0;0;0;44467;28504;0.641;30155;-1651
2016-02-02 23:00:00;9,53;15,38;-5,85;39081;0;0;0;0;44467;28434;0.6395;29943;-1509
2016-03-02 00:00:00;13,75;18,09;-4,34;39082;0;0;0;0;44472;27785;0.6248;29688;-1903
2016-03-02 01:00:00;11,58;16,42;-4,84;39082;0;0;0;0;44472;27733;0.6236;29344;-1611
2016-03-02 02:00:00;8,09;14,67;-6,58;39082;0;0;0;0;44472;26864;0.6041;28803;-1939
2016-03-02 03:00:00;6,93;15,34;-8,41;39082;0;0;0;0;44472;26042;0.5856;28290;-2248
2016-03-02 04:00:00;9,04;16,33;-7,29;39082;0;0;0;0;44472;24558;0.5522;27769;-3211
2016-03-02 05:00:00;13,74;22,37;-8,63;39082;0;0;0;0;44472;23470;0.5277;27096;-3626
2016-03-02 06:00:00;21,41;34,27;-12,86;39082;0;0;0;0;44472;22626;0.5088;26355;-3729
2016-03-02 07:00:00;33,25;41,73;-8,48;39082;6;0.0002;24;-18;44472;21860;0.4916;25625;-3765
2016-03-02 08:00:00;35,0;43,73;-8,73;39082;512;0.0131;662;-150;44472;20982;0.4718;25073;-4091
2016-03-02 09:00:00;33,96;40,65;-6,69;39082;1971;0.0504;2556;-585;44472;20464;0.4602;24948;-4484
2016-03-02 10:00:00;25,44;36,92;-11,48;39082;3691;0.0944;4537;-846;44472;20989;0.4719;25377;-4388
2016-03-02 11:00:00;22,93;35,12;-12,19;39082;5246;0.1342;6086;-840;44472;21847;0.4912;26002;-4155
2016-03-02 12:00:00;21,46;28,82;-7,36;39082;5783;0.148;6682;-899;44472;23191;0.5215;26429;-3238
2016-03-02 13:00:00;20,95;25,81;-4,86;39082;5410;0.1384;6268;-858;44472;23083;0.519;26237;-3154
2016-03-02 14:00:00;22,93;27,06;-4,13;39082;4523;0.1158;4970;-447;44472;22030;0.4954;25342;-3312
2016-03-02 15:00:00;23,02;29,45;-6,43;39082;2871;0.0735;3020;-149;44472;20933;0.4707;24021;-3088
2016-03-02 16:00:00;26,4;29,48;-3,08;39082;814;0.0208;890;-76;44472;20032;0.4504;22662;-2630
2016-03-02 17:00:00;32,62;35,41;-2,79;39082;32;0.0008;24;8;44472;19782;0.4448;21871;-2089
2016-03-02 18:00:00;36,69;37,42;-0,73;39082;0;0;0;0;44472;20728;0.4661;21449;-721
2016-03-02 19:00:00;36,19;35,86;0,33;39082;0;0;0;0;44472;21476;0.4829;21221;255
2016-03-02 20:00:00;30,13;27,7;2,43;39082;0;0;0;0;44472;22002;0.4948;21220;782
2016-03-02 21:00:00;23,75;26,27;-2,52;39082;0;0;0;0;44472;21936;0.4932;21321;615
2016-03-02 22:00:00;22,41;26,6;-4,19;39082;0;0;0;0;44472;21385;0.4809;21370;15
2016-03-02 23:00:00;17,13;22,48;-5,35;39082;0;0;0;0;44472;20732;0.4662;21255;-523
2016-04-02 00:00:00;18,04;24,19;-6,15;39084;0;0;0;0;44491;20226;0.4546;19503;723
2016-04-02 01:00:00;16,38;22,06;-5,68;39084;0;0;0;0;44491;19654;0.4418;19464;190
2016-04-02 02:00:00;15,99;17,55;-1,56;39084;0;0;0;0;44491;19360;0.4352;19427;-67
2016-04-02 03:00:00;15,29;15,43;-0,14;39084;0;0;0;0;44491;19754;0.444;19461;293
2016-04-02 04:00:00;13,93;12,94;0,99;39084;0;0;0;0;44491;19653;0.4417;19498;155
2016-04-02 05:00:00;17,01;19,03;-2,02;39084;0;0;0;0;44491;19693;0.4426;19308;385
2016-04-02 06:00:00;22,43;25,73;-3,3;39084;0;0;0;0;44491;19853;0.4462;18986;867
2016-04-02 07:00:00;31,96;32,19;-0,23;39084;8;0.0002;24;-16;44491;19832;0.4458;18445;1387
2016-04-02 08:00:00;30,91;29,0;1,91;39084;305;0.0078;461;-156;44491;19152;0.4305;17704;1448
2016-04-02 09:00:00;27,93;25,74;2,19;39084;1250;0.032;1550;-300;44491;18534;0.4166;17053;1481
2016-04-02 10:00:00;29,19;26,0;3,19;39084;2213;0.0566;2713;-500;44491;17584;0.3952;16729;855
2016-04-02 11:00:00;30,22;29,16;1,06;39084;2832;0.0725;3552;-720;44491;16815;0.3779;16647;168
2016-04-02 12:00:00;27,97;30,49;-2,52;39084;3063;0.0784;3642;-579;44491;16259;0.3654;16200;59
2016-04-02 13:00:00;26,87;30,74;-3,87;39084;2594;0.0664;3088;-494;44491;15398;0.3461;15110;288
2016-04-02 14:00:00;25,85;31,41;-5,56;39084;1706;0.0436;2161;-455;44491;14263;0.3206;13469;794
2016-04-02 15:00:00;27,94;32,98;-5,04;39084;942;0.0241;1165;-223;44491;13446;0.3022;11858;1588
2016-04-02 16:00:00;27,81;33,24;-5,43;39084;269;0.0069;336;-67;44491;12863;0.2891;10525;2338
2016-04-02 17:00:00;35,0;36,76;-1,76;39084;12;0.0003;14;-2;44491;11540;0.2594;9539;2001
2016-04-02 18:00:00;42,18;41,29;0,89;39084;0;0;0;0;44491;11197;0.2516;8850;2347
2016-04-02 19:00:00;39,01;40,73;-1,72;39084;0;0;0;0;44491;11275;0.2534;8548;2727
2016-04-02 20:00:00;32,04;31,83;0,21;39084;0;0;0;0;44491;11196;0.2516;8240;2956
2016-04-02 21:00:00;26,96;27,77;-0,81;39084;0;0;0;0;44491;10463;0.2352;7902;2561
2016-04-02 22:00:00;27,83;27,68;0,15;39084;0;0;0;0;44491;9538;0.2144;7512;2026
2016-04-02 23:00:00;23,98;25,94;-1,96;39084;0;0;0;0;44491;8908;0.2002;7024;1884
2016-05-02 00:00:00;24,61;23,53;1,08;39085;0;0;0;0;44501;8179;0.1838;7239;940
2016-05-02 01:00:00;23,0;21,25;1,75;39085;0;0;0;0;44501;7862;0.1767;6787;1075
2016-05-02 02:00:00;22,22;21,33;0,89;39085;0;0;0;0;44501;7374;0.1657;6606;768
2016-05-02 03:00:00;20,1;20,6;-0,5;39085;0;0;0;0;44501;6951;0.1562;6600;351
2016-05-02 04:00:00;21,18;21,62;-0,44;39085;0;0;0;0;44501;6767;0.1521;6810;-43
2016-05-02 05:00:00;21,18;21,89;-0,71;39085;0;0;0;0;44501;7232;0.1625;7221;11
2016-05-02 06:00:00;25,97;24,56;1,41;39085;0;0;0;0;44501;8272;0.1859;7746;526
2016-05-02 07:00:00;33,92;29,87;4,05;39085;12;0.0003;22;-10;44501;9302;0.209;8370;932
2016-05-02 08:00:00;37,48;29,92;7,56;39085;492;0.0126;420;72;44501;10422;0.2342;9002;1420
2016-05-02 09:00:00;35,25;26,45;8,8;39085;1666;0.0426;1286;380;44501;11042;0.2481;9559;1483
2016-05-02 10:00:00;36,5;26,21;10,29;39085;2665;0.0682;2286;379;44501;11222;0.2522;10024;1198
2016-05-02 11:00:00;35,94;28,42;7,52;39085;3675;0.094;2962;713;44501;12252;0.2753;10453;1799
2016-05-02 12:00:00;34,36;25,85;8,51;39085;4322;0.1106;3014;1308;44501;13045;0.2932;10878;2167
2016-05-02 13:00:00;31,95;24,17;7,78;39085;4336;0.111;2662;1674;44501;13329;0.2995;11196;2133
2016-05-02 14:00:00;27,74;21,56;6,18;39085;3156;0.0807;2029;1127;44501;12984;0.2918;11404;1580
2016-05-02 15:00:00;25,33;23,39;1,94;39085;1774;0.0454;1240;534;44501;12616;0.2835;11619;997
2016-05-02 16:00:00;24,78;24,69;0,09;39085;549;0.014;442;107;44501;12451;0.2798;12000;451
2016-05-02 17:00:00;29,96;26,7;3,26;39085;14;0.0004;24;-10;44501;12845;0.2886;12445;400
2016-05-02 18:00:00;33,09;30,2;2,89;39085;0;0;0;0;44501;13391;0.3009;12839;552
2016-05-02 19:00:00;28,01;28,05;-0,04;39085;0;0;0;0;44501;13561;0.3047;13129;432
2016-05-02 20:00:00;25,7;27,59;-1,89;39085;0;0;0;0;44501;13872;0.3117;13159;713
2016-05-02 21:00:00;23,12;26,67;-3,55;39085;0;0;0;0;44501;13364;0.3003;13237;127
2016-05-02 22:00:00;24,55;30,14;-5,59;39085;0;0;0;0;44501;13223;0.2971;13335;-112
2016-05-02 23:00:00;22,71;30,34;-7,63;39085;0;0;0;0;44501;13151;0.2955;13426;-275
2016-06-02 00:00:00;18,18;26,41;-8,23;39085;0;0;0;0;44504;13477;0.3028;13796;-319
2016-06-02 01:00:00;15,55;19,36;-3,81;39085;0;0;0;0;44504;13499;0.3033;14049;-550
2016-06-02 02:00:00;16,01;19,5;-3,49;39085;0;0;0;0;44504;13761;0.3092;14684;-923
2016-06-02 03:00:00;14,33;13,86;0,47;39085;0;0;0;0;44504;14254;0.3203;15375;-1121
2016-06-02 04:00:00;13,78;14,0;-0,22;39085;0;0;0;0;44504;14770;0.3319;15900;-1130
2016-06-02 05:00:00;13,98;14,14;-0,16;39085;0;0;0;0;44504;15485;0.348;16352;-867
2016-06-02 06:00:00;15,05;13,94;1,11;39085;0;0;0;0;44504;15883;0.3569;16612;-729
2016-06-02 07:00:00;16,08;18,69;-2,61;39085;38;0.001;64;-26;44504;16409;0.3687;16879;-470
2016-06-02 08:00:00;18,02;27,09;-9,07;39085;1435;0.0368;1374;61;44504;17033;0.3828;17270;-237
2016-06-02 09:00:00;19,34;24,82;-5,48;39085;4259;0.109;4486;-227;44504;16979;0.3815;17456;-477
2016-06-02 10:00:00;17,1;24,65;-7,55;39085;7286;0.1864;7896;-610;44504;16278;0.3658;17460;-1182
2016-06-02 11:00:00;16,5;22,21;-5,71;39085;9476;0.2424;10570;-1094;44504;16069;0.3611;17140;-1071
2016-06-02 12:00:00;16,09;17,3;-1,21;39085;10496;0.2686;11807;-1311;44504;16216;0.3644;16570;-354
2016-06-02 13:00:00;15,11;15,04;0,07;39085;10621;0.2717;11583;-962;44504;15993;0.3594;16215;-222
2016-06-02 14:00:00;13,99;10,0;3,99;39085;9100;0.2328;9624;-524;44504;16076;0.3612;16254;-178
2016-06-02 15:00:00;15,29;12,9;2,39;39085;5734;0.1467;6175;-441;44504;15751;0.3539;16480;-729
2016-06-02 16:00:00;17,01;16,3;0,71;39085;1720;0.044;2140;-420;44504;15499;0.3483;16844;-1345
2016-06-02 17:00:00;19,97;28,35;-8,38;39085;60;0.0015;91;-31;44504;16906;0.3799;17595;-689
2016-06-02 18:00:00;23,15;26,67;-3,52;39085;0;0;0;0;44504;18713;0.4205;18518;195
2016-06-02 19:00:00;21,02;23,04;-2,02;39085;0;0;0;0;44504;19909;0.4474;19454;455
2016-06-02 20:00:00;16,07;13,78;2,29;39085;0;0;0;0;44504;20982;0.4715;20221;761
2016-06-02 21:00:00;12,71;6,35;6,36;39085;0;0;0;0;44504;21360;0.48;20750;610
2016-06-02 22:00:00;15,04;16,21;-1,17;39085;0;0;0;0;44504;21124;0.4746;21035;89
2016-06-02 23:00:00;11,74;14,55;-2,81;39085;0;0;0;0;44504;21370;0.4802;21148;222
2016-07-02 00:00:00;5,01;5,97;-0,96;39085;0;0;0;0;44507;21808;0.49;21588;220
2016-07-02 01:00:00;5,98;4,43;1,55;39085;0;0;0;0;44507;21905;0.4922;21794;111
2016-07-02 02:00:00;5,62;5,44;0,18;39085;0;0;0;0;44507;21959;0.4934;21909;50
2016-07-02 03:00:00;3,05;3,12;-0,07;39085;0;0;0;0;44507;22072;0.4959;22049;23
2016-07-02 04:00:00;0,93;4,14;-3,21;39085;0;0;0;0;44507;22223;0.4993;22229;-6
2016-07-02 05:00:00;0,08;2,46;-2,38;39085;0;0;0;0;44507;22516;0.5059;22272;244
2016-07-02 06:00:00;-0,92;1,59;-2,51;39085;0;0;0;0;44507;22919;0.515;22229;690
2016-07-02 07:00:00;1,13;2,77;-1,64;39085;35;0.0009;70;-35;44507;23406;0.5259;22159;1247
2016-07-02 08:00:00;5,74;-2,15;7,89;39085;1232;0.0316;1263;-31;44507;22946;0.5156;21744;1202
2016-07-02 09:00:00;8,01;-2,71;10,72;39085;3475;0.0889;3558;-83;44507;21465;0.4823;20896;569
2016-07-02 10:00:00;12,92;4,48;8,44;39085;5508;0.1409;5769;-261;44507;19390;0.4356;19842;-452
2016-07-02 11:00:00;13,79;6,94;6,85;39085;6566;0.168;7374;-808;44507;18259;0.4102;18860;-601
2016-07-02 12:00:00;13,84;14,94;-1,1;39085;6976;0.1785;7828;-852;44507;17959;0.4035;18190;-231
2016-07-02 13:00:00;12,19;8,71;3,48;39085;6331;0.162;7121;-790;44507;18453;0.4146;18013;440
2016-07-02 14:00:00;11,76;6,88;4,88;39085;4471;0.1144;5499;-1028;44507;19231;0.4321;18214;1017
2016-07-02 15:00:00;10,01;5,1;4,91;39085;2567;0.0657;3335;-768;44507;19668;0.4419;18487;1181
2016-07-02 16:00:00;13,32;2,85;10,47;39085;860;0.022;1123;-263;44507;19890;0.4469;18829;1061
2016-07-02 17:00:00;16,64;10,87;5,77;39085;53;0.0014;75;-22;44507;20242;0.4548;19285;957
2016-07-02 18:00:00;22,17;12,47;9,7;39085;0;0;0;0;44507;21006;0.472;20123;883
2016-07-02 19:00:00;17,28;11,62;5,66;39085;0;0;0;0;44507;22314;0.5014;21201;1113
2016-07-02 20:00:00;17,88;9,77;8,11;39085;0;0;0;0;44507;22808;0.5125;22309;499
2016-07-02 21:00:00;13,79;8,68;5,11;39085;0;0;0;0;44507;23425;0.5264;23373;52
2016-07-02 22:00:00;15,04;10,42;4,62;39085;0;0;0;0;44507;23082;0.5186;24359;-1277
2016-07-02 23:00:00;9,29;7,2;2,09;39085;0;0;0;0;44507;23779;0.5343;25198;-1419
2016-08-02 00:00:00;10,02;6,51;3,51;39086;0;0;0;0;44512;25050;0.5628;24830;220
2016-08-02 01:00:00;7,99;-1,16;9,15;39086;0;0;0;0;44512;26199;0.5886;25889;310
2016-08-02 02:00:00;5,24;-15,24;20,48;39086;0;0;0;0;44512;27201;0.6111;27085;116
2016-08-02 03:00:00;1,16;-26,51;27,67;39086;0;0;0;0;44512;28770;0.6463;28240;530
2016-08-02 04:00:00;1,4;-24,12;25,52;39086;0;0;0;0;44512;29938;0.6726;29351;587
2016-08-02 05:00:00;7,32;-21,61;28,93;39086;0;0;0;0;44512;30778;0.6914;30314;464
2016-08-02 06:00:00;12,32;-2,78;15,1;39086;0;0;0;0;44512;32157;0.7224;31264;893
2016-08-02 07:00:00;16,17;4,43;11,74;39086;32;0.0008;62;-30;44512;32838;0.7377;32258;580
2016-08-02 08:00:00;16,55;3,17;13,38;39086;1098;0.0281;987;111;44512;32551;0.7313;32635;-84
2016-08-02 09:00:00;16,41;8,17;8,24;39086;2620;0.067;2606;14;44512;31979;0.7184;32799;-820
2016-08-02 10:00:00;16,56;10,81;5,75;39086;3783;0.0968;4106;-323;44512;31654;0.7111;32649;-995
2016-08-02 11:00:00;16,61;11,35;5,26;39086;5109;0.1307;5265;-156;44512;31185;0.7006;32458;-1273
2016-08-02 12:00:00;16,35;8,89;7,46;39086;6139;0.1571;5752;387;44512;31443;0.7064;32488;-1045
2016-08-02 13:00:00;16,1;7,39;8,71;39086;5999;0.1535;5407;592;44512;31182;0.7006;32518;-1336
2016-08-02 14:00:00;16,15;6,75;9,4;39086;4418;0.1131;4196;222;44512;31595;0.7098;32289;-694
2016-08-02 15:00:00;16,35;9,39;6,96;39086;2297;0.0588;2537;-240;44512;30876;0.6937;31998;-1122
2016-08-02 16:00:00;15,94;10,41;5,53;39086;739;0.0189;980;-241;44512;30703;0.6898;31766;-1063
2016-08-02 17:00:00;20,88;14,06;6,82;39086;46;0.0012;81;-35;44512;31031;0.6972;31826;-795
2016-08-02 18:00:00;27,26;16,62;10,64;39086;0;0;0;0;44512;31456;0.7067;32054;-598
2016-08-02 19:00:00;21,02;11,77;9,25;39086;0;0;0;0;44512;32301;0.7257;32412;-111
2016-08-02 20:00:00;15,24;4,35;10,89;39086;0;0;0;0;44512;32560;0.7315;32917;-357
2016-08-02 21:00:00;12,52;3,77;8,75;39086;0;0;0;0;44512;33626;0.7554;33372;254
2016-08-02 22:00:00;12,11;1,84;10,27;39086;0;0;0;0;44512;33461;0.7517;33619;-158
2016-08-02 23:00:00;9,72;-10,45;20,17;39086;0;0;0;0;44512;33258;0.7472;33635;-377
2016-09-02 00:00:00;-19,94;-13,66;-6,28;39087;0;0;0;0;44522;32914;0.7393;33954;-1040
2016-09-02 01:00:00;-12,34;-8,58;-3,76;39087;0;0;0;0;44522;33110;0.7437;33794;-684
2016-09-02 02:00:00;-19,95;-9,78;-10,17;39087;0;0;0;0;44522;32852;0.7379;33468;-616
2016-09-02 03:00:00;-19,3;-9,78;-9,52;39087;0;0;0;0;44522;32503;0.7301;32972;-469
2016-09-02 04:00:00;-5,52;-6,11;0,59;39087;0;0;0;0;44522;31980;0.7183;32326;-346
2016-09-02 05:00:00;2,79;1,31;1,48;39087;0;0;0;0;44522;31616;0.7102;31504;112
2016-09-02 06:00:00;16,98;21,62;-4,64;39087;0;0;0;0;44522;31238;0.7016;30545;693
2016-09-02 07:00:00;19,75;26,8;-7,05;39087;40;0.0011;62;-22;44522;29166;0.6551;29131;35
2016-09-02 08:00:00;23,43;31,26;-7,83;39087;1013;0.0259;1017;-4;44522;26749;0.6008;27520;-771
2016-09-02 09:00:00;20,99;31,72;-10,73;39087;2827;0.0723;2799;28;44522;24804;0.5571;26139;-1335
2016-09-02 10:00:00;23,9;30,24;-6,34;39087;4476;0.1145;4223;253;44522;23088;0.5186;24948;-1860
2016-09-02 11:00:00;24,93;29,49;-4,56;39087;4520;0.1156;4917;-397;44522;21694;0.4872;23817;-2123
2016-09-02 12:00:00;27,03;34,24;-7,21;39087;3896;0.0997;4535;-639;44522;19287;0.4332;22470;-3183
2016-09-02 13:00:00;28,69;37,46;-8,77;39087;3051;0.0781;3705;-654;44522;17667;0.3968;20315;-2648
2016-09-02 14:00:00;27,44;35,65;-8,21;39087;1811;0.0463;2719;-908;44522;17512;0.3934;17939;-427
2016-09-02 15:00:00;26,97;33,33;-6,36;39087;974;0.0249;1587;-613;44522;18343;0.412;16457;1886
2016-09-02 16:00:00;27,24;26,34;0,9;39087;339;0.0087;551;-212;44522;19866;0.4462;16207;3659
2016-09-02 17:00:00;31,01;25,56;5,45;39087;24;0.0006;52;-28;44522;21646;0.4862;16757;4889
2016-09-02 18:00:00;39,98;29,89;10,09;39087;0;0;0;0;44522;23182;0.5207;17512;5670
2016-09-02 19:00:00;34,06;26,6;7,46;39087;0;0;0;0;44522;25269;0.5676;18276;6993
2016-09-02 20:00:00;28,77;19,88;8,89;39087;0;0;0;0;44522;27403;0.6155;18879;8524
2016-09-02 21:00:00;23,97;14,63;9,34;39087;0;0;0;0;44522;27126;0.6093;19779;7347
2016-09-02 22:00:00;20,78;11,01;9,77;39087;0;0;0;0;44522;26534;0.596;20394;6140
2016-09-02 23:00:00;15,99;7,15;8,84;39087;0;0;0;0;44522;26272;0.5901;20586;5686
2016-10-02 00:00:00;13,08;3,61;9,47;39090;0;0;0;0;44535;25460;0.5717;21159;4301
2016-10-02 01:00:00;13,68;8,83;4,85;39090;0;0;0;0;44535;24426;0.5485;20655;3771
2016-10-02 02:00:00;13,06;10,84;2,22;39090;0;0;0;0;44535;22916;0.5145;19598;3318
2016-10-02 03:00:00;13,41;13,4;0,01;39090;0;0;0;0;44535;21844;0.4905;18314;3530
2016-10-02 04:00:00;14,3;10,45;3,85;39090;0;0;0;0;44535;19613;0.4404;17135;2478
2016-10-02 05:00:00;16,2;13,83;2,37;39090;0;0;0;0;44535;18176;0.4082;16169;2007
2016-10-02 06:00:00;22,8;19,81;2,99;39090;0;0;0;0;44535;17942;0.4029;15416;2526
2016-10-02 07:00:00;30,59;29,72;0,87;39090;33;0.0008;62;-29;44535;17458;0.392;14997;2461
2016-10-02 08:00:00;32,05;29,79;2,26;39090;759;0.0195;1034;-275;44535;16715;0.3753;14781;1934
2016-10-02 09:00:00;32,42;29,03;3,39;39090;2196;0.0562;2857;-661;44535;16135;0.3623;14789;1346
2016-10-02 10:00:00;30,94;29,8;1,14;39090;4215;0.1078;4685;-470;44535;15844;0.3558;14764;1080
2016-10-02 11:00:00;29,98;30,05;-0,07;39090;5438;0.1391;5966;-528;44535;16206;0.3639;14585;1621
2016-10-02 12:00:00;25,97;27,37;-1,4;39090;5352;0.1369;6287;-935;44535;15931;0.3577;14172;1759
2016-10-02 13:00:00;27,74;29,12;-1,38;39090;4529;0.1158;5759;-1230;44535;15596;0.3502;13546;2050
2016-10-02 14:00:00;27,44;29,49;-2,05;39090;3327;0.0851;4558;-1231;44535;15193;0.3411;12574;2619
2016-10-02 15:00:00;27,77;27,45;0,32;39090;2012;0.0515;2841;-829;44535;14222;0.3194;11716;2506
2016-10-02 16:00:00;28,68;27,49;1,19;39090;724;0.0185;1002;-278;44535;13315;0.299;11253;2062
2016-10-02 17:00:00;32,1;33,15;-1,05;39090;56;0.0015;86;-30;44535;13246;0.2974;11240;2006
2016-10-02 18:00:00;36,59;39,91;-3,32;39090;0;0;0;0;44535;13896;0.312;11521;2375
2016-10-02 19:00:00;29,44;34,9;-5,46;39090;0;0;0;0;44535;14630;0.3285;12051;2579
2016-10-02 20:00:00;23,18;26,09;-2,91;39090;0;0;0;0;44535;15377;0.3453;12787;2590
2016-10-02 21:00:00;21,66;25,08;-3,42;39090;0;0;0;0;44535;15338;0.3444;13393;1945
2016-10-02 22:00:00;21,94;25,94;-4,0;39090;0;0;0;0;44535;15853;0.356;13937;1916
2016-10-02 23:00:00;18,88;21,93;-3,05;39090;0;0;0;0;44535;16401;0.3683;14522;1879
2016-11-02 00:00:00;17,72;20,14;-2,42;39092;0;0;0;0;44555;16586;0.3723;14308;2278
2016-11-02 01:00:00;17,46;16,55;0,91;39092;0;0;0;0;44555;16893;0.3791;14974;1919
2016-11-02 02:00:00;16,91;17,09;-0,18;39092;0;0;0;0;44555;17480;0.3923;15464;2016
2016-11-02 03:00:00;16,97;15,01;1,96;39092;0;0;0;0;44555;17638;0.3959;15864;1774
2016-11-02 04:00:00;17,66;14,93;2,73;39092;0;0;0;0;44555;17766;0.3988;16217;1549
2016-11-02 05:00:00;18,55;17,46;1,09;39092;0;0;0;0;44555;17167;0.3853;16209;958
2016-11-02 06:00:00;20,84;23,7;-2,86;39092;0;0;0;0;44555;17270;0.3876;15989;1281
2016-11-02 07:00:00;30,82;33,44;-2,62;39092;32;0.0008;75;-43;44555;16751;0.376;15756;995
2016-11-02 08:00:00;25,34;31,88;-6,54;39092;899;0.023;1189;-290;44555;15368;0.3449;15852;-484
2016-11-02 09:00:00;22,84;31,34;-8,5;39092;3072;0.0786;3434;-362;44555;14823;0.3327;16158;-1335
2016-11-02 10:00:00;21,12;31,12;-10,0;39092;5480;0.1402;5762;-282;44555;15138;0.3397;16269;-1131
2016-11-02 11:00:00;24,74;30,72;-5,98;39092;7117;0.1821;7647;-530;44555;15534;0.3486;16202;-668
2016-11-02 12:00:00;23,72;29,02;-5,3;39092;7675;0.1963;8547;-872;44555;16317;0.3662;15936;381
2016-11-02 13:00:00;23,01;26,1;-3,09;39092;7497;0.1918;8307;-810;44555;15929;0.3575;15465;464
2016-11-02 14:00:00;21,03;24,16;-3,13;39092;6380;0.1632;6909;-529;44555;14798;0.3322;14402;396
2016-11-02 15:00:00;30,0;22,51;7,49;39092;4250;0.1088;4689;-439;44555;13115;0.2944;12937;178
2016-11-02 16:00:00;31,58;24,66;6,92;39092;1562;0.04;1906;-344;44555;10306;0.2313;11498;-1192
2016-11-02 17:00:00;36,0;27,56;8,44;39092;82;0.0021;162;-80;44555;9109;0.2044;10508;-1399
2016-11-02 18:00:00;41,02;40,57;0,45;39092;0;0;0;0;44555;9056;0.2033;9920;-864
2016-11-02 19:00:00;41,34;38,09;3,25;39092;0;0;0;0;44555;8845;0.1985;9453;-608
2016-11-02 20:00:00;32,98;32,21;0,77;39092;0;0;0;0;44555;8740;0.1962;9324;-584
2016-11-02 21:00:00;29,96;25,74;4,22;39092;0;0;0;0;44555;8842;0.1984;9179;-337
2016-11-02 22:00:00;29,46;25,51;3,95;39092;0;0;0;0;44555;8605;0.1932;8868;-263
2016-11-02 23:00:00;26,1;24,53;1,57;39092;0;0;0;0;44555;8298;0.1862;8443;-145
2016-12-02 00:00:00;22,81;22,26;0,55;39095;0;0;0;0;44560;7431;0.1667;6952;479
2016-12-02 01:00:00;21,59;20,14;1,45;39095;0;0;0;0;44560;6888;0.1546;6396;492
2016-12-02 02:00:00;21,3;18,91;2,39;39095;0;0;0;0;44560;6255;0.1404;5904;351
2016-12-02 03:00:00;19,86;17,84;2,02;39095;0;0;0;0;44560;5748;0.129;5424;324
2016-12-02 04:00:00;20,69;18,42;2,27;39095;0;0;0;0;44560;5298;0.1188;4999;299
2016-12-02 05:00:00;21,64;19,68;1,96;39095;0;0;0;0;44560;4880;0.1095;4686;194
2016-12-02 06:00:00;27,18;24,54;2,64;39095;0;0;0;0;44560;4760;0.1068;4401;359
2016-12-02 07:00:00;36,43;37,18;-0,75;39095;51;0.0013;108;-57;44560;4396;0.0987;4098;298
2016-12-02 08:00:00;37,3;35,57;1,73;39095;1446;0.037;1593;-147;44560;3874;0.087;3744;130
2016-12-02 09:00:00;34,97;33,02;1,95;39095;4415;0.113;4619;-204;44560;3055;0.0686;3330;-275
2016-12-02 10:00:00;34,7;31,79;2,91;39095;8364;0.214;8077;287;44560;2416;0.0542;2889;-473
2016-12-02 11:00:00;33,48;26,31;7,17;39095;11454;0.293;10867;587;44560;1860;0.0418;2417;-557
2016-12-02 12:00:00;30,0;24,77;5,23;39095;12608;0.3225;11939;669;44560;1732;0.0389;2065;-333
2016-12-02 13:00:00;26,93;22,84;4,09;39095;11638;0.2977;11394;244;44560;1647;0.037;1701;-54
2016-12-02 14:00:00;25,62;22,01;3,61;39095;9091;0.2326;9359;-268;44560;1548;0.0348;1494;54
2016-12-02 15:00:00;25,0;23,51;1,49;39095;5523;0.1413;6225;-702;44560;1676;0.0376;1338;338
2016-12-02 16:00:00;27,18;23,52;3,66;39095;1728;0.0442;2538;-810;44560;1886;0.0423;1285;601
2016-12-02 17:00:00;34,56;28,36;6,2;39095;87;0.0022;216;-129;44560;2374;0.0533;1477;897
2016-12-02 18:00:00;40,36;37,91;2,45;39095;0;0;0;0;44560;3194;0.0717;1822;1372
2016-12-02 19:00:00;35,56;29,4;6,16;39095;0;0;0;0;44560;3706;0.0832;2131;1575
2016-12-02 20:00:00;29,96;25,11;4,85;39095;0;0;0;0;44560;3894;0.0874;2309;1585
2016-12-02 21:00:00;26,45;22,53;3,92;39095;0;0;0;0;44560;3676;0.0825;2369;1307
2016-12-02 22:00:00;27,18;22,77;4,41;39095;0;0;0;0;44560;3562;0.0799;2384;1178
2016-12-02 23:00:00;25,45;22,46;2,99;39095;0;0;0;0;44560;3297;0.074;2384;913
2016-02-13 00:00:00;22,23;24,2;-1,97;39095;0;0;0;0;44560;2871;0.0644;2262;609
2016-02-13 01:00:00;21,1;23,36;-2,26;39095;0;0;0;0;44560;2517;0.0565;2235;282
2016-02-13 02:00:00;20,21;22,52;-2,31;39095;0;0;0;0;44560;2331;0.0523;2333;-2
2016-02-13 03:00:00;19,94;20,69;-0,75;39095;0;0;0;0;44560;2247;0.0504;2534;-287
2016-02-13 04:00:00;19,9;19,99;-0,09;39095;0;0;0;0;44560;2308;0.0518;2768;-460
2016-02-13 05:00:00;19,98;20,05;-0,07;39095;0;0;0;0;44560;2501;0.0561;3116;-615
2016-02-13 06:00:00;19,9;22,53;-2,63;39095;0;0;0;0;44560;2717;0.061;3550;-833
2016-02-13 07:00:00;21,48;22,32;-0,84;39095;53;0.0014;96;-43;44560;2974;0.0668;3909;-935
2016-02-13 08:00:00;28,38;23,63;4,75;39095;1202;0.0308;1273;-71;44560;3136;0.0704;4176;-1040
2016-02-13 09:00:00;30,36;26,88;3,48;39095;4049;0.1036;3728;321;44560;3123;0.0701;4323;-1200
2016-02-13 10:00:00;30,09;28,48;1,61;39095;6894;0.1763;6234;660;44560;2958;0.0664;4453;-1495
2016-02-13 11:00:00;29,84;26,62;3,22;39095;8801;0.2251;8027;774;44560;3124;0.0701;4643;-1519
2016-02-13 12:00:00;26,75;25,57;1,18;39095;9555;0.2444;8577;978;44560;3679;0.0826;4990;-1311
2016-02-13 13:00:00;23,93;20,73;3,2;39095;8408;0.2151;8048;360;44560;4471;0.1004;5501;-1030
2016-02-13 14:00:00;21,37;20,39;0,98;39095;5959;0.1524;6430;-471;44560;5683;0.1275;6234;-551
2016-02-13 15:00:00;21,15;22,86;-1,71;39095;3289;0.0841;4056;-767;44560;7198;0.1615;7141;57
2016-02-13 16:00:00;20,96;21,43;-0,47;39095;1089;0.0278;1584;-495;44560;9292;0.2086;8251;1041
2016-02-13 17:00:00;24,69;21,23;3,46;39095;74;0.0019;146;-72;44560;11491;0.2579;9633;1858
2016-02-13 18:00:00;29,65;24,49;5,16;39095;0;0;0;0;44560;13254;0.2975;11142;2112
2016-02-13 19:00:00;24,61;18,58;6,03;39095;0;0;0;0;44560;14291;0.3207;12153;2138
2016-02-13 20:00:00;19,91;14,5;5,41;39095;0;0;0;0;44560;14349;0.322;12267;2082
2016-02-13 21:00:00;18,7;14,15;4,55;39095;0;0;0;0;44560;14296;0.3208;11877;2419
2016-02-13 22:00:00;18,47;13,1;5,37;39095;0;0;0;0;44560;13990;0.314;11484;2506
2016-02-13 23:00:00;16,88;11,91;4,97;39095;0;0;0;0;44560;13884;0.3116;11159;2725
2016-02-14 00:00:00;13,06;16,63;-3,57;39095;0;0;0;0;44560;14110;0.3167;14283;-173
2016-02-14 01:00:00;10,28;16,24;-5,96;39095;0;0;0;0;44560;14386;0.3229;14863;-477
2016-02-14 02:00:00;8,48;14,84;-6,36;39095;0;0;0;0;44560;14254;0.3199;15612;-1358
2016-02-14 03:00:00;5,09;13,3;-8,21;39095;0;0;0;0;44560;14747;0.3309;16359;-1612
2016-02-14 04:00:00;4,21;12,64;-8,43;39095;0;0;0;0;44560;14977;0.3361;16746;-1769
2016-02-14 05:00:00;4,75;11,05;-6,3;39095;0;0;0;0;44560;14934;0.3351;16922;-1988
2016-02-14 06:00:00;5,3;11,81;-6,51;39095;0;0;0;0;44560;14827;0.3328;17001;-2174
2016-02-14 07:00:00;8,76;15,85;-7,09;39095;90;0.0023;100;-10;44560;13984;0.3138;16917;-2933
2016-02-14 08:00:00;11,81;17,71;-5,9;39095;1226;0.0314;1067;159;44560;13118;0.2944;16769;-3651
2016-02-14 09:00:00;15,03;19,28;-4,25;39095;3208;0.082;2530;678;44560;12349;0.2772;16549;-4200
2016-02-14 10:00:00;17,46;21,11;-3,65;39095;4480;0.1146;3914;566;44560;11776;0.2642;16240;-4464
2016-02-14 11:00:00;18,01;22,99;-4,98;39095;4874;0.1247;4849;25;44560;11310;0.2538;15742;-4432
2016-02-14 12:00:00;17,69;23,32;-5,63;39095;4297;0.1099;5028;-731;44560;10976;0.2463;15082;-4106
2016-02-14 13:00:00;17,34;23,87;-6,53;39095;3948;0.101;4594;-646;44560;10631;0.2386;14145;-3514
2016-02-14 14:00:00;16,27;21,49;-5,22;39095;2694;0.0689;3659;-965;44560;10516;0.236;13082;-2566
2016-02-14 15:00:00;15,13;20,5;-5,37;39095;1492;0.0382;2371;-879;44560;10222;0.2294;12126;-1904
2016-02-14 16:00:00;16,96;20,87;-3,91;39095;552;0.0141;957;-405;44560;9871;0.2215;11405;-1534
2016-02-14 17:00:00;21,21;24,21;-3,0;39095;49;0.0012;110;-61;44560;9660;0.2168;11023;-1363
2016-02-14 18:00:00;29,94;31,94;-2,0;39095;0;0;0;0;44560;9632;0.2162;10818;-1186
2016-02-14 19:00:00;30,38;32,03;-1,65;39095;0;0;0;0;44560;9926;0.2228;10618;-692
2016-02-14 20:00:00;23,57;25,6;-2,03;39095;0;0;0;0;44560;9906;0.2223;10396;-490
2016-02-14 21:00:00;20,21;21,65;-1,44;39095;0;0;0;0;44560;9735;0.2185;10218;-483
2016-02-14 22:00:00;20,33;26,17;-5,84;39095;0;0;0;0;44560;9485;0.2129;10032;-547
2016-02-14 23:00:00;17,52;22,74;-5,22;39095;0;0;0;0;44560;9568;0.2148;9800;-232
2016-02-15 00:00:00;16,57;16,18;0,39;39098;0;0;0;0;44563;9614;0.2157;9659;-45
2016-02-15 01:00:00;16,0;16,81;-0,81;39098;0;0;0;0;44563;9519;0.2136;9689;-170
2016-02-15 02:00:00;14,36;13,6;0,76;39098;0;0;0;0;44563;9483;0.2128;9795;-312
2016-02-15 03:00:00;13,14;11,47;1,67;39098;0;0;0;0;44563;9649;0.2165;9845;-196
2016-02-15 04:00:00;12,68;11,29;1,39;39098;0;0;0;0;44563;9720;0.2181;9897;-177
2016-02-15 05:00:00;14,65;13,56;1,09;39098;0;0;0;0;44563;9722;0.2182;9861;-139
2016-02-15 06:00:00;21,12;21,93;-0,81;39098;0;0;0;0;44563;9963;0.2236;9899;64
2016-02-15 07:00:00;32,18;31,18;1,0;39098;50;0.0012;92;-42;44563;9906;0.2223;10002;-96
2016-02-15 08:00:00;30,11;32,06;-1,95;39098;706;0.0181;952;-246;44563;9512;0.2134;10151;-639
2016-02-15 09:00:00;31,72;32,67;-0,95;39098;1872;0.0479;2361;-489;44563;9360;0.21;10385;-1025
2016-02-15 10:00:00;30,91;32,95;-2,04;39098;3196;0.0818;3821;-625;44563;9180;0.206;10582;-1402
2016-02-15 11:00:00;29,93;32,88;-2,95;39098;3902;0.0998;4930;-1028;44563;9113;0.2045;10573;-1460
2016-02-15 12:00:00;27,22;32,34;-5,12;39098;4170;0.1066;5407;-1237;44563;8848;0.1986;10420;-1572
2016-02-15 13:00:00;25,39;32,11;-6,72;39098;3874;0.0991;5262;-1388;44563;9096;0.2041;10388;-1292
2016-02-15 14:00:00;24,81;30,74;-5,93;39098;3088;0.079;4409;-1321;44563;9608;0.2156;10285;-677
2016-02-15 15:00:00;24,4;30,1;-5,7;39098;1877;0.048;2983;-1106;44563;9935;0.223;10217;-282
2016-02-15 16:00:00;24,93;30,74;-5,81;39098;680;0.0174;1295;-615;44563;9792;0.2197;10064;-272
2016-02-15 17:00:00;28,45;33,32;-4,87;39098;58;0.0015;144;-86;44563;9675;0.2171;9901;-226
2016-02-15 18:00:00;35,19;38,02;-2,83;39098;0;0;0;0;44563;9461;0.2123;9786;-325
2016-02-15 19:00:00;32,19;34,26;-2,07;39098;0;0;0;0;44563;8660;0.1944;9590;-930
2016-02-15 20:00:00;30,05;33,18;-3,13;39098;0;0;0;0;44563;7837;0.1758;9070;-1233
2016-02-15 21:00:00;24,39;27,48;-3,09;39098;0;0;0;0;44563;7053;0.1583;8382;-1329
2016-02-15 22:00:00;25,87;27,81;-1,94;39098;0;0;0;0;44563;6395;0.1435;7662;-1267
2016-02-15 23:00:00;22,39;25,44;-3,05;39098;0;0;0;0;44563;6090;0.1367;6967;-877
2016-02-16 00:00:00;22,37;21,42;0,95;39099;0;0;0;0;44584;6043;0.1356;6004;39
2016-02-16 01:00:00;22,32;21,59;0,73;39099;0;0;0;0;44584;5520;0.1239;5444;76
2016-02-16 02:00:00;22,31;21,29;1,02;39099;0;0;0;0;44584;4913;0.1102;4982;-69
2016-02-16 03:00:00;22,04;21,05;0,99;39099;0;0;0;0;44584;4292;0.0963;4486;-194
2016-02-16 04:00:00;21,83;21,89;-0,06;39099;0;0;0;0;44584;3640;0.0816;4037;-397
2016-02-16 05:00:00;22,74;23,73;-0,99;39099;0;0;0;0;44584;2754;0.0618;3639;-885
2016-02-16 06:00:00;29,39;32,68;-3,29;39099;0;0;0;0;44584;2190;0.0491;3216;-1026
2016-02-16 07:00:00;40,43;46,34;-5,91;39099;76;0.002;133;-57;44584;1756;0.0394;2787;-1031
2016-02-16 08:00:00;42,46;50,56;-8,1;39099;1113;0.0285;1695;-582;44584;1369;0.0307;2398;-1029
2016-02-16 09:00:00;42,42;49,33;-6,91;39099;3438;0.0879;4469;-1031;44584;1174;0.0263;2071;-897
2016-02-16 10:00:00;37,91;42,98;-5,07;39099;5806;0.1485;7235;-1429;44584;1055;0.0236;1816;-761
2016-02-16 11:00:00;35,72;38,12;-2,4;39099;7553;0.1931;9232;-1679;44584;1058;0.0238;1589;-531
2016-02-16 12:00:00;33,07;34,87;-1,8;39099;8108;0.2074;10002;-1894;44584;1057;0.0237;1456;-399
2016-02-16 13:00:00;32,77;32,38;0,39;39099;7890;0.2018;9664;-1774;44584;986;0.0221;1405;-419
2016-02-16 14:00:00;31,7;31,21;0,49;39099;6671;0.1706;8009;-1338;44584;966;0.0217;1437;-471
2016-02-16 15:00:00;32,09;32,11;-0,02;39099;4657;0.1191;5302;-645;44584;1113;0.025;1518;-405
2016-02-16 16:00:00;34,88;31,2;3,68;39099;1983;0.0508;2232;-249;44584;1352;0.0303;1715;-363
2016-02-16 17:00:00;39,81;33,2;6,61;39099;178;0.0045;244;-66;44584;1875;0.042;2071;-196
2016-02-16 18:00:00;53,46;41,0;12,46;39099;0;0;0;0;44584;2780;0.0624;2551;229
2016-02-16 19:00:00;49,71;32,72;16,99;39099;0;0;0;0;44584;4374;0.0981;3223;1151
2016-02-16 20:00:00;33,96;26,29;7,67;39099;0;0;0;0;44584;5609;0.1258;4036;1573
2016-02-16 21:00:00;27,0;24,98;2,02;39099;0;0;0;0;44584;6366;0.1428;4770;1596
2016-02-16 22:00:00;24,98;22,71;2,27;39099;0;0;0;0;44584;6980;0.1566;5537;1443
2016-02-16 23:00:00;21,48;18,3;3,18;39099;0;0;0;0;44584;6924;0.1553;6273;651
2016-02-17 00:00:00;18,97;16,2;2,77;39101;0;0;0;0;44591;7561;0.1696;7413;148
2016-02-17 01:00:00;18,86;16,57;2,29;39101;0;0;0;0;44591;8616;0.1932;8133;483
2016-02-17 02:00:00;18,7;16,24;2,46;39101;0;0;0;0;44591;9687;0.2172;8665;1022
2016-02-17 03:00:00;18,74;12,38;6,36;39101;0;0;0;0;44591;10694;0.2398;9128;1566
2016-02-17 04:00:00;19,58;11,84;7,74;39101;0;0;0;0;44591;11697;0.2623;9436;2261
2016-02-17 05:00:00;19,0;14,99;4,01;39101;0;0;0;0;44591;12309;0.276;9676;2633
2016-02-17 06:00:00;22,75;19,72;3,03;39101;0;0;0;0;44591;12200;0.2736;9703;2497
2016-02-17 07:00:00;30,97;24,03;6,94;39101;101;0.0026;157;-56;44591;12072;0.2708;9531;2541
2016-02-17 08:00:00;31,71;24,81;6,9;39101;1542;0.0394;1839;-297;44591;11272;0.2528;9152;2120
2016-02-17 09:00:00;29,95;24,01;5,94;39101;4233;0.1082;4593;-360;44591;10051;0.2254;8747;1304
2016-02-17 10:00:00;23,53;24,05;-0,52;39101;6986;0.1786;7070;-84;44591;9612;0.2156;8550;1062
2016-02-17 11:00:00;24,77;23,63;1,14;39101;8137;0.2081;8623;-486;44591;9904;0.2221;8532;1372
2016-02-17 12:00:00;23,55;22,98;0,57;39101;7903;0.2021;8732;-829;44591;9663;0.2167;8420;1243
2016-02-17 13:00:00;24,72;24,06;0,66;39101;6582;0.1683;7752;-1170;44591;8891;0.1994;8184;707
2016-02-17 14:00:00;25,91;25,13;0,78;39101;4726;0.1208;5983;-1257;44591;8369;0.1877;7754;615
2016-02-17 15:00:00;29,9;27,05;2,85;39101;2824;0.0722;3847;-1023;44591;7941;0.1781;7340;601
2016-02-17 16:00:00;30,67;27,79;2,88;39101;1080;0.0276;1655;-575;44591;7242;0.1624;7033;209
2016-02-17 17:00:00;38,06;32,14;5,92;39101;108;0.0028;209;-101;44591;6918;0.1551;6863;55
2016-02-17 18:00:00;40,87;34,31;6,56;39101;0;0;0;0;44591;6592;0.1478;6697;-105
2016-02-17 19:00:00;33,96;28,85;5,11;39101;0;0;0;0;44591;5460;0.1224;6440;-980
2016-02-17 20:00:00;29,94;28,5;1,44;39101;0;0;0;0;44591;4442;0.0996;5711;-1269
2016-02-17 21:00:00;24,05;27,62;-3,57;39101;0;0;0;0;44591;3825;0.0858;4809;-984
2016-02-17 22:00:00;24,25;24,42;-0,17;39101;0;0;0;0;44591;3462;0.0776;3944;-482
2016-02-17 23:00:00;22,73;19,52;3,21;39101;0;0;0;0;44591;3392;0.0761;3226;166
2016-02-18 00:00:00;20,74;20,04;0,7;39104;0;0;0;0;44607;3462;0.0776;2941;521
2016-02-18 01:00:00;20,57;19,02;1,55;39104;0;0;0;0;44607;3618;0.0811;2866;752
2016-02-18 02:00:00;18,87;15,87;3,0;39104;0;0;0;0;44607;3783;0.0848;2906;877
2016-02-18 03:00:00;19,88;15,95;3,93;39104;0;0;0;0;44607;3904;0.0875;2961;943
2016-02-18 04:00:00;19,89;16,54;3,35;39104;0;0;0;0;44607;3886;0.0872;3043;843
2016-02-18 05:00:00;20,33;20,27;0,06;39104;0;0;0;0;44607;3709;0.0832;3133;576
2016-02-18 06:00:00;23,16;21,26;1,9;39104;0;0;0;0;44607;3759;0.0843;3185;574
2016-02-18 07:00:00;35,53;26,07;9,46;39104;158;0.004;206;-48;44607;4303;0.0965;3184;1119
2016-02-18 08:00:00;39,92;30,66;9,26;39104;1367;0.0349;1785;-418;44607;4533;0.1016;3091;1442
2016-02-18 09:00:00;34,97;24,46;10,51;39104;3818;0.0976;4733;-915;44607;4166;0.0934;3062;1104
2016-02-18 10:00:00;29,92;26,14;3,78;39104;7576;0.1938;8019;-443;44607;3920;0.0879;3078;842
2016-02-18 11:00:00;25,98;25,23;0,75;39104;10971;0.2806;10096;875;44607;3693;0.0828;3165;528
2016-02-18 12:00:00;23,77;22,22;1,55;39104;12110;0.3097;10875;1235;44607;4050;0.0908;3192;858
2016-02-18 13:00:00;24,53;21,54;2,99;39104;11044;0.2824;10275;769;44607;3927;0.088;3141;786
2016-02-18 14:00:00;25,13;23,51;1,62;39104;8618;0.2204;8431;187;44607;3325;0.0745;2920;405
2016-02-18 15:00:00;29,04;27,76;1,28;39104;5577;0.1426;5569;8;44607;2706;0.0607;2596;110
2016-02-18 16:00:00;32,0;29,58;2,42;39104;2151;0.055;2440;-289;44607;2270;0.0509;2314;-44
2016-02-18 17:00:00;38,74;35,2;3,54;39104;201;0.0052;323;-122;44607;2526;0.0566;2216;310
2016-02-18 18:00:00;45,08;40,61;4,47;39104;0;0;0;0;44607;3030;0.0679;2291;739
2016-02-18 19:00:00;38,06;33,54;4,52;39104;0;0;0;0;44607;3258;0.073;2570;688
2016-02-18 20:00:00;32,24;29,03;3,21;39104;0;0;0;0;44607;3143;0.0705;2941;202
2016-02-18 21:00:00;25,95;24,97;0,98;39104;0;0;0;0;44607;2986;0.0669;3235;-249
2016-02-18 22:00:00;23,09;24,51;-1,42;39104;0;0;0;0;44607;2800;0.0628;3338;-538
2016-02-18 23:00:00;21,34;21,29;0,05;39104;0;0;0;0;44607;2375;0.0532;3276;-901
2016-02-19 00:00:00;21,85;21,34;0,51;39106;0;0;0;0;44641;2008;0.045;1883;125
2016-02-19 01:00:00;21,44;20,58;0,86;39106;0;0;0;0;44641;1842;0.0413;1684;158
2016-02-19 02:00:00;21,75;21,07;0,68;39106;0;0;0;0;44641;1612;0.0361;1619;-7
2016-02-19 03:00:00;22,19;20,98;1,21;39106;0;0;0;0;44641;1523;0.0341;1591;-68
2016-02-19 04:00:00;22,37;22,34;0,03;39106;0;0;0;0;44641;1350;0.0302;1588;-238
2016-02-19 05:00:00;19,46;21,54;-2,08;39106;0;0;0;0;44641;1351;0.0303;1600;-249
2016-02-19 06:00:00;27,83;25,71;2,12;39106;0;0;0;0;44641;1383;0.031;1676;-293
2016-02-19 07:00:00;34,98;32,94;2,04;39106;122;0.0031;181;-59;44641;1612;0.0361;1881;-269
2016-02-19 08:00:00;38,49;37,92;0,57;39106;1127;0.0288;1440;-313;44641;1710;0.0383;2129;-419
2016-02-19 09:00:00;34,95;34,76;0,19;39106;2745;0.0702;3219;-474;44641;1634;0.0366;2418;-784
2016-02-19 10:00:00;34,95;34,52;0,43;39106;4482;0.1146;4993;-511;44641;1590;0.0356;2693;-1103
2016-02-19 11:00:00;37,91;33,86;4,05;39106;5681;0.1453;6237;-556;44641;1808;0.0405;2918;-1110
2016-02-19 12:00:00;31,55;32,33;-0,78;39106;6200;0.1586;6636;-436;44641;2304;0.0516;3218;-914
2016-02-19 13:00:00;27,93;31,1;-3,17;39106;5743;0.1469;6403;-660;44641;3114;0.0698;3844;-730
2016-02-19 14:00:00;25,25;29,83;-4,58;39106;4704;0.1203;5607;-903;44641;4019;0.09;4538;-519
2016-02-19 15:00:00;25,09;26,07;-0,98;39106;3097;0.0792;4106;-1009;44641;4358;0.0976;5039;-681
2016-02-19 16:00:00;24,84;27,7;-2,86;39106;1351;0.0346;1995;-644;44641;4778;0.107;5615;-837
2016-02-19 17:00:00;30,04;32,59;-2,55;39106;176;0.0045;282;-106;44641;5392;0.1208;6475;-1083
2016-02-19 18:00:00;34,94;37,26;-2,32;39106;0;0;0;0;44641;6882;0.1542;7649;-767
2016-02-19 19:00:00;27,99;31,79;-3,8;39106;0;0;0;0;44641;9020;0.202;9042;-22
2016-02-19 20:00:00;23,69;25,23;-1,54;39106;0;0;0;0;44641;10774;0.2414;10476;298
2016-02-19 21:00:00;24,93;26,73;-1,8;39106;0;0;0;0;44641;12215;0.2736;11801;414
2016-02-19 22:00:00;23,38;25,31;-1,93;39106;0;0;0;0;44641;13338;0.2988;13134;204
2016-02-19 23:00:00;18,9;22,62;-3,72;39106;0;0;0;0;44641;14693;0.3292;14415;278
2016-02-20 00:00:00;18,3;19,74;-1,44;39106;0;0;0;0;44643;16088;0.3604;14784;1304
2016-02-20 01:00:00;16,82;19,66;-2,84;39106;0;0;0;0;44643;17708;0.3966;16319;1389
2016-02-20 02:00:00;11,54;12,79;-1,25;39106;0;0;0;0;44643;19224;0.4306;18127;1097
2016-02-20 03:00:00;9,69;12,48;-2,79;39106;0;0;0;0;44643;20806;0.466;20123;683
2016-02-20 04:00:00;9,52;14,51;-4,99;39106;0;0;0;0;44643;22932;0.5137;22022;910
2016-02-20 05:00:00;5,01;8,61;-3,6;39106;0;0;0;0;44643;25182;0.5641;23622;1560
2016-02-20 06:00:00;5,06;6,1;-1,04;39106;0;0;0;0;44643;27281;0.6111;24928;2353
2016-02-20 07:00:00;9,09;-9,02;18,11;39106;246;0.0063;208;38;44643;28225;0.6322;25708;2517
2016-02-20 08:00:00;8,69;-0,4;9,09;39106;1486;0.038;1325;161;44643;28359;0.6352;25880;2479
2016-02-20 09:00:00;13,43;3,33;10,1;39106;2290;0.0586;2414;-124;44643;28347;0.635;25737;2610
2016-02-20 10:00:00;16,36;13,47;2,89;39106;2800;0.0716;2959;-159;44643;28486;0.6381;25439;3047
2016-02-20 11:00:00;17,0;16,15;0,85;39106;2862;0.0732;3042;-180;44643;28458;0.6375;25183;3275
2016-02-20 12:00:00;16,96;13,28;3,68;39106;2646;0.0676;2915;-269;44643;28080;0.629;24913;3167
2016-02-20 13:00:00;15,94;13,69;2,25;39106;2123;0.0543;2532;-409;44643;27206;0.6094;24481;2725
2016-02-20 14:00:00;15,77;14,23;1,54;39106;1635;0.0418;1977;-342;44643;26410;0.5916;23888;2522
2016-02-20 15:00:00;16,05;12,26;3,79;39106;993;0.0254;1281;-288;44643;25921;0.5806;23277;2644
2016-02-20 16:00:00;16,15;12,64;3,51;39106;394;0.0101;537;-143;44643;25836;0.5787;22752;3084
2016-02-20 17:00:00;18,99;15,37;3,62;39106;42;0.0011;87;-45;44643;25771;0.5772;22434;3337
2016-02-20 18:00:00;24,22;16,7;7,52;39106;1;0;0;1;44643;24812;0.5558;22066;2746
2016-02-20 19:00:00;23,49;14,03;9,46;39106;0;0;0;0;44643;24102;0.5399;22011;2091
2016-02-20 20:00:00;18,96;13,47;5,49;39106;0;0;0;0;44643;23914;0.5356;22379;1535
2016-02-20 21:00:00;13,92;10,75;3,17;39106;0;0;0;0;44643;23791;0.5329;22928;863
2016-02-20 22:00:00;11,79;14,23;-2,44;39106;0;0;0;0;44643;24019;0.538;23457;562
2016-02-20 23:00:00;7,81;7,63;0,18;39106;0;0;0;0;44643;25306;0.5669;24174;1132
2016-02-21 00:00:00;9,37;-1,25;10,62;39106;0;0;0;0;44643;26906;0.6027;22438;4468
2016-02-21 01:00:00;6,52;-6,06;12,58;39106;0;0;0;0;44643;28060;0.6286;22822;5238
2016-02-21 02:00:00;5,09;-10,86;15,95;39106;0;0;0;0;44643;28387;0.6358;23307;5080
2016-02-21 03:00:00;3,14;-11,23;14,37;39106;0;0;0;0;44643;28498;0.6384;23807;4691
2016-02-21 04:00:00;0,46;-8,55;9,01;39106;0;0;0;0;44643;28598;0.6406;24133;4465
2016-02-21 05:00:00;0,13;-4,38;4,51;39106;0;0;0;0;44643;27872;0.6243;24243;3629
2016-02-21 06:00:00;-0,05;-4,44;4,39;39106;0;0;0;0;44643;26430;0.592;24435;1995
2016-02-21 07:00:00;0,13;2,88;-2,75;39106;56;0.0015;58;-2;44643;24803;0.5556;24475;328
2016-02-21 08:00:00;5,62;11,64;-6,02;39106;544;0.014;406;138;44643;23006;0.5153;24304;-1298
2016-02-21 09:00:00;10,81;15,65;-4,84;39106;1504;0.0384;1001;503;44643;22402;0.5018;24143;-1741
2016-02-21 10:00:00;13,07;16,92;-3,85;39106;2328;0.0595;1608;720;44643;22348;0.5006;23945;-1597
2016-02-21 11:00:00;14,94;15,0;-0,06;39106;3174;0.0812;2031;1143;44643;21962;0.492;23625;-1663
2016-02-21 12:00:00;14,95;13,45;1,5;39106;3858;0.0987;2186;1672;44643;21056;0.4716;23393;-2337
2016-02-21 13:00:00;10,6;8,52;2,08;39106;3772;0.0965;2084;1688;44643;20696;0.4636;23029;-2333
2016-02-21 14:00:00;7,71;6,07;1,64;39106;3430;0.0877;1734;1696;44643;21300;0.4771;22481;-1181
2016-02-21 15:00:00;4,95;1,83;3,12;39106;2470;0.0632;1172;1298;44643;22521;0.5045;22208;313
2016-02-21 16:00:00;7,69;-1,19;8,88;39106;1198;0.0306;567;631;44643;23954;0.5366;22165;1789
2016-02-21 17:00:00;14,34;2,22;12,12;39106;188;0.0048;106;82;44643;26399;0.5914;22595;3804
2016-02-21 18:00:00;18,61;2,35;16,26;39106;1;0;0;1;44643;29106;0.652;23150;5956
2016-02-21 19:00:00;18,2;0,73;17,47;39106;0;0;0;0;44643;30990;0.6942;23744;7246
2016-02-21 20:00:00;12,0;-3,65;15,65;39106;0;0;0;0;44643;32413;0.726;24101;8312
2016-02-21 21:00:00;12,64;-10,03;22,67;39106;0;0;0;0;44643;32974;0.7386;24245;8729
2016-02-21 22:00:00;13,94;-6,11;20,05;39106;0;0;0;0;44643;32643;0.7312;24344;8299
2016-02-21 23:00:00;9,31;-9,49;18,8;39106;0;0;0;0;44643;31420;0.7038;24502;6918
2016-02-22 00:00:00;-4,93;-13,09;8,16;39110;0;0;0;0;44649;32416;0.726;29403;3013
2016-02-22 01:00:00;-4,98;-17,52;12,54;39110;0;0;0;0;44649;31824;0.7128;29109;2715
2016-02-22 02:00:00;-5,08;-18,83;13,75;39110;0;0;0;0;44649;31631;0.7084;28637;2994
2016-02-22 03:00:00;-1,02;-14,78;13,76;39110;0;0;0;0;44649;31336;0.7018;27972;3364
2016-02-22 04:00:00;-0,97;-11,44;10,47;39110;0;0;0;0;44649;30528;0.6837;27179;3349
2016-02-22 05:00:00;7,63;-1,67;9,3;39110;0;0;0;0;44649;29676;0.6646;26201;3475
2016-02-22 06:00:00;18,05;12,33;5,72;39110;0;0;0;0;44649;30282;0.6782;25188;5094
2016-02-22 07:00:00;26,38;19,33;7,05;39110;216;0.0056;186;30;44649;28923;0.6478;24232;4691
2016-02-22 08:00:00;27,92;17,77;10,15;39110;1805;0.0461;1236;569;44649;26606;0.5959;23246;3360
2016-02-22 09:00:00;23,97;16,62;7,35;39110;4507;0.1152;2834;1673;44649;25559;0.5724;22280;3279
2016-02-22 10:00:00;23,11;14,48;8,63;39110;6625;0.1694;4475;2150;44649;24586;0.5507;21438;3148
2016-02-22 11:00:00;23,93;14,82;9,11;39110;8060;0.2061;5596;2464;44649;22746;0.5094;20767;1979
2016-02-22 12:00:00;24,0;16,85;7,15;39110;8911;0.2278;6130;2781;44649;21065;0.4718;20025;1040
2016-02-22 13:00:00;24,52;18,31;6,21;39110;8402;0.2148;6029;2373;44649;19842;0.4444;19269;573
2016-02-22 14:00:00;23,98;18,48;5,5;39110;6653;0.1701;5142;1511;44649;19288;0.432;18369;919
2016-02-22 15:00:00;23,91;20,22;3,69;39110;3374;0.0863;3559;-185;44649;18203;0.4077;17333;870
2016-02-22 16:00:00;23,92;21,29;2,63;39110;1400;0.0358;1683;-283;44649;17392;0.3895;16144;1248
2016-02-22 17:00:00;27,93;23,52;4,41;39110;163;0.0042;278;-115;44649;16948;0.3796;15122;1826
2016-02-22 18:00:00;40,13;30,82;9,31;39110;1;0;0;1;44649;16238;0.3636;14412;1826
2016-02-22 19:00:00;39,45;30,67;8,78;39110;0;0;0;0;44649;16515;0.3699;13803;2712
2016-02-22 20:00:00;29,37;24,72;4,65;39110;0;0;0;0;44649;16558;0.3708;13480;3078
2016-02-22 21:00:00;24,69;21,11;3,58;39110;0;0;0;0;44649;16226;0.3634;13221;3005
2016-02-22 22:00:00;25,08;21,73;3,35;39110;0;0;0;0;44649;16234;0.3636;12821;3413
2016-02-22 23:00:00;19,56;14,83;4,73;39110;0;0;0;0;44649;15243;0.3414;12371;2872
2016-02-23 00:00:00;17,81;20,91;-3,1;39111;0;0;0;0;44649;14627;0.3276;14206;421
2016-02-23 01:00:00;14,28;19,82;-5,54;39111;0;0;0;0;44649;13850;0.3102;13529;321
2016-02-23 02:00:00;17,23;20,89;-3,66;39111;0;0;0;0;44649;12746;0.2855;12945;-199
2016-02-23 03:00:00;17,47;18,67;-1,2;39111;0;0;0;0;44649;11983;0.2684;12403;-420
2016-02-23 04:00:00;17,83;18,88;-1,05;39111;0;0;0;0;44649;11431;0.256;11872;-441
2016-02-23 05:00:00;19,15;24,6;-5,45;39111;0;0;0;0;44649;10759;0.241;11418;-659
2016-02-23 06:00:00;27,32;28,05;-0,73;39111;0;0;0;0;44649;10554;0.2364;11183;-629
2016-02-23 07:00:00;30,62;32,12;-1,5;39111;168;0.0043;189;-21;44649;10344;0.2317;11044;-700
2016-02-23 08:00:00;31,9;33,37;-1,47;39111;1170;0.0299;1305;-135;44649;9761;0.2186;11022;-1261
2016-02-23 09:00:00;31,09;33,97;-2,88;39111;2754;0.0704;2922;-168;44649;9220;0.2065;11094;-1874
2016-02-23 10:00:00;29,19;35,02;-5,83;39111;4338;0.1109;4607;-269;44649;9388;0.2102;11324;-1936
2016-02-23 11:00:00;30,68;35,46;-4,78;39111;5757;0.1472;5868;-111;44649;10157;0.2275;11620;-1463
2016-02-23 12:00:00;25,92;29,0;-3,08;39111;6514;0.1666;6399;115;44649;10784;0.2415;11854;-1070
2016-02-23 13:00:00;24,96;27,47;-2,51;39111;6195;0.1584;6200;-5;44649;11098;0.2486;12010;-912
2016-02-23 14:00:00;23,9;26,3;-2,4;39111;5136;0.1313;5305;-169;44649;11354;0.2543;11900;-546
2016-02-23 15:00:00;24,13;25,43;-1,3;39111;3594;0.0919;3765;-171;44649;11179;0.2504;11683;-504
2016-02-23 16:00:00;24,36;23,25;1,11;39111;1808;0.0462;1817;-9;44649;11434;0.2561;11514;-80
2016-02-23 17:00:00;30,08;24,94;5,14;39111;288;0.0074;309;-21;44649;11744;0.263;11526;218
2016-02-23 18:00:00;36,75;35,8;0,95;39111;2;0;0;2;44649;13424;0.3007;11773;1651
2016-02-23 19:00:00;29,94;30,26;-0,32;39111;0;0;0;0;44649;14758;0.3305;12384;2374
2016-02-23 20:00:00;22,96;22,4;0,56;39111;0;0;0;0;44649;15241;0.3414;12754;2487
2016-02-23 21:00:00;23,23;21,14;2,09;39111;0;0;0;0;44649;16154;0.3618;13018;3136
2016-02-23 22:00:00;19,76;21,0;-1,24;39111;0;0;0;0;44649;16008;0.3586;13154;2854
2016-02-23 23:00:00;17,9;15,97;1,93;39111;0;0;0;0;44649;15446;0.346;13202;2244
2016-02-24 00:00:00;18,04;20,7;-2,66;39115;0;0;0;0;44655;15174;0.3398;13795;1379
2016-02-24 01:00:00;16,59;20,25;-3,66;39115;0;0;0;0;44655;14902;0.3337;13721;1181
2016-02-24 02:00:00;13,61;18,68;-5,07;39115;0;0;0;0;44655;15014;0.3362;13591;1423
2016-02-24 03:00:00;13,66;15,13;-1,47;39115;0;0;0;0;44655;14647;0.328;13367;1280
2016-02-24 04:00:00;17,43;18,0;-0,57;39115;0;0;0;0;44655;14472;0.3241;13078;1394
2016-02-24 05:00:00;18,92;22,38;-3,46;39115;0;0;0;0;44655;13844;0.31;12836;1008
2016-02-24 06:00:00;23,15;29,41;-6,26;39115;0;0;3;-3;44655;13990;0.3133;12576;1414
2016-02-24 07:00:00;33,69;35,85;-2,16;39115;342;0.0087;439;-97;44655;13089;0.2931;12295;794
2016-02-24 08:00:00;30,99;35,65;-4,66;39115;2150;0.055;3011;-861;44655;11461;0.2566;12166;-705
2016-02-24 09:00:00;25,04;35,46;-10,42;39115;5657;0.1446;6447;-790;44655;10698;0.2396;12015;-1317
2016-02-24 10:00:00;23,41;32,72;-9,31;39115;9072;0.2319;10078;-1006;44655;11371;0.2546;11765;-394
2016-02-24 11:00:00;22,56;29,64;-7,08;39115;11082;0.2833;12857;-1775;44655;12442;0.2786;11622;820
2016-02-24 12:00:00;22,03;28,76;-6,73;39115;11542;0.2951;14045;-2503;44655;12889;0.2886;11459;1430
2016-02-24 13:00:00;22,05;25,91;-3,86;39115;11518;0.2945;13641;-2123;44655;12683;0.284;11268;1415
2016-02-24 14:00:00;22,56;25,48;-2,92;39115;10518;0.2689;11547;-1029;44655;11415;0.2556;10780;635
2016-02-24 15:00:00;24,0;24,72;-0,72;39115;7958;0.2034;8049;-91;44655;9832;0.2202;10108;-276
2016-02-24 16:00:00;25,05;24,61;0,44;39115;3842;0.0982;3942;-100;44655;8085;0.181;9201;-1116
2016-02-24 17:00:00;31,96;31,02;0,94;39115;493;0.0126;669;-176;44655;6497;0.1455;8141;-1644
2016-02-24 18:00:00;35,68;38,15;-2,47;39115;3;0.0001;0;3;44655;6058;0.1357;7519;-1461
2016-02-24 19:00:00;36,41;34,85;1,56;39115;0;0;0;0;44655;6538;0.1464;7332;-794
2016-02-24 20:00:00;30,51;30,13;0,38;39115;0;0;0;0;44655;6544;0.1466;7423;-879
2016-02-24 21:00:00;23,97;28,6;-4,63;39115;0;0;0;0;44655;6464;0.1448;7462;-998
2016-02-24 22:00:00;22,96;26,34;-3,38;39115;0;0;0;0;44655;6583;0.1474;7357;-774
2016-02-24 23:00:00;20,56;24,02;-3,46;39115;0;0;0;0;44655;6372;0.1427;7181;-809
2016-02-25 00:00:00;24,04;22,98;1,06;39119;0;0;0;0;44672;5854;0.131;5236;618
2016-02-25 01:00:00;22,58;21,17;1,41;39119;0;0;0;0;44672;5508;0.1233;5047;461
2016-02-25 02:00:00;21,26;21,54;-0,28;39119;0;0;0;0;44672;5314;0.119;4858;456
2016-02-25 03:00:00;20,09;20,81;-0,72;39119;0;0;0;0;44672;5149;0.1153;4723;426
2016-02-25 04:00:00;19,94;20,54;-0,6;39119;0;0;0;0;44672;5068;0.1135;4636;432
2016-02-25 05:00:00;21,7;22,22;-0,52;39119;0;0;0;0;44672;5086;0.1139;4653;433
2016-02-25 06:00:00;27,19;28,91;-1,72;39119;0;0;3;-3;44672;5003;0.112;4712;291
2016-02-25 07:00:00;36,04;35,72;0,32;39119;277;0.0071;395;-118;44672;5179;0.116;4786;393
2016-02-25 08:00:00;38,29;33,36;4,93;39119;2172;0.0555;2463;-291;44672;4990;0.1117;4836;154
2016-02-25 09:00:00;34,44;29,06;5,38;39119;5504;0.1407;5356;148;44672;4730;0.1059;4975;-245
2016-02-25 10:00:00;32,12;26,16;5,96;39119;8730;0.2232;8308;422;44672;4972;0.1113;5238;-266
2016-02-25 11:00:00;30,44;25,27;5,17;39119;10326;0.264;10416;-90;44672;6368;0.1426;5637;731
2016-02-25 12:00:00;26,55;22,31;4,24;39119;9987;0.2553;11305;-1318;44672;7964;0.1782;6158;1806
2016-02-25 13:00:00;26,01;22,27;3,74;39119;8560;0.2188;10997;-2437;44672;8974;0.2009;6617;2357
2016-02-25 14:00:00;25,0;23,02;1,98;39119;6974;0.1782;9374;-2400;44672;9357;0.2095;6698;2659
2016-02-25 15:00:00;24,78;23,5;1,28;39119;5130;0.1312;6571;-1441;44672;9108;0.2039;6432;2676
2016-02-25 16:00:00;25,39;22,36;3,03;39119;2500;0.0639;3269;-769;44672;8006;0.1792;6003;2003
2016-02-25 17:00:00;31,16;25,42;5,74;39119;434;0.0111;623;-189;44672;7083;0.1586;5686;1397
2016-02-25 18:00:00;39,91;32,94;6,97;39119;3;0.0001;0;3;44672;7036;0.1575;5793;1243
2016-02-25 19:00:00;36,51;30,28;6,23;39119;0;0;0;0;44672;7366;0.1649;6309;1057
2016-02-25 20:00:00;31,54;26,4;5,14;39119;0;0;0;0;44672;8192;0.1834;6801;1391
2016-02-25 21:00:00;25,2;21,25;3,95;39119;0;0;0;0;44672;8686;0.1944;7051;1635
2016-02-25 22:00:00;25,1;22,16;2,94;39119;0;0;0;0;44672;8722;0.1953;7140;1582
2016-02-25 23:00:00;23,84;21,83;2,01;39119;0;0;0;0;44672;8888;0.199;7138;1750
2016-02-26 00:00:00;21,66;21,62;0,04;39122;0;0;0;0;44694;8540;0.1911;8198;342
2016-02-26 01:00:00;21,69;21,0;0,69;39122;0;0;0;0;44694;8258;0.1848;7944;314
2016-02-26 02:00:00;21,11;21,58;-0,47;39122;0;0;0;0;44694;7788;0.1743;7652;136
2016-02-26 03:00:00;20,0;21,07;-1,07;39122;0;0;0;0;44694;7579;0.1696;7261;318
2016-02-26 04:00:00;21,02;20,33;0,69;39122;0;0;0;0;44694;7205;0.1612;6804;401
2016-02-26 05:00:00;22,07;20,79;1,28;39122;0;0;0;0;44694;6146;0.1375;6248;-102
2016-02-26 06:00:00;27,35;26,97;0,38;39122;0;0;5;-5;44694;5799;0.1298;5641;158
2016-02-26 07:00:00;32,93;31,37;1,56;39122;542;0.0138;652;-110;44694;5177;0.1158;5046;131
2016-02-26 08:00:00;36,08;33,7;2,38;39122;3488;0.0892;3836;-348;44694;4430;0.0991;4489;-59
2016-02-26 09:00:00;33,48;33,07;0,41;39122;7392;0.1889;7805;-413;44694;3706;0.0829;3989;-283
2016-02-26 10:00:00;31,68;31,38;0,3;39122;10974;0.2805;11408;-434;44694;3383;0.0757;3531;-148
2016-02-26 11:00:00;29,5;28,65;0,85;39122;12492;0.3193;13794;-1302;44694;2930;0.0655;3072;-142
2016-02-26 12:00:00;27,47;27,41;0,06;39122;12066;0.3084;14759;-2693;44694;2617;0.0585;2615;2
2016-02-26 13:00:00;25,06;28,41;-3,35;39122;10965;0.2803;14118;-3153;44694;2158;0.0483;2221;-63
2016-02-26 14:00:00;24,0;26,47;-2,47;39122;9286;0.2374;11903;-2617;44694;1844;0.0412;1861;-17
2016-02-26 15:00:00;25,11;25,16;-0,05;39122;6764;0.1729;8393;-1629;44694;1430;0.032;1531;-101
2016-02-26 16:00:00;26,94;24,72;2,22;39122;3329;0.0851;4195;-866;44694;1290;0.0289;1329;-39
2016-02-26 17:00:00;33,98;28,56;5,42;39122;557;0.0142;777;-220;44694;1172;0.0262;1377;-205
2016-02-26 18:00:00;39,94;36,05;3,89;39122;4;0.0001;0;4;44694;1360;0.0304;1539;-179
2016-02-26 19:00:00;37,55;33,09;4,46;39122;0;0;0;0;44694;1689;0.0378;1725;-36
2016-02-26 20:00:00;31,18;28,18;3,0;39122;0;0;0;0;44694;2040;0.0456;1885;155
2016-02-26 21:00:00;26,35;24,04;2,31;39122;0;0;0;0;44694;2308;0.0516;2010;298
2016-02-26 22:00:00;26,86;23,51;3,35;39122;0;0;0;0;44694;2493;0.0558;2166;327
2016-02-26 23:00:00;25,0;23,13;1,87;39122;0;0;0;0;44694;2604;0.0582;2367;237
2016-02-27 00:00:00;26,94;23,56;3,38;39122;0;0;0;0;44694;2748;0.0615;2417;331
2016-02-27 01:00:00;23,02;20,7;2,32;39122;0;0;0;0;44694;2924;0.0654;2530;394
2016-02-27 02:00:00;21,77;19,37;2,4;39122;0;0;0;0;44694;3038;0.068;2705;333
2016-02-27 03:00:00;19,76;19,05;0,71;39122;0;0;0;0;44694;3131;0.07;2887;244
2016-02-27 04:00:00;19,83;19,02;0,81;39122;0;0;0;0;44694;3450;0.0772;3150;300
2016-02-27 05:00:00;20,16;18,66;1,5;39122;0;0;0;0;44694;3806;0.0852;3396;410
2016-02-27 06:00:00;21,18;19,77;1,41;39122;0;0;8;-8;44694;4286;0.0959;3656;630
2016-02-27 07:00:00;22,76;21,0;1,76;39122;660;0.0168;790;-130;44694;4762;0.1066;3719;1043
2016-02-27 08:00:00;25,71;20,16;5,55;39122;4233;0.1082;4608;-375;44694;4587;0.1026;3505;1082
2016-02-27 09:00:00;26,79;21,5;5,29;39122;9587;0.245;9338;249;44694;3348;0.075;3118;230
2016-02-27 10:00:00;23,24;21,26;1,98;39122;13795;0.3526;13588;207;44694;2584;0.0578;2965;-381
2016-02-27 11:00:00;21,17;19,44;1,73;39122;16523;0.4224;16257;266;44694;2901;0.0649;3195;-294
2016-02-27 12:00:00;19,92;20,28;-0,36;39122;17650;0.4512;17254;396;44694;3780;0.0846;3615;165
2016-02-27 13:00:00;19,49;18,08;1,41;39122;16978;0.434;16530;448;44694;4322;0.0967;4071;251
2016-02-27 14:00:00;19,68;16,09;3,59;39122;14562;0.3722;13973;589;44694;4642;0.1039;4472;170
2016-02-27 15:00:00;19,93;16,99;2,94;39122;10206;0.2609;9922;284;44694;5054;0.1131;4787;267
2016-02-27 16:00:00;20,21;16,99;3,22;39122;5000;0.1278;5096;-96;44694;5198;0.1163;5094;104
2016-02-27 17:00:00;24,97;21,73;3,24;39122;826;0.0211;1015;-189;44694;5369;0.1202;5622;-253
2016-02-27 18:00:00;32,04;26,94;5,1;39122;5;0.0001;1;4;44694;6715;0.1502;6337;378
2016-02-27 19:00:00;31,91;25,24;6,67;39122;0;0;0;0;44694;7802;0.1746;6866;936
2016-02-27 20:00:00;25,72;21,51;4,21;39122;0;0;0;0;44694;7814;0.1749;6806;1008
2016-02-27 21:00:00;21,74;20,36;1,38;39122;0;0;0;0;44694;7298;0.1633;6458;840
2016-02-27 22:00:00;23,1;20,72;2,38;39122;0;0;0;0;44694;6541;0.1464;6063;478
2016-02-27 23:00:00;20,98;19,39;1,59;39122;0;0;0;0;44694;5993;0.1341;5676;317
2016-02-28 00:00:00;19,9;18,87;1,03;39122;0;0;0;0;44731;5646;0.1262;4488;1158
2016-02-28 01:00:00;18,39;17,64;0,75;39122;0;0;0;0;44731;5713;0.1278;4281;1432
2016-02-28 02:00:00;18,01;14,36;3,65;39122;0;0;0;0;44731;5813;0.13;4123;1690
2016-02-28 03:00:00;17,62;13,21;4,41;39122;0;0;0;0;44731;5897;0.1318;4071;1826
2016-02-28 04:00:00;17,31;14,3;3,01;39122;0;0;0;0;44731;6263;0.14;4126;2137
2016-02-28 05:00:00;17,46;15,65;1,81;39122;0;0;0;0;44731;6581;0.1471;4151;2430
2016-02-28 06:00:00;17,51;14,78;2,73;39122;1;0;9;-8;44731;6870;0.1536;4088;2782
2016-02-28 07:00:00;17,58;14,79;2,79;39122;564;0.0144;681;-117;44731;7087;0.1584;4034;3053
2016-02-28 08:00:00;17,9;18,35;-0,45;39122;3294;0.0842;3692;-398;44731;6670;0.1491;3868;2802
2016-02-28 09:00:00;19,02;19,53;-0,51;39122;6832;0.1746;7393;-561;44731;5667;0.1267;3653;2014
2016-02-28 10:00:00;19,01;20,91;-1,9;39122;9960;0.2546;10900;-940;44731;5168;0.1156;3658;1510
2016-02-28 11:00:00;19,02;21,31;-2,29;39122;11690;0.2988;13227;-1537;44731;5552;0.1241;3939;1613
2016-02-28 12:00:00;16,6;20,84;-4,24;39122;11781;0.3011;14090;-2309;44731;6096;0.1363;4412;1684
2016-02-28 13:00:00;14,06;19,75;-5,69;39122;10275;0.2626;13465;-3190;44731;6748;0.1508;5135;1613
2016-02-28 14:00:00;12,45;18,28;-5,83;39122;8178;0.209;11269;-3091;44731;7740;0.1731;5968;1772
2016-02-28 15:00:00;12,21;16,02;-3,81;39122;5566;0.1423;7800;-2234;44731;8568;0.1916;6720;1848
2016-02-28 16:00:00;13,26;15,42;-2,16;39122;2586;0.0661;3893;-1307;44731;8618;0.1926;7392;1226
2016-02-28 17:00:00;19,11;21,33;-2,22;39122;471;0.012;776;-305;44731;8782;0.1964;8007;775
2016-02-28 18:00:00;24,6;27,41;-2,81;39122;4;0.0001;0;4;44731;10222;0.2285;8737;1485
2016-02-28 19:00:00;26,98;27,09;-0,11;39122;0;0;0;0;44731;10937;0.2445;9348;1589
2016-02-28 20:00:00;21,81;22,78;-0,97;39122;0;0;0;0;44731;10918;0.2441;9531;1387
2016-02-28 21:00:00;19,9;20,62;-0,72;39122;0;0;0;0;44731;10790;0.2412;9401;1389
2016-02-28 22:00:00;20,44;23,62;-3,18;39122;0;0;0;0;44731;10604;0.237;9231;1373
2016-02-28 23:00:00;19,93;21,17;-1,24;39122;0;0;0;0;44731;10255;0.2292;9087;1168
2016-02-29 00:00:00;19,12;17,85;1,27;39125;0;0;0;0;44749;10086;0.2254;8560;1526
2016-02-29 01:00:00;17,77;16,63;1,14;39125;0;0;0;0;44749;9836;0.2198;8563;1273
2016-02-29 02:00:00;17,6;17,0;0,6;39125;0;0;0;0;44749;9699;0.2168;8817;882
2016-02-29 03:00:00;16,77;17,62;-0,85;39125;0;0;0;0;44749;9846;0.22;9165;681
2016-02-29 04:00:00;17,01;17,61;-0,6;39125;0;0;0;0;44749;10274;0.2296;9608;666
2016-02-29 05:00:00;18,49;21,03;-2,54;39125;0;0;0;0;44749;10637;0.2377;9999;638
2016-02-29 06:00:00;28,23;30,41;-2,18;39125;0;0;5;-5;44749;11103;0.2481;10371;732
2016-02-29 07:00:00;34,72;36,0;-1,28;39125;334;0.0086;402;-68;44749;11394;0.2546;10656;738
2016-02-29 08:00:00;32,96;36,22;-3,26;39125;1700;0.0435;2162;-462;44749;11124;0.2486;10697;427
2016-02-29 09:00:00;27,99;32,01;-4,02;39125;3700;0.0946;4274;-574;44749;10318;0.2306;10463;-145
2016-02-29 10:00:00;24,92;32,08;-7,16;39125;5550;0.1419;6262;-712;44749;10420;0.2328;10503;-83
2016-02-29 11:00:00;23,48;29,83;-6,35;39125;6600;0.1687;7515;-915;44749;11010;0.246;11062;-52
2016-02-29 12:00:00;22,77;28,13;-5,36;39125;6930;0.1771;7985;-1055;44749;11711;0.2617;11766;-55
2016-02-29 13:00:00;22,2;26,58;-4,38;39125;6580;0.1682;7568;-988;44749;11947;0.267;12325;-378
2016-02-29 14:00:00;22,0;26,51;-4,51;39125;5599;0.1431;6328;-729;44749;12314;0.2752;12560;-246
2016-02-29 15:00:00;22,24;27,37;-5,13;39125;3973;0.1016;4507;-534;44749;12208;0.2728;12588;-380
2016-02-29 16:00:00;22,57;27,27;-4,7;39125;2007;0.0513;2354;-347;44749;11470;0.2563;12268;-798
2016-02-29 17:00:00;26,58;28,77;-2,19;39125;436;0.0112;523;-87;44749;10410;0.2326;11764;-1354
2016-02-29 18:00:00;34,03;40,12;-6,09;39125;7;0.0002;0;7;44749;9927;0.2218;11369;-1442
2016-02-29 19:00:00;31,21;39,28;-8,07;39125;0;0;0;0;44749;10045;0.2245;11157;-1112
2016-02-29 20:00:00;27,14;34,09;-6,95;39125;0;0;0;0;44749;9626;0.2151;10512;-886
2016-02-29 21:00:00;23,04;30,47;-7,43;39125;0;0;0;0;44749;9158;0.2046;9643;-485
2016-02-29 22:00:00;22,55;28,68;-6,13;39125;0;0;0;0;44749;8317;0.1859;8707;-390
2016-02-29 23:00:00;19,29;25,23;-5,94;39125;0;0;0;0;44749;7367;0.1646;7648;-281
2016-01-03 00:00:00;22,48;20,89;1,59;39127;0;0;0;0;44760;5789;0.1293;5168;621
2016-01-03 01:00:00;22,08;20,47;1,61;39127;0;0;0;0;44760;4600;0.1028;4436;164
2016-01-03 02:00:00;19,87;20,79;-0,92;39127;0;0;0;0;44760;3722;0.0831;4016;-294
2016-01-03 03:00:00;19,13;20,04;-0,91;39127;0;0;0;0;44760;3718;0.083;3841;-123
2016-01-03 04:00:00;19,33;18,75;0,58;39127;0;0;0;0;44760;4514;0.1009;3654;860
2016-01-03 05:00:00;20,18;18,47;1,71;39127;0;0;0;0;44760;5153;0.1151;3530;1623
2016-01-03 06:00:00;25,59;22,92;2,67;39127;1;0;7;-6;44760;5097;0.1139;3484;1613
2016-01-03 07:00:00;32,93;29,08;3,85;39127;322;0.0082;376;-54;44760;5032;0.1124;3468;1564
2016-01-03 08:00:00;37,86;29,37;8,49;39127;1721;0.044;2065;-344;44760;4692;0.1048;3555;1137
2016-01-03 09:00:00;34,95;28,16;6,79;39127;3983;0.1018;4125;-142;44760;4718;0.1054;3732;986
2016-01-03 10:00:00;31,9;24,59;7,31;39127;5838;0.1492;6265;-427;44760;5297;0.1183;4017;1280
2016-01-03 11:00:00;30,06;24,39;5,67;39127;7148;0.1827;7735;-587;44760;6372;0.1424;4531;1841
2016-01-03 12:00:00;28,8;24,38;4,42;39127;8000;0.2045;8297;-297;44760;7568;0.1691;5336;2232
2016-01-03 13:00:00;27,96;23,63;4,33;39127;7830;0.2001;7891;-61;44760;8428;0.1883;6235;2193
2016-01-03 14:00:00;25,55;22,48;3,07;39127;6569;0.1679;6519;50;44760;9478;0.2118;7224;2254
2016-01-03 15:00:00;25,48;23,65;1,83;39127;4321;0.1104;4417;-96;44760;11019;0.2462;8229;2790
2016-01-03 16:00:00;23,97;24,47;-0,5;39127;1892;0.0484;2180;-288;44760;12418;0.2774;9193;3225
2016-01-03 17:00:00;26,95;25,29;1,66;39127;302;0.0077;480;-178;44760;13566;0.3031;10471;3095
2016-01-03 18:00:00;26,0;26,74;-0,74;39127;6;0.0002;2;4;44760;15443;0.345;12014;3429
2016-01-03 19:00:00;22,63;26,49;-3,86;39127;0;0;0;0;44760;17501;0.391;13539;3962
2016-01-03 20:00:00;21,26;23,81;-2,55;39127;0;0;0;0;44760;19356;0.4324;15046;4310
2016-01-03 21:00:00;19,52;20,35;-0,83;39127;0;0;0;0;44760;20226;0.4518;16233;3993
2016-01-03 22:00:00;18,39;17,7;0,69;39127;0;0;0;0;44760;20115;0.4494;16830;3285
2016-01-03 23:00:00;17,06;19,49;-2,43;39127;0;0;0;0;44760;19938;0.4454;16833;3105
2016-02-03 00:00:00;10,58;10,26;0,32;39128;0;0;0;0;44771;19394;0.4332;16586;2808
2016-02-03 01:00:00;13,56;12,22;1,34;39128;0;0;0;0;44771;19205;0.429;16293;2912
2016-02-03 02:00:00;12,69;10,35;2,34;39128;0;0;0;0;44771;19230;0.4295;16176;3054
2016-02-03 03:00:00;12,62;7,83;4,79;39128;0;0;0;0;44771;19073;0.426;16240;2833
2016-02-03 04:00:00;13,27;7,76;5,51;39128;0;0;0;0;44771;19747;0.4411;16272;3475
2016-02-03 05:00:00;15,85;8,98;6,87;39128;0;0;0;0;44771;19489;0.4353;16241;3248
2016-02-03 06:00:00;21,45;17,01;4,44;39128;1;0;3;-2;44771;19916;0.4448;16224;3692
2016-02-03 07:00:00;23,08;20,5;2,58;39128;189;0.0048;194;-5;44771;19285;0.4308;16109;3176
2016-02-03 08:00:00;25,96;22,5;3,46;39128;924;0.0236;861;63;44771;18479;0.4128;15975;2504
2016-02-03 09:00:00;24,68;24,24;0,44;39128;2233;0.0571;1773;460;44771;19156;0.4279;15785;3371
2016-02-03 10:00:00;26,7;24,56;2,14;39128;3629;0.0928;2782;847;44771;19238;0.4297;15383;3855
2016-02-03 11:00:00;28,0;23,55;4,45;39128;4836;0.1236;3606;1230;44771;17828;0.3982;15096;2732
2016-02-03 12:00:00;27,43;24,12;3,31;39128;5581;0.1426;4170;1411;44771;17431;0.3893;14525;2906
2016-02-03 13:00:00;26,0;22,54;3,46;39128;5680;0.1452;4434;1246;44771;17115;0.3823;13508;3607
2016-02-03 14:00:00;25,92;21,74;4,18;39128;5089;0.13;4236;853;44771;15360;0.3431;11954;3406
2016-02-03 15:00:00;28,06;21,63;6,43;39128;3547;0.0907;3384;163;44771;13662;0.3051;10253;3409
2016-02-03 16:00:00;28,56;23,44;5,12;39128;1678;0.0429;1990;-312;44771;11071;0.2472;8623;2448
2016-02-03 17:00:00;31,99;26,37;5,62;39128;374;0.0096;508;-134;44771;8675;0.1938;7614;1061
2016-02-03 18:00:00;40,0;36,27;3,73;39128;8;0.0002;2;6;44771;8956;0.2;7441;1515
2016-02-03 19:00:00;36,87;33,05;3,82;39128;0;0;0;0;44771;9560;0.2135;7878;1682
2016-02-03 20:00:00;30,99;27,23;3,76;39128;0;0;0;0;44771;10102;0.2256;8341;1761
2016-02-03 21:00:00;27,07;24,67;2,4;39128;0;0;0;0;44771;10410;0.2325;8650;1760
2016-02-03 22:00:00;24,27;22,26;2,01;39128;0;0;0;0;44771;9850;0.22;8698;1152
2016-02-03 23:00:00;21,58;19,04;2,54;39128;0;0;0;0;44771;8868;0.1981;8551;317
2016-03-03 00:00:00;20,02;22,27;-2,25;39130;0;0;0;0;44793;8171;0.1824;7780;391
2016-03-03 01:00:00;19,29;22,32;-3,03;39130;0;0;0;0;44793;8044;0.1796;7497;547
2016-03-03 02:00:00;18,64;20,93;-2,29;39130;0;0;0;0;44793;8129;0.1815;7193;936
2016-03-03 03:00:00;17,93;18,44;-0,51;39130;0;0;0;0;44793;8417;0.1879;6757;1660
2016-03-03 04:00:00;18,26;15,83;2,43;39130;0;0;0;0;44793;8724;0.1948;6348;2376
2016-03-03 05:00:00;19,38;18,21;1,17;39130;0;0;0;0;44793;8042;0.1796;5977;2065
2016-03-03 06:00:00;24,58;25,24;-0,66;39130;4;0.0001;12;-8;44793;7471;0.1668;5558;1913
2016-03-03 07:00:00;30,93;30,99;-0,06;39130;490;0.0125;563;-73;44793;7414;0.1655;5148;2266
2016-03-03 08:00:00;31,04;31,67;-0,63;39130;2203;0.0563;2520;-317;44793;6668;0.1488;4602;2066
2016-03-03 09:00:00;30,94;32,39;-1,45;39130;4566;0.1167;4803;-237;44793;5280;0.1178;4051;1229
2016-03-03 10:00:00;30,57;31,94;-1,37;39130;6722;0.1718;6950;-228;44793;3716;0.083;3675;41
2016-03-03 11:00:00;31,94;32,25;-0,31;39130;8081;0.2065;8291;-210;44793;2816;0.0629;3385;-569
2016-03-03 12:00:00;30,07;32,31;-2,24;39130;8533;0.2181;8460;73;44793;2305;0.0514;3077;-772
2016-03-03 13:00:00;30,53;32,49;-1,96;39130;7773;0.1986;7787;-14;44793;1964;0.0438;2773;-809
2016-03-03 14:00:00;30,06;33,04;-2,98;39130;6304;0.1611;6499;-195;44793;1866;0.0417;2483;-617
2016-03-03 15:00:00;30,97;33,46;-2,49;39130;4380;0.112;4688;-308;44793;1874;0.0418;2264;-390
2016-03-03 16:00:00;30,96;35,18;-4,22;39130;2376;0.0607;2553;-177;44793;1661;0.0371;2020;-359
2016-03-03 17:00:00;32,85;38,21;-5,36;39130;562;0.0144;628;-66;44793;1676;0.0374;1925;-249
2016-03-03 18:00:00;42,71;47,0;-4,29;39130;12;0.0003;5;7;44793;1700;0.038;2063;-363
2016-03-03 19:00:00;42,92;45,26;-2,34;39130;0;0;0;0;44793;1986;0.0443;2403;-417
2016-03-03 20:00:00;33,98;39,79;-5,81;39130;0;0;0;0;44793;2322;0.0518;2851;-529
2016-03-03 21:00:00;28,97;30,9;-1,93;39130;0;0;0;0;44793;2654;0.0592;3218;-564
2016-03-03 22:00:00;25,92;26,39;-0,47;39130;0;0;0;0;44793;3139;0.0701;3506;-367
2016-03-03 23:00:00;23,11;21,47;1,64;39130;0;0;0;0;44793;3544;0.0791;3720;-176
2016-04-03 00:00:00;22,15;17,79;4,36;39136;0;0;0;0;44823;4077;0.091;1992;2085
2016-04-03 01:00:00;20,03;15,86;4,17;39136;0;0;0;0;44823;4545;0.1014;2252;2293
2016-04-03 02:00:00;19,75;16,53;3,22;39136;0;0;0;0;44823;5063;0.113;2494;2569
2016-04-03 03:00:00;19,19;17,03;2,16;39136;0;0;0;0;44823;5497;0.1227;2835;2662
2016-04-03 04:00:00;18,99;17,57;1,42;39136;0;0;0;0;44823;5647;0.126;3183;2464
2016-04-03 05:00:00;20,18;19,63;0,55;39136;0;0;0;0;44823;6042;0.1348;3574;2468
2016-04-03 06:00:00;26,92;22,34;4,58;39136;10;0.0003;20;-10;44823;6835;0.1525;4027;2808
2016-04-03 07:00:00;31,73;25,92;5,81;39136;920;0.0235;1031;-111;44823;8002;0.1786;4456;3546
2016-04-03 08:00:00;33,97;27,84;6,13;39136;4445;0.1136;4237;208;44823;8853;0.1975;4972;3881
2016-04-03 09:00:00;30,04;21,68;8,36;39136;8506;0.2174;7820;686;44823;9418;0.2101;5498;3920
2016-04-03 10:00:00;26,69;20,34;6,35;39136;11167;0.2853;10886;281;44823;10616;0.2368;6127;4489
2016-04-03 11:00:00;23,78;18,4;5,38;39136;12243;0.3129;12524;-281;44823;12658;0.2824;7262;5396
2016-04-03 12:00:00;22,48;18,8;3,68;39136;11870;0.3033;12491;-621;44823;14666;0.3272;8696;5970
2016-04-03 13:00:00;21,78;17,9;3,88;39136;10361;0.2648;11107;-746;44823;16672;0.3719;10152;6520
2016-04-03 14:00:00;21,86;17,04;4,82;39136;7646;0.1954;8626;-980;44823;18161;0.4052;11182;6979
2016-04-03 15:00:00;22,48;17,69;4,79;39136;4603;0.1176;5610;-1007;44823;18016;0.4019;11847;6169
2016-04-03 16:00:00;24,17;18,93;5,24;39136;1917;0.049;2707;-790;44823;17770;0.3964;12070;5700
2016-04-03 17:00:00;29,2;22,51;6,69;39136;345;0.0088;592;-247;44823;17314;0.3863;12179;5135
2016-04-03 18:00:00;33,99;25,92;8,07;39136;8;0.0002;3;5;44823;17271;0.3853;12596;4675
2016-04-03 19:00:00;31,06;24,32;6,74;39136;0;0;0;0;44823;16904;0.3771;12983;3921
2016-04-03 20:00:00;27,9;22,72;5,18;39136;0;0;0;0;44823;15565;0.3472;12912;2653
2016-04-03 21:00:00;23,52;22,68;0,84;39136;0;0;0;0;44823;14198;0.3168;12587;1611
2016-04-03 22:00:00;23,8;24,25;-0,45;39136;0;0;0;0;44823;12077;0.2695;12145;-68
2016-04-03 23:00:00;21,55;22,47;-0,92;39136;0;0;0;0;44823;10753;0.2399;11474;-721
2016-05-03 00:00:00;19,15;20,44;-1,29;39136;0;0;0;0;44829;9839;0.2195;9981;-142
2016-05-03 01:00:00;19,17;19,69;-0,52;39136;0;0;0;0;44829;8544;0.1906;8895;-351
2016-05-03 02:00:00;19,04;19,21;-0,17;39136;0;0;0;0;44829;7867;0.1755;7946;-79
2016-05-03 03:00:00;18,96;18,71;0,25;39136;0;0;0;0;44829;7204;0.1607;7074;130
2016-05-03 04:00:00;18,88;24,52;-5,64;39136;0;0;0;0;44829;6546;0.146;6524;22
2016-05-03 05:00:00;19,01;22,44;-3,43;39136;0;0;0;0;44829;5862;0.1308;6204;-342
2016-05-03 06:00:00;19,16;21,37;-2,21;39136;8;0.0002;18;-10;44829;5231;0.1167;5781;-550
2016-05-03 07:00:00;20,75;27,66;-6,91;39136;483;0.0123;630;-147;44829;4657;0.1039;5287;-630
2016-05-03 08:00:00;24,55;30,53;-5,98;39136;2226;0.0569;2247;-21;44829;4266;0.0952;4849;-583
2016-05-03 09:00:00;26,9;28,58;-1,68;39136;4172;0.1066;4177;-5;44829;3595;0.0802;4477;-882
2016-05-03 10:00:00;24,78;27,28;-2,5;39136;5685;0.1453;5759;-74;44829;3097;0.0691;4297;-1200
2016-05-03 11:00:00;24,63;27,29;-2,66;39136;6370;0.1628;6716;-346;44829;2909;0.0649;4319;-1410
2016-05-03 12:00:00;24,25;27,64;-3,39;39136;6812;0.174;6831;-19;44829;2671;0.0596;4310;-1639
2016-05-03 13:00:00;21,14;26,32;-5,18;39136;5888;0.1504;6055;-167;44829;2155;0.0481;4360;-2205
2016-05-03 14:00:00;20,42;27,04;-6,62;39136;4737;0.121;4793;-56;44829;2078;0.0464;4391;-2313
2016-05-03 15:00:00;20,57;26,24;-5,67;39136;3316;0.0847;3267;49;44829;1884;0.042;4373;-2489
2016-05-03 16:00:00;21,25;26,53;-5,28;39136;1552;0.0396;1677;-125;44829;1608;0.0359;4430;-2822
2016-05-03 17:00:00;25,92;30,84;-4,92;39136;346;0.0088;413;-67;44829;1759;0.0392;4547;-2788
2016-05-03 18:00:00;34,02;41,91;-7,89;39136;11;0.0003;7;4;44829;1981;0.0442;4549;-2568
2016-05-03 19:00:00;35,0;40,93;-5,93;39136;0;0;0;0;44829;2053;0.0458;4051;-1998
2016-05-03 20:00:00;27,86;33,59;-5,73;39136;0;0;0;0;44829;1839;0.041;3885;-2046
2016-05-03 21:00:00;24,44;28,77;-4,33;39136;0;0;0;0;44829;1615;0.036;3874;-2259
2016-05-03 22:00:00;25,18;30,02;-4,84;39136;0;0;0;0;44829;1529;0.0341;3914;-2385
2016-05-03 23:00:00;20,0;27,83;-7,83;39136;0;0;0;0;44829;1598;0.0356;4033;-2435
2016-06-03 00:00:00;20,69;23,97;-3,28;39136;0;0;0;0;44829;1603;0.0358;2413;-810
2016-06-03 01:00:00;19,94;22,99;-3,05;39136;0;0;0;0;44829;1667;0.0372;2582;-915
2016-06-03 02:00:00;19,13;22,63;-3,5;39136;0;0;0;0;44829;2019;0.045;2762;-743
2016-06-03 03:00:00;18,69;22,41;-3,72;39136;0;0;0;0;44829;2240;0.05;2922;-682
2016-06-03 04:00:00;18,58;20,69;-2,11;39136;0;0;0;0;44829;2346;0.0524;3134;-788
2016-06-03 05:00:00;18,83;21,21;-2,38;39136;0;0;0;0;44829;2686;0.0599;3411;-725
2016-06-03 06:00:00;18,65;21,31;-2,66;39136;5;0.0002;15;-10;44829;3218;0.0718;3826;-608
2016-06-03 07:00:00;18,78;20,3;-1,52;39136;389;0.01;489;-100;44829;3660;0.0816;4438;-778
2016-06-03 08:00:00;19,28;19,21;0,07;39136;1757;0.0449;1969;-212;44829;4266;0.0952;5177;-911
2016-06-03 09:00:00;19,99;21,67;-1,68;39136;3742;0.0956;3879;-137;44829;4587;0.1023;5980;-1393
2016-06-03 10:00:00;20,26;22,2;-1,94;39136;5757;0.1471;5775;-18;44829;5302;0.1182;6748;-1446
2016-06-03 11:00:00;20,51;21,61;-1,1;39136;7308;0.1867;7209;99;44829;5964;0.133;7365;-1401
2016-06-03 12:00:00;20,02;20,73;-0,71;39136;7874;0.2012;7949;-75;44829;6817;0.1521;7857;-1040
2016-06-03 13:00:00;19,14;19,73;-0,59;39136;7434;0.19;7847;-413;44829;7248;0.1617;8130;-882
2016-06-03 14:00:00;18,24;20,39;-2,15;39136;6219;0.1589;6815;-596;44829;7266;0.1621;7925;-659
2016-06-03 15:00:00;18,23;20,73;-2,5;39136;4902;0.1252;5056;-154;44829;6816;0.1521;7419;-603
2016-06-03 16:00:00;18,73;20,3;-1,57;39136;3006;0.0768;2824;182;44829;6636;0.148;6598;38
2016-06-03 17:00:00;20,57;22,91;-2,34;39136;792;0.0202;749;43;44829;5854;0.1306;5883;-29
2016-06-03 18:00:00;28,93;33,02;-4,09;39136;19;0.0005;14;5;44829;5785;0.129;5514;271
2016-06-03 19:00:00;31,62;33,34;-1,72;39136;0;0;0;0;44829;5773;0.1288;5704;69
2016-06-03 20:00:00;29,17;32,04;-2,87;39136;0;0;0;0;44829;6324;0.1411;6333;-9
2016-06-03 21:00:00;25,44;27,01;-1,57;39136;0;0;0;0;44829;6496;0.1449;6893;-397
2016-06-03 22:00:00;27,44;29,0;-1,56;39136;0;0;0;0;44829;6303;0.1406;7117;-814
2016-06-03 23:00:00;21,15;25,84;-4,69;39136;0;0;0;0;44829;6008;0.134;7042;-1034
2016-07-03 00:00:00;22,04;24,25;-2,21;39137;0;0;0;0;44833;6063;0.1352;6588;-525
2016-07-03 01:00:00;22,05;23,43;-1,38;39137;0;0;0;0;44833;5845;0.1304;6301;-456
2016-07-03 02:00:00;20,34;22,3;-1,96;39137;0;0;0;0;44833;5499;0.1227;5993;-494
2016-07-03 03:00:00;20,02;21,0;-0,98;39137;0;0;0;0;44833;5110;0.114;5679;-569
2016-07-03 04:00:00;20,09;21,27;-1,18;39137;0;0;0;0;44833;4719;0.1052;5413;-694
2016-07-03 05:00:00;21,87;24,98;-3,11;39137;0;0;0;0;44833;4176;0.0932;5168;-992
2016-07-03 06:00:00;32,34;29,92;2,42;39137;14;0.0004;32;-18;44833;3630;0.081;4871;-1241
2016-07-03 07:00:00;35,97;34,66;1,31;39137;730;0.0187;854;-124;44833;3108;0.0693;4479;-1371
2016-07-03 08:00:00;37,79;34,51;3,28;39137;3301;0.0844;3117;184;44833;2302;0.0514;4076;-1774
2016-07-03 09:00:00;33,07;29,6;3,47;39137;7101;0.1814;5920;1181;44833;1805;0.0402;3786;-1981
2016-07-03 10:00:00;31,98;25,83;6,15;39137;9795;0.2503;8205;1590;44833;1718;0.0383;3653;-1935
2016-07-03 11:00:00;29,96;24,7;5,26;39137;10770;0.2752;9678;1092;44833;1850;0.0413;3554;-1704
2016-07-03 12:00:00;27,98;24,37;3,61;39137;10664;0.2724;10377;287;44833;2050;0.0457;3488;-1438
2016-07-03 13:00:00;27,44;25,41;2,03;39137;9819;0.2509;10208;-389;44833;2277;0.0508;3287;-1010
2016-07-03 14:00:00;27,72;26,49;1,23;39137;8616;0.2202;8808;-192;44833;2018;0.045;2945;-927
2016-07-03 15:00:00;27,1;25,01;2,09;39137;6684;0.1708;6590;94;44833;1615;0.036;2679;-1064
2016-07-03 16:00:00;30,07;25,86;4,21;39137;3930;0.1004;3726;204;44833;1290;0.0288;2381;-1091
2016-07-03 17:00:00;33,97;28,1;5,87;39137;1010;0.0258;1010;0;44833;1093;0.0244;2087;-994
2016-07-03 18:00:00;48,29;45,69;2,6;39137;26;0.0007;22;4;44833;1090;0.0243;1912;-822
2016-07-03 19:00:00;46,65;46,39;0,26;39137;0;0;0;0;44833;1059;0.0236;1876;-817
2016-07-03 20:00:00;30,03;28,07;1,96;39137;0;0;0;0;44833;1086;0.0242;1877;-791
2016-07-03 21:00:00;27,95;25,0;2,95;39137;0;0;0;0;44833;1192;0.0266;1893;-701
2016-07-03 22:00:00;26,96;23,79;3,17;39137;0;0;0;0;44833;1294;0.0289;1932;-638
2016-07-03 23:00:00;24,47;20,17;4,3;39137;0;0;0;0;44833;1305;0.0291;1887;-582
2016-08-03 00:00:00;22,39;24,54;-2,15;39139;0;0;0;0;44844;1286;0.0287;1444;-158
2016-08-03 01:00:00;22,91;22,43;0,48;39139;0;0;0;0;44844;1324;0.0295;1518;-194
2016-08-03 02:00:00;22,81;23,06;-0,25;39139;0;0;0;0;44844;1344;0.03;1632;-288
2016-08-03 03:00:00;22,0;24,08;-2,08;39139;0;0;0;0;44844;1376;0.0307;1818;-442
2016-08-03 04:00:00;21,67;24,49;-2,82;39139;0;0;0;0;44844;1632;0.0364;1980;-348
2016-08-03 05:00:00;22,7;27,48;-4,78;39139;0;0;0;0;44844;1758;0.0392;2119;-361
2016-08-03 06:00:00;27,44;31,53;-4,09;39139;28;0.0007;47;-19;44844;2050;0.0457;2250;-200
2016-08-03 07:00:00;37,73;41,0;-3,27;39139;856;0.0219;1009;-153;44844;2278;0.0508;2289;-11
2016-08-03 08:00:00;39,08;43,48;-4,4;39139;3071;0.0785;3551;-480;44844;2001;0.0446;2222;-221
2016-08-03 09:00:00;34,98;38,36;-3,38;39139;7256;0.1854;7090;166;44844;1656;0.0369;2119;-463
2016-08-03 10:00:00;28,61;30,49;-1,88;39139;9899;0.2529;10100;-201;44844;1464;0.0326;2060;-596
2016-08-03 11:00:00;25,42;30,54;-5,12;39139;11736;0.2998;11860;-124;44844;1886;0.0421;2212;-326
2016-08-03 12:00:00;25,1;29,86;-4,76;39139;11752;0.3003;12270;-518;44844;2587;0.0577;2517;70
2016-08-03 13:00:00;24,64;27,22;-2,58;39139;10356;0.2646;11402;-1046;44844;3091;0.0689;2768;323
2016-08-03 14:00:00;24,81;26,76;-1,95;39139;8784;0.2244;9569;-785;44844;3562;0.0794;2848;714
2016-08-03 15:00:00;25,09;24,95;0,14;39139;6794;0.1736;7121;-327;44844;3547;0.0791;2796;751
2016-08-03 16:00:00;27,92;26,39;1,53;39139;4097;0.1047;4131;-34;44844;3164;0.0706;2652;512
2016-08-03 17:00:00;33,1;31,94;1,16;39139;1146;0.0293;1182;-36;44844;2613;0.0582;2533;80
2016-08-03 18:00:00;44,93;45,7;-0,77;39139;26;0.0006;34;-8;44844;2513;0.056;2612;-99
2016-08-03 19:00:00;40,58;42,28;-1,7;39139;0;0;0;0;44844;3146;0.0702;3118;28
2016-08-03 20:00:00;31,94;33,75;-1,81;39139;0;0;0;0;44844;4425;0.0987;4008;417
2016-08-03 21:00:00;25,07;25,87;-0,8;39139;0;0;0;0;44844;5790;0.1291;4961;829
2016-08-03 22:00:00;27,2;23,46;3,74;39139;0;0;0;0;44844;6571;0.1465;5820;751
2016-08-03 23:00:00;22,61;21,76;0,85;39139;0;0;0;0;44844;6819;0.1521;6434;385
2016-09-03 00:00:00;23,8;17,21;6,59;39141;0;0;0;0;44850;7126;0.1589;6544;582
2016-09-03 01:00:00;22,03;18,02;4,01;39141;0;0;0;0;44850;7365;0.1642;6719;646
2016-09-03 02:00:00;20,94;19,38;1,56;39141;0;0;0;0;44850;7347;0.1638;6867;480
2016-09-03 03:00:00;20,08;16,89;3,19;39141;0;0;0;0;44850;7488;0.1669;7036;452
2016-09-03 04:00:00;20,01;18,1;1,91;39141;0;0;0;0;44850;7883;0.1758;7246;637
2016-09-03 05:00:00;21,14;17,6;3,54;39141;0;0;0;0;44850;8280;0.1846;7554;726
2016-09-03 06:00:00;24,95;16,98;7,97;39141;37;0.001;60;-23;44850;9163;0.2043;7976;1187
2016-09-03 07:00:00;31,92;23,39;8,53;39141;1552;0.0397;1623;-71;44850;9404;0.2097;8308;1096
2016-09-03 08:00:00;29,91;21,93;7,98;39141;5509;0.1407;5748;-239;44850;8616;0.1921;8279;337
2016-09-03 09:00:00;25,03;24,14;0,89;39141;10208;0.2608;10905;-697;44850;7937;0.177;7964;-27
2016-09-03 10:00:00;23,43;23,74;-0,31;39141;14146;0.3614;15346;-1200;44850;8292;0.1849;7894;398
2016-09-03 11:00:00;23,85;21,8;2,05;39141;16862;0.4308;17692;-830;44850;9554;0.213;8295;1259
2016-09-03 12:00:00;22,28;21,02;1,26;39141;18016;0.4603;18414;-398;44850;10911;0.2433;8865;2046
2016-09-03 13:00:00;21,96;19,44;2,52;39141;17452;0.4458;17536;-84;44850;12364;0.2757;9260;3104
2016-09-03 14:00:00;22,48;18,28;4,2;39141;15471;0.3953;15212;259;44850;13194;0.2942;9402;3792
2016-09-03 15:00:00;23,05;16,82;6,23;39141;11646;0.2976;11274;372;44850;13528;0.3016;9472;4056
2016-09-03 16:00:00;24,83;17,59;7,24;39141;6380;0.163;6293;87;44850;13153;0.2932;9372;3781
2016-09-03 17:00:00;33,0;21,71;11,29;39141;1690;0.0432;1757;-67;44850;11632;0.2594;9425;2207
2016-09-03 18:00:00;38,77;29,33;9,44;39141;37;0.0009;50;-13;44850;11658;0.2599;10121;1537
2016-09-03 19:00:00;37,99;27,47;10,52;39141;0;0;0;0;44850;12332;0.2749;10939;1393
2016-09-03 20:00:00;29,81;22,41;7,4;39141;0;0;0;0;44850;12706;0.2833;11058;1648
2016-09-03 21:00:00;25,8;21,5;4,3;39141;0;0;0;0;44850;11707;0.261;10695;1012
2016-09-03 22:00:00;27,51;22,65;4,86;39141;0;0;0;0;44850;10022;0.2234;9926;96
2016-09-03 23:00:00;23,41;20,49;2,92;39141;0;0;0;0;44850;9072;0.2023;8903;169
2016-10-03 00:00:00;19,72;19,15;0,57;39143;0;0;0;0;44882;8492;0.1892;7851;641
2016-10-03 01:00:00;20,17;19,93;0,24;39143;0;0;0;0;44882;7895;0.1759;7132;763
2016-10-03 02:00:00;20,04;20,25;-0,21;39143;0;0;0;0;44882;7106;0.1583;6620;486
2016-10-03 03:00:00;20,16;20,01;0,15;39143;0;0;0;0;44882;6614;0.1474;6181;433
2016-10-03 04:00:00;20,94;21,34;-0,4;39143;0;0;0;0;44882;6449;0.1437;5866;583
2016-10-03 05:00:00;21,6;21,24;0,36;39143;0;0;0;0;44882;6449;0.1437;5694;755
2016-10-03 06:00:00;28,48;24,95;3,53;39143;32;0.0008;54;-22;44882;6418;0.143;5535;883
2016-10-03 07:00:00;35,44;33,08;2,36;39143;1327;0.0339;1225;102;44882;5762;0.1284;5265;497
2016-10-03 08:00:00;31,99;31,85;0,14;39143;4851;0.1239;4277;574;44882;5194;0.1157;4868;326
2016-10-03 09:00:00;30,07;27,23;2,84;39143;8984;0.2296;7709;1275;44882;4510;0.1005;4443;67
2016-10-03 10:00:00;25,53;21,35;4,18;39143;12217;0.3121;10834;1383;44882;4249;0.0947;4057;192
2016-10-03 11:00:00;24,71;21,11;3,6;39143;14298;0.3653;12705;1593;44882;3785;0.0843;3693;92
2016-10-03 12:00:00;26,35;22,17;4,18;39143;14836;0.379;13497;1339;44882;3680;0.082;3398;282
2016-10-03 13:00:00;25,0;22,49;2,51;39143;13852;0.3539;12868;984;44882;3596;0.0801;3291;305
2016-10-03 14:00:00;25,0;22,69;2,31;39143;11836;0.3024;10890;946;44882;3404;0.0758;3382;22
2016-10-03 15:00:00;24,89;22,62;2,27;39143;8548;0.2184;7872;676;44882;3617;0.0806;3658;-41
2016-10-03 16:00:00;25,03;23,14;1,89;39143;4604;0.1176;4392;212;44882;4042;0.0901;4064;-22
2016-10-03 17:00:00;29,95;26,39;3,56;39143;1277;0.0326;1343;-66;44882;4247;0.0946;4534;-287
2016-10-03 18:00:00;35,49;36,15;-0,66;39143;32;0.0008;56;-24;44882;4762;0.1061;5050;-288
2016-10-03 19:00:00;37,79;39,39;-1,6;39143;0;0;0;0;44882;5761;0.1284;5487;274
2016-10-03 20:00:00;30,02;31,97;-1,95;39143;0;0;0;0;44882;6231;0.1388;5613;618
2016-10-03 21:00:00;25,31;26,95;-1,64;39143;0;0;0;0;44882;6205;0.1382;5534;671
2016-10-03 22:00:00;22,72;22,26;0,46;39143;0;0;0;0;44882;5856;0.1304;5246;610
2016-10-03 23:00:00;21,32;21,86;-0,54;39143;0;0;0;0;44882;5345;0.1191;4824;521
2016-11-03 00:00:00;22,03;20,78;1,25;39148;0;0;0;0;44903;4914;0.1094;4091;823
2016-11-03 01:00:00;20,85;17,57;3,28;39148;0;0;0;0;44903;4399;0.098;3651;748
2016-11-03 02:00:00;21,03;19,38;1,65;39148;0;0;0;0;44903;4181;0.0931;3243;938
2016-11-03 03:00:00;21,06;18,03;3,03;39148;0;0;0;0;44903;3859;0.0859;2969;890
2016-11-03 04:00:00;21,75;20,04;1,71;39148;0;0;0;0;44903;3627;0.0808;2854;773
2016-11-03 05:00:00;22,39;19,61;2,78;39148;0;0;0;0;44903;3526;0.0785;2909;617
2016-11-03 06:00:00;28,34;29,58;-1,24;39148;26;0.0007;43;-17;44903;3574;0.0796;2974;600
2016-11-03 07:00:00;34,47;33,72;0,75;39148;838;0.0214;810;28;44903;3626;0.0808;3026;600
2016-11-03 08:00:00;38,34;40,26;-1,92;39148;3120;0.0797;2707;413;44903;3395;0.0756;3118;277
2016-11-03 09:00:00;36,69;37,18;-0,49;39148;6023;0.1539;5200;823;44903;3172;0.0706;3164;8
2016-11-03 10:00:00;32,91;34,74;-1,83;39148;8832;0.2256;7625;1207;44903;3336;0.0743;3149;187
2016-11-03 11:00:00;31,98;29,63;2,35;39148;10875;0.2778;9163;1712;44903;3305;0.0736;2976;329
2016-11-03 12:00:00;29,81;27,02;2,79;39148;11152;0.2849;9863;1289;44903;3110;0.0692;2785;325
2016-11-03 13:00:00;27,03;26,1;0,93;39148;10134;0.2589;9542;592;44903;3045;0.0678;2780;265
2016-11-03 14:00:00;25,01;28,45;-3,44;39148;8062;0.2059;8189;-127;44903;3106;0.0692;2971;135
2016-11-03 15:00:00;24,92;29,27;-4,35;39148;5525;0.1411;5998;-473;44903;3457;0.077;3311;146
2016-11-03 16:00:00;24,88;28,9;-4,02;39148;2869;0.0733;3402;-533;44903;3726;0.083;3665;61
2016-11-03 17:00:00;27,9;33,03;-5,13;39148;742;0.0189;1062;-320;44903;3892;0.0867;3929;-37
2016-11-03 18:00:00;32,55;43,46;-10,91;39148;27;0.0007;51;-24;44903;4380;0.0976;4128;252
2016-11-03 19:00:00;35,69;46,83;-11,14;39148;0;0;0;0;44903;5141;0.1144;4237;904
2016-11-03 20:00:00;30,33;36,33;-6,0;39148;0;0;0;0;44903;5513;0.1228;4262;1251
2016-11-03 21:00:00;26,77;29,31;-2,54;39148;0;0;0;0;44903;5114;0.1139;4156;958
2016-11-03 22:00:00;28,2;27,95;0,25;39148;0;0;0;0;44903;4664;0.1039;3975;689
2016-11-03 23:00:00;25,21;25,54;-0,33;39148;0;0;0;0;44903;4211;0.0938;3770;441
2016-12-03 00:00:00;29,01;29,53;-0,52;39148;0;0;0;0;44906;3801;0.0846;3453;348
2016-12-03 01:00:00;26,1;25,24;0,86;39148;0;0;0;0;44906;3614;0.0805;3182;432
2016-12-03 02:00:00;25,69;25,52;0,17;39148;0;0;0;0;44906;3566;0.0794;3032;534
2016-12-03 03:00:00;24,5;24,91;-0,41;39148;0;0;0;0;44906;3513;0.0782;2988;525
2016-12-03 04:00:00;23,26;24,26;-1,0;39148;0;0;0;0;44906;3660;0.0815;3001;659
2016-12-03 05:00:00;24,5;23,91;0,59;39148;0;0;0;0;44906;4010;0.0893;3091;919
2016-12-03 06:00:00;25,45;25,34;0,11;39148;31;0.0008;55;-24;44906;4232;0.0942;3155;1077
2016-12-03 07:00:00;25,51;25,6;-0,09;39148;851;0.0217;971;-120;44906;4186;0.0932;3097;1089
2016-12-03 08:00:00;28,91;26,57;2,34;39148;3243;0.0828;3199;44;44906;3430;0.0764;2930;500
2016-12-03 09:00:00;30,09;31,8;-1,71;39148;6288;0.1606;6102;186;44906;2979;0.0663;2756;223
2016-12-03 10:00:00;29,26;31,17;-1,91;39148;8644;0.2208;8675;-31;44906;2737;0.0609;2636;101
2016-12-03 11:00:00;28,44;29,99;-1,55;39148;9951;0.2542;10284;-333;44906;2559;0.057;2559;0
2016-12-03 12:00:00;27,6;31,39;-3,79;39148;9796;0.2502;10756;-960;44906;2475;0.0551;2546;-71
2016-12-03 13:00:00;25,01;27,92;-2,91;39148;8685;0.2218;10172;-1487;44906;2526;0.0563;2605;-79
2016-12-03 14:00:00;23,38;27,16;-3,78;39148;7031;0.1796;8656;-1625;44906;2663;0.0593;2758;-95
2016-12-03 15:00:00;22,96;25,98;-3,02;39148;4901;0.1252;6330;-1429;44906;2967;0.066;3025;-58
2016-12-03 16:00:00;23,67;27,97;-4,3;39148;2626;0.0671;3574;-948;44906;3106;0.0692;3300;-194
2016-12-03 17:00:00;27,07;31,16;-4,09;39148;738;0.0189;1140;-402;44906;3380;0.0752;3459;-79
2016-12-03 18:00:00;34,09;36,19;-2,1;39148;32;0.0008;62;-30;44906;3763;0.0838;3684;79
2016-12-03 19:00:00;36,97;37,79;-0,82;39148;0;0;0;0;44906;4401;0.098;3986;415
2016-12-03 20:00:00;35,0;31,7;3,3;39148;0;0;0;0;44906;4924;0.1096;4173;751
2016-12-03 21:00:00;30,17;28,84;1,33;39148;0;0;0;0;44906;5070;0.1129;4237;833
2016-12-03 22:00:00;30,91;31,46;-0,55;39148;0;0;0;0;44906;4936;0.11;4217;719
2016-12-03 23:00:00;30,0;30,04;-0,04;39148;0;0;0;0;44906;4950;0.1102;4116;834
2016-03-13 00:00:00;26,51;26,15;0,36;39148;0;0;0;0;44906;5059;0.1127;4555;504
2016-03-13 01:00:00;22,65;23,4;-0,75;39148;0;0;0;0;44906;5292;0.1179;4462;830
2016-03-13 02:00:00;21,67;20,35;1,32;39148;0;0;0;0;44906;5351;0.1192;4337;1014
2016-03-13 03:00:00;21,05;18,93;2,12;39148;0;0;0;0;44906;5360;0.1193;4233;1127
2016-03-13 04:00:00;21,12;19,9;1,22;39148;0;0;0;0;44906;4893;0.109;4148;745
2016-03-13 05:00:00;21,17;19,68;1,49;39148;0;0;0;0;44906;4940;0.11;4144;796
2016-03-13 06:00:00;21,11;20,82;0,29;39148;33;0.0008;60;-27;44906;5342;0.119;4158;1184
2016-03-13 07:00:00;21,08;19,16;1,92;39148;830;0.0212;968;-138;44906;5607;0.1249;4293;1314
2016-03-13 08:00:00;21,31;19,46;1,85;39148;2319;0.0592;3122;-803;44906;5788;0.1289;4538;1250
2016-03-13 09:00:00;21,69;20,97;0,72;39148;4362;0.1114;5720;-1358;44906;5890;0.1312;4607;1283
2016-03-13 10:00:00;21,73;21,14;0,59;39148;6162;0.1574;8059;-1897;44906;5889;0.1311;4531;1358
2016-03-13 11:00:00;21,69;21,54;0,15;39148;7716;0.1971;9716;-2000;44906;5480;0.122;4582;898
2016-03-13 12:00:00;21,07;22,72;-1,65;39148;9172;0.2343;10580;-1408;44906;4878;0.1086;4629;249
2016-03-13 13:00:00;19,4;20,51;-1,11;39148;9732;0.2486;10479;-747;44906;4743;0.1056;4764;-21
2016-03-13 14:00:00;17,78;19,78;-2,0;39148;8949;0.2286;9316;-367;44906;4979;0.1108;5002;-23
2016-03-13 15:00:00;17,46;18,78;-1,32;39148;6882;0.1758;6989;-107;44906;5453;0.1214;5419;34
2016-03-13 16:00:00;18,08;19,74;-1,66;39148;3893;0.0994;3938;-45;44906;6101;0.1358;5798;303
2016-03-13 17:00:00;20,19;22,25;-2,06;39148;1246;0.0319;1283;-37;44906;6336;0.1411;6001;335
2016-03-13 18:00:00;26,08;25,59;0,49;39148;58;0.0015;74;-16;44906;6584;0.1466;6220;364
2016-03-13 19:00:00;33,55;28,24;5,31;39148;0;0;0;0;44906;6771;0.1508;6538;233
2016-03-13 20:00:00;31,05;25,93;5,12;39148;0;0;0;0;44906;6860;0.1528;6522;338
2016-03-13 21:00:00;27,24;24,86;2,38;39148;0;0;0;0;44906;6474;0.1442;6305;169
2016-03-13 22:00:00;28,93;26,33;2,6;39148;0;0;0;0;44906;6120;0.1363;5977;143
2016-03-13 23:00:00;26,63;23,56;3,07;39148;0;0;0;0;44906;5768;0.1284;5597;171
2016-03-14 00:00:00;22,39;21,65;0,74;39149;0;0;0;0;44919;5374;0.1196;5297;77
2016-03-14 01:00:00;20,7;22,71;-2,01;39149;0;0;0;0;44919;5156;0.1148;5027;129
2016-03-14 02:00:00;20,22;21,2;-0,98;39149;0;0;0;0;44919;5032;0.112;4820;212
2016-03-14 03:00:00;19,99;19,51;0,48;39149;0;0;0;0;44919;5030;0.112;4554;476
2016-03-14 04:00:00;20,36;19,71;0,65;39149;0;0;0;0;44919;4964;0.1105;4363;601
2016-03-14 05:00:00;21,92;20,64;1,28;39149;0;0;0;0;44919;4959;0.1104;4204;755
2016-03-14 06:00:00;29,46;29,99;-0,53;39149;85;0.0022;103;-18;44919;4817;0.1072;4014;803
2016-03-14 07:00:00;35,43;33,86;1,57;39149;1912;0.0489;1440;472;44919;4364;0.0972;3888;476
2016-03-14 08:00:00;35,81;32,15;3,66;39149;6572;0.1679;4593;1979;44919;3554;0.0791;3767;-213
2016-03-14 09:00:00;31,75;23,87;7,88;39149;11762;0.3004;8663;3099;44919;3104;0.0691;3582;-478
2016-03-14 10:00:00;28,82;22,77;6,05;39149;15717;0.4015;12637;3080;44919;2916;0.0649;3453;-537
2016-03-14 11:00:00;24,33;21,69;2,64;39149;18578;0.4745;15543;3035;44919;2662;0.0592;3448;-786
2016-03-14 12:00:00;23,31;20,84;2,47;39149;19926;0.509;17016;2910;44919;2647;0.0589;3511;-864
2016-03-14 13:00:00;22,84;21,18;1,66;39149;19427;0.4962;16818;2609;44919;2766;0.0616;3682;-916
2016-03-14 14:00:00;22,55;20,9;1,65;39149;16798;0.4291;14916;1882;44919;2986;0.0665;3911;-925
2016-03-14 15:00:00;23,04;21,2;1,84;39149;12392;0.3166;11339;1053;44919;3225;0.0718;4114;-889
2016-03-14 16:00:00;24,8;21,72;3,08;39149;7010;0.179;6656;354;44919;3318;0.0739;4178;-860
2016-03-14 17:00:00;30,71;28,62;2,09;39149;2155;0.055;2174;-19;44919;3298;0.0734;4034;-736
2016-03-14 18:00:00;39,48;35,1;4,38;39149;88;0.0023;121;-33;44919;3563;0.0793;4043;-480
2016-03-14 19:00:00;47,92;46,05;1,87;39149;0;0;0;0;44919;4020;0.0895;4118;-98
2016-03-14 20:00:00;34,32;33,12;1,2;39149;0;0;0;0;44919;4400;0.0979;4139;261
2016-03-14 21:00:00;29,48;26,88;2,6;39149;0;0;0;0;44919;4379;0.0975;4027;352
2016-03-14 22:00:00;26,37;24,45;1,92;39149;0;0;0;0;44919;4074;0.0907;3862;212
2016-03-14 23:00:00;22,91;20,55;2,36;39149;0;0;0;0;44919;3778;0.0841;3634;144
2016-03-15 00:00:00;21,1;21,2;-0,1;39153;0;0;0;0;44934;3628;0.0807;3508;120
2016-03-15 01:00:00;20,76;22,5;-1,74;39153;0;0;0;0;44934;3578;0.0796;3522;56
2016-03-15 02:00:00;21,17;22,78;-1,61;39153;0;0;0;0;44934;3562;0.0793;3683;-121
2016-03-15 03:00:00;20,74;22,43;-1,69;39153;0;0;0;0;44934;3646;0.0811;3980;-334
2016-03-15 04:00:00;20,91;22,86;-1,95;39153;0;0;0;0;44934;3687;0.082;4414;-727
2016-03-15 05:00:00;22,86;28,5;-5,64;39153;0;0;0;0;44934;3649;0.0812;4995;-1346
2016-03-15 06:00:00;27,1;35,2;-8,1;39153;45;0.0012;54;-9;44934;3759;0.0837;5488;-1729
2016-03-15 07:00:00;33,69;43,99;-10,3;39153;739;0.0189;750;-11;44934;4052;0.0902;5778;-1726
2016-03-15 08:00:00;38,47;58,35;-19,88;39153;2223;0.0568;2115;108;44934;4354;0.0969;5906;-1552
2016-03-15 09:00:00;35,96;47,37;-11,41;39153;3642;0.093;3612;30;44934;4818;0.1072;6083;-1265
2016-03-15 10:00:00;36,09;41,48;-5,39;39153;4856;0.124;4964;-108;44934;5347;0.119;6417;-1070
2016-03-15 11:00:00;34,31;39,7;-5,39;39153;5196;0.1327;5910;-714;44934;6296;0.1402;6917;-621
2016-03-15 12:00:00;30,93;34,25;-3,32;39153;4734;0.1209;6414;-1680;44934;6931;0.1542;7433;-502
2016-03-15 13:00:00;27,44;32,97;-5,53;39153;4194;0.1071;6407;-2213;44934;7539;0.1678;7893;-354
2016-03-15 14:00:00;24,78;31,26;-6,48;39153;3706;0.0946;5791;-2085;44934;7992;0.1778;8278;-286
2016-03-15 15:00:00;23,71;30,0;-6,29;39153;3108;0.0794;4458;-1350;44934;8554;0.1904;8498;56
2016-03-15 16:00:00;23,3;28,36;-5,06;39153;2052;0.0524;2746;-694;44934;9103;0.2026;8490;613
2016-03-15 17:00:00;25,45;28,21;-2,76;39153;701;0.0179;983;-282;44934;9339;0.2079;8355;984
2016-03-15 18:00:00;31,91;32,72;-0,81;39153;45;0.0012;64;-19;44934;8903;0.1981;8354;549
2016-03-15 19:00:00;34,13;36,07;-1,94;39153;0;0;0;0;44934;9604;0.2138;8342;1262
2016-03-15 20:00:00;29,06;28,69;0,37;39153;0;0;0;0;44934;9827;0.2187;8278;1549
2016-03-15 21:00:00;24,15;23,03;1,12;39153;0;0;0;0;44934;8370;0.1863;8260;110
2016-03-15 22:00:00;22,52;22,97;-0,45;39153;0;0;0;0;44934;8423;0.1874;8160;263
2016-03-15 23:00:00;20,95;23,48;-2,53;39153;0;0;0;0;44934;7740;0.1722;7900;-160
2016-03-16 00:00:00;21,22;19,81;1,41;39155;0;0;0;0;44943;9416;0.2095;8361;1055
2016-03-16 01:00:00;20,92;19,17;1,75;39155;0;0;0;0;44943;9762;0.2172;8144;1618
2016-03-16 02:00:00;20,45;16,59;3,86;39155;0;0;0;0;44943;10052;0.2236;8048;2004
2016-03-16 03:00:00;20,06;16,58;3,48;39155;0;0;0;0;44943;10419;0.2318;8017;2402
2016-03-16 04:00:00;20,49;16,06;4,43;39155;0;0;0;0;44943;10965;0.244;8106;2859
2016-03-16 05:00:00;21,59;15,25;6,34;39155;0;0;0;0;44943;11439;0.2545;8269;3170
2016-03-16 06:00:00;26,24;19,92;6,32;39155;100;0.0026;148;-48;44943;11814;0.2629;8577;3237
2016-03-16 07:00:00;33,94;25,6;8,34;39155;1704;0.0435;1957;-253;44943;11715;0.2607;8768;2947
2016-03-16 08:00:00;32,99;23,41;9,58;39155;4996;0.1276;5493;-497;44943;11016;0.2451;9005;2011
2016-03-16 09:00:00;24,71;21,68;3,03;39155;9090;0.2322;9517;-427;44943;11622;0.2586;9410;2212
2016-03-16 10:00:00;22,48;20,65;1,83;39155;12394;0.3166;12958;-564;44943;13054;0.2904;9772;3282
2016-03-16 11:00:00;22,43;19,5;2,93;39155;13968;0.3567;15150;-1182;44943;14557;0.3239;10229;4328
2016-03-16 12:00:00;22,16;19,7;2,46;39155;15197;0.3881;16141;-944;44943;14330;0.3188;10525;3805
2016-03-16 13:00:00;21,85;19,9;1,95;39155;15689;0.4007;15902;-213;44943;13628;0.3032;10621;3007
2016-03-16 14:00:00;21,9;20,3;1,6;39155;14696;0.3753;14211;485;44943;12985;0.2889;10531;2454
2016-03-16 15:00:00;22,28;19,77;2,51;39155;11434;0.292;10788;646;44943;12539;0.279;10405;2134
2016-03-16 16:00:00;23,67;19,9;3,77;39155;6761;0.1727;6232;529;44943;11653;0.2593;9949;1704
2016-03-16 17:00:00;29,92;29,15;0,77;39155;2237;0.0572;2020;217;44943;10133;0.2254;9192;941
2016-03-16 18:00:00;35,6;33,91;1,69;39155;100;0.0026;133;-33;44943;9019;0.2007;8678;341
2016-03-16 19:00:00;39,2;34,67;4,53;39155;0;0;0;0;44943;9344;0.2079;8471;873
2016-03-16 20:00:00;32,02;31,69;0,33;39155;0;0;0;0;44943;9390;0.209;8126;1264
2016-03-16 21:00:00;27,04;28,55;-1,51;39155;0;0;0;0;44943;8846;0.1969;7703;1143
2016-03-16 22:00:00;23,7;23,29;0,41;39155;0;0;0;0;44943;8013;0.1783;7056;957
2016-03-16 23:00:00;22,97;23,23;-0,26;39155;0;0;0;0;44943;6994;0.1556;6197;797
2016-03-17 00:00:00;23,08;22,23;0,85;39158;0;0;0;0;44975;5946;0.1322;4899;1047
2016-03-17 01:00:00;22,3;21,93;0,37;39158;0;0;0;0;44975;5096;0.1133;4127;969
2016-03-17 02:00:00;22,13;22,42;-0,29;39158;0;0;0;0;44975;4432;0.0985;3559;873
2016-03-17 03:00:00;22,27;24,1;-1,83;39158;0;0;0;0;44975;4002;0.089;3138;864
2016-03-17 04:00:00;22,24;23,5;-1,26;39158;0;0;0;0;44975;3630;0.0807;2882;748
2016-03-17 05:00:00;23,55;26,7;-3,15;39158;0;0;0;0;44975;3272;0.0727;2699;573
2016-03-17 06:00:00;33,9;33,88;0,02;39158;212;0.0054;242;-30;44975;3177;0.0706;2572;605
2016-03-17 07:00:00;38,16;39,69;-1,53;39158;3247;0.0829;3061;186;44975;2857;0.0635;2378;479
2016-03-17 08:00:00;34,97;28,3;6,67;39158;9224;0.2356;8562;662;44975;1852;0.0412;2078;-226
2016-03-17 09:00:00;25,98;21,04;4,94;39158;14940;0.3816;14224;716;44975;996;0.0221;1805;-809
2016-03-17 10:00:00;23,11;21,37;1,74;39158;19105;0.4879;18459;646;44975;931;0.0207;1719;-788
2016-03-17 11:00:00;22,96;20,96;2,0;39158;21804;0.5568;20849;955;44975;1252;0.0278;1834;-582
2016-03-17 12:00:00;22,38;20,41;1,97;39158;22950;0.5861;21654;1296;44975;1388;0.0308;2076;-688
2016-03-17 13:00:00;22,2;19,89;2,31;39158;22022;0.5624;20781;1241;44975;1578;0.0351;2476;-898
2016-03-17 14:00:00;22,15;19,87;2,28;39158;19109;0.488;18143;966;44975;1798;0.04;2905;-1107
2016-03-17 15:00:00;22,43;20,62;1,81;39158;14338;0.3661;13691;647;44975;2121;0.0472;3325;-1204
2016-03-17 16:00:00;25,85;24,02;1,83;39158;8186;0.209;7905;281;44975;2528;0.0562;3777;-1249
2016-03-17 17:00:00;31,92;30,97;0,95;39158;2630;0.0672;2626;4;44975;2962;0.0659;4173;-1211
2016-03-17 18:00:00;38,81;39,34;-0,53;39158;156;0.004;189;-33;44975;3689;0.082;4639;-950
2016-03-17 19:00:00;46,69;41,98;4,71;39158;0;0;0;0;44975;4644;0.1032;5248;-604
2016-03-17 20:00:00;37,76;37,84;-0,08;39158;0;0;0;0;44975;5295;0.1177;5777;-482
2016-03-17 21:00:00;30,98;30,23;0,75;39158;0;0;0;0;44975;5751;0.1279;6249;-498
2016-03-17 22:00:00;25,48;26,68;-1,2;39158;0;0;0;0;44975;6127;0.1362;6587;-460
2016-03-17 23:00:00;21,84;22,42;-0,58;39158;0;0;0;0;44975;6422;0.1428;6746;-324
2016-03-18 00:00:00;20,34;23,43;-3,09;39160;0;0;0;0;45001;6865;0.1526;6777;88
2016-03-18 01:00:00;19,47;22,05;-2,58;39160;0;0;0;0;45001;7364;0.1637;6989;375
2016-03-18 02:00:00;19,49;22,19;-2,7;39160;0;0;0;0;45001;7937;0.1764;7307;630
2016-03-18 03:00:00;19,67;21,36;-1,69;39160;0;0;0;0;45001;8352;0.1856;7583;769
2016-03-18 04:00:00;20,14;22,17;-2,03;39160;0;0;0;0;45001;8384;0.1863;7776;608
2016-03-18 05:00:00;21,58;25,79;-4,21;39160;0;0;0;0;45001;8414;0.187;7727;687
2016-03-18 06:00:00;24,86;28,37;-3,51;39160;208;0.0053;231;-23;45001;8236;0.183;7496;740
2016-03-18 07:00:00;32,69;29,87;2,82;39160;2724;0.0696;2597;127;45001;8111;0.1802;7089;1022
2016-03-18 08:00:00;29,94;29,74;0,2;39160;7390;0.1887;6988;402;45001;7576;0.1684;6442;1134
2016-03-18 09:00:00;23,88;21,88;2,0;39160;11486;0.2933;11354;132;45001;6576;0.1461;5908;668
2016-03-18 10:00:00;22,43;21,11;1,32;39160;14153;0.3614;14509;-356;45001;6008;0.1335;5465;543
2016-03-18 11:00:00;22,92;23,52;-0,6;39160;15443;0.3944;16237;-794;45001;5510;0.1225;5006;504
2016-03-18 12:00:00;22,59;24,6;-2,01;39160;15717;0.4014;16777;-1060;45001;5019;0.1115;4651;368
2016-03-18 13:00:00;22,53;24,08;-1,55;39160;14940;0.3816;16117;-1177;45001;4948;0.11;4422;526
2016-03-18 14:00:00;22,56;24,77;-2,21;39160;12904;0.3295;14083;-1179;45001;5092;0.1131;4246;846
2016-03-18 15:00:00;23,46;25,83;-2,37;39160;9540;0.2436;10603;-1063;45001;4981;0.1107;4112;869
2016-03-18 16:00:00;24,42;24,93;-0,51;39160;5426;0.1386;6106;-680;45001;4590;0.102;3940;650
2016-03-18 17:00:00;27,82;28,61;-0,79;39160;1738;0.0444;2051;-313;45001;4062;0.0903;3763;299
2016-03-18 18:00:00;33,99;32,88;1,11;39160;97;0.0025;159;-62;45001;4014;0.0892;3588;426
2016-03-18 19:00:00;39,3;40,48;-1,18;39160;0;0;0;0;45001;3946;0.0876;3439;507
2016-03-18 20:00:00;33,91;35,02;-1,11;39160;0;0;0;0;45001;3530;0.0784;3251;279
2016-03-18 21:00:00;27,09;28,73;-1,64;39160;0;0;0;0;45001;3325;0.0739;3116;209
2016-03-18 22:00:00;26,92;29,08;-2,16;39160;0;0;0;0;45001;2966;0.0659;2954;12
2016-03-18 23:00:00;23,78;25,39;-1,61;39160;0;0;0;0;45001;2636;0.0586;2681;-45
2016-03-19 00:00:00;23,37;24,54;-1,17;39160;0;0;0;0;45004;2424;0.0538;2408;16
2016-03-19 01:00:00;21,68;24,5;-2,82;39160;0;0;0;0;45004;2219;0.0493;2075;144
2016-03-19 02:00:00;21,66;22,83;-1,17;39160;0;0;0;0;45004;2018;0.0448;1858;160
2016-03-19 03:00:00;22,6;22,58;0,02;39160;0;0;0;0;45004;1947;0.0432;1701;246
2016-03-19 04:00:00;22,71;21,44;1,27;39160;0;0;0;0;45004;1812;0.0403;1598;214
2016-03-19 05:00:00;22,2;21,42;0,78;39160;0;0;0;0;45004;1724;0.0383;1538;186
2016-03-19 06:00:00;22,4;20,97;1,43;39160;137;0.0035;140;-3;45004;1583;0.0352;1426;157
2016-03-19 07:00:00;28,93;27,55;1,38;39160;1506;0.0385;1412;94;45004;1612;0.0358;1259;353
2016-03-19 08:00:00;29,38;26,56;2,82;39160;4002;0.1022;3763;239;45004;1846;0.041;1178;668
2016-03-19 09:00:00;28,58;26,02;2,56;39160;6800;0.1737;6398;402;45004;2114;0.047;1181;933
2016-03-19 10:00:00;26,96;23,96;3,0;39160;8782;0.2243;8623;159;45004;2504;0.0556;1320;1184
2016-03-19 11:00:00;24,79;22,09;2,7;39160;10135;0.2588;10225;-90;45004;2962;0.0658;1654;1308
2016-03-19 12:00:00;23,04;21,21;1,83;39160;10888;0.278;11066;-178;45004;3513;0.078;2088;1425
2016-03-19 13:00:00;22,04;20,8;1,24;39160;10703;0.2733;10963;-260;45004;4208;0.0935;2729;1479
2016-03-19 14:00:00;21,12;20,52;0,6;39160;9317;0.2379;9762;-445;45004;5173;0.115;3574;1599
2016-03-19 15:00:00;20,93;18,99;1,94;39160;6987;0.1784;7336;-349;45004;6150;0.1366;4398;1752
2016-03-19 16:00:00;21,3;18,82;2,48;39160;4030;0.103;4237;-207;45004;7038;0.1564;5160;1878
2016-03-19 17:00:00;24,0;24,92;-0,92;39160;1252;0.032;1452;-200;45004;7504;0.1667;5762;1742
2016-03-19 18:00:00;31,21;28,66;2,55;39160;64;0.0016;118;-54;45004;8347;0.1854;6393;1954
2016-03-19 19:00:00;35,42;30,21;5,21;39160;0;0;0;0;45004;9360;0.208;7153;2207
2016-03-19 20:00:00;26,18;20,92;5,26;39160;0;0;0;0;45004;10254;0.2278;8017;2237
2016-03-19 21:00:00;22,78;21,23;1,55;39160;0;0;0;0;45004;10697;0.2377;8913;1784
2016-03-19 22:00:00;24,69;24,15;0,54;39160;0;0;0;0;45004;11094;0.2465;9663;1431
2016-03-19 23:00:00;21,21;23,03;-1,82;39160;0;0;0;0;45004;11454;0.2545;10180;1274
2016-03-20 00:00:00;17,73;20,99;-3,26;39160;0;0;0;0;45007;11496;0.2554;11529;-33
2016-03-20 01:00:00;17,04;19,57;-2,53;39160;0;0;0;0;45007;11311;0.2513;11586;-275
2016-03-20 02:00:00;18,63;18,75;-0,12;39160;0;0;0;0;45007;11321;0.2515;11678;-357
2016-03-20 03:00:00;18,59;18,69;-0,1;39160;0;0;0;0;45007;11612;0.258;11808;-196
2016-03-20 04:00:00;18,71;22,53;-3,82;39160;0;0;0;0;45007;11858;0.2635;11876;-18
2016-03-20 05:00:00;18,73;20,25;-1,52;39160;0;0;0;0;45007;11948;0.2655;11928;20
2016-03-20 06:00:00;18,51;19,82;-1,31;39160;99;0.0025;143;-44;45007;12316;0.2737;11983;333
2016-03-20 07:00:00;17,05;18,42;-1,37;39160;914;0.0233;1265;-351;45007;12414;0.2758;12144;270
2016-03-20 08:00:00;16,04;18,79;-2,75;39160;2163;0.0552;3325;-1162;45007;12736;0.283;12608;128
2016-03-20 09:00:00;16,09;22,32;-6,23;39160;3734;0.0953;5688;-1954;45007;12965;0.2881;13337;-372
2016-03-20 10:00:00;14,33;23,08;-8,75;39160;5493;0.1403;7695;-2202;45007;13076;0.2905;13888;-812
2016-03-20 11:00:00;16,07;23,95;-7,88;39160;7526;0.1922;9045;-1519;45007;13470;0.2993;13917;-447
2016-03-20 12:00:00;13,19;21,96;-8,77;39160;9601;0.2452;9801;-200;45007;13335;0.2963;13899;-564
2016-03-20 13:00:00;12,44;17,61;-5,17;39160;10654;0.2721;9859;795;45007;13037;0.2896;13717;-680
2016-03-20 14:00:00;12,0;13,37;-1,37;39160;9882;0.2524;8814;1068;45007;12844;0.2854;13246;-402
2016-03-20 15:00:00;12,69;13,86;-1,17;39160;7470;0.1907;6674;796;45007;12731;0.2829;12772;-41
2016-03-20 16:00:00;13,59;17,06;-3,47;39160;4335;0.1107;3891;444;45007;12332;0.274;12251;81
2016-03-20 17:00:00;19,02;20,21;-1,19;39160;1416;0.0361;1379;37;45007;11080;0.2462;11762;-682
2016-03-20 18:00:00;23,54;27,84;-4,3;39160;73;0.0018;140;-67;45007;10106;0.2246;11395;-1289
2016-03-20 19:00:00;25,86;32,8;-6,94;39160;0;0;0;0;45007;9904;0.22;11363;-1459
2016-03-20 20:00:00;22,66;33,77;-11,11;39160;0;0;0;0;45007;9987;0.2219;11547;-1560
2016-03-20 21:00:00;22,32;31,77;-9,45;39160;0;0;0;0;45007;10052;0.2233;11644;-1592
2016-03-20 22:00:00;24,03;30,57;-6,54;39160;0;0;0;0;45007;9798;0.2177;11677;-1879
2016-03-20 23:00:00;20,33;26,62;-6,29;39160;0;0;0;0;45007;9750;0.2166;11799;-2049
2016-03-21 00:00:00;20,82;25,47;-4,65;39163;0;0;0;0;45029;10168;0.2258;10451;-283
2016-03-21 01:00:00;19,9;26,31;-6,41;39163;0;0;0;0;45029;10536;0.234;10445;91
2016-03-21 02:00:00;19,79;22,57;-2,78;39163;0;0;0;0;45029;10696;0.2375;10316;380
2016-03-21 03:00:00;19,9;21,56;-1,66;39163;0;0;0;0;45029;10914;0.2424;10124;790
2016-03-21 04:00:00;20,4;21,76;-1,36;39163;0;0;0;0;45029;10701;0.2376;9897;804
2016-03-21 05:00:00;23,18;25,88;-2,7;39163;0;0;1;-1;45029;10017;0.2224;9644;373
2016-03-21 06:00:00;32,01;36,13;-4,12;39163;118;0.003;139;-21;45029;10234;0.2273;9640;594
2016-03-21 07:00:00;31,72;37,22;-5,5;39163;1143;0.0292;1144;-1;45029;10294;0.2286;9960;334
2016-03-21 08:00:00;30,94;34,52;-3,58;39163;3066;0.0783;2862;204;45029;10987;0.244;10775;212
2016-03-21 09:00:00;30,04;36,99;-6,95;39163;5807;0.1483;4815;992;45029;12085;0.2684;11904;181
2016-03-21 10:00:00;24,9;27,34;-2,44;39163;8509;0.2173;6506;2003;45029;13411;0.2978;12928;483
2016-03-21 11:00:00;24,73;25,73;-1,0;39163;10166;0.2595;7668;2498;45029;14468;0.3213;13656;812
2016-03-21 12:00:00;26,03;21,85;4,18;39163;9830;0.251;8160;1670;45029;14906;0.331;14280;626
2016-03-21 13:00:00;24,53;22,84;1,69;39163;8390;0.2142;7913;477;45029;15495;0.3441;14704;791
2016-03-21 14:00:00;23,75;26,0;-2,25;39163;6658;0.17;6970;-312;45029;15852;0.352;14779;1073
2016-03-21 15:00:00;24,28;27,66;-3,38;39163;4806;0.1228;5303;-497;45029;16216;0.3601;14529;1687
2016-03-21 16:00:00;23,91;27,96;-4,05;39163;2712;0.0693;3226;-514;45029;15555;0.3455;14031;1524
2016-03-21 17:00:00;26,87;30,37;-3,5;39163;922;0.0235;1218;-296;45029;15173;0.337;13239;1934
2016-03-21 18:00:00;30,1;32,63;-2,53;39163;53;0.0014;127;-74;45029;15220;0.338;12471;2749
2016-03-21 19:00:00;33,49;34,44;-0,95;39163;0;0;0;0;45029;15118;0.3358;11907;3211
2016-03-21 20:00:00;29,9;28,37;1,53;39163;0;0;0;0;45029;14733;0.3272;11590;3143
2016-03-21 21:00:00;23,02;23,66;-0,64;39163;0;0;0;0;45029;14711;0.3267;11437;3274
2016-03-21 22:00:00;22,11;21,35;0,76;39163;0;0;0;0;45029;13925;0.3092;11198;2727
2016-03-21 23:00:00;20,9;20,66;0,24;39163;0;0;0;0;45029;13259;0.2945;10913;2346
2016-03-22 00:00:00;20,28;21,82;-1,54;39166;0;0;0;0;45063;12702;0.2819;12712;-10
2016-03-22 01:00:00;20,08;22,02;-1,94;39166;0;0;0;0;45063;12282;0.2726;12248;34
2016-03-22 02:00:00;20,05;20,71;-0,66;39166;0;0;0;0;45063;11663;0.2588;11743;-80
2016-03-22 03:00:00;20,47;23,22;-2,75;39166;0;0;0;0;45063;11221;0.249;11182;39
2016-03-22 04:00:00;21,0;22,67;-1,67;39166;0;0;0;0;45063;10820;0.2401;10518;302
2016-03-22 05:00:00;22,01;23,18;-1,17;39166;1;0;0;1;45063;10193;0.2262;9809;384
2016-03-22 06:00:00;24,07;25,65;-1,58;39166;170;0.0044;175;-5;45063;9372;0.208;9120;252
2016-03-22 07:00:00;29,99;30,1;-0,11;39166;1630;0.0416;1423;207;45063;8894;0.1974;8683;211
2016-03-22 08:00:00;31,46;27,3;4,16;39166;4407;0.1125;3516;891;45063;8399;0.1864;8549;-150
2016-03-22 09:00:00;31,41;27,22;4,19;39166;7525;0.1921;5822;1703;45063;8153;0.1809;8708;-555
2016-03-22 10:00:00;28,9;25,46;3,44;39166;9778;0.2497;7753;2025;45063;7807;0.1732;8660;-853
2016-03-22 11:00:00;30,0;26,54;3,46;39166;10398;0.2654;9046;1352;45063;7858;0.1744;8175;-317
2016-03-22 12:00:00;28,94;26,95;1,99;39166;9452;0.2414;9507;-55;45063;7491;0.1662;7710;-219
2016-03-22 13:00:00;28,99;28,82;0,17;39166;9003;0.2298;9053;-50;45063;7028;0.156;7438;-410
2016-03-22 14:00:00;29,0;27,15;1,85;39166;7540;0.1925;7733;-193;45063;6521;0.1447;7223;-702
2016-03-22 15:00:00;29,29;27,02;2,27;39166;5520;0.141;5839;-319;45063;6032;0.1339;7006;-974
2016-03-22 16:00:00;30,08;29,18;0,9;39166;3191;0.0815;3531;-340;45063;5472;0.1214;6522;-1050
2016-03-22 17:00:00;34,01;30,3;3,71;39166;1215;0.031;1301;-86;45063;4869;0.1081;5697;-828
2016-03-22 18:00:00;36,73;32,85;3,88;39166;104;0.0026;134;-30;45063;4302;0.0955;4963;-661
2016-03-22 19:00:00;40,64;39,36;1,28;39166;0;0;0;0;45063;4442;0.0986;4953;-511
2016-03-22 20:00:00;38,1;34,11;3,99;39166;0;0;0;0;45063;4566;0.1013;5164;-598
2016-03-22 21:00:00;33,05;28,96;4,09;39166;0;0;0;0;45063;4518;0.1003;5386;-868
2016-03-22 22:00:00;29,86;27,3;2,56;39166;0;0;0;0;45063;4352;0.0966;5590;-1238
2016-03-22 23:00:00;23,73;24,46;-0,73;39166;0;0;0;0;45063;4456;0.0989;5758;-1302
2016-03-23 00:00:00;21,3;24,06;-2,76;39170;0;0;0;0;45100;4598;0.102;4972;-374
2016-03-23 01:00:00;20,51;22,14;-1,63;39170;0;0;0;0;45100;4666;0.1035;5064;-398
2016-03-23 02:00:00;20,26;21,85;-1,59;39170;0;0;0;0;45100;5260;0.1166;5232;28
2016-03-23 03:00:00;21,06;22,0;-0,94;39170;0;0;0;0;45100;5692;0.1262;5402;290
2016-03-23 04:00:00;21,38;22,86;-1,48;39170;0;0;0;0;45100;5696;0.1263;5671;25
2016-03-23 05:00:00;21,38;24,37;-2,99;39170;1;0;0;1;45100;5666;0.1256;5931;-265
2016-03-23 06:00:00;25,88;27,17;-1,29;39170;172;0.0044;181;-9;45100;5381;0.1193;6229;-848
2016-03-23 07:00:00;32,9;35,42;-2,52;39170;1335;0.0341;1297;38;45100;5442;0.1207;6612;-1170
2016-03-23 08:00:00;32,46;36,06;-3,6;39170;3428;0.0875;3204;224;45100;5857;0.1298;7133;-1276
2016-03-23 09:00:00;30,03;33,28;-3,25;39170;5806;0.1482;5582;224;45100;6243;0.1385;7743;-1500
2016-03-23 10:00:00;26,53;30,59;-4,06;39170;7703;0.1966;7536;167;45100;6402;0.142;8206;-1804
2016-03-23 11:00:00;26,73;29,17;-2,44;39170;8664;0.2212;8901;-237;45100;6753;0.1497;8450;-1697
2016-03-23 12:00:00;25,23;28,33;-3,1;39170;8765;0.2238;9475;-710;45100;7088;0.1572;8663;-1575
2016-03-23 13:00:00;25,0;28,8;-3,8;39170;8634;0.2204;9270;-636;45100;7666;0.17;9095;-1429
2016-03-23 14:00:00;24,03;28,84;-4,81;39170;7622;0.1946;8202;-580;45100;8109;0.1798;9357;-1248
2016-03-23 15:00:00;24,13;25,85;-1,72;39170;5834;0.1489;6476;-642;45100;8075;0.179;9321;-1246
2016-03-23 16:00:00;24,18;26,13;-1,95;39170;3405;0.0869;4176;-771;45100;7216;0.16;8943;-1727
2016-03-23 17:00:00;28,0;29,23;-1,23;39170;1251;0.0319;1702;-451;45100;6284;0.1393;7984;-1700
2016-03-23 18:00:00;32,44;33,56;-1,12;39170;115;0.0029;198;-83;45100;5132;0.1138;6974;-1842
2016-03-23 19:00:00;37,16;36,88;0,28;39170;0;0;0;0;45100;4873;0.1081;6255;-1382
2016-03-23 20:00:00;34,98;29,23;5,75;39170;0;0;0;0;45100;4910;0.1089;5622;-712
2016-03-23 21:00:00;31,43;25,7;5,73;39170;0;0;0;0;45100;4684;0.1038;5128;-444
2016-03-23 22:00:00;25,02;23,29;1,73;39170;0;0;0;0;45100;4359;0.0966;4651;-292
2016-03-23 23:00:00;22,59;22,1;0,49;39170;0;0;0;0;45100;4098;0.0909;4015;83
2016-03-24 00:00:00;22,08;20,76;1,32;39178;0;0;0;0;45139;4115;0.0912;3043;1072
2016-03-24 01:00:00;21,5;19,07;2,43;39178;0;0;0;0;45139;3862;0.0856;2641;1221
2016-03-24 02:00:00;21,11;18,78;2,33;39178;0;0;0;0;45139;3568;0.079;2267;1301
2016-03-24 03:00:00;21,38;19,95;1,43;39178;0;0;0;0;45139;3006;0.0666;1932;1074
2016-03-24 04:00:00;21,75;21,37;0,38;39178;0;0;0;0;45139;2508;0.0556;1645;863
2016-03-24 05:00:00;22,97;24,48;-1,51;39178;1;0;1;0;45139;2211;0.049;1400;811
2016-03-24 06:00:00;31,49;27,18;4,31;39178;228;0.0058;292;-64;45139;1945;0.0431;1268;677
2016-03-24 07:00:00;35,0;30,57;4,43;39178;1770;0.0452;2139;-369;45139;1734;0.0384;1218;516
2016-03-24 08:00:00;34,94;31,84;3,1;39178;4452;0.1136;5195;-743;45139;1446;0.032;1224;222
2016-03-24 09:00:00;32,4;31,76;0,64;39178;7313;0.1867;8423;-1110;45139;1386;0.0307;1286;100
2016-03-24 10:00:00;31,69;32,73;-1,04;39178;9685;0.2472;10722;-1037;45139;1598;0.0354;1505;93
2016-03-24 11:00:00;31,0;32,06;-1,06;39178;10209;0.2606;12082;-1873;45139;2064;0.0457;1872;192
2016-03-24 12:00:00;28,62;31,53;-2,91;39178;9628;0.2458;12372;-2744;45139;2324;0.0515;2259;65
2016-03-24 13:00:00;27,27;33,32;-6,05;39178;9156;0.2337;11388;-2232;45139;2499;0.0554;2695;-196
2016-03-24 14:00:00;26,5;30,85;-4,35;39178;8252;0.2106;9558;-1306;45139;3017;0.0668;3040;-23
2016-03-24 15:00:00;25,35;28,75;-3,4;39178;6307;0.161;7094;-787;45139;3352;0.0742;3255;97
2016-03-24 16:00:00;26,6;27,24;-0,64;39178;3747;0.0956;4271;-524;45139;3165;0.0701;3271;-106
2016-03-24 17:00:00;30,0;31,09;-1,09;39178;1270;0.0324;1619;-349;45139;2989;0.0662;3260;-271
2016-03-24 18:00:00;32,47;35,68;-3,21;39178;80;0.002;169;-89;45139;3318;0.0735;3439;-121
2016-03-24 19:00:00;35,18;38,43;-3,25;39178;0;0;0;0;45139;3782;0.0838;4080;-298
2016-03-24 20:00:00;33,97;35,01;-1,04;39178;0;0;0;0;45139;4380;0.097;4846;-466
2016-03-24 21:00:00;25,96;29,34;-3,38;39178;0;0;0;0;45139;5371;0.119;5852;-481
2016-03-24 22:00:00;25,06;27,75;-2,69;39178;0;0;0;0;45139;6147;0.1362;6771;-624
2016-03-24 23:00:00;22,52;23,58;-1,06;39178;0;0;0;0;45139;6473;0.1434;7501;-1028
2016-03-25 00:00:00;23,92;27,24;-3,32;39178;0;0;0;0;45148;6760;0.1498;7271;-511
2016-03-25 01:00:00;21,07;26,87;-5,8;39178;0;0;0;0;45148;7191;0.1593;7598;-407
2016-03-25 02:00:00;21,0;25,24;-4,24;39178;0;0;0;0;45148;7576;0.1678;7871;-295
2016-03-25 03:00:00;20,0;23,86;-3,86;39178;0;0;0;0;45148;7928;0.1756;8168;-240
2016-03-25 04:00:00;20,01;24,16;-4,15;39178;0;0;0;0;45148;8205;0.1818;8526;-321
2016-03-25 05:00:00;20,3;24,2;-3,9;39178;1;0;1;0;45148;8536;0.1891;8888;-352
2016-03-25 06:00:00;20,26;24,87;-4,61;39178;143;0.0036;184;-41;45148;9022;0.1998;9276;-254
2016-03-25 07:00:00;20,39;24,72;-4,33;39178;995;0.0254;1063;-68;45148;9242;0.2047;9685;-443
2016-03-25 08:00:00;21,85;27,07;-5,22;39178;2622;0.0669;2336;286;45148;9085;0.2012;10098;-1013
2016-03-25 09:00:00;23,85;28,33;-4,48;39178;4061;0.1036;3543;518;45148;9071;0.2009;10487;-1416
2016-03-25 10:00:00;27,26;28,55;-1,29;39178;4793;0.1224;4266;527;45148;9310;0.2062;10798;-1488
2016-03-25 11:00:00;28,91;28,99;-0,08;39178;4918;0.1255;4542;376;45148;8897;0.1971;10818;-1921
2016-03-25 12:00:00;27,87;29,19;-1,32;39178;4570;0.1166;4279;291;45148;8380;0.1856;10641;-2261
2016-03-25 13:00:00;27,06;29,99;-2,93;39178;4060;0.1036;3636;424;45148;7959;0.1763;10306;-2347
2016-03-25 14:00:00;26,01;28,75;-2,74;39178;3328;0.085;2925;403;45148;8220;0.1821;9635;-1415
2016-03-25 15:00:00;24,44;28,51;-4,07;39178;2529;0.0646;2204;325;45148;8476;0.1878;8996;-520
2016-03-25 16:00:00;23,5;26,58;-3,08;39178;1556;0.0397;1369;187;45148;7924;0.1755;8263;-339
2016-03-25 17:00:00;26,1;27,73;-1,63;39178;673;0.0172;554;119;45148;6724;0.149;7535;-811
2016-03-25 18:00:00;29,44;32,17;-2,73;39178;77;0.0019;72;5;45148;5582;0.1236;6934;-1352
2016-03-25 19:00:00;33,08;36,39;-3,31;39178;0;0;0;0;45148;5264;0.1166;6269;-1005
2016-03-25 20:00:00;32,95;36,31;-3,36;39178;0;0;0;0;45148;5614;0.1243;5766;-152
2016-03-25 21:00:00;31,48;31,51;-0,03;39178;0;0;0;0;45148;5792;0.1283;5372;420
2016-03-25 22:00:00;30,12;28,81;1,31;39178;0;0;0;0;45148;5584;0.1237;4982;602
2016-03-25 23:00:00;30,0;26,33;3,67;39178;0;0;0;0;45148;5084;0.1126;4734;350
2016-03-26 00:00:00;28,07;21,54;6,53;39178;0;0;0;0;45155;4750;0.1052;4230;520
2016-03-26 01:00:00;24,08;18,53;5,55;39178;0;0;0;0;45155;4181;0.0926;3853;328
2016-03-26 02:00:00;21,11;17,85;3,26;39178;0;0;0;0;45155;3718;0.0823;3638;80
2016-03-26 03:00:00;20,0;17,45;2,55;39178;0;0;0;0;45155;4014;0.0889;3505;509
2016-03-26 04:00:00;20,0;17,37;2,63;39178;0;0;0;0;45155;4233;0.0938;3474;759
2016-03-26 05:00:00;20,01;16,27;3,74;39178;1;0;1;0;45155;4355;0.0965;3532;823
2016-03-26 06:00:00;20,01;15,44;4,57;39178;289;0.0074;259;30;45155;4456;0.0986;3603;853
2016-03-26 07:00:00;21,69;17,12;4,57;39178;2258;0.0576;1755;503;45155;4620;0.1023;3754;866
2016-03-26 08:00:00;22,49;15,69;6,8;39178;6038;0.1541;4298;1740;45155;4630;0.1025;3962;668
2016-03-26 09:00:00;24,0;13,76;10,24;39178;10671;0.2724;7540;3131;45155;5142;0.1139;4241;901
2016-03-26 10:00:00;21,6;11,44;10,16;39178;14736;0.3761;10713;4023;45155;6251;0.1385;4686;1565
2016-03-26 11:00:00;19,97;9,66;10,31;39178;16504;0.4212;13228;3276;45155;7200;0.1595;5235;1965
2016-03-26 12:00:00;19,06;8,91;10,15;39178;16838;0.4298;14864;1974;45155;8205;0.1817;5886;2319
2016-03-26 13:00:00;18,07;7,87;10,2;39178;16934;0.4322;15577;1357;45155;8666;0.1919;6639;2027
2016-03-26 14:00:00;16,28;6,44;9,84;39178;16323;0.4166;14629;1694;45155;9407;0.2083;7484;1923
2016-03-26 15:00:00;15,75;1,75;14,0;39178;13501;0.3446;11728;1773;45155;10562;0.2339;8414;2148
2016-03-26 16:00:00;15,85;4,82;11,03;39178;8516;0.2174;7382;1134;45155;11784;0.261;9216;2568
2016-03-26 17:00:00;19,39;7,71;11,68;39178;3392;0.0866;2900;492;45155;11993;0.2656;10308;1685
2016-03-26 18:00:00;21,32;13,04;8,28;39178;358;0.0091;363;-5;45155;13292;0.2943;11956;1336
2016-03-26 19:00:00;22,12;17,34;4,78;39178;0;0;0;0;45155;16552;0.3665;13915;2637
2016-03-26 20:00:00;20,75;14,6;6,15;39178;0;0;0;0;45155;19180;0.4248;15498;3682
2016-03-26 21:00:00;17,99;11,14;6,85;39178;0;0;0;0;45155;20902;0.4629;16819;4083
2016-03-26 22:00:00;17,91;9,69;8,22;39178;0;0;0;0;45155;20958;0.4641;17752;3206
2016-03-26 23:00:00;14,66;6,53;8,13;39178;0;0;0;0;45155;20875;0.4623;18038;2837
2016-03-27 00:00:00;7,33;-2,69;10,02;39178;0;0;0;0;45155;20100;0.4451;19274;826
2016-03-27 01:00:00;3,04;-11,42;14,46;39178;0;0;0;0;45155;20214;0.4476;19459;755
2016-03-27 02:00:00;0,0;0,0;0,0;39178;0;0;0;0;45155;0;0;0;0
2016-03-27 03:00:00;6,1;-6,32;12,42;39178;0;0;0;0;45155;20679;0.458;19877;802
2016-03-27 04:00:00;4,02;-4,01;8,03;39178;0;0;0;0;45155;21346;0.4727;19972;1374
2016-03-27 05:00:00;4,02;-2,25;6,27;39178;0;0;0;0;45155;21778;0.4823;19604;2174
2016-03-27 06:00:00;0,91;-6,75;7,66;39178;3;0.0001;8;-5;45155;21626;0.4789;18899;2727
2016-03-27 07:00:00;4,63;-3,33;7,96;39178;676;0.0173;631;45;45155;21001;0.4651;17839;3162
2016-03-27 08:00:00;7,5;5,89;1,61;39178;3699;0.0944;3434;265;45155;20734;0.4592;16599;4135
2016-03-27 09:00:00;8,91;6,08;2,83;39178;7236;0.1847;7367;-131;45155;20146;0.4462;15631;4515
2016-03-27 10:00:00;10,99;7,52;3,47;39178;9322;0.2379;10479;-1157;45155;19997;0.4429;15192;4805
2016-03-27 11:00:00;11,16;13,55;-2,39;39178;10688;0.2728;11881;-1193;45155;19756;0.4375;14964;4792
2016-03-27 12:00:00;11,49;12,25;-0,76;39178;11791;0.301;12219;-428;45155;19894;0.4406;15401;4493
2016-03-27 13:00:00;9,19;7,26;1,93;39178;12359;0.3155;11756;603;45155;19627;0.4347;15680;3947
2016-03-27 14:00:00;6,49;1,82;4,67;39178;10633;0.2714;10590;43;45155;19492;0.4317;14969;4523
2016-03-27 15:00:00;6,92;2,32;4,6;39178;8760;0.2236;8880;-120;45155;18571;0.4113;13745;4826
2016-03-27 16:00:00;7,47;-2,22;9,69;39178;6758;0.1725;6773;-15;45155;16304;0.361;12440;3864
2016-03-27 17:00:00;13,06;1,67;11,39;39178;4434;0.1132;4375;59;45155;13615;0.3015;11095;2520
2016-03-27 18:00:00;14,94;7,8;7,14;39178;1924;0.0491;1907;17;45155;11676;0.2586;9795;1881
2016-03-27 19:00:00;19,6;14,16;5,44;39178;241;0.0062;260;-19;45155;10553;0.2337;9001;1552
2016-03-27 20:00:00;22,86;15,73;7,13;39178;0;0;0;0;45155;10964;0.2428;9235;1729
2016-03-27 21:00:00;20,36;12,52;7,84;39178;0;0;0;0;45155;12394;0.2745;9991;2403
2016-03-27 22:00:00;19,98;13,25;6,73;39178;0;0;0;0;45155;13927;0.3084;10802;3125
2016-03-27 23:00:00;18,5;10,92;7,58;39178;0;0;0;0;45155;14613;0.3236;11381;3232
2016-03-28 00:00:00;12,88;3,98;8,9;39178;0;0;0;0;45155;14458;0.3202;12187;2271
2016-03-28 01:00:00;8,28;1,97;6,31;39178;0;0;0;0;45155;14498;0.321;12291;2207
2016-03-28 02:00:00;7,43;1,18;6,25;39178;0;0;0;0;45155;14758;0.3268;12437;2321
2016-03-28 03:00:00;6,5;1,22;5,28;39178;0;0;0;0;45155;15337;0.3396;12865;2472
2016-03-28 04:00:00;5,27;1,53;3,74;39178;0;0;0;0;45155;16098;0.3565;13496;2602
2016-03-28 05:00:00;6,28;1,49;4,79;39178;0;0;0;0;45155;17234;0.3817;14344;2890
2016-03-28 06:00:00;5,86;-1,92;7,78;39178;6;0.0002;41;-35;45155;18870;0.4179;15429;3441
2016-03-28 07:00:00;5,96;-0,29;6,25;39178;732;0.0187;901;-169;45155;20410;0.452;16548;3862
2016-03-28 08:00:00;3,99;-4,66;8,65;39178;4250;0.1084;4341;-91;45155;20967;0.4643;17254;3713
2016-03-28 09:00:00;3,41;-7,73;11,14;39178;8803;0.2247;8772;31;45155;20476;0.4535;17710;2766
2016-03-28 10:00:00;2,68;-13,11;15,79;39178;11635;0.297;12295;-660;45155;22381;0.4956;18654;3727
2016-03-28 11:00:00;0,07;-14,37;14,44;39178;12813;0.327;14044;-1231;45155;25916;0.574;20445;5471
2016-03-28 12:00:00;-4,01;-52,46;48,45;39178;12404;0.3166;14251;-1847;45155;26255;0.5814;22790;3465
2016-03-28 13:00:00;-28,68;-86,78;58,1;39178;11171;0.2851;13116;-1945;45155;26540;0.5878;24834;1706
2016-03-28 14:00:00;-38,45;-84,31;45,86;39178;9986;0.2549;11114;-1128;45155;26848;0.5946;26129;719
2016-03-28 15:00:00;-19,92;-72,47;52,55;39178;8132;0.2076;8741;-609;45155;26728;0.5919;26505;223
2016-03-28 16:00:00;-13,82;-24,29;10,47;39178;6314;0.1612;6401;-87;45155;25608;0.5671;26142;-534
2016-03-28 17:00:00;-4,2;2,64;-6,84;39178;4681;0.1195;4051;630;45155;23787;0.5268;25222;-1435
2016-03-28 18:00:00;7,45;16,29;-8,84;39178;2120;0.0541;1804;316;45155;21076;0.4667;24100;-3024
2016-03-28 19:00:00;11,79;25,55;-13,76;39178;228;0.0058;272;-44;45155;19281;0.427;22817;-3536
2016-03-28 20:00:00;17,02;30,48;-13,46;39178;0;0;1;-1;45155;18317;0.4056;21290;-2973
2016-03-28 21:00:00;11,47;26,85;-15,38;39178;0;0;0;0;45155;18182;0.4026;20139;-1957
2016-03-28 22:00:00;16,29;26,48;-10,19;39178;0;0;0;0;45155;17887;0.3961;19170;-1283
2016-03-28 23:00:00;12,98;24,15;-11,17;39178;0;0;0;0;45155;18139;0.4017;18404;-265
2016-03-29 00:00:00;11,51;20,27;-8,76;39179;0;0;0;0;45188;18057;0.3996;17913;144
2016-03-29 01:00:00;9,14;16,69;-7,55;39179;0;0;0;0;45188;17628;0.3901;17646;-18
2016-03-29 02:00:00;11,95;17,09;-5,14;39179;0;0;0;0;45188;17891;0.3959;17313;578
2016-03-29 03:00:00;9,23;14,79;-5,56;39179;0;0;0;0;45188;18539;0.4103;17249;1290
2016-03-29 04:00:00;8,3;13,63;-5,33;39179;0;0;0;0;45188;18767;0.4153;17342;1425
2016-03-29 05:00:00;13,49;17,16;-3,67;39179;0;0;0;0;45188;18894;0.4181;17511;1383
2016-03-29 06:00:00;25,35;24,66;0,69;39179;6;0.0002;32;-26;45188;20168;0.4463;17807;2361
2016-03-29 07:00:00;31,52;29,92;1,6;39179;538;0.0137;656;-118;45188;20440;0.4523;18191;2249
2016-03-29 08:00:00;31,43;31,7;-0,27;39179;3127;0.0798;3035;92;45188;20617;0.4562;18958;1659
2016-03-29 09:00:00;26,37;27,7;-1,33;39179;6980;0.1782;6555;425;45188;21470;0.4751;20121;1349
2016-03-29 10:00:00;21,76;22,28;-0,52;39179;10031;0.256;10418;-387;45188;22934;0.5075;21176;1758
2016-03-29 11:00:00;21,06;21,05;0,01;39179;12194;0.3113;13399;-1205;45188;23295;0.5155;21892;1403
2016-03-29 12:00:00;20,43;22,54;-2,11;39179;13600;0.3471;15172;-1572;45188;22808;0.5047;21852;956
2016-03-29 13:00:00;19,99;21,21;-1,22;39179;14140;0.3609;15649;-1509;45188;22426;0.4963;21488;938
2016-03-29 14:00:00;19,08;18,14;0,94;39179;14326;0.3656;14944;-618;45188;22161;0.4904;20943;1218
2016-03-29 15:00:00;19,05;15,91;3,14;39179;12979;0.3313;12880;99;45188;21784;0.4821;20105;1679
2016-03-29 16:00:00;19,14;16,71;2,43;39179;9937;0.2536;9847;90;45188;20518;0.4541;18939;1579
2016-03-29 17:00:00;21,48;20,07;1,41;39179;6184;0.1578;6214;-30;45188;17518;0.3877;17342;176
2016-03-29 18:00:00;30,07;29,37;0,7;39179;2622;0.067;2625;-3;45188;14027;0.3104;14992;-965
2016-03-29 19:00:00;35,79;36,74;-0,95;39179;317;0.0081;408;-91;45188;10890;0.241;12831;-1941
2016-03-29 20:00:00;39,54;42,85;-3,31;39179;0;0;2;-2;45188;9666;0.2139;11629;-1963
2016-03-29 21:00:00;32,64;33,43;-0,79;39179;0;0;0;0;45188;9137;0.2022;11387;-2250
2016-03-29 22:00:00;28,56;34,16;-5,6;39179;0;0;0;0;45188;9057;0.2004;11531;-2474
2016-03-29 23:00:00;22,72;28,98;-6,26;39179;0;0;0;0;45188;9103;0.2015;11700;-2597
2016-03-30 00:00:00;24,9;26,57;-1,67;39184;0;0;0;0;45249;9621;0.2126;10930;-1309
2016-03-30 01:00:00;22,0;22,93;-0,93;39184;0;0;0;0;45249;10971;0.2425;11015;-44
2016-03-30 02:00:00;20,87;20,79;0,08;39184;0;0;0;0;45249;12004;0.2653;11080;924
2016-03-30 03:00:00;19,92;19,47;0,45;39184;0;0;0;0;45249;12499;0.2762;11359;1140
2016-03-30 04:00:00;20,18;19,53;0,65;39184;0;0;0;0;45249;12431;0.2747;11405;1026
2016-03-30 05:00:00;21,65;20,54;1,11;39184;0;0;0;0;45249;13270;0.2933;11709;1561
2016-03-30 06:00:00;29,6;24,75;4,85;39184;4;0.0001;7;-3;45249;13746;0.3038;12445;1301
2016-03-30 07:00:00;29,89;23,38;6,51;39184;300;0.0076;356;-56;45249;14271;0.3154;13181;1090
2016-03-30 08:00:00;27,95;24,53;3,42;39184;1332;0.034;1718;-386;45249;14322;0.3165;13773;549
2016-03-30 09:00:00;31,93;27,08;4,85;39184;3390;0.0865;3683;-293;45249;14660;0.324;14495;165
2016-03-30 10:00:00;29,65;28,72;0,93;39184;5734;0.1463;5873;-139;45249;15518;0.343;15442;76
2016-03-30 11:00:00;27,16;24,48;2,68;39184;8099;0.2067;7778;321;45249;16181;0.3576;16054;127
2016-03-30 12:00:00;26,89;24,51;2,38;39184;9378;0.2394;9189;189;45249;16432;0.3631;16211;221
2016-03-30 13:00:00;22,25;23,05;-0,8;39184;9381;0.2394;9677;-296;45249;16617;0.3672;16253;364
2016-03-30 14:00:00;22,3;23,62;-1,32;39184;9227;0.2355;9584;-357;45249;16251;0.3592;15735;516
2016-03-30 15:00:00;22,23;23,36;-1,13;39184;8666;0.2212;8766;-100;45249;15396;0.3402;14412;984
2016-03-30 16:00:00;25,64;22,34;3,3;39184;7338;0.1873;7147;191;45249;14810;0.3273;12807;2003
2016-03-30 17:00:00;29,04;23,89;5,15;39184;4791;0.1223;4781;10;45249;13818;0.3054;10928;2890
2016-03-30 18:00:00;31,9;26,57;5,33;39184;1995;0.051;2111;-116;45249;11789;0.2605;8903;2886
2016-03-30 19:00:00;37,42;28,18;9,24;39184;252;0.0064;325;-73;45249;9809;0.2168;7165;2644
2016-03-30 20:00:00;37,0;29,0;8,0;39184;0;0;0;0;45249;9169;0.2026;6356;2813
2016-03-30 21:00:00;34,65;28,83;5,82;39184;0;0;0;0;45249;8236;0.182;6146;2090
2016-03-30 22:00:00;30,38;25,93;4,45;39184;0;0;0;0;45249;7348;0.1624;5868;1480
2016-03-30 23:00:00;27,25;23,65;3,6;39184;0;0;0;0;45249;6666;0.1473;5462;1204
2016-03-31 00:00:00;23,34;24,2;-0,86;39193;0;0;0;0;45334;6192;0.1366;5629;563
2016-03-31 01:00:00;22,27;23,63;-1,36;39193;0;0;0;0;45334;5459;0.1204;4998;461
2016-03-31 02:00:00;21,5;23,22;-1,72;39193;0;0;0;0;45334;4604;0.1016;4369;235
2016-03-31 03:00:00;21,11;22,04;-0,93;39193;0;0;0;0;45334;4248;0.0937;3801;447
2016-03-31 04:00:00;21,29;20,44;0,85;39193;0;0;0;0;45334;3786;0.0835;3156;630
2016-03-31 05:00:00;22,86;24,37;-1,51;39193;0;0;0;0;45334;3125;0.0689;2524;601
2016-03-31 06:00:00;29,08;33,45;-4,37;39193;8;0.0002;14;-6;45334;2719;0.06;2011;708
2016-03-31 07:00:00;36,09;36,98;-0,89;39193;526;0.0134;650;-124;45334;2264;0.0499;1661;603
2016-03-31 08:00:00;40,96;34,75;6,21;39193;2622;0.0669;2907;-285;45334;1757;0.0388;1466;291
2016-03-31 09:00:00;36,46;33,1;3,36;39193;5980;0.1526;6061;-81;45334;1441;0.0318;1323;118
2016-03-31 10:00:00;34,64;31,52;3,12;39193;9288;0.237;9338;-50;45334;1487;0.0328;1291;196
2016-03-31 11:00:00;33,95;31,01;2,94;39193;11718;0.299;11855;-137;45334;1824;0.0402;1442;382
2016-03-31 12:00:00;30,03;30,13;-0,1;39193;13532;0.3453;12884;648;45334;2258;0.0498;1733;525
2016-03-31 13:00:00;30,03;26,69;3,34;39193;13638;0.348;12287;1351;45334;2776;0.0612;2018;758
2016-03-31 14:00:00;27,92;24,23;3,69;39193;12471;0.3182;10870;1601;45334;3538;0.078;2483;1055
2016-03-31 15:00:00;25,12;23,85;1,27;39193;9418;0.2403;8841;577;45334;4424;0.0976;3221;1203
2016-03-31 16:00:00;24,73;25,97;-1,24;39193;5804;0.1481;6296;-492;45334;5046;0.1113;4028;1018
2016-03-31 17:00:00;24,93;29,2;-4,27;39193;2931;0.0748;3630;-699;45334;5363;0.1183;4872;491
2016-03-31 18:00:00;27,44;33,02;-5,58;39193;1192;0.0304;1479;-287;45334;6166;0.136;5539;627
2016-03-31 19:00:00;31,07;34,72;-3,65;39193;152;0.0039;238;-86;45334;6971;0.1538;6121;850
2016-03-31 20:00:00;31,99;32,77;-0,78;39193;1;0;0;1;45334;7539;0.1663;6633;906
2016-03-31 21:00:00;25,35;29,59;-4,24;39193;0;0;0;0;45334;8048;0.1776;7027;1021
2016-03-31 22:00:00;25,23;27,17;-1,94;39193;0;0;0;0;45334;8486;0.1872;7438;1048
2016-03-31 23:00:00;23,22;25,01;-1,79;39193;0;0;0;0;45334;9017;0.1989;7738;1279
2016-01-04 00:00:00;21,35;21,01;0,34;39195;0;0;0;0;45334;9337;0.206;7964;1373
2016-01-04 01:00:00;20,98;22,51;-1,53;39195;0;0;0;0;45334;9045;0.1995;8049;996
2016-01-04 02:00:00;21,19;23,92;-2,73;39195;0;0;0;0;45334;8336;0.1839;7739;597
2016-01-04 03:00:00;20,64;24,34;-3,7;39195;0;0;0;0;45334;7564;0.1668;7177;387
2016-01-04 04:00:00;21,13;23,61;-2,48;39195;0;0;0;0;45334;6520;0.1438;6605;-85
2016-01-04 05:00:00;21,78;24,3;-2,52;39195;0;0;0;0;45334;5500;0.1213;6082;-582
2016-01-04 06:00:00;29,73;30,79;-1,06;39195;7;0.0002;19;-12;45334;4812;0.1062;5557;-745
2016-01-04 07:00:00;36,5;37,66;-1,16;39195;512;0.0131;674;-162;45334;4422;0.0976;4906;-484
2016-01-04 08:00:00;40,44;43,57;-3,13;39195;2383;0.0608;3042;-659;45334;3469;0.0765;4001;-532
2016-01-04 09:00:00;38,39;39,0;-0,61;39195;5325;0.1358;6299;-974;45334;2592;0.0572;3046;-454
2016-01-04 10:00:00;34,57;35,81;-1,24;39195;8722;0.2226;9691;-969;45334;2303;0.0508;2385;-82
2016-01-04 11:00:00;30,55;29,95;0,6;39195;11605;0.2961;12292;-687;45334;2070;0.0456;2098;-28
2016-01-04 12:00:00;25,79;24,24;1,55;39195;13433;0.3427;13814;-381;45334;2126;0.0469;1958;168
2016-01-04 13:00:00;23,09;24,11;-1,02;39195;14210;0.3625;14561;-351;45334;2175;0.048;1988;187
2016-01-04 14:00:00;23,13;25,1;-1,97;39195;14310;0.3651;14594;-284;45334;1965;0.0434;2017;-52
2016-01-04 15:00:00;23,0;24,17;-1,17;39195;13398;0.3418;13301;97;45334;1736;0.0383;1977;-241
2016-01-04 16:00:00;22,45;22,4;0,05;39195;10814;0.2759;10665;149;45334;1518;0.0335;2000;-482
2016-01-04 17:00:00;24,28;23,64;0,64;39195;7167;0.1829;6724;443;45334;1373;0.0303;2100;-727
2016-01-04 18:00:00;31,91;28,83;3,08;39195;3104;0.0792;2786;318;45334;1327;0.0292;2132;-805
2016-01-04 19:00:00;33,9;30,49;3,41;39195;442;0.0113;425;17;45334;1443;0.0318;2450;-1007
2016-01-04 20:00:00;35,85;32,59;3,26;39195;2;0;1;1;45334;2157;0.0476;3638;-1481
2016-01-04 21:00:00;31,3;31,91;-0,61;39195;0;0;0;0;45334;3520;0.0776;5073;-1553
2016-01-04 22:00:00;24,33;25,28;-0,95;39195;0;0;0;0;45334;5425;0.1197;6197;-772
2016-01-04 23:00:00;26,03;25,86;0,17;39195;0;0;0;0;45334;7111;0.1569;7383;-272
2016-02-04 00:00:00;21,82;21,89;-0,07;39195;0;0;0;0;45334;8309;0.1833;7691;618
2016-02-04 01:00:00;21,31;23,35;-2,04;39195;0;0;0;0;45334;8777;0.1936;8465;312
2016-02-04 02:00:00;21,1;21,81;-0,71;39195;0;0;0;0;45334;9145;0.2017;9341;-196
2016-02-04 03:00:00;19,84;22,02;-2,18;39195;0;0;0;0;45334;9690;0.2137;9895;-205
2016-02-04 04:00:00;19,91;22,08;-2,17;39195;0;0;0;0;45334;10372;0.2288;10307;65
2016-02-04 05:00:00;20,09;21,98;-1,89;39195;0;0;0;0;45334;10614;0.2341;10693;-79
2016-02-04 06:00:00;20,19;21,2;-1,01;39195;21;0.0005;45;-24;45334;10344;0.2282;10893;-549
2016-02-04 07:00:00;22,29;23,55;-1,26;39195;1097;0.028;1328;-231;45334;9761;0.2154;10853;-1092
2016-02-04 08:00:00;22,51;23,8;-1,29;39195;4554;0.1162;5618;-1064;45334;8520;0.188;9840;-1320
2016-02-04 09:00:00;22,04;27,93;-5,89;39195;9060;0.2312;11251;-2191;45334;6305;0.1391;7743;-1438
2016-02-04 10:00:00;20,81;26,05;-5,24;39195;13742;0.3506;16647;-2905;45334;5492;0.1211;6557;-1065
2016-02-04 11:00:00;19,55;27,12;-7,57;39195;17358;0.4428;20604;-3246;45334;5321;0.1174;6535;-1214
2016-02-04 12:00:00;18,12;25,01;-6,89;39195;19202;0.4899;22832;-3630;45334;4983;0.1099;6605;-1622
2016-02-04 13:00:00;17,06;24,05;-6,99;39195;19707;0.5028;23360;-3653;45334;5068;0.1118;6679;-1611
2016-02-04 14:00:00;14,06;22,02;-7,96;39195;18402;0.4695;22364;-3962;45334;5416;0.1195;6744;-1328
2016-02-04 15:00:00;16,05;22,52;-6,47;39195;15636;0.399;19546;-3910;45334;5184;0.1144;6639;-1455
2016-02-04 16:00:00;18,73;23,76;-5,03;39195;12010;0.3064;15103;-3093;45334;4968;0.1096;6392;-1424
2016-02-04 17:00:00;20,12;25,84;-5,72;39195;7333;0.1871;9350;-2017;45334;4732;0.1044;5970;-1238
2016-02-04 18:00:00;23,41;32,24;-8,83;39195;2929;0.0747;3800;-871;45334;4075;0.0899;6020;-1945
2016-02-04 19:00:00;28,2;35,08;-6,88;39195;423;0.0108;605;-182;45334;4345;0.0958;6838;-2493
2016-02-04 20:00:00;30,43;39,34;-8,91;39195;2;0.0001;3;-1;45334;6076;0.134;8628;-2552
2016-02-04 21:00:00;30,1;35,88;-5,78;39195;0;0;0;0;45334;7870;0.1736;10516;-2646
2016-02-04 22:00:00;26,79;30,51;-3,72;39195;0;0;0;0;45334;9075;0.2002;11655;-2580
2016-02-04 23:00:00;21,43;23,61;-2,18;39195;0;0;0;0;45334;9406;0.2075;11765;-2359
2016-03-04 00:00:00;19,59;18,93;0,66;39195;0;0;0;0;45334;9420;0.2078;8986;434
2016-03-04 01:00:00;18,07;17,43;0,64;39195;0;0;0;0;45334;8880;0.1959;8793;87
2016-03-04 02:00:00;17,5;14,94;2,56;39195;0;0;0;0;45334;8176;0.1803;8500;-324
2016-03-04 03:00:00;15,29;13,65;1,64;39195;0;0;0;0;45334;7542;0.1664;8326;-784
2016-03-04 04:00:00;15,68;13,91;1,77;39195;0;0;0;0;45334;7151;0.1578;8385;-1234
2016-03-04 05:00:00;15,59;14,06;1,53;39195;0;0;0;0;45334;7003;0.1545;8482;-1479
2016-03-04 06:00:00;13,32;12,01;1,31;39195;21;0.0006;42;-21;45334;6588;0.1453;8590;-2002
2016-03-04 07:00:00;14,6;13,78;0,82;39195;984;0.0251;1119;-135;45334;6624;0.1461;8615;-1991
2016-03-04 08:00:00;17,48;16,94;0,54;39195;3711;0.0947;4411;-700;45334;6134;0.1353;8024;-1890
2016-03-04 09:00:00;18,55;19,18;-0,63;39195;7481;0.1909;8504;-1023;45334;5306;0.1171;6563;-1257
2016-03-04 10:00:00;17,36;17,47;-0,11;39195;11599;0.296;12491;-892;45334;3879;0.0856;5421;-1542
2016-03-04 11:00:00;17,67;16,27;1,4;39195;14799;0.3776;15515;-716;45334;3340;0.0737;4763;-1423
2016-03-04 12:00:00;15,48;15,01;0,47;39195;17055;0.4352;17220;-165;45334;3158;0.0697;4407;-1249
2016-03-04 13:00:00;14,8;7,5;7,3;39195;17806;0.4543;17498;308;45334;3169;0.0699;4144;-975
2016-03-04 14:00:00;12,75;6,29;6,46;39195;16825;0.4292;16537;288;45334;3260;0.0719;3756;-496
2016-03-04 15:00:00;12,18;6,58;5,6;39195;14279;0.3643;14187;92;45334;2941;0.0649;3254;-313
2016-03-04 16:00:00;13,02;7,53;5,49;39195;10636;0.2714;10802;-166;45334;2214;0.0488;2762;-548
2016-03-04 17:00:00;15,77;12,47;3,3;39195;6447;0.1645;6715;-268;45334;1734;0.0382;2384;-650
2016-03-04 18:00:00;21,19;22,78;-1,59;39195;2588;0.066;2831;-243;45334;1393;0.0307;2375;-982
2016-03-04 19:00:00;23,15;25,63;-2,48;39195;376;0.0096;470;-94;45334;1795;0.0396;2585;-790
2016-03-04 20:00:00;25,28;27,66;-2,38;39195;2;0;2;0;45334;2414;0.0532;3047;-633
2016-03-04 21:00:00;25,01;25,64;-0,63;39195;0;0;0;0;45334;3172;0.07;3646;-474
2016-03-04 22:00:00;24,32;22,7;1,62;39195;0;0;0;0;45334;3634;0.0802;4273;-639
2016-03-04 23:00:00;20,9;21,43;-0,53;39195;0;0;0;0;45334;4076;0.0899;4881;-805
2016-04-04 00:00:00;21,0;20,34;0,66;39197;0;0;0;0;45337;4343;0.0958;3724;619
2016-04-04 01:00:00;19,59;19,02;0,57;39197;0;0;0;0;45337;4703;0.1037;3961;742
2016-04-04 02:00:00;19,15;18,07;1,08;39197;0;0;0;0;45337;5100;0.1125;4124;976
2016-04-04 03:00:00;18,75;15,65;3,1;39197;0;0;0;0;45337;5286;0.1166;4398;888
2016-04-04 04:00:00;18,72;16,4;2,32;39197;0;0;0;0;45337;6131;0.1352;4714;1417
2016-04-04 05:00:00;20,39;19,13;1,26;39197;0;0;0;0;45337;6878;0.1517;5071;1807
2016-04-04 06:00:00;29,1;26,08;3,02;39197;20;0.0006;34;-14;45337;7641;0.1685;5450;2191
2016-04-04 07:00:00;34,19;29,25;4,94;39197;746;0.019;835;-89;45337;8381;0.1849;5865;2516
2016-04-04 08:00:00;35,42;29,88;5,54;39197;3028;0.0773;3360;-332;45337;8099;0.1786;6019;2080
2016-04-04 09:00:00;33,5;25,88;7,62;39197;6382;0.1628;6865;-483;45337;7678;0.1694;5814;1864
2016-04-04 10:00:00;29,62;22,97;6,65;39197;10620;0.2709;10320;300;45337;7292;0.1608;5614;1678
2016-04-04 11:00:00;25,1;22,01;3,09;39197;13634;0.3478;13115;519;45337;7381;0.1628;5576;1805
2016-04-04 12:00:00;23,37;21,5;1,87;39197;15506;0.3956;14930;576;45337;7746;0.1708;5603;2143
2016-04-04 13:00:00;23,83;19,9;3,93;39197;16366;0.4176;15335;1031;45337;7931;0.1749;5610;2321
2016-04-04 14:00:00;23,93;19,25;4,68;39197;15337;0.3913;14743;594;45337;7473;0.1648;5548;1925
2016-04-04 15:00:00;23,04;19,39;3,65;39197;12967;0.3308;13020;-53;45337;7716;0.1702;5201;2515
2016-04-04 16:00:00;27,42;20,65;6,77;39197;10030;0.2559;10190;-160;45337;7099;0.1566;4729;2370
2016-04-04 17:00:00;29,25;24,44;4,81;39197;6377;0.1627;6496;-119;45337;6488;0.1431;4167;2321
2016-04-04 18:00:00;32,96;27,62;5,34;39197;2856;0.0728;2822;34;45337;5118;0.1129;3627;1491
2016-04-04 19:00:00;35,05;29,43;5,62;39197;478;0.0122;476;2;45337;3300;0.0728;3018;282
2016-04-04 20:00:00;36,1;31,52;4,58;39197;5;0.0001;2;3;45337;3092;0.0682;2721;371
2016-04-04 21:00:00;35,6;30,2;5,4;39197;0;0;0;0;45337;2344;0.0517;2627;-283
2016-04-04 22:00:00;30,3;29,01;1,29;39197;0;0;0;0;45337;2014;0.0444;2628;-614
2016-04-04 23:00:00;25,96;22,73;3,23;39197;0;0;0;0;45337;2031;0.0448;2644;-613
2016-05-04 00:00:00;21,39;22,3;-0,91;39198;0;0;0;0;45340;2600;0.0573;2525;75
2016-05-04 01:00:00;20,8;20,01;0,79;39198;0;0;0;0;45340;3456;0.0762;2793;663
2016-05-04 02:00:00;20,76;17,79;2,97;39198;0;0;0;0;45340;3913;0.0863;2973;940
2016-05-04 03:00:00;20,31;17,64;2,67;39198;0;0;0;0;45340;4388;0.0968;3037;1351
2016-05-04 04:00:00;20,34;20,11;0,23;39198;0;0;0;0;45340;4818;0.1063;3074;1744
2016-05-04 05:00:00;21,79;23,1;-1,31;39198;0;0;0;0;45340;4646;0.1025;3137;1509
2016-05-04 06:00:00;27,84;36,1;-8,26;39198;26;0.0007;45;-19;45340;4356;0.0961;3247;1109
2016-05-04 07:00:00;32,76;42,42;-9,66;39198;1047;0.0267;1043;4;45340;4187;0.0923;3374;813
2016-05-04 08:00:00;35,18;43,58;-8,4;39198;3841;0.098;3811;30;45340;3558;0.0785;3420;138
2016-05-04 09:00:00;34,92;39,32;-4,4;39198;7470;0.1906;7226;244;45340;2715;0.0599;3253;-538
2016-05-04 10:00:00;34,1;36,43;-2,33;39198;10836;0.2764;10455;381;45340;2457;0.0542;3114;-657
2016-05-04 11:00:00;32,93;32,93;0,0;39198;12521;0.3194;12815;-294;45340;2467;0.0544;3230;-763
2016-05-04 12:00:00;29,52;29,78;-0,26;39198;13379;0.3413;13942;-563;45340;2782;0.0614;3604;-822
2016-05-04 13:00:00;26,58;28,18;-1,6;39198;13266;0.3384;13514;-248;45340;3032;0.0669;3977;-945
2016-05-04 14:00:00;24,74;27,44;-2,7;39198;12194;0.3111;11984;210;45340;3411;0.0752;4330;-919
2016-05-04 15:00:00;24,19;26,0;-1,81;39198;9916;0.253;9919;-3;45340;3864;0.0852;4578;-714
2016-05-04 16:00:00;23,96;24,09;-0,13;39198;6932;0.1768;7321;-389;45340;4672;0.103;4971;-299
2016-05-04 17:00:00;27,05;24,55;2,5;39198;4014;0.1024;4371;-357;45340;5460;0.1204;5412;48
2016-05-04 18:00:00;29,79;26,8;2,99;39198;1636;0.0417;1788;-152;45340;6552;0.1445;5948;604
2016-05-04 19:00:00;30,66;26,49;4,17;39198;266;0.0068;316;-50;45340;7260;0.1601;6652;608
2016-05-04 20:00:00;30,04;26,58;3,46;39198;4;0.0001;2;2;45340;8149;0.1798;7341;808
2016-05-04 21:00:00;28,0;23,83;4,17;39198;0;0;0;0;45340;9798;0.2161;8219;1579
2016-05-04 22:00:00;25,32;20,02;5,3;39198;0;0;0;0;45340;12306;0.2714;9364;2942
2016-05-04 23:00:00;21,97;18,08;3,89;39198;0;0;0;0;45340;13478;0.2973;10325;3153
2016-06-04 00:00:00;20,0;15,35;4,65;39211;0;0;0;0;45340;13202;0.2912;10369;2833
2016-06-04 01:00:00;19,2;15,49;3,71;39211;0;0;0;0;45340;12987;0.2864;11304;1683
2016-06-04 02:00:00;19,06;15,45;3,61;39211;0;0;0;0;45340;12948;0.2856;11845;1103
2016-06-04 03:00:00;18,95;14,11;4,84;39211;0;0;0;0;45340;13080;0.2885;11977;1103
2016-06-04 04:00:00;19,02;14,66;4,36;39211;0;0;0;0;45340;12663;0.2793;11981;682
2016-06-04 05:00:00;20,0;15,89;4,11;39211;0;0;0;0;45340;12534;0.2764;11948;586
2016-06-04 06:00:00;24,33;19,1;5,23;39211;28;0.0008;36;-8;45340;12256;0.2703;11874;382
2016-06-04 07:00:00;32,97;31,56;1,41;39211;904;0.023;885;19;45340;12405;0.2736;11927;478
2016-06-04 08:00:00;34,24;35,17;-0,93;39211;3732;0.0952;3456;276;45340;12273;0.2707;12268;5
2016-06-04 09:00:00;25,98;29,6;-3,62;39211;7747;0.1976;6797;950;45340;13004;0.2868;13006;-2
2016-06-04 10:00:00;23,24;23,23;0,01;39211;11372;0.2901;10174;1198;45340;15501;0.3419;14020;1481
2016-06-04 11:00:00;21,97;19,0;2,97;39211;13334;0.34;12803;531;45340;18396;0.4057;15029;3367
2016-06-04 12:00:00;21,25;17,25;4,0;39211;13839;0.3529;14145;-306;45340;19794;0.4366;16003;3791
2016-06-04 13:00:00;20,02;16,7;3,32;39211;14081;0.3591;14058;23;45340;20337;0.4486;16952;3385
2016-06-04 14:00:00;19,75;16,74;3,01;39211;13312;0.3395;12951;361;45340;20982;0.4628;17690;3292
2016-06-04 15:00:00;19,85;14,86;4,99;39211;12258;0.3126;10942;1316;45340;21509;0.4744;18030;3479
2016-06-04 16:00:00;20,09;14,85;5,24;39211;10102;0.2577;8593;1509;45340;21483;0.4738;17975;3508
2016-06-04 17:00:00;21,59;16,88;4,71;39211;6730;0.1716;5624;1106;45340;20376;0.4494;17320;3056
2016-06-04 18:00:00;23,1;16,68;6,42;39211;3162;0.0806;2470;692;45340;18746;0.4134;16280;2466
2016-06-04 19:00:00;26,71;20,18;6,53;39211;519;0.0132;419;100;45340;16718;0.3687;15481;1237
2016-06-04 20:00:00;28,26;22,65;5,61;39211;3;0.0001;4;-1;45340;16738;0.3692;15302;1436
2016-06-04 21:00:00;23,23;20,24;2,99;39211;0;0;0;0;45340;19056;0.4203;16117;2939
2016-06-04 22:00:00;21,06;18,07;2,99;39211;0;0;0;0;45340;20656;0.4556;17429;3227
2016-06-04 23:00:00;19,01;11,56;7,45;39211;0;0;0;0;45340;21232;0.4683;18535;2697
2016-07-04 00:00:00;16,42;10,47;5,95;39212;0;0;0;0;45355;21052;0.4642;18932;2120
2016-07-04 01:00:00;16,0;7,04;8,96;39212;0;0;0;0;45355;20598;0.4542;19021;1577
2016-07-04 02:00:00;13,46;8,79;4,67;39212;0;0;0;0;45355;19468;0.4293;18937;531
2016-07-04 03:00:00;12,57;7,72;4,85;39212;0;0;0;0;45355;18646;0.4111;18816;-170
2016-07-04 04:00:00;13,49;11,32;2,17;39212;0;0;0;0;45355;16999;0.3748;18629;-1630
2016-07-04 05:00:00;17,37;19,74;-2,37;39212;0;0;0;0;45355;15714;0.3465;18304;-2590
2016-07-04 06:00:00;22,62;31,56;-8,94;39212;38;0.001;53;-15;45355;14815;0.3267;18071;-3256
2016-07-04 07:00:00;28,4;35,12;-6,72;39212;1031;0.0263;1057;-26;45355;13937;0.3073;17963;-4026
2016-07-04 08:00:00;31,31;37,86;-6,55;39212;3620;0.0923;3876;-256;45355;13868;0.3058;18448;-4580
2016-07-04 09:00:00;26,33;35,29;-8,96;39212;6400;0.1632;7193;-793;45355;15409;0.3397;19452;-4043
2016-07-04 10:00:00;21,55;28,13;-6,58;39212;8919;0.2274;10164;-1245;45355;17068;0.3764;20292;-3224
2016-07-04 11:00:00;21,56;28,6;-7,04;39212;10722;0.2734;12151;-1429;45355;18131;0.3998;20516;-2385
2016-07-04 12:00:00;22,32;25,9;-3,58;39212;11392;0.2905;13250;-1858;45355;18363;0.4049;19915;-1552
2016-07-04 13:00:00;21,6;24,52;-2,92;39212;11719;0.2989;13397;-1678;45355;17818;0.3929;19006;-1188
2016-07-04 14:00:00;22,57;24,48;-1,91;39212;11688;0.298;12728;-1040;45355;17505;0.386;17916;-411
2016-07-04 15:00:00;21,86;23,37;-1,51;39212;10858;0.2769;11210;-352;45355;17178;0.3788;16757;421
2016-07-04 16:00:00;21,94;21,86;0,08;39212;9082;0.2316;8928;154;45355;16397;0.3615;15415;982
2016-07-04 17:00:00;22,73;22,9;-0,17;39212;6250;0.1594;5953;297;45355;14968;0.33;13715;1253
2016-07-04 18:00:00;28,59;28,9;-0,31;39212;2962;0.0755;2722;240;45355;12939;0.2853;11571;1368
2016-07-04 19:00:00;31,11;30,02;1,09;39212;560;0.0143;520;40;45355;10330;0.2278;9712;618
2016-07-04 20:00:00;32,68;31,52;1,16;39212;6;0.0002;9;-3;45355;9924;0.2188;8882;1042
2016-07-04 21:00:00;29,41;28,51;0,9;39212;0;0;0;0;45355;9688;0.2136;8914;774
2016-07-04 22:00:00;28,27;27,09;1,18;39212;0;0;0;0;45355;9479;0.209;9251;228
2016-07-04 23:00:00;23,54;23,03;0,51;39212;0;0;0;0;45355;9393;0.2071;9356;37
2016-08-04 00:00:00;23,39;24,73;-1,34;39215;0;0;0;0;45363;9159;0.2019;8917;242
2016-08-04 01:00:00;21,69;24,17;-2,48;39215;0;0;0;0;45363;8603;0.1896;8608;-5
2016-08-04 02:00:00;21,18;22,49;-1,31;39215;0;0;0;0;45363;8354;0.1841;8065;289
2016-08-04 03:00:00;20,52;22,16;-1,64;39215;0;0;0;0;45363;8143;0.1795;7409;734
2016-08-04 04:00:00;21,04;21,88;-0,84;39215;0;0;0;0;45363;7989;0.1761;6830;1159
2016-08-04 05:00:00;21,72;21,4;0,32;39215;0;0;0;0;45363;7144;0.1575;6224;920
2016-08-04 06:00:00;29,12;27,53;1,59;39215;45;0.0012;60;-15;45363;6160;0.1358;5625;535
2016-08-04 07:00:00;35,0;29,47;5,53;39215;1152;0.0294;1154;-2;45363;5345;0.1178;4972;373
2016-08-04 08:00:00;38,2;34,64;3,56;39215;4406;0.1124;4176;230;45363;4318;0.0952;4189;129
2016-08-04 09:00:00;37,55;31,05;6,5;39215;8662;0.2209;7825;837;45363;3518;0.0776;3507;11
2016-08-04 10:00:00;34,22;27,16;7,06;39215;12309;0.3138;11005;1304;45363;3780;0.0833;3162;618
2016-08-04 11:00:00;32,96;25,3;7,66;39215;14936;0.3809;13050;1886;45363;4242;0.0935;3011;1231
2016-08-04 12:00:00;29,74;23,68;6,06;39215;15395;0.3926;14020;1375;45363;4041;0.0891;2953;1088
2016-08-04 13:00:00;27,9;23,88;4,02;39215;14385;0.3668;13995;390;45363;3764;0.083;2895;869
2016-08-04 14:00:00;26,36;25,71;0,65;39215;12910;0.3292;13054;-144;45363;3510;0.0774;2743;767
2016-08-04 15:00:00;24,66;23,86;0,8;39215;10967;0.2796;11209;-242;45363;3098;0.0683;2382;716
2016-08-04 16:00:00;23,95;25,23;-1,28;39215;8534;0.2176;8621;-87;45363;2574;0.0567;1959;615
2016-08-04 17:00:00;27,03;26,46;0,57;39215;5563;0.1419;5584;-21;45363;2211;0.0488;1530;681
2016-08-04 18:00:00;29,58;28,21;1,37;39215;2770;0.0706;2564;206;45363;1744;0.0384;1117;627
2016-08-04 19:00:00;32,22;29,26;2,96;39215;582;0.0148;490;92;45363;1170;0.0258;824;346
2016-08-04 20:00:00;31,96;30,64;1,32;39215;8;0.0002;8;0;45363;930;0.0205;697;233
2016-08-04 21:00:00;30,66;29,4;1,26;39215;0;0;0;0;45363;942;0.0208;683;259
2016-08-04 22:00:00;30,68;29,4;1,28;39215;0;0;0;0;45363;1078;0.0238;699;379
2016-08-04 23:00:00;29,0;27,54;1,46;39215;0;0;0;0;45363;1300;0.0286;752;548
2016-09-04 00:00:00;28,45;24,34;4,11;39215;0;0;0;0;45363;1383;0.0305;773;610
2016-09-04 01:00:00;24,18;22,34;1,84;39215;0;0;0;0;45363;1533;0.0338;799;734
2016-09-04 02:00:00;23,28;21,98;1,3;39215;0;0;0;0;45363;1467;0.0323;810;657
2016-09-04 03:00:00;21,84;19,97;1,87;39215;0;0;0;0;45363;1367;0.0301;820;547
2016-09-04 04:00:00;21,46;19,63;1,83;39215;0;0;0;0;45363;1194;0.0263;862;332
2016-09-04 05:00:00;21,72;19,18;2,54;39215;0;0;0;0;45363;1008;0.0222;904;104
2016-09-04 06:00:00;22,42;20,13;2,29;39215;61;0.0016;90;-29;45363;1033;0.0227;941;92
2016-09-04 07:00:00;23,42;21,66;1,76;39215;1374;0.035;1514;-140;45363;1236;0.0272;968;268
2016-09-04 08:00:00;27,21;22,94;4,27;39215;5010;0.1278;5295;-285;45363;1240;0.0274;938;302
2016-09-04 09:00:00;25,12;22,76;2,36;39215;9427;0.2404;9826;-399;45363;809;0.0178;871;-62
2016-09-04 10:00:00;22,76;22,56;0,2;39215;13222;0.3372;13452;-230;45363;805;0.0178;892;-87
2016-09-04 11:00:00;22,58;22,82;-0,24;39215;15233;0.3884;15655;-422;45363;1174;0.0258;1032;142
2016-09-04 12:00:00;21,83;22,93;-1,1;39215;15808;0.4031;16470;-662;45363;1507;0.0332;1239;268
2016-09-04 13:00:00;20,81;21,23;-0,42;39215;14813;0.3777;15692;-879;45363;1466;0.0323;1433;33
2016-09-04 14:00:00;19,94;21,08;-1,14;39215;12956;0.3304;13777;-821;45363;1394;0.0308;1568;-174
2016-09-04 15:00:00;20,35;21,33;-0,98;39215;10663;0.2719;11262;-599;45363;1392;0.0307;1672;-280
2016-09-04 16:00:00;20,3;21,07;-0,77;39215;7968;0.2032;8413;-445;45363;1706;0.0376;1791;-85
2016-09-04 17:00:00;22,27;20,33;1,94;39215;5160;0.1316;5290;-130;45363;2471;0.0544;2133;338
2016-09-04 18:00:00;26,91;23,07;3,84;39215;2664;0.068;2405;259;45363;3309;0.073;2881;428
2016-09-04 19:00:00;29,62;24,82;4,8;39215;577;0.0147;463;114;45363;4153;0.0916;3863;290
2016-09-04 20:00:00;31,81;26,34;5,47;39215;10;0.0002;8;2;45363;5794;0.1277;5139;655
2016-09-04 21:00:00;29,56;26,07;3,49;39215;0;0;0;0;45363;7698;0.1697;6402;1296
2016-09-04 22:00:00;27,44;24,86;2,58;39215;0;0;0;0;45363;8572;0.1889;7420;1152
2016-09-04 23:00:00;24,0;20,61;3,39;39215;0;0;0;0;45363;9009;0.1986;7902;1107
2016-10-04 00:00:00;21,13;18,8;2,33;39215;0;0;0;0;45363;8874;0.1956;8350;524
2016-10-04 01:00:00;20,03;17,22;2,81;39215;0;0;0;0;45363;8245;0.1818;8008;237
2016-10-04 02:00:00;19,25;16,97;2,28;39215;0;0;0;0;45363;7529;0.166;7601;-72
2016-10-04 03:00:00;18,96;17,86;1,1;39215;0;0;0;0;45363;7106;0.1566;7162;-56
2016-10-04 04:00:00;19,02;17,21;1,81;39215;0;0;0;0;45363;6774;0.1493;6805;-31
2016-10-04 05:00:00;18,88;17,63;1,25;39215;0;0;0;0;45363;6502;0.1434;6539;-37
2016-10-04 06:00:00;19,15;16,21;2,94;39215;42;0.0011;58;-16;45363;6274;0.1383;6260;14
2016-10-04 07:00:00;19,19;18,57;0,62;39215;941;0.024;964;-23;45363;5786;0.1276;5896;-110
2016-10-04 08:00:00;20,22;18,6;1,62;39215;3358;0.0856;3417;-59;45363;4604;0.1015;5284;-680
2016-10-04 09:00:00;20,97;19,84;1,13;39215;7122;0.1816;6611;511;45363;3429;0.0756;4467;-1038
2016-10-04 10:00:00;21,0;18,16;2,84;39215;11649;0.297;9750;1899;45363;3153;0.0695;3770;-617
2016-10-04 11:00:00;20,59;15,34;5,25;39215;15514;0.3956;12288;3226;45363;3090;0.0681;3433;-343
2016-10-04 12:00:00;19,29;11,83;7,46;39215;17658;0.4503;13857;3801;45363;2866;0.0632;3399;-533
2016-10-04 13:00:00;16,89;9,58;7,31;39215;18215;0.4645;13988;4227;45363;2878;0.0634;3398;-520
2016-10-04 14:00:00;14,25;4,51;9,74;39215;16457;0.4196;13117;3340;45363;3254;0.0718;3484;-230
2016-10-04 15:00:00;13,61;3,53;10,08;39215;13902;0.3546;11524;2378;45363;3980;0.0878;3722;258
2016-10-04 16:00:00;12,06;4,29;7,77;39215;11042;0.2816;9420;1622;45363;4796;0.1057;4128;668
2016-10-04 17:00:00;16,67;9,46;7,21;39215;7536;0.1922;6484;1052;45363;5512;0.1215;4775;737
2016-10-04 18:00:00;20,78;17,5;3,28;39215;3774;0.0962;3112;662;45363;6499;0.1433;5745;754
2016-10-04 19:00:00;22,47;18,55;3,92;39215;850;0.0217;627;223;45363;7210;0.1589;6765;445
2016-10-04 20:00:00;24,55;19,22;5,33;39215;15;0.0004;12;3;45363;8759;0.1931;7969;790
2016-10-04 21:00:00;23,0;16,28;6,72;39215;0;0;0;0;45363;11014;0.2428;8892;2122
2016-10-04 22:00:00;21,84;16,57;5,27;39215;0;0;0;0;45363;11780;0.2597;9482;2298
2016-10-04 23:00:00;19,57;15,48;4,09;39215;0;0;0;0;45363;11639;0.2566;9645;1994
2016-11-04 00:00:00;16,35;10,55;5,8;39219;0;0;0;0;45363;10998;0.2424;9866;1132
2016-11-04 01:00:00;13,7;9,37;4,33;39219;0;0;0;0;45363;10560;0.2328;9498;1062
2016-11-04 02:00:00;12,81;9,41;3,4;39219;0;0;0;0;45363;10521;0.232;9172;1349
2016-11-04 03:00:00;10,66;8,4;2,26;39219;0;0;0;0;45363;10193;0.2247;8977;1216
2016-11-04 04:00:00;13,09;8,99;4,1;39219;0;0;0;0;45363;9807;0.2162;8880;927
2016-11-04 05:00:00;18,55;14,62;3,93;39219;0;0;0;0;45363;9436;0.208;8858;578
2016-11-04 06:00:00;25,49;21,85;3,64;39219;90;0.0023;132;-42;45363;9781;0.2156;8807;974
2016-11-04 07:00:00;32,0;32,29;-0,29;39219;1808;0.0461;1973;-165;45363;9392;0.207;8575;817
2016-11-04 08:00:00;34,61;32,29;2,32;39219;5992;0.1528;6590;-598;45363;8002;0.1764;8093;-91
2016-11-04 09:00:00;28,98;31,05;-2,07;39219;10960;0.2795;12079;-1119;45363;7766;0.1712;7638;128
2016-11-04 10:00:00;25,63;27,88;-2,25;39219;15427;0.3934;16819;-1392;45363;8166;0.18;7452;714
2016-11-04 11:00:00;23,1;23,56;-0,46;39219;18822;0.4799;19892;-1070;45363;8196;0.1807;7606;590
2016-11-04 12:00:00;22,59;23,47;-0,88;39219;20776;0.5297;21411;-635;45363;8233;0.1815;8071;162
2016-11-04 13:00:00;22,51;24,1;-1,59;39219;21217;0.541;21494;-277;45363;8694;0.1916;8614;80
2016-11-04 14:00:00;22,12;22,25;-0,13;39219;20016;0.5104;20305;-289;45363;9275;0.2045;9201;74
2016-11-04 15:00:00;21,83;22,36;-0,53;39219;17632;0.4496;17633;-1;45363;10097;0.2226;9710;387
2016-11-04 16:00:00;22,11;23,05;-0,94;39219;13644;0.3479;13653;-9;45363;10692;0.2357;10241;451
2016-11-04 17:00:00;23,68;23,72;-0,04;39219;8567;0.2184;8582;-15;45363;11082;0.2443;10645;437
2016-11-04 18:00:00;28,47;29,62;-1,15;39219;3809;0.0971;3767;42;45363;11174;0.2464;10842;332
2016-11-04 19:00:00;31,27;31,74;-0,47;39219;776;0.0198;760;16;45363;10622;0.2342;10957;-335
2016-11-04 20:00:00;32,56;34,15;-1,59;39219;16;0.0004;19;-3;45363;10764;0.2373;11143;-379
2016-11-04 21:00:00;31,49;32,59;-1,1;39219;0;0;0;0;45363;10579;0.2332;11227;-648
2016-11-04 22:00:00;27,86;32,44;-4,58;39219;0;0;0;0;45363;9924;0.2188;11219;-1295
2016-11-04 23:00:00;24,8;27,79;-2,99;39219;0;0;0;0;45363;9169;0.2021;10952;-1783
2016-12-04 00:00:00;22,8;24,77;-1,97;39221;0;0;0;0;45366;8688;0.1915;9185;-497
2016-12-04 01:00:00;22,2;23,73;-1,53;39221;0;0;0;0;45366;8011;0.1766;8658;-647
2016-12-04 02:00:00;21,69;23,73;-2,04;39221;0;0;0;0;45366;7384;0.1628;8157;-773
2016-12-04 03:00:00;21,05;23,32;-2,27;39221;0;0;0;0;45366;7235;0.1595;7783;-548
2016-12-04 04:00:00;21,32;22,43;-1,11;39221;0;0;0;0;45366;7165;0.158;7493;-328
2016-12-04 05:00:00;22,15;23,0;-0,85;39221;0;0;0;0;45366;7209;0.1589;7192;17
2016-12-04 06:00:00;28,98;30,21;-1,23;39221;85;0.0022;100;-15;45366;6922;0.1526;6819;103
2016-12-04 07:00:00;36,0;33,78;2,22;39221;1170;0.0298;1318;-148;45366;6378;0.1406;6357;21
2016-12-04 08:00:00;38,94;40,93;-1,99;39221;3484;0.0889;4158;-674;45366;5158;0.1137;5528;-370
2016-12-04 09:00:00;37,6;40,02;-2,42;39221;6534;0.1666;7643;-1109;45366;4059;0.0895;4631;-572
2016-12-04 10:00:00;34,0;35,75;-1,75;39221;10263;0.2617;11170;-907;45366;3349;0.0738;4055;-706
2016-12-04 11:00:00;31,02;31,14;-0,12;39221;13527;0.3449;14063;-536;45366;2832;0.0624;3840;-1008
2016-12-04 12:00:00;27,97;26,97;1,0;39221;16028;0.4087;15926;102;45366;2371;0.0523;3610;-1239
2016-12-04 13:00:00;26,41;25,39;1,02;39221;17562;0.4478;16623;939;45366;2266;0.0499;3405;-1139
2016-12-04 14:00:00;24,59;24,47;0,12;39221;17528;0.4469;16243;1285;45366;2300;0.0507;3222;-922
2016-12-04 15:00:00;24,18;23,35;0,83;39221;15428;0.3934;14467;961;45366;2604;0.0574;3038;-434
2016-12-04 16:00:00;25,13;23,08;2,05;39221;11970;0.3052;11454;516;45366;2608;0.0574;2938;-330
2016-12-04 17:00:00;27,26;26,86;0,4;39221;7848;0.2001;7450;398;45366;2678;0.059;2963;-285
2016-12-04 18:00:00;31,32;30,5;0,82;39221;3414;0.0871;3364;50;45366;2683;0.0592;3134;-451
2016-12-04 19:00:00;34,62;32,37;2,25;39221;662;0.0169;702;-40;45366;2474;0.0546;3457;-983
2016-12-04 20:00:00;34,95;32,86;2,09;39221;16;0.0004;19;-3;45366;3138;0.0692;3933;-795
2016-12-04 21:00:00;32,24;29,82;2,42;39221;0;0;0;0;45366;3274;0.0722;4411;-1137
2016-12-04 22:00:00;30,0;26,49;3,51;39221;0;0;0;0;45366;3189;0.0703;4656;-1467
2016-12-04 23:00:00;24,1;25,04;-0,94;39221;0;0;0;0;45366;3150;0.0694;4719;-1569
2016-04-13 00:00:00;22,93;24,62;-1,69;39234;0;0;0;0;45378;3096;0.0682;3689;-593
2016-04-13 01:00:00;21,68;22,81;-1,13;39234;0;0;0;0;45378;2822;0.0622;3473;-651
2016-04-13 02:00:00;21,68;24,01;-2,33;39234;0;0;0;0;45378;2774;0.0611;3263;-489
2016-04-13 03:00:00;21,41;22,84;-1,43;39234;0;0;0;0;45378;1969;0.0434;3133;-1164
2016-04-13 04:00:00;21,71;21,69;0,02;39234;0;0;0;0;45378;1808;0.0398;2936;-1128
2016-04-13 05:00:00;22,77;23,64;-0,87;39234;0;0;0;0;45378;2100;0.0463;2763;-663
2016-04-13 06:00:00;31,35;34,29;-2,94;39234;110;0.0028;119;-9;45378;2369;0.0522;2694;-325
2016-04-13 07:00:00;34,99;35,67;-0,68;39234;1527;0.0389;1422;105;45378;2254;0.0497;2569;-315
2016-04-13 08:00:00;39,41;39,97;-0,56;39234;4732;0.1206;4344;388;45378;1778;0.0392;2350;-572
2016-04-13 09:00:00;35,06;33,19;1,87;39234;8892;0.2266;7824;1068;45378;1032;0.0228;2135;-1103
2016-04-13 10:00:00;33,23;29,87;3,36;39234;12812;0.3266;10874;1938;45378;904;0.0199;1950;-1046
2016-04-13 11:00:00;31,94;28,19;3,75;39234;15197;0.3874;12792;2405;45378;1020;0.0224;1903;-883
2016-04-13 12:00:00;28,9;26,81;2,09;39234;15193;0.3872;13599;1594;45378;1119;0.0247;2019;-900
2016-04-13 13:00:00;27,01;28,76;-1,75;39234;13220;0.337;13394;-174;45378;1341;0.0296;2193;-852
2016-04-13 14:00:00;25,96;30,17;-4,21;39234;11180;0.285;12365;-1185;45378;1418;0.0313;2519;-1101
2016-04-13 15:00:00;26,0;30,38;-4,38;39234;8936;0.2278;10452;-1516;45378;1580;0.0348;2902;-1322
2016-04-13 16:00:00;26,33;31,24;-4,91;39234;6287;0.1602;7888;-1601;45378;1927;0.0424;3314;-1387
2016-04-13 17:00:00;29,0;32,07;-3,07;39234;4149;0.1058;5086;-937;45378;2007;0.0443;3643;-1636
2016-04-13 18:00:00;32,37;36,51;-4,14;39234;2288;0.0583;2436;-148;45378;2256;0.0497;3785;-1529
2016-04-13 19:00:00;33,86;35,94;-2,08;39234;567;0.0144;556;11;45378;2360;0.052;3878;-1518
2016-04-13 20:00:00;34,42;36,83;-2,41;39234;16;0.0004;19;-3;45378;2686;0.0592;4080;-1394
2016-04-13 21:00:00;31,31;31,39;-0,08;39234;0;0;0;0;45378;2816;0.0621;4244;-1428
2016-04-13 22:00:00;28,0;28,12;-0,12;39234;0;0;0;0;45378;2856;0.0629;4375;-1519
2016-04-13 23:00:00;23,59;24,66;-1,07;39234;0;0;0;0;45378;2612;0.0576;4451;-1839
2016-04-14 00:00:00;23,35;19,62;3,73;39237;0;0;0;0;45390;2541;0.056;2052;489
2016-04-14 01:00:00;21,93;17,65;4,28;39237;0;0;0;0;45390;2565;0.0565;1985;580
2016-04-14 02:00:00;21,18;16,94;4,24;39237;0;0;0;0;45390;2573;0.0567;1998;575
2016-04-14 03:00:00;20,94;16,95;3,99;39237;0;0;0;0;45390;2844;0.0627;2104;740
2016-04-14 04:00:00;21,06;16,85;4,21;39237;0;0;0;0;45390;2991;0.0659;2217;774
2016-04-14 05:00:00;21,74;18,41;3,33;39237;0;0;0;0;45390;3042;0.067;2220;822
2016-04-14 06:00:00;27,0;24,05;2,95;39237;89;0.0023;118;-29;45390;2952;0.065;2143;809
2016-04-14 07:00:00;32,03;27,3;4,73;39237;1328;0.0338;1400;-72;45390;2646;0.0583;2052;594
2016-04-14 08:00:00;37,28;33,2;4,08;39237;4244;0.1082;4366;-122;45390;2224;0.049;1916;308
2016-04-14 09:00:00;34,59;31,95;2,64;39237;8140;0.2074;8073;67;45390;1936;0.0426;1796;140
2016-04-14 10:00:00;30,91;26,15;4,76;39237;11562;0.2946;11730;-168;45390;1729;0.0381;1765;-36
2016-04-14 11:00:00;28,08;26,55;1,53;39237;14512;0.3698;14696;-184;45390;1740;0.0384;1812;-72
2016-04-14 12:00:00;26,4;24,74;1,66;39237;15829;0.4034;16713;-884;45390;1908;0.042;1906;2
2016-04-14 13:00:00;25,05;23,96;1,09;39237;15970;0.407;17317;-1347;45390;2195;0.0484;1995;200
2016-04-14 14:00:00;23,83;23,23;0,6;39237;15214;0.3878;16668;-1454;45390;2370;0.0522;2136;234
2016-04-14 15:00:00;23,44;23,35;0,09;39237;13844;0.3528;14808;-964;45390;2720;0.0599;2260;460
2016-04-14 16:00:00;23,22;23,91;-0,69;39237;11494;0.2929;11827;-333;45390;2777;0.0612;2258;519
2016-04-14 17:00:00;24,2;24,82;-0,62;39237;8006;0.204;7932;74;45390;2359;0.052;2021;338
2016-04-14 18:00:00;27,25;27,27;-0,02;39237;4190;0.1068;3742;448;45390;1702;0.0375;1576;126
2016-04-14 19:00:00;32,51;29,5;3,01;39237;1022;0.026;841;181;45390;1047;0.023;1207;-160
2016-04-14 20:00:00;31,98;31,73;0,25;39237;29;0.0007;29;0;45390;894;0.0197;1171;-277
2016-04-14 21:00:00;31,53;31,0;0,53;39237;0;0;0;0;45390;1080;0.0238;1526;-446
2016-04-14 22:00:00;28,33;27,89;0,44;39237;0;0;0;0;45390;1759;0.0388;2131;-372
2016-04-14 23:00:00;23,9;26,54;-2,64;39237;0;0;0;0;45390;2897;0.0638;2889;8
2016-04-15 00:00:00;22,1;21,82;0,28;39239;0;0;0;0;45400;3902;0.0859;3652;250
2016-04-15 01:00:00;21,31;20,93;0,38;39239;0;0;0;0;45400;4786;0.1054;4625;161
2016-04-15 02:00:00;20,45;20,9;-0,45;39239;0;0;0;0;45400;5840;0.1286;5359;481
2016-04-15 03:00:00;20,14;21,2;-1,06;39239;0;0;0;0;45400;6156;0.1356;5704;452
2016-04-15 04:00:00;20,34;21,52;-1,18;39239;0;0;0;0;45400;6859;0.1511;5968;891
2016-04-15 05:00:00;21,08;21,81;-0,73;39239;0;0;0;0;45400;7400;0.163;6364;1036
2016-04-15 06:00:00;25,0;24,66;0,34;39239;115;0.0029;128;-13;45400;7809;0.172;6897;912
2016-04-15 07:00:00;31,69;30,55;1,14;39239;1166;0.0297;1131;35;45400;8326;0.1834;7336;990
2016-04-15 08:00:00;34,7;32,17;2,53;39239;2472;0.063;2894;-422;45400;8350;0.1839;7278;1072
2016-04-15 09:00:00;33,02;33,09;-0,07;39239;4175;0.1064;4731;-556;45400;7575;0.1668;7107;468
2016-04-15 10:00:00;30,98;33,6;-2,62;39239;5790;0.1476;6385;-595;45400;8081;0.178;7450;631
2016-04-15 11:00:00;29,94;31,55;-1,61;39239;7260;0.185;7770;-510;45400;9369;0.2064;8028;1341
2016-04-15 12:00:00;28,0;29,88;-1,88;39239;8324;0.2121;8893;-569;45400;10960;0.2414;8903;2057
2016-04-15 13:00:00;23,82;25,53;-1,71;39239;8695;0.2216;9606;-911;45400;11984;0.2639;9873;2111
2016-04-15 14:00:00;22,81;23,04;-0,23;39239;9652;0.246;9758;-106;45400;12452;0.2743;10283;2169
2016-04-15 15:00:00;21,36;21,41;-0,05;39239;10053;0.2562;9084;969;45400;13170;0.29;10428;2742
2016-04-15 16:00:00;21,32;19,74;1,58;39239;8799;0.2243;7612;1187;45400;13069;0.2878;10623;2446
2016-04-15 17:00:00;22,51;20,4;2,11;39239;6387;0.1628;5412;975;45400;12595;0.2774;10151;2444
2016-04-15 18:00:00;23,94;21,73;2,21;39239;3517;0.0896;2795;722;45400;10518;0.2317;8831;1687
2016-04-15 19:00:00;26,34;24,05;2,29;39239;868;0.0221;681;187;45400;8132;0.1791;7495;637
2016-04-15 20:00:00;28,08;25,56;2,52;39239;28;0.0007;27;1;45400;7010;0.1544;7285;-275
2016-04-15 21:00:00;27,08;24,75;2,33;39239;0;0;0;0;45400;6864;0.1512;7622;-758
2016-04-15 22:00:00;25,0;23,36;1,64;39239;0;0;0;0;45400;7356;0.162;8036;-680
2016-04-15 23:00:00;24,69;22,62;2,07;39239;0;0;0;0;45400;8070;0.1778;8461;-391
2016-04-16 00:00:00;21,3;22,73;-1,43;39239;0;0;0;0;45406;8993;0.1981;9616;-623
2016-04-16 01:00:00;19,7;18,61;1,09;39239;0;0;0;0;45406;9532;0.2099;10115;-583
2016-04-16 02:00:00;19,24;17,36;1,88;39239;0;0;0;0;45406;10307;0.227;10452;-145
2016-04-16 03:00:00;18,28;16,89;1,39;39239;0;0;0;0;45406;10914;0.2404;10859;55
2016-04-16 04:00:00;17,19;16,68;0,51;39239;0;0;0;0;45406;11369;0.2504;11388;-19
2016-04-16 05:00:00;18,76;17,99;0,77;39239;0;0;0;0;45406;12050;0.2654;11949;101
2016-04-16 06:00:00;19,46;19,39;0,07;39239;137;0.0035;149;-12;45406;12361;0.2722;12440;-79
2016-04-16 07:00:00;19,54;20,05;-0,51;39239;1490;0.038;1374;116;45406;13022;0.2868;12830;192
2016-04-16 08:00:00;21,14;18,35;2,79;39239;3837;0.0978;3609;228;45406;13250;0.2918;13473;-223
2016-04-16 09:00:00;21,64;20,14;1,5;39239;6050;0.1542;6030;20;45406;13778;0.3034;14774;-996
2016-04-16 10:00:00;19,8;19,4;0,4;39239;7349;0.1872;8118;-769;45406;15563;0.3428;16457;-894
2016-04-16 11:00:00;19,06;19,44;-0,38;39239;8418;0.2146;9695;-1277;45406;17645;0.3886;17833;-188
2016-04-16 12:00:00;18,05;17,83;0,22;39239;9613;0.245;10768;-1155;45406;18536;0.4082;18613;-77
2016-04-16 13:00:00;14,06;15,9;-1,84;39239;10990;0.2801;11370;-380;45406;19050;0.4195;19160;-110
2016-04-16 14:00:00;13,77;13,29;0,48;39239;12542;0.3196;11370;1172;45406;18902;0.4162;19317;-415
2016-04-16 15:00:00;13,19;6,05;7,14;39239;12438;0.317;10479;1959;45406;19016;0.4188;18343;673
2016-04-16 16:00:00;12,69;0,23;12,46;39239;10148;0.2586;8598;1550;45406;18462;0.4066;16923;1539
2016-04-16 17:00:00;14,08;8,84;5,24;39239;6972;0.1777;5993;979;45406;17369;0.3825;15295;2074
2016-04-16 18:00:00;17,69;16,72;0,97;39239;3380;0.0861;3026;354;45406;15100;0.3326;13367;1733
2016-04-16 19:00:00;22,05;21,31;0,74;39239;734;0.0187;755;-21;45406;12470;0.2746;11490;980
2016-04-16 20:00:00;23,7;25,88;-2,18;39239;24;0.0006;32;-8;45406;11001;0.2423;10284;717
2016-04-16 21:00:00;24,31;24,12;0,19;39239;0;0;0;0;45406;9689;0.2134;9703;-14
2016-04-16 22:00:00;23,94;25,15;-1,21;39239;0;0;0;0;45406;8936;0.1968;9217;-281
2016-04-16 23:00:00;20,83;21,71;-0,88;39239;0;0;0;0;45406;8597;0.1893;8839;-242
2016-04-17 00:00:00;19,33;16,63;2,7;39239;0;0;0;0;45406;7414;0.1633;7530;-116
2016-04-17 01:00:00;17,74;15,04;2,7;39239;0;0;0;0;45406;6939;0.1528;7071;-132
2016-04-17 02:00:00;15,85;12,48;3,37;39239;0;0;0;0;45406;7022;0.1546;6709;313
2016-04-17 03:00:00;15,13;8,16;6,97;39239;0;0;0;0;45406;7547;0.1662;6458;1089
2016-04-17 04:00:00;15,15;10,17;4,98;39239;0;0;0;0;45406;7488;0.1649;6242;1246
2016-04-17 05:00:00;14,57;9,17;5,4;39239;0;0;0;0;45406;7066;0.1556;6122;944
2016-04-17 06:00:00;14,82;10,73;4,09;39239;109;0.0028;132;-23;45406;6898;0.1519;6166;732
2016-04-17 07:00:00;14,57;10,93;3,64;39239;999;0.0254;1116;-117;45406;6265;0.138;6359;-94
2016-04-17 08:00:00;16,48;14,49;1,99;39239;2805;0.0715;3177;-372;45406;6260;0.1378;6734;-474
2016-04-17 09:00:00;18,69;14,8;3,89;39239;5182;0.1321;5669;-487;45406;6843;0.1507;7376;-533
2016-04-17 10:00:00;18,69;12,57;6,12;39239;7712;0.1965;8046;-334;45406;7410;0.1632;8074;-664
2016-04-17 11:00:00;18,94;14,33;4,61;39239;9659;0.2462;9976;-317;45406;7873;0.1734;8738;-865
2016-04-17 12:00:00;18,16;15,49;2,67;39239;10904;0.2779;11328;-424;45406;8695;0.1915;9413;-718
2016-04-17 13:00:00;16,16;9,27;6,89;39239;11440;0.2915;11773;-333;45406;9646;0.2124;10041;-395
2016-04-17 14:00:00;13,82;7,59;6,23;39239;11184;0.285;11447;-263;45406;10118;0.2228;10521;-403
2016-04-17 15:00:00;12,52;8,87;3,65;39239;10309;0.2627;10330;-21;45406;10352;0.228;10921;-569
2016-04-17 16:00:00;13,52;12,52;1,0;39239;8109;0.2066;8451;-342;45406;10134;0.2232;11140;-1006
2016-04-17 17:00:00;16,16;18,94;-2,78;39239;5383;0.1372;5867;-484;45406;9997;0.2202;10918;-921
2016-04-17 18:00:00;19,35;24,39;-5,04;39239;2669;0.068;2989;-320;45406;9236;0.2034;10218;-982
2016-04-17 19:00:00;21,19;26,22;-5,03;39239;808;0.0206;797;11;45406;7928;0.1746;9359;-1431
2016-04-17 20:00:00;26,4;27,63;-1,23;39239;44;0.0011;40;4;45406;7062;0.1556;8712;-1650
2016-04-17 21:00:00;29,65;28,52;1,13;39239;0;0;0;0;45406;6975;0.1536;8701;-1726
2016-04-17 22:00:00;30,16;28,96;1,2;39239;0;0;0;0;45406;7285;0.1604;8930;-1645
2016-04-17 23:00:00;27,25;23,8;3,45;39239;0;0;0;0;45406;7547;0.1662;9119;-1572
2016-04-18 00:00:00;20,92;19,73;1,19;39243;0;0;0;0;45406;7570;0.1667;7639;-69
2016-04-18 01:00:00;20,9;18,8;2,1;39243;0;0;0;0;45406;7349;0.1618;7755;-406
2016-04-18 02:00:00;19,7;19,35;0,35;39243;0;0;0;0;45406;7270;0.1601;7854;-584
2016-04-18 03:00:00;18,9;19,58;-0,68;39243;0;0;0;0;45406;7263;0.16;8006;-743
2016-04-18 04:00:00;19,0;20,14;-1,14;39243;0;0;0;0;45406;7608;0.1676;8154;-546
2016-04-18 05:00:00;20,6;20,93;-0,33;39243;0;0;0;0;45406;7885;0.1737;8253;-368
2016-04-18 06:00:00;30,0;34,35;-4,35;39243;219;0.0056;293;-74;45406;8223;0.1811;8367;-144
2016-04-18 07:00:00;37,06;45,72;-8,66;39243;2118;0.054;2540;-422;45406;7867;0.1732;8379;-512
2016-04-18 08:00:00;38,79;47,95;-9,16;39243;5834;0.1486;7004;-1170;45406;7034;0.1549;8622;-1588
2016-04-18 09:00:00;29,27;37,69;-8,42;39243;10307;0.2626;11907;-1600;45406;7734;0.1703;9464;-1730
2016-04-18 10:00:00;24,09;30,22;-6,13;39243;13908;0.3544;15358;-1450;45406;9294;0.2047;10633;-1339
2016-04-18 11:00:00;23,28;28,83;-5,55;39243;15286;0.3896;17097;-1811;45406;10165;0.2239;11831;-1666
2016-04-18 12:00:00;21,14;25,48;-4,34;39243;15442;0.3935;17622;-2180;45406;10846;0.2389;13040;-2194
2016-04-18 13:00:00;20,7;23,34;-2,64;39243;14662;0.3736;17021;-2359;45406;11732;0.2584;14252;-2520
2016-04-18 14:00:00;20,65;24,63;-3,98;39243;12970;0.3305;15466;-2496;45406;12682;0.2793;15336;-2654
2016-04-18 15:00:00;20,49;23,23;-2,74;39243;10731;0.2734;13088;-2357;45406;13560;0.2986;16026;-2466
2016-04-18 16:00:00;20,31;22,44;-2,13;39243;8604;0.2192;10298;-1694;45406;14176;0.3122;16534;-2358
2016-04-18 17:00:00;20,94;24,34;-3,4;39243;5826;0.1484;7015;-1189;45406;13998;0.3083;16454;-2456
2016-04-18 18:00:00;23,19;27,82;-4,63;39243;2940;0.0749;3530;-590;45406;13532;0.298;15704;-2172
2016-04-18 19:00:00;25,62;30,56;-4,94;39243;810;0.0206;928;-118;45406;12485;0.2749;14823;-2338
2016-04-18 20:00:00;27,92;30,98;-3,06;39243;34;0.0009;44;-10;45406;11688;0.2574;14241;-2553
2016-04-18 21:00:00;29,03;30,34;-1,31;39243;0;0;0;0;45406;11602;0.2555;13973;-2371
2016-04-18 22:00:00;22,55;27,7;-5,15;39243;0;0;0;0;45406;11608;0.2556;14031;-2423
2016-04-18 23:00:00;19,31;25,3;-5,99;39243;0;0;0;0;45406;11959;0.2634;14234;-2275
2016-04-19 00:00:00;19,32;22,62;-3,3;39245;0;0;0;0;45412;12257;0.2699;13205;-948
2016-04-19 01:00:00;18,69;23,65;-4,96;39245;0;0;0;0;45412;12291;0.2706;13496;-1205
2016-04-19 02:00:00;18,04;22,59;-4,55;39245;0;0;0;0;45412;12658;0.2787;13627;-969
2016-04-19 03:00:00;17,49;20,43;-2,94;39245;0;0;0;0;45412;12779;0.2814;13747;-968
2016-04-19 04:00:00;18,44;19,55;-1,11;39245;0;0;0;0;45412;12776;0.2814;13862;-1086
2016-04-19 05:00:00;19,8;25,14;-5,34;39245;0;0;0;0;45412;12980;0.2858;13899;-919
2016-04-19 06:00:00;26,93;32,96;-6,03;39245;277;0.007;294;-17;45412;13278;0.2924;13899;-621
2016-04-19 07:00:00;29,99;35,8;-5,81;39245;2368;0.0604;2470;-102;45412;13286;0.2926;13928;-642
2016-04-19 08:00:00;29,68;35,45;-5,77;39245;6116;0.1558;6554;-438;45412;14017;0.3086;14471;-454
2016-04-19 09:00:00;21,96;29,06;-7,1;39245;10970;0.2795;11181;-211;45412;15535;0.3421;15916;-381
2016-04-19 10:00:00;20,94;25,25;-4,31;39245;15291;0.3896;14886;405;45412;17316;0.3813;17345;-29
2016-04-19 11:00:00;20,42;23,18;-2,76;39245;16087;0.4099;17073;-986;45412;18830;0.4146;18554;276
2016-04-19 12:00:00;17,79;21,02;-3,23;39245;15199;0.3873;17918;-2719;45412;19577;0.4311;19483;94
2016-04-19 13:00:00;15,62;23,02;-7,4;39245;14345;0.3655;17701;-3356;45412;20182;0.4444;20281;-99
2016-04-19 14:00:00;13,6;22,04;-8,44;39245;13287;0.3386;16511;-3224;45412;20267;0.4463;21017;-750
2016-04-19 15:00:00;13,68;19,8;-6,12;39245;11872;0.3025;14454;-2582;45412;21291;0.4688;21471;-180
2016-04-19 16:00:00;15,02;21,09;-6,07;39245;9998;0.2548;11768;-1770;45412;21624;0.4762;21699;-75
2016-04-19 17:00:00;19,24;21,99;-2,75;39245;6907;0.176;8155;-1248;45412;21404;0.4713;21434;-30
2016-04-19 18:00:00;20,76;25,05;-4,29;39245;3703;0.0943;4143;-440;45412;20635;0.4544;20409;226
2016-04-19 19:00:00;23,99;27,21;-3,22;39245;1086;0.0277;1123;-37;45412;19258;0.424;18876;382
2016-04-19 20:00:00;25,95;27,65;-1,7;39245;56;0.0015;60;-4;45412;17322;0.3814;17460;-138
2016-04-19 21:00:00;24,87;28,14;-3,27;39245;0;0;0;0;45412;16079;0.3541;16460;-381
2016-04-19 22:00:00;21,42;26,99;-5,57;39245;0;0;0;0;45412;14856;0.3271;15673;-817
2016-04-19 23:00:00;19,33;21,65;-2,32;39245;0;0;0;0;45412;14013;0.3086;14972;-959
2016-04-20 00:00:00;19,14;24,75;-5,61;39249;0;0;0;0;45417;13134;0.2892;14360;-1226
2016-04-20 01:00:00;18,85;24,65;-5,8;39249;0;0;0;0;45417;12668;0.2789;13684;-1016
2016-04-20 02:00:00;16,5;21,23;-4,73;39249;0;0;0;0;45417;12138;0.2672;13027;-889
2016-04-20 03:00:00;17,49;19,72;-2,23;39249;0;0;0;0;45417;11529;0.2538;12468;-939
2016-04-20 04:00:00;18,63;20,61;-1,98;39249;0;0;0;0;45417;10868;0.2393;11985;-1117
2016-04-20 05:00:00;20,0;22,74;-2,74;39249;1;0;1;0;45417;10233;0.2253;11528;-1295
2016-04-20 06:00:00;25,76;32,56;-6,8;39249;361;0.0092;344;17;45417;9613;0.2117;11056;-1443
2016-04-20 07:00:00;30,55;35,76;-5,21;39249;2904;0.074;2977;-73;45417;9178;0.2021;10518;-1340
2016-04-20 08:00:00;31,91;32,7;-0,79;39249;7572;0.193;8005;-433;45417;9219;0.203;9986;-767
2016-04-20 09:00:00;26,44;27,63;-1,19;39249;12920;0.3292;13798;-878;45417;9791;0.2156;9638;153
2016-04-20 10:00:00;23,02;20,23;2,79;39249;17164;0.4373;18816;-1652;45417;8954;0.1972;9151;-197
2016-04-20 11:00:00;22,43;22,64;-0,21;39249;20281;0.5167;22154;-1873;45417;7786;0.1714;8455;-669
2016-04-20 12:00:00;21,51;21,74;-0,23;39249;22810;0.5812;23794;-984;45417;7000;0.1541;7762;-762
2016-04-20 13:00:00;20,49;20,12;0,37;39249;24216;0.617;24298;-82;45417;6477;0.1426;7208;-731
2016-04-20 14:00:00;20,89;19,88;1,01;39249;24054;0.6129;23598;456;45417;5911;0.1301;6875;-964
2016-04-20 15:00:00;21,57;18,64;2,93;39249;21897;0.5579;21189;708;45417;5777;0.1272;6577;-800
2016-04-20 16:00:00;21,59;18,55;3,04;39249;17750;0.4523;17041;709;45417;5433;0.1196;6320;-887
2016-04-20 17:00:00;22,89;20,17;2,72;39249;11995;0.3056;11405;590;45417;5574;0.1227;6058;-484
2016-04-20 18:00:00;27,24;26,66;0,58;39249;5854;0.1492;5368;486;45417;5780;0.1273;5725;55
2016-04-20 19:00:00;31,09;29,16;1,93;39249;1653;0.0421;1465;188;45417;5522;0.1216;5394;128
2016-04-20 20:00:00;32,16;30,44;1,72;39249;94;0.0024;84;10;45417;5449;0.12;5361;88
2016-04-20 21:00:00;30,66;29,02;1,64;39249;0;0;0;0;45417;5986;0.1318;5508;478
2016-04-20 22:00:00;28,52;27,1;1,42;39249;0;0;0;0;45417;6393;0.1408;5634;759
2016-04-20 23:00:00;24,5;22,11;2,39;39249;0;0;0;0;45417;6110;0.1345;5546;564
2016-04-21 00:00:00;22,51;18,0;4,51;39251;0;0;0;0;45431;5567;0.1226;5041;526
2016-04-21 01:00:00;20,5;20,5;0,0;39251;0;0;0;0;45431;5129;0.1129;4796;333
2016-04-21 02:00:00;19,93;19,86;0,07;39251;0;0;0;0;45431;4563;0.1005;4509;54
2016-04-21 03:00:00;19,58;18,97;0,61;39251;0;0;0;0;45431;3924;0.0864;4287;-363
2016-04-21 04:00:00;19,84;21,38;-1,54;39251;0;0;0;0;45431;3649;0.0803;4072;-423
2016-04-21 05:00:00;21,11;25,46;-4,35;39251;1;0;4;-3;45431;3493;0.0769;3884;-391
2016-04-21 06:00:00;29,1;33,71;-4,61;39251;476;0.0121;488;-12;45431;3301;0.0726;3748;-447
2016-04-21 07:00:00;34,58;38,49;-3,91;39251;3665;0.0934;3584;81;45431;2963;0.0652;3524;-561
2016-04-21 08:00:00;35,38;38,41;-3,03;39251;9471;0.2413;9385;86;45431;2086;0.046;3201;-1115
2016-04-21 09:00:00;32,92;28,34;4,58;39251;15526;0.3956;15700;-174;45431;1786;0.0393;3196;-1410
2016-04-21 10:00:00;28,91;25,19;3,72;39251;20629;0.5256;20783;-154;45431;2004;0.0441;3462;-1458
2016-04-21 11:00:00;26,12;24,13;1,99;39251;24038;0.6124;23919;119;45431;2492;0.0548;3641;-1149
2016-04-21 12:00:00;23,59;21,67;1,92;39251;25594;0.652;25317;277;45431;2855;0.0628;3692;-837
2016-04-21 13:00:00;23,43;22,0;1,43;39251;25764;0.6564;25381;383;45431;2964;0.0653;3730;-766
2016-04-21 14:00:00;23,47;22,32;1,15;39251;24594;0.6266;24042;552;45431;3029;0.0667;3842;-813
2016-04-21 15:00:00;23,93;22,8;1,13;39251;21918;0.5584;21232;686;45431;3353;0.0738;4064;-711
2016-04-21 16:00:00;23,95;21,64;2,31;39251;17638;0.4494;16796;842;45431;3552;0.0782;4352;-800
2016-04-21 17:00:00;27,61;25,75;1,86;39251;11892;0.303;11004;888;45431;3616;0.0796;4688;-1072
2016-04-21 18:00:00;30,74;30,11;0,63;39251;5750;0.1465;5117;633;45431;3930;0.0865;5083;-1153
2016-04-21 19:00:00;32,33;33,58;-1,25;39251;1599;0.0407;1393;206;45431;4098;0.0902;5516;-1418
2016-04-21 20:00:00;32,34;37,36;-5,02;39251;92;0.0023;89;3;45431;5082;0.1119;6110;-1028
2016-04-21 21:00:00;32,02;32,22;-0,2;39251;0;0;0;0;45431;6045;0.1331;6910;-865
2016-04-21 22:00:00;29,19;29,33;-0,14;39251;0;0;0;0;45431;7056;0.1553;7807;-751
2016-04-21 23:00:00;25,0;23,78;1,22;39251;0;0;0;0;45431;8078;0.1779;8548;-470
2016-04-22 00:00:00;21,95;24,75;-2,8;39257;0;0;0;0;45443;8686;0.1911;8620;66
2016-04-22 01:00:00;20,7;24,42;-3,72;39257;0;0;0;0;45443;9274;0.2041;8899;375
2016-04-22 02:00:00;19,59;23,35;-3,76;39257;0;0;0;0;45443;9432;0.2076;9124;308
2016-04-22 03:00:00;19,32;23,54;-4,22;39257;0;0;0;0;45443;9636;0.2121;9211;425
2016-04-22 04:00:00;19,85;22,52;-2,67;39257;0;0;0;0;45443;9566;0.2105;9123;443
2016-04-22 05:00:00;22,94;29,48;-6,54;39257;2;0.0001;4;-2;45443;9498;0.209;8940;558
2016-04-22 06:00:00;28,0;33,5;-5,5;39257;466;0.0119;445;21;45443;9027;0.1986;8541;486
2016-04-22 07:00:00;33,14;35,11;-1,97;39257;3282;0.0836;3097;185;45443;7612;0.1675;7752;-140
2016-04-22 08:00:00;34,61;34,72;-0,11;39257;7822;0.1992;7773;49;45443;6526;0.1436;6738;-212
2016-04-22 09:00:00;31,59;31,08;0,51;39257;12559;0.3199;12821;-262;45443;6392;0.1407;5982;410
2016-04-22 10:00:00;28,69;25,98;2,71;39257;16783;0.4275;16918;-135;45443;5214;0.1148;5537;-323
2016-04-22 11:00:00;25,22;24,54;0,68;39257;19844;0.5055;19575;269;45443;4582;0.1008;5300;-718
2016-04-22 12:00:00;23,98;24,05;-0,07;39257;21411;0.5454;20844;567;45443;4260;0.0938;5231;-971
2016-04-22 13:00:00;22,95;22,52;0,43;39257;21565;0.5493;20703;862;45443;4251;0.0935;5232;-981
2016-04-22 14:00:00;22,24;22,99;-0,75;39257;20372;0.519;19270;1102;45443;4379;0.0964;5449;-1070
2016-04-22 15:00:00;22,32;21,31;1,01;39257;17921;0.4565;16606;1315;45443;4419;0.0972;5867;-1448
2016-04-22 16:00:00;22,89;22,18;0,71;39257;14146;0.3604;12870;1276;45443;4805;0.1058;6252;-1447
2016-04-22 17:00:00;24,75;25,14;-0,39;39257;9306;0.2371;8416;890;45443;5080;0.1118;6450;-1370
2016-04-22 18:00:00;28,99;28,05;0,94;39257;4650;0.1184;4091;559;45443;5273;0.116;6550;-1277
2016-04-22 19:00:00;30,93;28,57;2,36;39257;1303;0.0332;1165;138;45443;5270;0.116;6635;-1365
2016-04-22 20:00:00;30,94;29,49;1,45;39257;68;0.0017;80;-12;45443;5535;0.1218;6677;-1142
2016-04-22 21:00:00;29,33;28,04;1,29;39257;0;0;0;0;45443;5614;0.1236;6621;-1007
2016-04-22 22:00:00;27,94;28,33;-0,39;39257;0;0;0;0;45443;5687;0.1252;6612;-925
2016-04-22 23:00:00;25,04;25,43;-0,39;39257;0;0;0;0;45443;5788;0.1274;6587;-799
2016-04-23 00:00:00;27,72;24,59;3,13;39257;0;0;0;0;45443;5810;0.1278;6352;-542
2016-04-23 01:00:00;22,45;20,96;1,49;39257;0;0;0;0;45443;5859;0.1289;6433;-574
2016-04-23 02:00:00;21,47;19,42;2,05;39257;0;0;0;0;45443;5764;0.1268;6595;-831
2016-04-23 03:00:00;20,99;19,38;1,61;39257;0;0;0;0;45443;5869;0.1291;6720;-851
2016-04-23 04:00:00;20,99;20,24;0,75;39257;0;0;0;0;45443;6150;0.1354;6791;-641
2016-04-23 05:00:00;20,9;19,56;1,34;39257;2;0;4;-2;45443;6388;0.1406;6832;-444
2016-04-23 06:00:00;21,05;20,02;1,03;39257;280;0.0072;302;-22;45443;6230;0.1371;6698;-468
2016-04-23 07:00:00;21,48;21,67;-0,19;39257;1792;0.0457;1862;-70;45443;5664;0.1246;6308;-644
2016-04-23 08:00:00;23,62;23,81;-0,19;39257;4197;0.1069;4354;-157;45443;5168;0.1138;6232;-1064
2016-04-23 09:00:00;27,29;24,49;2,8;39257;6884;0.1754;7023;-139;45443;5927;0.1304;6903;-976
2016-04-23 10:00:00;26,91;23,79;3,12;39257;9034;0.2302;9432;-398;45443;6340;0.1395;7542;-1202
2016-04-23 11:00:00;25,76;22,67;3,09;39257;10591;0.2698;11228;-637;45443;6727;0.148;7812;-1085
2016-04-23 12:00:00;23,4;23,09;0,31;39257;11327;0.2885;12268;-941;45443;7250;0.1596;8070;-820
2016-04-23 13:00:00;21,36;21,25;0,11;39257;11007;0.2804;12162;-1155;45443;8037;0.1768;8685;-648
2016-04-23 14:00:00;20,42;20,14;0,28;39257;9934;0.253;11182;-1248;45443;9117;0.2006;9566;-449
2016-04-23 15:00:00;18,29;18,37;-0,08;39257;8648;0.2203;9727;-1079;45443;10192;0.2243;10559;-367
2016-04-23 16:00:00;16,27;16,63;-0,36;39257;7118;0.1813;7834;-716;45443;11380;0.2504;11553;-173
2016-04-23 17:00:00;19,13;17,58;1,55;39257;5015;0.1277;5488;-473;45443;12826;0.2822;12100;726
2016-04-23 18:00:00;21,07;19,37;1,7;39257;2804;0.0714;2958;-154;45443;13298;0.2926;11927;1371
2016-04-23 19:00:00;22,46;19,26;3,2;39257;976;0.0249;942;34;45443;11684;0.2571;11374;310
2016-04-23 20:00:00;25,0;22,04;2,96;39257;85;0.0022;75;10;45443;9784;0.2153;10523;-739
2016-04-23 21:00:00;27,19;22,9;4,29;39257;0;0;0;0;45443;8751;0.1926;9673;-922
2016-04-23 22:00:00;25,05;22,29;2,76;39257;0;0;0;0;45443;8136;0.179;9149;-1013
2016-04-23 23:00:00;22,1;21,74;0,36;39257;0;0;0;0;45443;8220;0.1809;9193;-973
2016-04-24 00:00:00;18,21;20,5;-2,29;39258;0;0;0;0;45443;8896;0.1958;9981;-1085
2016-04-24 01:00:00;15,07;15,16;-0,09;39258;0;0;0;0;45443;9484;0.2087;10039;-555
2016-04-24 02:00:00;14,31;8,54;5,77;39258;0;0;0;0;45443;9604;0.2114;9792;-188
2016-04-24 03:00:00;12,59;7,95;4,64;39258;0;0;0;0;45443;9466;0.2083;9349;117
2016-04-24 04:00:00;12,79;8,95;3,84;39258;0;0;0;0;45443;8816;0.194;8757;59
2016-04-24 05:00:00;13,62;10,23;3,39;39258;3;0.0001;8;-5;45443;8376;0.1843;8298;78
2016-04-24 06:00:00;12,76;11,19;1,57;39258;478;0.0122;489;-11;45443;7519;0.1654;7918;-399
2016-04-24 07:00:00;12,2;11,96;0,24;39258;2946;0.075;3202;-256;45443;6601;0.1452;7546;-945
2016-04-24 08:00:00;13,75;14,07;-0,32;39258;6718;0.1711;7776;-1058;45443;6486;0.1427;7232;-746
2016-04-24 09:00:00;12,57;15,0;-2,43;39258;10662;0.2716;12573;-1911;45443;6827;0.1502;7200;-373
2016-04-24 10:00:00;12,54;13,59;-1,05;39258;12925;0.3292;16196;-3271;45443;7741;0.1704;7077;664
2016-04-24 11:00:00;13,79;15,8;-2,01;39258;13870;0.3533;18390;-4520;45443;7998;0.176;6848;1150
2016-04-24 12:00:00;14,19;18,4;-4,21;39258;15009;0.3823;19255;-4246;45443;8003;0.1761;6745;1258
2016-04-24 13:00:00;11,88;15,54;-3,66;39258;16520;0.4208;19028;-2508;45443;7696;0.1694;6707;989
2016-04-24 14:00:00;9,44;14,41;-4,97;39258;16380;0.4172;17713;-1333;45443;8040;0.1769;7155;885
2016-04-24 15:00:00;9,5;8,5;1,0;39258;14887;0.3792;15406;-519;45443;8342;0.1836;7856;486
2016-04-24 16:00:00;8,47;4,18;4,29;39258;12034;0.3065;12285;-251;45443;8199;0.1804;8418;-219
2016-04-24 17:00:00;13,04;10,76;2,28;39258;8156;0.2078;8331;-175;45443;8318;0.1831;8592;-274
2016-04-24 18:00:00;20,28;19,79;0,49;39258;4510;0.1149;4271;239;45443;7337;0.1614;8077;-740
2016-04-24 19:00:00;21,96;23,9;-1,94;39258;1440;0.0367;1323;117;45443;6422;0.1413;7299;-877
2016-04-24 20:00:00;23,94;27,87;-3,93;39258;104;0.0026;103;1;45443;5845;0.1286;6833;-988
2016-04-24 21:00:00;24,37;25,36;-0,99;39258;0;0;0;0;45443;5177;0.1139;6674;-1497
2016-04-24 22:00:00;27,87;28,58;-0,71;39258;0;0;0;0;45443;4888;0.1076;6654;-1766
2016-04-24 23:00:00;24,04;27,41;-3,37;39258;0;0;0;0;45443;5380;0.1184;6652;-1272
2016-04-25 00:00:00;22,56;24,19;-1,63;39260;0;0;0;0;45451;5458;0.1201;6713;-1255
2016-04-25 01:00:00;21,46;22,5;-1,04;39260;0;0;0;0;45451;5686;0.1251;6754;-1068
2016-04-25 02:00:00;20,82;21,77;-0,95;39260;0;0;0;0;45451;5725;0.126;6853;-1128
2016-04-25 03:00:00;20,23;21,85;-1,62;39260;0;0;0;0;45451;5986;0.1317;7052;-1066
2016-04-25 04:00:00;20,26;20,98;-0,72;39260;0;0;0;0;45451;6261;0.1378;7232;-971
2016-04-25 05:00:00;21,1;24,68;-3,58;39260;5;0.0001;9;-4;45451;6439;0.1417;7327;-888
2016-04-25 06:00:00;29,02;32,4;-3,38;39260;434;0.0111;498;-64;45451;7282;0.1602;7364;-82
2016-04-25 07:00:00;32,97;32,29;0,68;39260;2546;0.0648;2994;-448;45451;7169;0.1577;7327;-158
2016-04-25 08:00:00;34,48;32,74;1,74;39260;5680;0.1447;7063;-1383;45451;7142;0.1571;7407;-265
2016-04-25 09:00:00;30,03;28,27;1,76;39260;9199;0.2343;11368;-2169;45451;8423;0.1853;7899;524
2016-04-25 10:00:00;28,95;27,51;1,44;39260;12130;0.309;14775;-2645;45451;10037;0.2208;8660;1377
2016-04-25 11:00:00;27,94;27,15;0,79;39260;13896;0.354;16805;-2909;45451;11203;0.2465;9534;1669
2016-04-25 12:00:00;28,31;27,72;0,59;39260;14741;0.3755;17367;-2626;45451;11910;0.262;10422;1488
2016-04-25 13:00:00;27,37;25,93;1,44;39260;14774;0.3763;16856;-2082;45451;11895;0.2617;11361;534
2016-04-25 14:00:00;24,39;24,43;-0,04;39260;14224;0.3623;15501;-1277;45451;12523;0.2755;12222;301
2016-04-25 15:00:00;23,75;22,29;1,46;39260;12134;0.309;13311;-1177;45451;12987;0.2857;12720;267
2016-04-25 16:00:00;23,78;21,17;2,61;39260;9592;0.2443;10432;-840;45451;12934;0.2845;13046;-112
2016-04-25 17:00:00;25,95;23,47;2,48;39260;6368;0.1622;6912;-544;45451;12770;0.281;12794;-24
2016-04-25 18:00:00;28,41;26,15;2,26;39260;3092;0.0788;3453;-361;45451;12497;0.275;12114;383
2016-04-25 19:00:00;31,19;26,82;4,37;39260;874;0.0222;1061;-187;45451;11984;0.2636;11628;356
2016-04-25 20:00:00;31,46;27,94;3,52;39260;47;0.0012;83;-36;45451;12020;0.2645;11574;446
2016-04-25 21:00:00;30,15;27,4;2,75;39260;0;0;0;0;45451;12952;0.285;11911;1041
2016-04-25 22:00:00;28,14;25,9;2,24;39260;0;0;0;0;45451;14142;0.3112;12278;1864
2016-04-25 23:00:00;22,97;21,01;1,96;39260;0;0;0;0;45451;14843;0.3266;12703;2140
2016-04-26 00:00:00;21,81;22,96;-1,15;39262;0;0;0;0;45457;14770;0.325;13418;1352
2016-04-26 01:00:00;20,9;21,62;-0,72;39262;0;0;0;0;45457;14154;0.3114;13125;1029
2016-04-26 02:00:00;20,96;21,8;-0,84;39262;0;0;0;0;45457;13019;0.2864;12533;486
2016-04-26 03:00:00;20,62;22,13;-1,51;39262;0;0;0;0;45457;12086;0.2659;11671;415
2016-04-26 04:00:00;21,07;22,32;-1,25;39262;0;0;0;0;45457;10368;0.2281;10827;-459
2016-04-26 05:00:00;22,73;25,21;-2,48;39262;3;0.0001;7;-4;45457;9594;0.211;10213;-619
2016-04-26 06:00:00;29,91;35,19;-5,28;39262;283;0.0072;313;-30;45457;9160;0.2016;10142;-982
2016-04-26 07:00:00;34,07;39,55;-5,48;39262;1645;0.0419;1867;-222;45457;8825;0.1942;10354;-1529
2016-04-26 08:00:00;35,14;48,42;-13,28;39262;3595;0.0915;4346;-751;45457;9065;0.1994;10543;-1478
2016-04-26 09:00:00;32,7;44,48;-11,78;39262;5988;0.1525;7155;-1167;45457;9401;0.2068;10624;-1223
2016-04-26 10:00:00;30,36;38,24;-7,88;39262;8323;0.212;9953;-1630;45457;9846;0.2166;10821;-975
2016-04-26 11:00:00;29,78;35,68;-5,9;39262;10162;0.2589;12370;-2208;45457;10145;0.2232;11270;-1125
2016-04-26 12:00:00;26,95;33,55;-6,6;39262;11156;0.2841;14019;-2863;45457;10546;0.232;11950;-1404
2016-04-26 13:00:00;25,65;33,17;-7,52;39262;11930;0.3038;14564;-2634;45457;11035;0.2428;12644;-1609
2016-04-26 14:00:00;25,29;32,97;-7,68;39262;11786;0.3002;14244;-2458;45457;10992;0.2418;13127;-2135
2016-04-26 15:00:00;25,23;30,59;-5,36;39262;11381;0.2899;12962;-1581;45457;11062;0.2434;13364;-2302
2016-04-26 16:00:00;24,73;28,03;-3,3;39262;9392;0.2392;10608;-1216;45457;11703;0.2574;13409;-1706
2016-04-26 17:00:00;25,29;27,25;-1,96;39262;6460;0.1645;7339;-879;45457;12286;0.2702;13085;-799
2016-04-26 18:00:00;28,92;30,5;-1,58;39262;3334;0.0849;3865;-531;45457;11888;0.2615;12440;-552
2016-04-26 19:00:00;31,11;31,27;-0,16;39262;1052;0.0268;1248;-196;45457;11542;0.254;11694;-152
2016-04-26 20:00:00;31,61;30,79;0,82;39262;80;0.002;109;-29;45457;11178;0.2459;11318;-140
2016-04-26 21:00:00;31,07;30,19;0,88;39262;0;0;0;0;45457;11176;0.2458;11603;-427
2016-04-26 22:00:00;27,98;29,39;-1,41;39262;0;0;0;0;45457;12690;0.2792;12058;632
2016-04-26 23:00:00;23,99;26,27;-2,28;39262;0;0;0;0;45457;13356;0.2938;12306;1050
2016-04-27 00:00:00;23,01;17,9;5,11;39264;0;0;0;0;45479;14496;0.3187;11882;2614
2016-04-27 01:00:00;22,42;18,51;3,91;39264;0;0;0;0;45479;15162;0.3334;12126;3036
2016-04-27 02:00:00;22,53;18,2;4,33;39264;0;0;0;0;45479;15440;0.3395;12250;3190
2016-04-27 03:00:00;22,04;18,33;3,71;39264;0;0;0;0;45479;15592;0.3428;12261;3331
2016-04-27 04:00:00;22,17;18,73;3,44;39264;0;0;0;0;45479;15520;0.3412;12319;3201
2016-04-27 05:00:00;23,77;19,33;4,44;39264;6;0.0002;8;-2;45479;15642;0.344;12414;3228
2016-04-27 06:00:00;28,6;20,92;7,68;39264;406;0.0103;469;-63;45479;16436;0.3614;12483;3953
2016-04-27 07:00:00;31,47;22,44;9,03;39264;2134;0.0544;2621;-487;45479;16572;0.3644;12670;3902
2016-04-27 08:00:00;30,27;23,12;7,15;39264;4061;0.1034;5848;-1787;45479;16848;0.3705;13221;3627
2016-04-27 09:00:00;28,85;24,23;4,62;39264;6380;0.1625;9277;-2897;45479;16934;0.3724;14085;2849
2016-04-27 10:00:00;25,65;25,15;0,5;39264;8467;0.2157;12075;-3608;45479;17029;0.3744;14767;2262
2016-04-27 11:00:00;24,91;26,86;-1,95;39264;10700;0.2725;14039;-3339;45479;18071;0.3974;15059;3012
2016-04-27 12:00:00;24,21;25,13;-0,92;39264;12493;0.3182;15036;-2543;45479;18969;0.4171;15071;3898
2016-04-27 13:00:00;24,14;23,7;0,44;39264;12960;0.3301;15136;-2176;45479;19161;0.4213;14917;4244
2016-04-27 14:00:00;23,56;23,3;0,26;39264;13178;0.3357;14558;-1380;45479;19916;0.4379;14864;5052
2016-04-27 15:00:00;23,42;20,71;2,71;39264;12136;0.3091;13051;-915;45479;20111;0.4422;14976;5135
2016-04-27 16:00:00;23,53;20,61;2,92;39264;10125;0.2579;10599;-474;45479;19226;0.4227;14932;4294
2016-04-27 17:00:00;24,03;22,02;2,01;39264;7406;0.1886;7452;-46;45479;19128;0.4206;14283;4845
2016-04-27 18:00:00;28,95;22,07;6,88;39264;4124;0.105;4036;88;45479;17602;0.387;13044;4558
2016-04-27 19:00:00;30,27;24,87;5,4;39264;1390;0.0354;1326;64;45479;15265;0.3356;11865;3400
2016-04-27 20:00:00;33,0;26,92;6,08;39264;108;0.0028;116;-8;45479;13911;0.3059;11093;2818
2016-04-27 21:00:00;31,95;26,67;5,28;39264;0;0;0;0;45479;13130;0.2887;10840;2290
2016-04-27 22:00:00;27,93;23,81;4,12;39264;0;0;0;0;45479;12957;0.2849;10815;2142
2016-04-27 23:00:00;25,51;22,13;3,38;39264;0;0;0;0;45479;12874;0.2831;10739;2135
2016-04-28 00:00:00;23,0;27,94;-4,94;39273;0;0;0;0;45521;12663;0.2782;12163;500
2016-04-28 01:00:00;23,46;27,47;-4,01;39273;0;0;0;0;45521;11806;0.2594;11731;75
2016-04-28 02:00:00;24,55;28,29;-3,74;39273;0;0;0;0;45521;11327;0.2488;11257;70
2016-04-28 03:00:00;23,28;26,84;-3,56;39273;0;0;0;0;45521;10891;0.2392;10745;146
2016-04-28 04:00:00;23,73;26,65;-2,92;39273;0;0;0;0;45521;10574;0.2323;10266;308
2016-04-28 05:00:00;25,59;28,02;-2,43;39273;7;0.0002;8;-1;45521;9960;0.2188;9777;183
2016-04-28 06:00:00;31,12;33,7;-2,58;39273;614;0.0156;584;30;45521;9234;0.2028;9266;-32
2016-04-28 07:00:00;37,99;39,11;-1,12;39273;3124;0.0796;3182;-58;45521;8314;0.1826;8707;-393
2016-04-28 08:00:00;37,99;38,94;-0,95;39273;6748;0.1718;7132;-384;45521;8048;0.1768;8283;-235
2016-04-28 09:00:00;34,1;35,17;-1,07;39273;10577;0.2694;11447;-870;45521;8152;0.1791;8177;-25
2016-04-28 10:00:00;29,93;29,33;0,6;39273;13889;0.3537;15234;-1345;45521;8185;0.1798;8172;13
2016-04-28 11:00:00;29,39;31,66;-2,27;39273;15988;0.4071;17795;-1807;45521;8489;0.1865;8125;364
2016-04-28 12:00:00;26,16;28,73;-2,57;39273;16584;0.4223;19176;-2592;45521;8812;0.1936;8030;782
2016-04-28 13:00:00;24,98;26,65;-1,67;39273;16964;0.4319;19375;-2411;45521;8937;0.1963;7860;1077
2016-04-28 14:00:00;27,39;28,69;-1,3;39273;17124;0.436;18534;-1410;45521;8510;0.187;7766;744
2016-04-28 15:00:00;26,96;27,34;-0,38;39273;15743;0.4009;16494;-751;45521;8522;0.1872;7641;881
2016-04-28 16:00:00;26,5;26,92;-0,42;39273;13084;0.3332;13241;-157;45521;8122;0.1784;7332;790
2016-04-28 17:00:00;30,0;29,26;0,74;39273;9376;0.2387;9039;337;45521;6877;0.1511;6529;348
2016-04-28 18:00:00;34,79;33,27;1,52;39273;5100;0.1299;4701;399;45521;5660;0.1244;5264;396
2016-04-28 19:00:00;38,43;35,27;3,16;39273;1772;0.0451;1531;241;45521;4506;0.099;4018;488
2016-04-28 20:00:00;35,75;35,34;0,41;39273;172;0.0044;149;23;45521;3430;0.0753;3296;134
2016-04-28 21:00:00;37,19;35,33;1,86;39273;0;0;0;0;45521;3549;0.078;3165;384
2016-04-28 22:00:00;34,92;33,71;1,21;39273;0;0;0;0;45521;4184;0.0919;3308;876
2016-04-28 23:00:00;30,3;29,73;0,57;39273;0;0;0;0;45521;5386;0.1183;3617;1769
2016-04-29 00:00:00;26,41;27,98;-1,57;39277;0;0;0;0;45543;6466;0.142;5873;593
2016-04-29 01:00:00;25,01;27,36;-2,35;39277;0;0;0;0;45543;7913;0.1738;7196;717
2016-04-29 02:00:00;23,99;25,9;-1,91;39277;0;0;0;0;45543;9048;0.1987;8312;736
2016-04-29 03:00:00;22,46;24,7;-2,24;39277;0;0;0;0;45543;10546;0.2316;9298;1248
2016-04-29 04:00:00;22,35;26,47;-4,12;39277;0;0;0;0;45543;11732;0.2576;10224;1508
2016-04-29 05:00:00;23,47;27,36;-3,89;39277;12;0.0003;15;-3;45543;12835;0.2818;11123;1712
2016-04-29 06:00:00;26,8;33,51;-6,71;39277;804;0.0204;794;10;45543;13999;0.3074;11986;2013
2016-04-29 07:00:00;30,68;34,95;-4,27;39277;4147;0.1056;4096;51;45543;14182;0.3114;12494;1688
2016-04-29 08:00:00;28,51;30,98;-2,47;39277;9430;0.2401;9376;54;45543;12953;0.2844;12688;265
2016-04-29 09:00:00;22,39;24,69;-2,3;39277;14942;0.3804;14698;244;45543;12995;0.2854;13339;-344
2016-04-29 10:00:00;20,69;23,1;-2,41;39277;18865;0.4803;18359;506;45543;15457;0.3394;14564;893
2016-04-29 11:00:00;20,05;20,51;-0,46;39277;19604;0.4991;19952;-348;45543;18394;0.4039;15713;2681
2016-04-29 12:00:00;19,09;17,99;1,1;39277;17905;0.4558;19974;-2069;45543;18542;0.4072;16148;2394
2016-04-29 13:00:00;20,14;21,29;-1,15;39277;16380;0.417;18934;-2554;45543;17452;0.3832;16127;1325
2016-04-29 14:00:00;20,86;22,86;-2,0;39277;15713;0.4;16914;-1201;45543;15255;0.335;15700;-445
2016-04-29 15:00:00;22,01;23,68;-1,67;39277;14690;0.374;14267;423;45543;15522;0.3408;14780;742
2016-04-29 16:00:00;22,59;23,67;-1,08;39277;12552;0.3196;11509;1043;45543;14939;0.328;13442;1497
2016-04-29 17:00:00;26,01;24,72;1,29;39277;9154;0.2331;8049;1105;45543;13698;0.3008;11840;1858
2016-04-29 18:00:00;30,82;28,2;2,62;39277;5065;0.1289;4235;830;45543;11404;0.2504;10107;1297
2016-04-29 19:00:00;34,83;33,0;1,83;39277;1643;0.0418;1409;234;45543;8910;0.1956;8712;198
2016-04-29 20:00:00;35,18;35,21;-0,03;39277;125;0.0032;149;-24;45543;7793;0.1711;8532;-739
2016-04-29 21:00:00;33,08;34,01;-0,93;39277;0;0;0;0;45543;8566;0.1881;9128;-562
2016-04-29 22:00:00;30,93;32,83;-1,9;39277;0;0;0;0;45543;9312;0.2045;9690;-378
2016-04-29 23:00:00;27,35;27,35;0,0;39277;0;0;0;0;45543;9935;0.2181;9835;100
2016-04-30 00:00:00;24,17;30,8;-6,63;39280;0;0;0;0;45543;10280;0.2257;10317;-37
2016-04-30 01:00:00;24,25;29,81;-5,56;39280;0;0;0;0;45543;10194;0.2238;9951;243
2016-04-30 02:00:00;24,54;28,87;-4,33;39280;0;0;0;0;45543;9654;0.212;9345;309
2016-04-30 03:00:00;25,04;26,19;-1,15;39280;0;0;0;0;45543;8984;0.1972;8548;436
2016-04-30 04:00:00;24,0;25,66;-1,66;39280;0;0;0;0;45543;8258;0.1813;7672;586
2016-04-30 05:00:00;24,0;24,24;-0,24;39280;12;0.0003;15;-3;45543;7407;0.1626;6848;559
2016-04-30 06:00:00;24,22;26,57;-2,35;39280;741;0.0189;689;52;45543;6990;0.1534;6037;953
2016-04-30 07:00:00;25,45;26,33;-0,88;39280;3509;0.0893;3363;146;45543;6264;0.1375;5080;1184
2016-04-30 08:00:00;26,81;26,72;0,09;39280;7681;0.1956;7376;305;45543;4742;0.1041;3930;812
2016-04-30 09:00:00;28,69;26,42;2,27;39280;12009;0.3058;11629;380;45543;3876;0.0851;2931;945
2016-04-30 10:00:00;25,7;24,59;1,11;39280;16164;0.4115;15190;974;45543;3432;0.0754;2313;1119
2016-04-30 11:00:00;24,05;20,44;3,61;39280;19068;0.4854;17510;1558;45543;2951;0.0648;2065;886
2016-04-30 12:00:00;22,44;19,64;2,8;39280;20235;0.5152;18514;1721;45543;2826;0.0621;2088;738
2016-04-30 13:00:00;22,01;19,04;2,97;39280;19682;0.5011;18196;1486;45543;2564;0.0563;2109;455
2016-04-30 14:00:00;21,48;18,79;2,69;39280;17740;0.4516;16823;917;45543;2331;0.0512;2115;216
2016-04-30 15:00:00;21,17;19,43;1,74;39280;14856;0.3782;14480;376;45543;2335;0.0512;2122;213
2016-04-30 16:00:00;21,54;19,49;2,05;39280;11312;0.288;11223;89;45543;2594;0.057;2185;409
2016-04-30 17:00:00;22,34;20,82;1,52;39280;7727;0.1967;7386;341;45543;3760;0.0826;2599;1161
2016-04-30 18:00:00;25,02;22,54;2,48;39280;4191;0.1067;3780;411;45543;5280;0.116;3641;1639
2016-04-30 19:00:00;25,51;22,91;2,6;39280;1326;0.0338;1257;69;45543;6532;0.1434;5123;1409
2016-04-30 20:00:00;25,61;22,17;3,44;39280;121;0.0031;134;-13;45543;8054;0.1768;6731;1323
2016-04-30 21:00:00;28,53;23,63;4,9;39280;0;0;0;0;45543;9568;0.2101;7896;1672
2016-04-30 22:00:00;27,92;24,02;3,9;39280;0;0;0;0;45543;10158;0.223;8729;1429
2016-04-30 23:00:00;24,03;22,75;1,28;39280;0;0;0;0;45543;10194;0.2238;9036;1158
2016-01-05 00:00:00;20,1;17,88;2,22;39283;0;0;0;0;45543;10691;0.2348;9317;1374
2016-01-05 01:00:00;19,81;16,86;2,95;39283;0;0;0;0;45543;10789;0.2369;9214;1575
2016-01-05 02:00:00;18,72;14,82;3,9;39283;0;0;0;0;45543;10807;0.2373;9012;1795
2016-01-05 03:00:00;17,03;12,47;4,56;39283;0;0;0;0;45543;10786;0.2368;8999;1787
2016-01-05 04:00:00;17,17;12,77;4,4;39283;0;0;0;0;45543;10154;0.223;9018;1136
2016-01-05 05:00:00;17,92;13,04;4,88;39283;14;0.0004;18;-4;45543;9804;0.2153;8871;933
2016-01-05 06:00:00;17,64;13,71;3,93;39283;642;0.0164;659;-17;45543;9514;0.2089;8490;1024
2016-01-05 07:00:00;17,04;11,9;5,14;39283;2880;0.0733;3053;-173;45543;8297;0.1822;7951;346
2016-01-05 08:00:00;16,82;12,93;3,89;39283;6136;0.1562;6544;-408;45543;6898;0.1515;7304;-406
2016-01-05 09:00:00;17,42;13,71;3,71;39283;9933;0.2528;10303;-370;45543;6528;0.1434;6783;-255
2016-01-05 10:00:00;16,77;11,91;4,86;39283;14222;0.362;13293;929;45543;6573;0.1443;6486;87
2016-01-05 11:00:00;16,97;8,2;8,77;39283;17110;0.4356;15403;1707;45543;6710;0.1473;6295;415
2016-01-05 12:00:00;15,16;6,41;8,75;39283;18690;0.4758;16532;2158;45543;7034;0.1544;6233;801
2016-01-05 13:00:00;13,73;3,8;9,93;39283;18449;0.4696;16309;2140;45543;7437;0.1633;6226;1211
2016-01-05 14:00:00;14,29;3,92;10,37;39283;17159;0.4368;15036;2123;45543;7719;0.1695;6330;1389
2016-01-05 15:00:00;13,54;6,66;6,88;39283;15189;0.3866;13073;2116;45543;7688;0.1688;6279;1409
2016-01-05 16:00:00;14,25;8,12;6,13;39283;12244;0.3117;10645;1599;45543;7645;0.1678;6162;1483
2016-01-05 17:00:00;16,21;11,07;5,14;39283;8569;0.2181;7464;1105;45543;7577;0.1664;6005;1572
2016-01-05 18:00:00;21,35;20,13;1,22;39283;4732;0.1204;4106;626;45543;7312;0.1606;5801;1511
2016-01-05 19:00:00;23,57;21,86;1,71;39283;1738;0.0442;1468;270;45543;6508;0.1429;5577;931
2016-01-05 20:00:00;25,08;20,96;4,12;39283;224;0.0057;171;53;45543;5893;0.1294;5539;354
2016-01-05 21:00:00;25,74;23,11;2,63;39283;0;0;0;0;45543;6287;0.138;5568;719
2016-01-05 22:00:00;26,35;23,21;3,14;39283;0;0;0;0;45543;6318;0.1387;5521;797
2016-01-05 23:00:00;24,48;20,84;3,64;39283;0;0;0;0;45543;5944;0.1305;5211;733
2016-02-05 00:00:00;21,45;19,14;2,31;39285;0;0;0;0;45549;5533;0.1215;5013;520
2016-02-05 01:00:00;20,23;17,04;3,19;39285;0;0;0;0;45549;4904;0.1077;4487;417
2016-02-05 02:00:00;20,03;16,7;3,33;39285;0;0;0;0;45549;4338;0.0952;3960;378
2016-02-05 03:00:00;19,94;16,35;3,59;39285;0;0;0;0;45549;3930;0.0862;3595;335
2016-02-05 04:00:00;20,08;17,48;2,6;39285;0;0;0;0;45549;3799;0.0834;3343;456
2016-02-05 05:00:00;23,47;20,33;3,14;39285;21;0.0005;30;-9;45549;3556;0.0781;3154;402
2016-02-05 06:00:00;31,12;29,46;1,66;39285;897;0.0228;923;-26;45549;3241;0.0711;2966;275
2016-02-05 07:00:00;35,53;33,73;1,8;39285;4260;0.1084;4263;-3;45549;2603;0.0572;2679;-76
2016-02-05 08:00:00;34,96;34,97;-0,01;39285;9767;0.2486;9545;222;45549;1696;0.0372;2356;-660
2016-02-05 09:00:00;31,35;30,51;0,84;39285;15511;0.3948;15072;439;45549;1472;0.0323;2231;-759
2016-02-05 10:00:00;28,29;25,08;3,21;39285;19786;0.5036;19487;299;45549;1764;0.0387;2235;-471
2016-02-05 11:00:00;26,91;23,3;3,61;39285;22729;0.5786;22111;618;45549;2082;0.0457;2400;-318
2016-02-05 12:00:00;25,29;22,84;2,45;39285;23836;0.6067;23088;748;45549;2362;0.0518;2649;-287
2016-02-05 13:00:00;25,07;22,51;2,56;39285;23746;0.6044;22600;1146;45549;2771;0.0608;2868;-97
2016-02-05 14:00:00;25,02;22,18;2,84;39285;22294;0.5675;20758;1536;45549;3014;0.0661;3075;-61
2016-02-05 15:00:00;25,53;22,18;3,35;39285;19530;0.4972;17830;1700;45549;3095;0.068;3127;-32
2016-02-05 16:00:00;26,94;23,34;3,6;39285;15740;0.4007;14274;1466;45549;2952;0.0648;3118;-166
2016-02-05 17:00:00;29,06;26,61;2,45;39285;10889;0.2772;9847;1042;45549;2828;0.0621;3090;-262
2016-02-05 18:00:00;33,0;30,8;2,2;39285;5893;0.15;5249;644;45549;2776;0.061;3061;-285
2016-02-05 19:00:00;35,79;32,71;3,08;39285;2056;0.0524;1785;271;45549;2914;0.064;3133;-219
2016-02-05 20:00:00;35,76;32,87;2,89;39285;228;0.0058;225;3;45549;3208;0.0704;3524;-316
2016-02-05 21:00:00;34,08;32,01;2,07;39285;0;0;0;0;45549;4210;0.0924;4320;-110
2016-02-05 22:00:00;31,93;30,83;1,1;39285;0;0;0;0;45549;5112;0.1122;5182;-70
2016-02-05 23:00:00;27,05;27,02;0,03;39285;0;0;0;0;45549;5664;0.1244;5744;-80
2016-03-05 00:00:00;23,91;24,11;-0,2;39288;0;0;0;0;45576;6107;0.134;6730;-623
2016-03-05 01:00:00;22,32;20,45;1,87;39288;0;0;0;0;45576;6374;0.1398;6632;-258
2016-03-05 02:00:00;21,84;20,34;1,5;39288;0;0;0;0;45576;6059;0.1329;6165;-106
2016-03-05 03:00:00;21,37;19,29;2,08;39288;0;0;0;0;45576;5507;0.1208;5642;-135
2016-03-05 04:00:00;21,85;19,01;2,84;39288;0;0;0;0;45576;4994;0.1096;5222;-228
2016-03-05 05:00:00;23,26;21,52;1,74;39288;22;0.0006;26;-4;45576;4794;0.1052;4904;-110
2016-03-05 06:00:00;30,39;30,32;0,07;39288;833;0.0212;713;120;45576;4875;0.107;4767;108
2016-03-05 07:00:00;33,9;31,29;2,61;39288;3495;0.089;3113;382;45576;5248;0.1151;4475;773
2016-03-05 08:00:00;36,48;29,72;6,76;39288;7397;0.1883;6470;927;45576;5331;0.117;4088;1243
2016-03-05 09:00:00;35,95;27,48;8,47;39288;11426;0.2908;9998;1428;45576;5132;0.1126;4195;937
2016-03-05 10:00:00;35,58;25,54;10,04;39288;14718;0.3746;12784;1934;45576;5923;0.13;4623;1300
2016-03-05 11:00:00;34,9;24,32;10,58;39288;16806;0.4277;14447;2359;45576;6722;0.1475;5241;1481
2016-03-05 12:00:00;31,55;22,18;9,37;39288;16990;0.4324;15251;1739;45576;7659;0.168;6223;1436
2016-03-05 13:00:00;26,59;21,37;5,22;39288;15931;0.4055;15020;911;45576;8848;0.1941;7388;1460
2016-03-05 14:00:00;24,9;21,89;3,01;39288;14392;0.3663;14176;216;45576;11369;0.2495;8746;2623
2016-03-05 15:00:00;24,1;20,68;3,42;39288;12723;0.3239;12507;216;45576;13346;0.2928;10343;3003
2016-03-05 16:00:00;23,91;20,43;3,48;39288;10537;0.2682;10061;476;45576;15186;0.3332;11829;3357
2016-03-05 17:00:00;25,17;22,04;3,13;39288;7474;0.1902;7202;272;45576;13922;0.3055;12544;1378
2016-03-05 18:00:00;28,51;24,99;3,52;39288;4468;0.1137;4179;289;45576;15389;0.3377;12342;3047
2016-03-05 19:00:00;31,69;27,69;4,0;39288;1700;0.0433;1564;136;45576;13860;0.3041;11689;2171
2016-03-05 20:00:00;32,1;29,27;2,83;39288;239;0.0061;197;42;45576;11620;0.255;10865;755
2016-03-05 21:00:00;32,8;29,26;3,54;39288;0;0;0;0;45576;9697;0.2128;10163;-466
2016-03-05 22:00:00;30,92;29,13;1,79;39288;0;0;0;0;45576;8904;0.1954;9586;-682
2016-03-05 23:00:00;24,59;29,03;-4,44;39288;0;0;0;0;45576;8528;0.1871;9165;-637
2016-04-05 00:00:00;22,94;26,29;-3,35;39291;0;0;0;0;45586;8121;0.1781;8577;-456
2016-04-05 01:00:00;21,98;23,77;-1,79;39291;0;0;0;0;45586;7644;0.1677;8226;-582
2016-04-05 02:00:00;21,95;22,79;-0,84;39291;0;0;0;0;45586;7357;0.1614;7764;-407
2016-04-05 03:00:00;21,69;22,52;-0,83;39291;0;0;0;0;45586;6914;0.1516;7211;-297
2016-04-05 04:00:00;22,14;23,33;-1,19;39291;0;0;0;0;45586;6276;0.1377;6666;-390
2016-04-05 05:00:00;23,59;25,22;-1,63;39291;25;0.0006;30;-5;45586;5490;0.1204;6170;-680
2016-04-05 06:00:00;31,47;34,5;-3,03;39291;845;0.0215;919;-74;45586;4649;0.102;5668;-1019
2016-04-05 07:00:00;35,05;38,27;-3,22;39291;3627;0.0923;4051;-424;45586;3672;0.0806;5102;-1430
2016-04-05 08:00:00;35,97;37,23;-1,26;39291;8136;0.2071;8862;-726;45586;2998;0.0658;4476;-1478
2016-04-05 09:00:00;32,46;34,02;-1,56;39291;12848;0.327;14042;-1194;45586;2924;0.0642;3867;-943
2016-04-05 10:00:00;28,51;28,67;-0,16;39291;16616;0.4229;18515;-1899;45586;2682;0.0588;3340;-658
2016-04-05 11:00:00;27,14;30,42;-3,28;39291;19104;0.4862;21612;-2508;45586;2493;0.0547;3119;-626
2016-04-05 12:00:00;25,43;27,95;-2,52;39291;20480;0.5212;23142;-2662;45586;2312;0.0507;3005;-693
2016-04-05 13:00:00;24,37;26,58;-2,21;39291;20947;0.5331;23356;-2409;45586;2170;0.0476;2908;-738
2016-04-05 14:00:00;24,01;26,31;-2,3;39291;20138;0.5125;22334;-2196;45586;2064;0.0453;2884;-820
2016-04-05 15:00:00;23,64;25,0;-1,36;39291;17865;0.4547;19796;-1931;45586;2014;0.0442;2785;-771
2016-04-05 16:00:00;23,88;24,15;-0,27;39291;14541;0.3701;15927;-1386;45586;2011;0.0441;2625;-614
2016-04-05 17:00:00;25,1;26,03;-0,93;39291;10367;0.2638;11039;-672;45586;1963;0.0431;2363;-400
2016-04-05 18:00:00;28,96;27,84;1,12;39291;6000;0.1527;5882;118;45586;1822;0.04;2079;-257
2016-04-05 19:00:00;31,73;30,4;1,33;39291;2311;0.0588;2061;250;45586;1758;0.0386;1920;-162
2016-04-05 20:00:00;32,0;30,76;1,24;39291;335;0.0086;300;35;45586;1878;0.0412;2108;-230
2016-04-05 21:00:00;32,9;31,13;1,77;39291;0;0;1;-1;45586;2601;0.057;2679;-78
2016-04-05 22:00:00;31,93;29,04;2,89;39291;0;0;0;0;45586;3794;0.0832;3289;505
2016-04-05 23:00:00;27,8;26,54;1,26;39291;0;0;0;0;45586;4662;0.1023;3755;907
2016-05-05 00:00:00;23,69;21,74;1,95;39291;0;0;0;0;45586;5148;0.1129;4083;1065
2016-05-05 01:00:00;21,86;20,47;1,39;39291;0;0;0;0;45586;5309;0.1164;4295;1014
2016-05-05 02:00:00;21,26;17,72;3,54;39291;0;0;0;0;45586;5293;0.1162;4459;834
2016-05-05 03:00:00;20,26;17,18;3,08;39291;0;0;0;0;45586;5449;0.1196;4552;897
2016-05-05 04:00:00;19,79;16,97;2,82;39291;0;0;0;0;45586;5171;0.1134;4557;614
2016-05-05 05:00:00;19,79;16,99;2,8;39291;36;0.0009;45;-9;45586;4924;0.108;4457;467
2016-05-05 06:00:00;19,95;17,14;2,81;39291;1023;0.026;1129;-106;45586;4772;0.1047;4306;466
2016-05-05 07:00:00;20,07;17,15;2,92;39291;4384;0.1116;4780;-396;45586;4132;0.0906;4059;73
2016-05-05 08:00:00;20,0;18,69;1,31;39291;9916;0.2523;10444;-528;45586;2642;0.058;3467;-825
2016-05-05 09:00:00;19,57;19,4;0,17;39291;15801;0.4022;16241;-440;45586;2678;0.0588;2985;-307
2016-05-05 10:00:00;19,01;18,25;0,76;39291;20324;0.5172;20784;-460;45586;3688;0.0809;2982;706
2016-05-05 11:00:00;17,76;16,69;1,07;39291;23462;0.5972;23700;-238;45586;4178;0.0916;3207;971
2016-05-05 12:00:00;16,97;13,19;3,78;39291;25208;0.6416;25086;122;45586;4357;0.0956;3498;859
2016-05-05 13:00:00;13,42;7,47;5,95;39291;25369;0.6457;25067;302;45586;4458;0.0978;3784;674
2016-05-05 14:00:00;10,85;3,05;7,8;39291;24282;0.618;23552;730;45586;4502;0.0988;4146;356
2016-05-05 15:00:00;10,49;4,94;5,55;39291;22133;0.5633;20625;1508;45586;4702;0.1032;4483;219
2016-05-05 16:00:00;13,06;4,51;8,55;39291;18272;0.465;16727;1545;45586;5089;0.1116;4887;202
2016-05-05 17:00:00;17,77;12,68;5,09;39291;12900;0.3283;11689;1211;45586;5711;0.1252;5298;413
2016-05-05 18:00:00;20,67;18,01;2,66;39291;6845;0.1742;6190;655;45586;6184;0.1356;5699;485
2016-05-05 19:00:00;24,2;20,52;3,68;39291;2404;0.0612;2138;266;45586;6264;0.1374;6095;169
2016-05-05 20:00:00;24,08;23,8;0,28;39291;354;0.009;328;26;45586;6741;0.1479;7081;-340
2016-05-05 21:00:00;24,87;24,75;0,12;39291;0;0;2;-2;45586;9375;0.2057;8776;599
2016-05-05 22:00:00;25,79;25,41;0,38;39291;0;0;0;0;45586;11510;0.2525;10457;1053
2016-05-05 23:00:00;21,62;21,29;0,33;39291;0;0;0;0;45586;12926;0.2835;11376;1550
2016-06-05 00:00:00;20,73;17,21;3,52;39292;0;0;0;0;45589;13264;0.2909;10675;2589
2016-06-05 01:00:00;19,08;17,2;1,88;39292;0;0;0;0;45589;12614;0.2766;10607;2007
2016-06-05 02:00:00;18,46;15,95;2,51;39292;0;0;0;0;45589;11906;0.2612;10231;1675
2016-06-05 03:00:00;17,87;14,84;3,03;39292;0;0;0;0;45589;11283;0.2475;9829;1454
2016-06-05 04:00:00;19,11;15,98;3,13;39292;0;0;0;0;45589;10567;0.2318;9491;1076
2016-06-05 05:00:00;20,0;17,93;2,07;39292;46;0.0012;56;-10;45589;9642;0.2115;9192;450
2016-06-05 06:00:00;24,44;24,25;0,19;39292;1176;0.0299;1207;-31;45589;9057;0.1987;8848;209
2016-06-05 07:00:00;30,33;29,53;0,8;39292;4828;0.1228;4989;-161;45589;7499;0.1645;8095;-596
2016-06-05 08:00:00;30,99;29,07;1,92;39292;10509;0.2674;10859;-350;45589;5130;0.1125;6978;-1848
2016-06-05 09:00:00;29,98;25,38;4,6;39292;16204;0.4124;16857;-653;45589;4241;0.093;6456;-2215
2016-06-05 10:00:00;24,28;22,59;1,69;39292;21093;0.5368;21773;-680;45589;4884;0.1071;6699;-1815
2016-06-05 11:00:00;22,58;21,78;0,8;39292;24311;0.6187;25067;-756;45589;6509;0.1428;7435;-926
2016-06-05 12:00:00;19,66;18,04;1,62;39292;25930;0.6599;26734;-804;45589;8446;0.1852;8515;-69
2016-06-05 13:00:00;14,24;12,72;1,52;39292;26055;0.6631;26894;-839;45589;10401;0.2281;9630;771
2016-06-05 14:00:00;11,92;12,74;-0,82;39292;24841;0.6322;25587;-746;45589;11911;0.2613;10484;1427
2016-06-05 15:00:00;14,96;11,37;3,59;39292;22245;0.5662;22719;-474;45589;12435;0.2728;10901;1534
2016-06-05 16:00:00;17,93;11,14;6,79;39292;18179;0.4626;18448;-269;45589;12392;0.2718;11102;1290
2016-06-05 17:00:00;21,85;16,9;4,95;39292;12692;0.323;12774;-82;45589;11875;0.2605;11074;801
2016-06-05 18:00:00;27,99;22,32;5,67;39292;6757;0.172;6607;150;45589;11282;0.2475;10786;496
2016-06-05 19:00:00;30,94;25,43;5,51;39292;2351;0.0598;2260;91;45589;10120;0.222;10831;-711
2016-06-05 20:00:00;28,8;24,82;3,98;39292;352;0.009;367;-15;45589;10581;0.2321;11659;-1078
2016-06-05 21:00:00;27,86;25,98;1,88;39292;0;0;2;-2;45589;13113;0.2876;12864;249
2016-06-05 22:00:00;25,43;25,87;-0,44;39292;0;0;0;0;45589;15002;0.3291;13838;1164
2016-06-05 23:00:00;21,42;23,57;-2,15;39292;0;0;0;0;45589;15777;0.3461;14129;1648
2016-07-05 00:00:00;19,73;18,31;1,42;39292;0;0;0;0;45611;16106;0.3532;13823;2283
2016-07-05 01:00:00;16,9;11,11;5,79;39292;0;0;0;0;45611;15415;0.338;13276;2139
2016-07-05 02:00:00;14,95;10,03;4,92;39292;0;0;0;0;45611;14215;0.3117;12858;1357
2016-07-05 03:00:00;14,64;9,09;5,55;39292;0;0;0;0;45611;13447;0.2948;12486;961
2016-07-05 04:00:00;14,96;9,64;5,32;39292;0;0;0;0;45611;12861;0.282;11990;871
2016-07-05 05:00:00;15,2;9,96;5,24;39292;56;0.0014;64;-8;45611;12234;0.2682;11629;605
2016-07-05 06:00:00;16,27;12,79;3,48;39292;1207;0.0307;1300;-93;45611;11436;0.2508;11125;311
2016-07-05 07:00:00;19,32;15,48;3,84;39292;4954;0.1261;5321;-367;45611;9328;0.2045;9792;-464
2016-07-05 08:00:00;19,94;15,57;4,37;39292;10669;0.2715;11316;-647;45611;6049;0.1326;8435;-2386
2016-07-05 09:00:00;19,41;19,15;0,26;39292;16378;0.4168;17340;-962;45611;4842;0.1061;7965;-3123
2016-07-05 10:00:00;13,1;16,74;-3,64;39292;21070;0.5362;22158;-1088;45611;5761;0.1263;8331;-2570
2016-07-05 11:00:00;10,54;12,09;-1,55;39292;24168;0.6151;25313;-1145;45611;8742;0.1916;9137;-395
2016-07-05 12:00:00;6,12;7,83;-1,71;39292;25687;0.6538;26860;-1173;45611;12444;0.2728;10537;1907
2016-07-05 13:00:00;5,32;4,95;0,37;39292;25750;0.6554;26976;-1226;45611;13686;0.3;11862;1824
2016-07-05 14:00:00;3,05;-1,22;4,27;39292;24542;0.6246;25699;-1157;45611;13629;0.2988;12295;1334
2016-07-05 15:00:00;3,84;2,47;1,37;39292;21800;0.5548;22857;-1057;45611;13807;0.3027;12570;1237
2016-07-05 16:00:00;8,67;9,96;-1,29;39292;17779;0.4525;18569;-790;45611;14364;0.3149;12749;1615
2016-07-05 17:00:00;13,49;10,59;2,9;39292;12392;0.3154;12908;-516;45611;14674;0.3217;12814;1860
2016-07-05 18:00:00;19,92;13,55;6,37;39292;6680;0.17;6728;-48;45611;14286;0.3132;12798;1488
2016-07-05 19:00:00;21,43;14,19;7,24;39292;2439;0.0621;2308;131;45611;13528;0.2966;12889;639
2016-07-05 20:00:00;19,93;15,77;4,16;39292;392;0.01;401;-9;45611;13983;0.3066;13462;521
2016-07-05 21:00:00;19,81;19,19;0,62;39292;0;0;2;-2;45611;17134;0.3756;14786;2348
2016-07-05 22:00:00;19,72;14,53;5,19;39292;0;0;0;0;45611;18906;0.4145;15514;3392
2016-07-05 23:00:00;18,22;11,45;6,77;39292;0;0;0;0;45611;19034;0.4173;15555;3479
2016-08-05 00:00:00;14,2;5,44;8,76;39292;0;0;0;0;45623;18878;0.4138;16051;2827
2016-08-05 01:00:00;10,01;1,8;8,21;39292;0;0;0;0;45623;18094;0.3966;15340;2754
2016-08-05 02:00:00;7,98;-1,78;9,76;39292;0;0;0;0;45623;17076;0.3743;14695;2381
2016-08-05 03:00:00;5,07;-7,15;12,22;39292;0;0;0;0;45623;16112;0.3532;14084;2028
2016-08-05 04:00:00;4,0;-1,09;5,09;39292;0;0;0;0;45623;15361;0.3367;13626;1735
2016-08-05 05:00:00;3,0;-1,08;4,08;39292;65;0.0016;74;-9;45623;14688;0.3219;13148;1540
2016-08-05 06:00:00;2,91;0,26;2,65;39292;1239;0.0315;1314;-75;45623;14404;0.3157;12450;1954
2016-08-05 07:00:00;2,79;0,36;2,43;39292;4972;0.1266;5282;-310;45623;12278;0.2691;11373;905
2016-08-05 08:00:00;4,0;5,47;-1,47;39292;10836;0.2758;11369;-533;45623;9397;0.206;10418;-1021
2016-08-05 09:00:00;2,35;8,66;-6,31;39292;16688;0.4247;17429;-741;45623;9978;0.2187;10844;-866
2016-08-05 10:00:00;-1,63;5,59;-7,22;39292;21373;0.544;22223;-850;45623;14762;0.3235;12707;2055
2016-08-05 11:00:00;-7,09;-5,09;-2,0;39292;24409;0.6212;25314;-905;45623;18936;0.415;14874;4062
2016-08-05 12:00:00;-76,09;-78,53;2,44;39292;25961;0.6607;26798;-837;45623;16753;0.3672;16669;84
2016-08-05 13:00:00;-100,06;-123,46;23,4;39292;25966;0.6609;26777;-811;45623;15308;0.3355;17830;-2522
2016-08-05 14:00:00;-130,09;-155,52;25,43;39292;24593;0.6259;25308;-715;45623;13816;0.3028;18316;-4500
2016-08-05 15:00:00;-82,06;-99,46;17,4;39292;21888;0.557;22343;-455;45623;16282;0.3569;18203;-1921
2016-08-05 16:00:00;-76,0;-65,39;-10,61;39292;17762;0.4521;18145;-383;45623;19728;0.4324;17727;2001
2016-08-05 17:00:00;-0,6;-15,1;14,5;39292;12477;0.3175;12614;-137;45623;21186;0.4644;17322;3864
2016-08-05 18:00:00;10,4;11,43;-1,03;39292;6746;0.1717;6616;130;45623;21083;0.4621;16793;4290
2016-08-05 19:00:00;19,35;16,3;3,05;39292;2422;0.0617;2311;111;45623;18785;0.4118;15929;2856
2016-08-05 20:00:00;19,4;23,32;-3,92;39292;422;0.0107;423;-1;45623;16447;0.3605;15695;752
2016-08-05 21:00:00;20,02;29,7;-9,68;39292;0;0;4;-4;45623;17140;0.3757;16009;1131
2016-08-05 22:00:00;20,12;27,96;-7,84;39292;0;0;0;0;45623;17958;0.3936;16361;1597
2016-08-05 23:00:00;18,66;23,48;-4,82;39292;0;0;0;0;45623;18184;0.3986;16142;2042
2016-09-05 00:00:00;14,28;18,12;-3,84;39303;0;0;0;0;45642;17763;0.3892;16221;1542
2016-09-05 01:00:00;12,68;15,54;-2,86;39303;0;0;0;0;45642;17132;0.3753;15483;1649
2016-09-05 02:00:00;12,09;14,38;-2,29;39303;0;0;0;0;45642;16074;0.3522;14807;1267
2016-09-05 03:00:00;9,57;15,26;-5,69;39303;0;0;0;0;45642;15128;0.3314;14333;795
2016-09-05 04:00:00;11,0;18,21;-7,21;39303;0;0;0;0;45642;14736;0.3229;13959;777
2016-09-05 05:00:00;14,18;21,92;-7,74;39303;71;0.0018;83;-12;45642;14448;0.3166;13499;949
2016-09-05 06:00:00;28,57;28,63;-0,06;39303;1265;0.0322;1375;-110;45642;13391;0.2934;12842;549
2016-09-05 07:00:00;32,95;35,26;-2,31;39303;4974;0.1265;5280;-306;45642;10842;0.2376;11807;-965
2016-09-05 08:00:00;34,69;49,19;-14,5;39303;10652;0.271;11103;-451;45642;8654;0.1896;10786;-2132
2016-09-05 09:00:00;31,24;39,7;-8,46;39303;16335;0.4156;16895;-560;45642;10232;0.2242;11142;-910
2016-09-05 10:00:00;24,23;27,19;-2,96;39303;20798;0.5291;21429;-631;45642;14034;0.3075;12526;1508
2016-09-05 11:00:00;22,15;22,61;-0,46;39303;23642;0.6015;24325;-683;45642;17504;0.3835;14047;3457
2016-09-05 12:00:00;17,08;16,54;0,54;39303;24940;0.6346;25610;-670;45642;18018;0.3948;15383;2635
2016-09-05 13:00:00;12,01;12,58;-0,57;39303;24600;0.6259;25313;-713;45642;18851;0.413;16369;2482
2016-09-05 14:00:00;10,85;13,46;-2,61;39303;23011;0.5855;23657;-646;45642;18812;0.4122;16681;2131
2016-09-05 15:00:00;18,63;22,46;-3,83;39303;20375;0.5184;20622;-247;45642;18548;0.4064;16433;2115
2016-09-05 16:00:00;21,0;23,68;-2,68;39303;16387;0.417;16481;-94;45642;18159;0.3979;15961;2198
2016-09-05 17:00:00;23,71;30,81;-7,1;39303;11318;0.288;11315;3;45642;17084;0.3743;15366;1718
2016-09-05 18:00:00;27,12;38,3;-11,18;39303;6303;0.1604;6022;281;45642;15859;0.3475;14441;1418
2016-09-05 19:00:00;31,46;41,58;-10,12;39303;2388;0.0608;2211;177;45642;13750;0.3012;13306;444
2016-09-05 20:00:00;31,28;40,65;-9,37;39303;367;0.0093;386;-19;45642;12900;0.2826;13267;-367
2016-09-05 21:00:00;30,0;40,27;-10,27;39303;1;0;3;-2;45642;14435;0.3163;13846;589
2016-09-05 22:00:00;24,92;34,95;-10,03;39303;0;0;0;0;45642;15157;0.3321;14203;954
2016-09-05 23:00:00;21,83;28,46;-6,63;39303;0;0;0;0;45642;15198;0.333;14207;991
2016-10-05 00:00:00;22,55;23,4;-0,85;39306;0;0;0;0;45667;14838;0.3249;13842;996
2016-10-05 01:00:00;21,09;23,74;-2,65;39306;0;0;0;0;45667;13769;0.3015;13285;484
2016-10-05 02:00:00;19,61;23,71;-4,1;39306;0;0;0;0;45667;12863;0.2817;12773;90
2016-10-05 03:00:00;19,33;22,76;-3,43;39306;0;0;0;0;45667;12478;0.2732;12169;309
2016-10-05 04:00:00;19,87;20,49;-0,62;39306;0;0;0;0;45667;12450;0.2726;11768;682
2016-10-05 05:00:00;21,56;22,2;-0,64;39306;80;0.002;88;-8;45667;12054;0.264;11387;667
2016-10-05 06:00:00;28,5;30,35;-1,85;39306;1260;0.0321;1208;52;45667;11111;0.2433;10887;224
2016-10-05 07:00:00;31,87;40,54;-8,67;39306;4459;0.1134;4470;-11;45667;9099;0.1992;10072;-973
2016-10-05 08:00:00;36,66;50,18;-13,52;39306;8986;0.2286;8952;34;45667;6928;0.1518;9263;-2335
2016-10-05 09:00:00;34,61;39,88;-5,27;39306;13104;0.3334;13217;-113;45667;7541;0.1651;9264;-1723
2016-10-05 10:00:00;29,96;29,76;0,2;39306;16361;0.4162;16415;-54;45667;9914;0.2171;10247;-333
2016-10-05 11:00:00;25,54;27,38;-1,84;39306;18494;0.4705;18278;216;45667;11362;0.2488;11084;278
2016-10-05 12:00:00;23,46;24,36;-0,9;39306;19140;0.4869;18961;179;45667;11173;0.2447;11506;-333
2016-10-05 13:00:00;23,34;25,29;-1,95;39306;18148;0.4617;18470;-322;45667;9943;0.2177;11473;-1530
2016-10-05 14:00:00;23,41;27,22;-3,81;39306;16436;0.4182;17084;-648;45667;10509;0.2301;11142;-633
2016-10-05 15:00:00;27,6;27,58;0,02;39306;14242;0.3623;14856;-614;45667;10665;0.2336;10710;-45
2016-10-05 16:00:00;28,21;30,45;-2,24;39306;11565;0.2942;11959;-394;45667;10525;0.2304;10334;191
2016-10-05 17:00:00;30,69;32,31;-1,62;39306;8259;0.2101;8427;-168;45667;10839;0.2374;10065;774
2016-10-05 18:00:00;31,93;31,37;0,56;39306;4890;0.1244;4716;174;45667;10536;0.2308;9888;648
2016-10-05 19:00:00;32,5;32,68;-0,18;39306;1988;0.0506;1819;169;45667;9756;0.2136;9808;-52
2016-10-05 20:00:00;32,25;33,06;-0,81;39306;297;0.0075;331;-34;45667;10001;0.219;10291;-290
2016-10-05 21:00:00;31,99;31,58;0,41;39306;1;0;3;-2;45667;11303;0.2475;10838;465
2016-10-05 22:00:00;29,96;30,36;-0,4;39306;0;0;0;0;45667;12273;0.2687;11202;1071
2016-10-05 23:00:00;22,34;23,67;-1,33;39306;0;0;0;0;45667;12397;0.2714;11154;1243
2016-11-05 00:00:00;22,4;25,96;-3,56;39309;0;0;0;0;45670;11744;0.2572;11572;172
2016-11-05 01:00:00;20,54;23,17;-2,63;39309;0;0;0;0;45670;11199;0.2452;11045;154
2016-11-05 02:00:00;19,92;21,34;-1,42;39309;0;0;0;0;45670;10475;0.2294;10571;-96
2016-11-05 03:00:00;19,11;18,85;0,26;39309;0;0;0;0;45670;9756;0.2136;10128;-372
2016-11-05 04:00:00;19,87;19,76;0,11;39309;0;0;0;0;45670;9281;0.2032;9764;-483
2016-11-05 05:00:00;21,84;24,63;-2,79;39309;90;0.0023;95;-5;45670;8966;0.1963;9388;-422
2016-11-05 06:00:00;28,96;31,41;-2,45;39309;1350;0.0343;1384;-34;45670;8733;0.1912;8864;-131
2016-11-05 07:00:00;35,27;36,8;-1,53;39309;4842;0.1232;5063;-221;45670;7434;0.1628;8100;-666
2016-11-05 08:00:00;39,6;38,75;0,85;39309;9430;0.2398;10357;-927;45670;5784;0.1266;7450;-1666
2016-11-05 09:00:00;34,94;31,81;3,13;39309;14038;0.3571;15630;-1592;45670;5748;0.1259;7670;-1922
2016-11-05 10:00:00;29,41;28,49;0,92;39309;18186;0.4626;19800;-1614;45670;7751;0.1698;8396;-645
2016-11-05 11:00:00;24,58;27,56;-2,98;39309;21068;0.536;22503;-1435;45670;11646;0.255;9628;2018
2016-11-05 12:00:00;22,19;23,21;-1,02;39309;21365;0.5435;23700;-2335;45670;14520;0.3179;11162;3358
2016-11-05 13:00:00;20,87;20,72;0,15;39309;21411;0.5447;23229;-1818;45670;14683;0.3215;12236;2447
2016-11-05 14:00:00;20,74;21,4;-0,66;39309;20523;0.5221;21393;-870;45670;14643;0.3206;12890;1753
2016-11-05 15:00:00;21,73;23,13;-1,4;39309;17548;0.4464;18370;-822;45670;15322;0.3355;13216;2106
2016-11-05 16:00:00;22,54;24,69;-2,15;39309;13540;0.3444;14558;-1018;45670;15848;0.347;13629;2219
2016-11-05 17:00:00;23,36;25,63;-2,27;39309;9400;0.2392;10029;-629;45670;16092;0.3523;14184;1908
2016-11-05 18:00:00;25,87;30,0;-4,13;39309;5282;0.1344;5436;-154;45670;15716;0.3441;14483;1233
2016-11-05 19:00:00;31,32;33,8;-2,48;39309;2162;0.055;2083;79;45670;14989;0.3282;14625;364
2016-11-05 20:00:00;29,94;32,6;-2,66;39309;402;0.0102;384;18;45670;14629;0.3203;15348;-719
2016-11-05 21:00:00;25,09;30,18;-5,09;39309;2;0;3;-1;45670;16033;0.351;16142;-109
2016-11-05 22:00:00;22,23;28,58;-6,35;39309;0;0;0;0;45670;16322;0.3574;16693;-371
2016-11-05 23:00:00;19,44;25,62;-6,18;39309;0;0;0;0;45670;16790;0.3676;16905;-115
2016-12-05 00:00:00;19,5;19,1;0,4;39312;0;0;0;0;45700;16891;0.3696;16359;532
2016-12-05 01:00:00;17,81;15,92;1,89;39312;0;0;0;0;45700;16384;0.3585;16171;213
2016-12-05 02:00:00;14,67;14,87;-0,2;39312;0;0;0;0;45700;15981;0.3497;15969;12
2016-12-05 03:00:00;14,0;13,51;0,49;39312;0;0;0;0;45700;15514;0.3394;15700;-186
2016-12-05 04:00:00;13,02;13,83;-0,81;39312;0;0;0;0;45700;14922;0.3265;15409;-487
2016-12-05 05:00:00;18,08;18,39;-0,31;39312;88;0.0022;100;-12;45700;14263;0.3121;14965;-702
2016-12-05 06:00:00;24,08;21,44;2,64;39312;1158;0.0294;1196;-38;45700;13454;0.2944;14291;-837
2016-12-05 07:00:00;30,93;29,49;1,44;39312;3988;0.1014;4171;-183;45700;11688;0.2558;13517;-1829
2016-12-05 08:00:00;34,05;36,67;-2,62;39312;7718;0.1964;8054;-336;45700;9604;0.2102;13067;-3463
2016-12-05 09:00:00;30,96;33,74;-2,78;39312;11377;0.2894;11612;-235;45700;9286;0.2032;13415;-4129
2016-12-05 10:00:00;28,93;28,9;0,03;39312;13937;0.3545;14016;-79;45700;10868;0.2378;14063;-3195
2016-12-05 11:00:00;26,95;27,26;-0,31;39312;15167;0.3858;15235;-68;45700;13609;0.2978;14857;-1248
2016-12-05 12:00:00;25,24;28,5;-3,26;39312;15161;0.3856;15607;-446;45700;16172;0.3539;15557;615
2016-12-05 13:00:00;24,15;28,69;-4,54;39312;14363;0.3654;15243;-880;45700;16948;0.3709;15937;1011
2016-12-05 14:00:00;24,75;29,61;-4,86;39312;13039;0.3317;14033;-994;45700;16860;0.3689;15905;955
2016-12-05 15:00:00;25,07;28,35;-3,28;39312;11490;0.2923;12176;-686;45700;16036;0.3509;15392;644
2016-12-05 16:00:00;25,14;28,56;-3,42;39312;9496;0.2416;9790;-294;45700;15523;0.3397;14813;710
2016-12-05 17:00:00;27,47;31,4;-3,93;39312;6844;0.1741;6862;-18;45700;15443;0.3379;14229;1214
2016-12-05 18:00:00;29,79;35,27;-5,48;39312;3988;0.1014;3933;55;45700;15044;0.3292;13552;1492
2016-12-05 19:00:00;32,91;34,26;-1,35;39312;1694;0.0431;1621;73;45700;13968;0.3056;12714;1254
2016-12-05 20:00:00;32,85;30,79;2,06;39312;348;0.0089;311;37;45700;13248;0.2899;12373;875
2016-12-05 21:00:00;31,84;28,02;3,82;39312;5;0.0001;4;1;45700;12530;0.2742;11967;563
2016-12-05 22:00:00;29,98;26,83;3,15;39312;0;0;0;0;45700;11091;0.2427;11270;-179
2016-12-05 23:00:00;25,14;25,16;-0,02;39312;0;0;0;0;45700;10063;0.2202;10488;-425
2016-05-13 00:00:00;23,07;20,76;2,31;39317;0;0;0;0;45737;9211;0.2014;9313;-102
2016-05-13 01:00:00;21,41;20,42;0,99;39317;0;0;0;0;45737;8352;0.1826;8561;-209
2016-05-13 02:00:00;21,04;18,88;2,16;39317;0;0;0;0;45737;7803;0.1706;7843;-40
2016-05-13 03:00:00;20,55;17,72;2,83;39317;0;0;0;0;45737;7344;0.1606;7221;123
2016-05-13 04:00:00;21,13;16,51;4,62;39317;0;0;0;0;45737;6894;0.1507;6682;212
2016-05-13 05:00:00;23,0;19,53;3,47;39317;70;0.0018;86;-16;45737;6212;0.1358;6130;82
2016-05-13 06:00:00;28,07;22,42;5,65;39317;910;0.0232;1011;-101;45737;5519;0.1207;5466;53
2016-05-13 07:00:00;36,14;35,31;0,83;39317;3030;0.0771;3365;-335;45737;4224;0.0924;4721;-497
2016-05-13 08:00:00;40,21;37,87;2,34;39317;6004;0.1527;6537;-533;45737;3106;0.0679;4299;-1193
2016-05-13 09:00:00;38,23;37,28;0,95;39317;9322;0.2371;9862;-540;45737;3132;0.0685;4428;-1296
2016-05-13 10:00:00;35,37;33,45;1,92;39317;12438;0.3163;12696;-258;45737;3973;0.0868;4792;-819
2016-05-13 11:00:00;35,45;33,33;2,12;39317;14604;0.3714;14729;-125;45737;5517;0.1206;5521;-4
2016-05-13 12:00:00;30,94;28,5;2,44;39317;15844;0.403;15868;-24;45737;7008;0.1532;6597;411
2016-05-13 13:00:00;27,99;26,39;1,6;39317;16024;0.4075;16112;-88;45737;8187;0.179;7785;402
2016-05-13 14:00:00;25,28;25,15;0,13;39317;15777;0.4013;15572;205;45737;10286;0.2249;8920;1366
2016-05-13 15:00:00;23,8;22,66;1,14;39317;14391;0.366;14076;315;45737;12474;0.2727;10015;2459
2016-05-13 16:00:00;23,53;21,43;2,1;39317;11864;0.3018;11678;186;45737;13573;0.2968;11050;2523
2016-05-13 17:00:00;24,01;22,66;1,35;39317;8477;0.2156;8469;8;45737;14119;0.3087;11854;2265
2016-05-13 18:00:00;26,37;27,17;-0,8;39317;4809;0.1223;4958;-149;45737;14160;0.3096;12108;2052
2016-05-13 19:00:00;29,0;29,97;-0,97;39317;1946;0.0495;2009;-63;45737;13260;0.29;12083;1177
2016-05-13 20:00:00;27,1;28,61;-1,51;39317;410;0.0104;382;28;45737;11993;0.2622;12091;-98
2016-05-13 21:00:00;25,03;27,0;-1,97;39317;6;0.0001;5;1;45737;11146;0.2437;12399;-1253
2016-05-13 22:00:00;26,96;27,77;-0,81;39317;0;0;0;0;45737;11236;0.2456;12769;-1533
2016-05-13 23:00:00;23,02;27,29;-4,27;39317;0;0;0;0;45737;11588;0.2534;13196;-1608
2016-05-14 00:00:00;13,76;20,74;-6,98;39318;0;0;0;0;45737;11893;0.26;12970;-1077
2016-05-14 01:00:00;13,1;18,71;-5,61;39318;0;0;0;0;45737;12289;0.2687;13351;-1062
2016-05-14 02:00:00;11,51;14,75;-3,24;39318;0;0;0;0;45737;12804;0.2799;13753;-949
2016-05-14 03:00:00;9,71;13,97;-4,26;39318;0;0;0;0;45737;13432;0.2937;14174;-742
2016-05-14 04:00:00;10,37;12,19;-1,82;39318;0;0;0;0;45737;13916;0.3042;14570;-654
2016-05-14 05:00:00;10,21;11,17;-0,96;39318;90;0.0023;111;-21;45737;14014;0.3064;14896;-882
2016-05-14 06:00:00;9,91;13,32;-3,41;39318;1144;0.0291;1281;-137;45737;14179;0.31;15171;-992
2016-05-14 07:00:00;11,24;15,6;-4,36;39318;3686;0.0937;4334;-648;45737;14277;0.3122;15539;-1262
2016-05-14 08:00:00;15,57;22,11;-6,54;39318;6797;0.1729;8377;-1580;45737;15666;0.3425;15818;-152
2016-05-14 09:00:00;14,86;18,1;-3,24;39318;9970;0.2536;12412;-2442;45737;16230;0.3549;15902;328
2016-05-14 10:00:00;11,99;15,26;-3,27;39318;12641;0.3215;15793;-3152;45737;16441;0.3595;16053;388
2016-05-14 11:00:00;11,37;17,5;-6,13;39318;14918;0.3794;18180;-3262;45737;17141;0.3748;16296;845
2016-05-14 12:00:00;10,27;17,55;-7,28;39318;15741;0.4004;19450;-3709;45737;17333;0.379;16668;665
2016-05-14 13:00:00;8,14;15,34;-7,2;39318;15765;0.401;19398;-3633;45737;17918;0.3917;17196;722
2016-05-14 14:00:00;7,01;13,45;-6,44;39318;14938;0.38;18179;-3241;45737;18643;0.4076;17923;720
2016-05-14 15:00:00;4,95;12,99;-8,04;39318;12562;0.3195;15992;-3430;45737;19022;0.4159;18819;203
2016-05-14 16:00:00;4,92;11,9;-6,98;39318;9995;0.2542;13065;-3070;45737;19456;0.4254;19454;2
2016-05-14 17:00:00;9,91;17,71;-7,8;39318;7156;0.182;9371;-2215;45737;19536;0.4271;19572;-36
2016-05-14 18:00:00;15,01;22,21;-7,2;39318;4270;0.1086;5467;-1197;45737;18697;0.4088;18937;-240
2016-05-14 19:00:00;20,71;24,31;-3,6;39318;1945;0.0495;2281;-336;45737;17697;0.3869;17938;-241
2016-05-14 20:00:00;20,46;26,31;-5,85;39318;385;0.0098;435;-50;45737;16282;0.356;16877;-595
2016-05-14 21:00:00;19,3;27,41;-8,11;39318;6;0.0001;7;-1;45737;14788;0.3233;16023;-1235
2016-05-14 22:00:00;23,6;31,7;-8,1;39318;0;0;0;0;45737;14547;0.3181;15461;-914
2016-05-14 23:00:00;20,52;28,12;-7,6;39318;0;0;0;0;45737;14907;0.3259;15406;-499
2016-05-15 00:00:00;20,0;18,75;1,25;39318;0;0;0;0;45737;14820;0.324;15763;-943
2016-05-15 01:00:00;12,98;11,24;1,74;39318;0;0;0;0;45737;15437;0.3375;16126;-689
2016-05-15 02:00:00;11,94;9,02;2,92;39318;0;0;0;0;45737;15472;0.3383;16292;-820
2016-05-15 03:00:00;9,13;5,13;4,0;39318;0;0;0;0;45737;15313;0.3348;16372;-1059
2016-05-15 04:00:00;9,19;5,18;4,01;39318;0;0;0;0;45737;15226;0.3329;16462;-1236
2016-05-15 05:00:00;9,56;5,0;4,56;39318;87;0.0022;108;-21;45737;15435;0.3375;16484;-1049
2016-05-15 06:00:00;7,1;4,77;2,33;39318;1191;0.0303;1318;-127;45737;15479;0.3384;16440;-961
2016-05-15 07:00:00;5,63;2,53;3,1;39318;3687;0.0938;4388;-701;45737;15218;0.3328;16522;-1304
2016-05-15 08:00:00;5,5;5,14;0,36;39318;6764;0.172;8375;-1611;45737;15487;0.3386;16866;-1379
2016-05-15 09:00:00;4,57;7,97;-3,4;39318;10232;0.2602;12349;-2117;45737;16738;0.3659;17197;-459
2016-05-15 10:00:00;3,5;10,95;-7,45;39318;12226;0.311;15420;-3194;45737;18018;0.3939;17367;651
2016-05-15 11:00:00;3,63;13,5;-9,87;39318;13224;0.3364;17467;-4243;45737;19134;0.4184;17711;1423
2016-05-15 12:00:00;0,73;15,48;-14,75;39318;13899;0.3535;18253;-4354;45737;19429;0.4248;18379;1050
2016-05-15 13:00:00;-9,25;13,46;-22,71;39318;14752;0.3752;17749;-2997;45737;19951;0.4362;19118;833
2016-05-15 14:00:00;-35,02;1,41;-36,43;39318;14710;0.3741;16396;-1686;45737;20029;0.4379;19294;735
2016-05-15 15:00:00;-8,24;3,62;-11,86;39318;13401;0.3408;14375;-974;45737;20349;0.4449;19530;819
2016-05-15 16:00:00;-2,97;4,37;-7,34;39318;11146;0.2835;11877;-731;45737;19710;0.4309;19630;80
2016-05-15 17:00:00;2,49;11,12;-8,63;39318;8130;0.2068;8739;-609;45737;18978;0.415;18955;23
2016-05-15 18:00:00;14,45;18,93;-4,48;39318;4902;0.1247;5273;-371;45737;18200;0.3979;17320;880
2016-05-15 19:00:00;21,41;25,64;-4,23;39318;2192;0.0557;2307;-115;45737;16077;0.3515;15542;535
2016-05-15 20:00:00;21,69;25,1;-3,41;39318;385;0.0098;429;-44;45737;14058;0.3074;14047;11
2016-05-15 21:00:00;22,95;25,33;-2,38;39318;7;0.0002;7;0;45737;13065;0.2856;13113;-48
2016-05-15 22:00:00;24,28;27,47;-3,19;39318;0;0;0;0;45737;12621;0.276;12511;110
2016-05-15 23:00:00;22,36;23,28;-0,92;39318;0;0;0;0;45737;13078;0.286;12217;861
2016-05-16 00:00:00;17,85;15,81;2,04;39318;0;0;0;0;45737;12562;0.2747;12046;516
2016-05-16 01:00:00;16,86;15,44;1,42;39318;0;0;0;0;45737;12060;0.2637;12024;36
2016-05-16 02:00:00;16,06;15,15;0,91;39318;0;0;0;0;45737;11727;0.2564;11957;-230
2016-05-16 03:00:00;15,04;16,35;-1,31;39318;0;0;0;0;45737;11276;0.2466;11719;-443
2016-05-16 04:00:00;14,06;16,71;-2,65;39318;0;0;1;-1;45737;11226;0.2454;11418;-192
2016-05-16 05:00:00;15,93;17,61;-1,68;39318;94;0.0024;121;-27;45737;11154;0.2439;11155;-1
2016-05-16 06:00:00;16,42;17,35;-0,93;39318;1082;0.0275;1212;-130;45737;10104;0.2209;10900;-796
2016-05-16 07:00:00;19,43;19,58;-0,15;39318;3220;0.0819;3801;-581;45737;9615;0.2102;10713;-1098
2016-05-16 08:00:00;22,54;22,58;-0,04;39318;5721;0.1455;6996;-1275;45737;9984;0.2183;10631;-647
2016-05-16 09:00:00;22,91;25,39;-2,48;39318;8235;0.2094;10166;-1931;45737;10930;0.239;10573;357
2016-05-16 10:00:00;23,11;24,96;-1,85;39318;10332;0.2628;12825;-2493;45737;10890;0.2381;10518;372
2016-05-16 11:00:00;23,35;25,35;-2,0;39318;12057;0.3066;14706;-2649;45737;10598;0.2317;10584;14
2016-05-16 12:00:00;22,9;25,67;-2,77;39318;13066;0.3323;15624;-2558;45737;10998;0.2405;10830;168
2016-05-16 13:00:00;18,23;23,27;-5,04;39318;13260;0.3373;15643;-2383;45737;11119;0.2431;11191;-72
2016-05-16 14:00:00;16,09;20,81;-4,72;39318;12949;0.3293;15025;-2076;45737;11952;0.2613;11767;185
2016-05-16 15:00:00;16,26;21,09;-4,83;39318;11918;0.3031;13617;-1699;45737;12460;0.2724;12490;-30
2016-05-16 16:00:00;17,15;20,08;-2,93;39318;9698;0.2466;11313;-1615;45737;12927;0.2826;13061;-134
2016-05-16 17:00:00;18,27;21,0;-2,73;39318;7124;0.1812;8289;-1165;45737;13032;0.285;13124;-92
2016-05-16 18:00:00;24,0;27,8;-3,8;39318;4420;0.1124;5037;-617;45737;12983;0.2838;12527;456
2016-05-16 19:00:00;27,16;27,64;-0,48;39318;2063;0.0525;2192;-129;45737;11876;0.2596;11684;192
2016-05-16 20:00:00;28,37;26,8;1,57;39318;415;0.0106;439;-24;45737;10498;0.2295;10579;-81
2016-05-16 21:00:00;31,93;27,36;4,57;39318;6;0.0001;9;-3;45737;9537;0.2085;10060;-523
2016-05-16 22:00:00;29,99;27,03;2,96;39318;0;0;0;0;45737;9300;0.2033;9945;-645
2016-05-16 23:00:00;24,99;22,45;2,54;39318;0;0;0;0;45737;9952;0.2176;10052;-100
2016-05-17 00:00:00;30,0;24,39;5,61;39320;0;0;0;0;45752;9973;0.218;9385;588
2016-05-17 01:00:00;24,0;18,47;5,53;39320;0;0;0;0;45752;10170;0.2223;9641;529
2016-05-17 02:00:00;22,82;17,82;5,0;39320;0;0;0;0;45752;10425;0.2278;9900;525
2016-05-17 03:00:00;21,6;18,02;3,58;39320;0;0;0;0;45752;10266;0.2244;10126;140
2016-05-17 04:00:00;21,73;17,28;4,45;39320;0;0;1;-1;45752;10485;0.2292;10318;167
2016-05-17 05:00:00;22,91;17,32;5,59;39320;90;0.0023;117;-27;45752;10313;0.2254;10458;-145
2016-05-17 06:00:00;29,95;24,71;5,24;39320;1103;0.028;1359;-256;45752;9693;0.2119;10435;-742
2016-05-17 07:00:00;36,36;34,55;1,81;39320;3119;0.0793;4158;-1039;45752;9349;0.2044;10527;-1178
2016-05-17 08:00:00;38,0;39,32;-1,32;39320;5598;0.1424;7533;-1935;45752;9732;0.2127;10929;-1197
2016-05-17 09:00:00;30,93;39,58;-8,65;39320;8505;0.2163;10763;-2258;45752;10808;0.2362;11605;-797
2016-05-17 10:00:00;28,99;36,9;-7,91;39320;11106;0.2824;12790;-1684;45752;10833;0.2368;12161;-1328
2016-05-17 11:00:00;32,22;35,93;-3,71;39320;12340;0.3138;13785;-1445;45752;10447;0.2283;12536;-2089
2016-05-17 12:00:00;31,61;34,13;-2,52;39320;12769;0.3248;14235;-1466;45752;10377;0.2268;12691;-2314
2016-05-17 13:00:00;30,08;34,62;-4,54;39320;12281;0.3123;14365;-2084;45752;10494;0.2294;12660;-2166
2016-05-17 14:00:00;29,93;34,49;-4,56;39320;11563;0.2941;13829;-2266;45752;10256;0.2242;12400;-2144
2016-05-17 15:00:00;30,0;34,46;-4,46;39320;10681;0.2716;12496;-1815;45752;9769;0.2135;12140;-2371
2016-05-17 16:00:00;30,02;33,33;-3,31;39320;9202;0.234;10498;-1296;45752;9015;0.1971;11602;-2587
2016-05-17 17:00:00;30,14;35,68;-5,54;39320;7183;0.1826;7905;-722;45752;7706;0.1685;10450;-2744
2016-05-17 18:00:00;34,64;36,73;-2,09;39320;4821;0.1226;4937;-116;45752;6461;0.1412;8712;-2251
2016-05-17 19:00:00;34,92;36,55;-1,63;39320;2307;0.0587;2222;85;45752;4870;0.1064;6910;-2040
2016-05-17 20:00:00;36,76;36,17;0,59;39320;481;0.0122;435;46;45752;3622;0.0792;5584;-1962
2016-05-17 21:00:00;37,44;36,39;1,05;39320;7;0.0002;8;-1;45752;3209;0.0701;4982;-1773
2016-05-17 22:00:00;33,22;35,86;-2,64;39320;0;0;0;0;45752;3418;0.0747;4691;-1273
2016-05-17 23:00:00;29,0;30,64;-1,64;39320;0;0;0;0;45752;3794;0.0829;4692;-898
2016-05-18 00:00:00;24,91;22,69;2,22;39323;0;0;0;0;45773;4002;0.0874;3862;140
2016-05-18 01:00:00;24,29;21,49;2,8;39323;0;0;0;0;45773;4036;0.0882;4216;-180
2016-05-18 02:00:00;23,89;21,59;2,3;39323;0;0;0;0;45773;4084;0.0892;4545;-461
2016-05-18 03:00:00;22,92;23,3;-0,38;39323;0;0;0;0;45773;4282;0.0936;4837;-555
2016-05-18 04:00:00;23,31;22,35;0,96;39323;0;0;1;-1;45773;4679;0.1023;5082;-403
2016-05-18 05:00:00;24,57;22,71;1,86;39323;116;0.003;140;-24;45773;4896;0.1069;5186;-290
2016-05-18 06:00:00;31,12;27,96;3,16;39323;1196;0.0304;1215;-19;45773;4823;0.1054;5070;-247
2016-05-18 07:00:00;37,06;35,93;1,13;39323;3878;0.0986;4261;-383;45773;4204;0.0919;4752;-548
2016-05-18 08:00:00;39,48;38,83;0,65;39323;7684;0.1954;8868;-1184;45773;3062;0.0669;4220;-1158
2016-05-18 09:00:00;35,31;36,03;-0,72;39323;12316;0.3132;13878;-1562;45773;3056;0.0668;4046;-990
2016-05-18 10:00:00;32,58;29,85;2,73;39323;16294;0.4144;17421;-1127;45773;3682;0.0804;4333;-651
2016-05-18 11:00:00;30,98;28,91;2,07;39323;18574;0.4724;18818;-244;45773;3867;0.0845;4721;-854
2016-05-18 12:00:00;31,12;28,86;2,26;39323;18796;0.478;19034;-238;45773;4276;0.0934;4913;-637
2016-05-18 13:00:00;30,9;26,67;4,23;39323;17342;0.441;18467;-1125;45773;4230;0.0924;4954;-724
2016-05-18 14:00:00;30,87;26,88;3,99;39323;15485;0.3938;17102;-1617;45773;3738;0.0816;4727;-989
2016-05-18 15:00:00;30,85;28,72;2,13;39323;13396;0.3407;14953;-1557;45773;3441;0.0752;4172;-731
2016-05-18 16:00:00;31,32;31,51;-0,19;39323;11048;0.281;12251;-1203;45773;2918;0.0638;3409;-491
2016-05-18 17:00:00;31,69;31,56;0,13;39323;8255;0.21;8864;-609;45773;2364;0.0516;2641;-277
2016-05-18 18:00:00;33,08;34,67;-1,59;39323;4885;0.1242;5291;-406;45773;1925;0.0421;2201;-276
2016-05-18 19:00:00;34,94;37,49;-2,55;39323;2064;0.0525;2326;-262;45773;1971;0.0431;1966;5
2016-05-18 20:00:00;34,64;36,79;-2,15;39323;372;0.0094;463;-91;45773;2334;0.051;2243;91
2016-05-18 21:00:00;34,95;38,03;-3,08;39323;6;0.0001;9;-3;45773;3034;0.0662;3235;-201
2016-05-18 22:00:00;33,09;36,12;-3,03;39323;0;0;0;0;45773;3820;0.0835;4389;-569
2016-05-18 23:00:00;27,2;28,61;-1,41;39323;0;0;0;0;45773;4464;0.0975;5112;-648
2016-05-19 00:00:00;24,88;25,86;-0,98;39326;0;0;0;0;45787;4852;0.106;5544;-692
2016-05-19 01:00:00;22,91;26,02;-3,11;39326;0;0;0;0;45787;4947;0.108;5533;-586
2016-05-19 02:00:00;22,23;25,67;-3,44;39326;0;0;0;0;45787;4709;0.1028;5203;-494
2016-05-19 03:00:00;21,85;23,34;-1,49;39326;0;0;0;0;45787;4196;0.0916;4600;-404
2016-05-19 04:00:00;22,29;22,57;-0,28;39326;0;0;0;0;45787;3658;0.0799;4013;-355
2016-05-19 05:00:00;23,9;26,13;-2,23;39326;112;0.0029;124;-12;45787;3134;0.0684;3376;-242
2016-05-19 06:00:00;31,58;26,83;4,75;39326;1031;0.0262;1080;-49;45787;2514;0.0549;2729;-215
2016-05-19 07:00:00;39,4;40,0;-0,6;39326;2997;0.0762;3100;-103;45787;1914;0.0418;2082;-168
2016-05-19 08:00:00;46,0;51,32;-5,32;39326;5394;0.1372;5535;-141;45787;1394;0.0304;1533;-139
2016-05-19 09:00:00;44,13;43,19;0,94;39326;8205;0.2086;8113;92;45787;1071;0.0234;1216;-145
2016-05-19 10:00:00;45,0;40,81;4,19;39326;10769;0.2738;10330;439;45787;1000;0.0218;1052;-52
2016-05-19 11:00:00;44,91;38,28;6,63;39326;12775;0.3249;12008;767;45787;1008;0.022;966;42
2016-05-19 12:00:00;40,07;34,4;5,67;39326;13764;0.35;13020;744;45787;971;0.0212;952;19
2016-05-19 13:00:00;38,96;34,49;4,47;39326;13687;0.3481;13178;509;45787;926;0.0202;923;3
2016-05-19 14:00:00;35,0;32,8;2,2;39326;13126;0.3338;12684;442;45787;974;0.0213;906;68
2016-05-19 15:00:00;33,06;31,0;2,06;39326;11959;0.3041;11563;396;45787;988;0.0216;983;5
2016-05-19 16:00:00;31,91;29,79;2,12;39326;10176;0.2588;9764;412;45787;1159;0.0253;1112;47
2016-05-19 17:00:00;32,35;29,24;3,11;39326;7927;0.2016;7367;560;45787;1374;0.03;1246;128
2016-05-19 18:00:00;34,0;30,8;3,2;39326;5018;0.1276;4656;362;45787;1704;0.0372;1334;370
2016-05-19 19:00:00;36,08;31,49;4,59;39326;2319;0.059;2171;148;45787;1932;0.0422;1448;484
2016-05-19 20:00:00;34,96;31,55;3,41;39326;526;0.0134;480;46;45787;2229;0.0486;1685;544
2016-05-19 21:00:00;33,85;31,6;2,25;39326;10;0.0003;10;0;45787;3051;0.0666;2325;726
2016-05-19 22:00:00;32,08;29,24;2,84;39326;0;0;0;0;45787;3982;0.087;3101;881
2016-05-19 23:00:00;29,14;27,67;1,47;39326;0;0;0;0;45787;4757;0.1039;3829;928
2016-05-20 00:00:00;24,73;22,86;1,87;39333;0;0;0;0;45813;5240;0.1144;4304;936
2016-05-20 01:00:00;23,42;21,06;2,36;39333;0;0;0;0;45813;6193;0.1352;4801;1392
2016-05-20 02:00:00;21,5;20,02;1,48;39333;0;0;0;0;45813;7204;0.1572;5385;1819
2016-05-20 03:00:00;21,34;18,57;2,77;39333;0;0;0;0;45813;8125;0.1774;5951;2174
2016-05-20 04:00:00;21,52;18,93;2,59;39333;0;0;1;-1;45813;9031;0.1971;6448;2583
2016-05-20 05:00:00;23,23;21,43;1,8;39333;147;0.0038;163;-16;45813;9261;0.2022;6628;2633
2016-05-20 06:00:00;27,71;24,52;3,19;39333;1425;0.0362;1558;-133;45813;9438;0.206;6630;2808
2016-05-20 07:00:00;33,07;28,97;4,1;39333;4344;0.1105;4753;-409;45813;8481;0.1851;6539;1942
2016-05-20 08:00:00;34,97;32,84;2,13;39333;8338;0.212;8900;-562;45813;7958;0.1737;6672;1286
2016-05-20 09:00:00;31,91;26,49;5,42;39333;12398;0.3152;12884;-486;45813;8678;0.1894;7283;1395
2016-05-20 10:00:00;27,5;23,47;4,03;39333;15528;0.3948;15586;-58;45813;9630;0.2102;7994;1636
2016-05-20 11:00:00;26,27;22,24;4,03;39333;16424;0.4176;16870;-446;45813;10126;0.221;8622;1504
2016-05-20 12:00:00;24,99;24,79;0,2;39333;16219;0.4124;17135;-916;45813;10243;0.2236;9038;1205
2016-05-20 13:00:00;24,3;25,1;-0,8;39333;15343;0.3901;16516;-1173;45813;10406;0.2271;9301;1105
2016-05-20 14:00:00;24,22;25,2;-0,98;39333;14412;0.3664;15076;-664;45813;9778;0.2134;9225;553
2016-05-20 15:00:00;24,2;24,68;-0,48;39333;13129;0.3338;12998;131;45813;9422;0.2056;8853;569
2016-05-20 16:00:00;24,57;25,38;-0,81;39333;11042;0.2808;10640;402;45813;8522;0.186;8152;370
2016-05-20 17:00:00;28,9;27,55;1,35;39333;8158;0.2074;7859;299;45813;7527;0.1643;7132;395
2016-05-20 18:00:00;32,69;30,64;2,05;39333;4902;0.1246;4825;77;45813;6652;0.1452;6009;643
2016-05-20 19:00:00;33,92;31,48;2,44;39333;2156;0.0548;2213;-57;45813;5708;0.1246;4862;846
2016-05-20 20:00:00;34,06;31,95;2,11;39333;424;0.0108;473;-49;45813;4519;0.0986;3982;537
2016-05-20 21:00:00;33,21;32,39;0,82;39333;8;0.0002;10;-2;45813;3711;0.081;3626;85
2016-05-20 22:00:00;33,66;31,87;1,79;39333;0;0;0;0;45813;3768;0.0823;3475;293
2016-05-20 23:00:00;27,98;26,45;1,53;39333;0;0;0;0;45813;3778;0.0824;3414;364
2016-05-21 00:00:00;24,36;23,82;0,54;39334;0;0;0;0;45813;3620;0.079;3692;-72
2016-05-21 01:00:00;23,49;23,25;0,24;39334;0;0;0;0;45813;3614;0.0789;3656;-42
2016-05-21 02:00:00;22,6;24,74;-2,14;39334;0;0;0;0;45813;3625;0.0792;3663;-38
2016-05-21 03:00:00;21,75;22,41;-0,66;39334;0;0;0;0;45813;3887;0.0848;3723;164
2016-05-21 04:00:00;21,26;21,59;-0,33;39334;0;0;1;-1;45813;4183;0.0913;3799;384
2016-05-21 05:00:00;20,5;21,06;-0,56;39334;159;0.004;148;11;45813;4459;0.0973;3776;683
2016-05-21 06:00:00;20,66;20,79;-0,13;39334;1636;0.0416;1502;134;45813;4800;0.1048;3679;1121
2016-05-21 07:00:00;22,88;24,35;-1,47;39334;4710;0.1198;4636;74;45813;4496;0.0982;3529;967
2016-05-21 08:00:00;23,06;24,3;-1,24;39334;9204;0.234;9052;152;45813;3912;0.0854;3494;418
2016-05-21 09:00:00;22,55;26,0;-3,45;39334;13978;0.3554;13881;97;45813;4192;0.0915;3731;461
2016-05-21 10:00:00;20,32;23,28;-2,96;39334;18154;0.4615;17825;329;45813;4998;0.1091;4099;899
2016-05-21 11:00:00;18,95;21,03;-2,08;39334;20429;0.5194;20431;-2;45813;6044;0.1319;4460;1584
2016-05-21 12:00:00;16,19;19,39;-3,2;39334;21354;0.5429;21644;-290;45813;6184;0.135;4742;1442
2016-05-21 13:00:00;15,24;19,24;-4,0;39334;21482;0.5461;21576;-94;45813;6525;0.1424;4898;1627
2016-05-21 14:00:00;15,09;16,92;-1,83;39334;20300;0.5161;20432;-132;45813;6950;0.1517;4879;2071
2016-05-21 15:00:00;13,29;12,44;0,85;39334;18326;0.4659;18261;65;45813;6924;0.1512;4752;2172
2016-05-21 16:00:00;17,42;8,9;8,52;39334;15410;0.3918;15248;162;45813;6450;0.1408;4473;1977
2016-05-21 17:00:00;19,06;12,68;6,38;39334;11234;0.2856;11172;62;45813;5884;0.1284;4046;1838
2016-05-21 18:00:00;23,9;25,11;-1,21;39334;6702;0.1704;6518;184;45813;4959;0.1082;3511;1448
2016-05-21 19:00:00;26,28;30,0;-3,72;39334;2996;0.0762;2718;278;45813;3814;0.0832;3060;754
2016-05-21 20:00:00;30,94;29,94;1,0;39334;752;0.0191;655;97;45813;3522;0.0769;3077;445
2016-05-21 21:00:00;31,49;34,78;-3,29;39334;13;0.0004;17;-4;45813;4810;0.105;4151;659
2016-05-21 22:00:00;28,94;37,48;-8,54;39334;0;0;0;0;45813;6402;0.1398;5793;609
2016-05-21 23:00:00;23,42;30,31;-6,89;39334;0;0;0;0;45813;7851;0.1714;7434;417
2016-05-22 00:00:00;17,79;19,84;-2,05;39334;0;0;0;0;45813;8897;0.1942;10033;-1136
2016-05-22 01:00:00;10,38;9,27;1,11;39334;0;0;0;0;45813;9749;0.2128;11186;-1437
2016-05-22 02:00:00;7,62;5,99;1,63;39334;0;0;0;0;45813;9805;0.214;11905;-2100
2016-05-22 03:00:00;4,6;8,5;-3,9;39334;0;0;0;0;45813;9651;0.2106;12376;-2725
2016-05-22 04:00:00;2,81;9,26;-6,45;39334;0;0;1;-1;45813;10078;0.22;12784;-2706
2016-05-22 05:00:00;0,13;7,93;-7,8;39334;216;0.0055;213;3;45813;10734;0.2343;12958;-2224
2016-05-22 06:00:00;-1,0;7,49;-8,49;39334;1791;0.0455;1776;15;45813;11087;0.242;12723;-1636
2016-05-22 07:00:00;0,5;6,39;-5,89;39334;5370;0.1365;5616;-246;45813;9515;0.2077;11915;-2400
2016-05-22 08:00:00;2,59;8,55;-5,96;39334;10534;0.2678;11002;-468;45813;6964;0.152;10784;-3820
2016-05-22 09:00:00;-0,94;10,58;-11,52;39334;15565;0.3957;16289;-724;45813;6338;0.1383;10301;-3963
2016-05-22 10:00:00;-1,11;12,76;-13,87;39334;19134;0.4865;20437;-1303;45813;7912;0.1727;10405;-2493
2016-05-22 11:00:00;-0,9;10,76;-11,66;39334;21636;0.55;22988;-1352;45813;10179;0.2222;10681;-502
2016-05-22 12:00:00;-5,68;5,23;-10,91;39334;22562;0.5736;24142;-1580;45813;12024;0.2624;11047;977
2016-05-22 13:00:00;-25,72;-2,96;-22,76;39334;22248;0.5656;23872;-1624;45813;12103;0.2642;11219;884
2016-05-22 14:00:00;-10,97;2,91;-13,88;39334;20436;0.5196;22291;-1855;45813;11204;0.2446;10891;313
2016-05-22 15:00:00;-7,82;4,38;-12,2;39334;17308;0.44;19437;-2129;45813;10000;0.2183;10033;-33
2016-05-22 16:00:00;-5,19;7,75;-12,94;39334;13070;0.3322;15452;-2382;45813;9065;0.1979;8988;77
2016-05-22 17:00:00;2,02;16,68;-14,66;39334;8608;0.2188;10653;-2045;45813;8107;0.1769;7935;172
2016-05-22 18:00:00;21,33;27,2;-5,87;39334;4558;0.1159;5765;-1207;45813;7534;0.1645;6994;540
2016-05-22 19:00:00;23,65;29,08;-5,43;39334;1956;0.0497;2333;-377;45813;7395;0.1614;6456;939
2016-05-22 20:00:00;25,32;25,99;-0,67;39334;443;0.0113;559;-116;45813;7515;0.164;6478;1037
2016-05-22 21:00:00;26,11;24,38;1,73;39334;9;0.0002;13;-4;45813;7804;0.1703;6851;953
2016-05-22 22:00:00;27,22;26,57;0,65;39334;0;0;0;0;45813;8493;0.1854;7130;1363
2016-05-22 23:00:00;22,9;24,83;-1,93;39334;0;0;0;0;45813;8887;0.194;6966;1921
2016-05-23 00:00:00;22,61;23,22;-0,61;39337;0;0;0;0;45834;8370;0.1826;7506;864
2016-05-23 01:00:00;20,89;20,73;0,16;39337;0;0;0;0;45834;7004;0.1528;7196;-192
2016-05-23 02:00:00;19,51;21,3;-1,79;39337;0;0;0;0;45834;5146;0.1123;6980;-1834
2016-05-23 03:00:00;18,91;21,92;-3,01;39337;0;0;0;0;45834;4639;0.1012;6829;-2190
2016-05-23 04:00:00;19,46;22,44;-2,98;39337;0;0;1;-1;45834;4228;0.0922;6761;-2533
2016-05-23 05:00:00;20,69;24,61;-3,92;39337;155;0.004;165;-10;45834;4338;0.0946;6626;-2288
2016-05-23 06:00:00;28,05;35,32;-7,27;39337;1137;0.0289;1215;-78;45834;4486;0.0979;6202;-1716
2016-05-23 07:00:00;34,51;40,97;-6,46;39337;2937;0.0747;3312;-375;45834;4388;0.0957;5735;-1347
2016-05-23 08:00:00;35,93;40,26;-4,33;39337;4932;0.1254;5636;-704;45834;4248;0.0927;5407;-1159
2016-05-23 09:00:00;33,99;39,06;-5,07;39337;7004;0.178;7750;-746;45834;4473;0.0976;5307;-834
2016-05-23 10:00:00;36,0;38,89;-2,89;39337;8343;0.2121;9242;-899;45834;4442;0.0969;5362;-920
2016-05-23 11:00:00;35,94;39,36;-3,42;39337;9303;0.2365;10147;-844;45834;4337;0.0946;5578;-1241
2016-05-23 12:00:00;33,91;38,35;-4,44;39337;9447;0.2401;10434;-987;45834;4434;0.0968;5920;-1486
2016-05-23 13:00:00;33,54;37,83;-4,29;39337;9456;0.2404;9924;-468;45834;5104;0.1114;6324;-1220
2016-05-23 14:00:00;32,5;37,74;-5,24;39337;8831;0.2245;8932;-101;45834;5711;0.1246;6662;-951
2016-05-23 15:00:00;32,78;35,39;-2,61;39337;7577;0.1926;7530;47;45834;6389;0.1394;7134;-745
2016-05-23 16:00:00;31,96;33,07;-1,11;39337;6236;0.1585;5931;305;45834;7144;0.1559;7706;-562
2016-05-23 17:00:00;31,68;32,38;-0,7;39337;4526;0.1151;4264;262;45834;8077;0.1762;8294;-217
2016-05-23 18:00:00;32,49;31,07;1,42;39337;2628;0.0668;2639;-11;45834;9172;0.2001;8865;307
2016-05-23 19:00:00;33,09;31,56;1,53;39337;1128;0.0287;1243;-115;45834;10316;0.225;9541;775
2016-05-23 20:00:00;33,97;30,02;3,95;39337;239;0.0061;300;-61;45834;12008;0.262;10385;1623
2016-05-23 21:00:00;31,97;28,57;3,4;39337;7;0.0002;10;-3;45834;13753;0.3001;10978;2775
2016-05-23 22:00:00;24,47;24,18;0,29;39337;0;0;0;0;45834;14202;0.3099;11399;2803
2016-05-23 23:00:00;22,71;20,5;2,21;39337;0;0;0;0;45834;13496;0.2945;11703;1793
2016-05-24 00:00:00;21,99;20,26;1,73;39351;0;0;0;0;45845;12737;0.2778;10315;2422
2016-05-24 01:00:00;21,75;19,06;2,69;39351;0;0;0;0;45845;11829;0.258;10203;1626
2016-05-24 02:00:00;20,48;18,51;1,97;39351;0;0;0;0;45845;12419;0.2709;9977;2442
2016-05-24 03:00:00;20,0;19,82;0,18;39351;0;0;0;0;45845;11799;0.2574;9879;1920
2016-05-24 04:00:00;20,72;19,11;1,61;39351;0;0;1;-1;45845;11425;0.2492;9962;1463
2016-05-24 05:00:00;22,61;21,46;1,15;39351;100;0.0025;118;-18;45845;11420;0.2491;9880;1540
2016-05-24 06:00:00;26,13;24,47;1,66;39351;612;0.0156;715;-103;45845;11140;0.243;9570;1570
2016-05-24 07:00:00;34,38;30,89;3,49;39351;1528;0.0388;1862;-334;45845;10298;0.2246;9145;1153
2016-05-24 08:00:00;37,09;35,2;1,89;39351;2591;0.0658;3238;-647;45845;9751;0.2127;8731;1020
2016-05-24 09:00:00;36,19;33,47;2,72;39351;3741;0.0951;4654;-913;45845;9360;0.2042;8243;1117
2016-05-24 10:00:00;36,94;32,59;4,35;39351;4984;0.1266;6003;-1019;45845;9090;0.1983;7767;1323
2016-05-24 11:00:00;36,06;33,48;2,58;39351;5936;0.1508;7102;-1166;45845;8690;0.1896;7272;1418
2016-05-24 12:00:00;33,09;33,03;0,06;39351;6573;0.167;7827;-1254;45845;8044;0.1755;6730;1314
2016-05-24 13:00:00;33,0;32,93;0,07;39351;6953;0.1767;7875;-922;45845;7432;0.1621;6212;1220
2016-05-24 14:00:00;32,69;31,71;0,98;39351;6882;0.1749;7508;-626;45845;6802;0.1484;5811;991
2016-05-24 15:00:00;30,92;30,77;0,15;39351;6200;0.1576;6773;-573;45845;6669;0.1454;5563;1106
2016-05-24 16:00:00;29,12;31,24;-2,12;39351;4950;0.1258;5607;-657;45845;6370;0.1389;5479;891
2016-05-24 17:00:00;29,8;33,4;-3,6;39351;3448;0.0876;4223;-775;45845;5879;0.1282;5431;448
2016-05-24 18:00:00;31,25;32,03;-0,78;39351;2055;0.0522;2761;-706;45845;5485;0.1196;5352;133
2016-05-24 19:00:00;32,2;31,76;0,44;39351;910;0.0231;1384;-474;45845;5116;0.1116;5158;-42
2016-05-24 20:00:00;31,64;31,8;-0,16;39351;201;0.0051;339;-138;45845;4911;0.1071;4847;64
2016-05-24 21:00:00;32,38;30,93;1,45;39351;8;0.0002;12;-4;45845;4473;0.0976;4588;-115
2016-05-24 22:00:00;30,43;28,7;1,73;39351;0;0;0;0;45845;4099;0.0894;4330;-231
2016-05-24 23:00:00;24,98;22,51;2,47;39351;0;0;0;0;45845;3465;0.0756;4058;-593
2016-05-25 00:00:00;22,97;23,85;-0,88;39366;0;0;0;0;45870;3077;0.0671;3884;-807
2016-05-25 01:00:00;22,57;22,87;-0,3;39366;0;0;0;0;45870;2694;0.0588;3582;-888
2016-05-25 02:00:00;21,57;22,91;-1,34;39366;0;0;0;0;45870;2427;0.0529;3329;-902
2016-05-25 03:00:00;21,0;19,66;1,34;39366;0;0;0;0;45870;2270;0.0495;3139;-869
2016-05-25 04:00:00;21,63;22,95;-1,32;39366;0;0;1;-1;45870;2170;0.0473;2941;-771
2016-05-25 05:00:00;22,99;23,82;-0,83;39366;117;0.003;150;-33;45870;1960;0.0427;2712;-752
2016-05-25 06:00:00;30,92;31,79;-0,87;39366;963;0.0244;1266;-303;45870;1772;0.0386;2482;-710
2016-05-25 07:00:00;35,8;34,55;1,25;39366;2538;0.0645;3699;-1161;45870;1628;0.0355;2256;-628
2016-05-25 08:00:00;39,2;37,58;1,62;39366;4081;0.1037;6772;-2691;45870;1401;0.0306;1992;-591
2016-05-25 09:00:00;34,99;37,91;-2,92;39366;5905;0.15;9998;-4093;45870;1244;0.0271;1733;-489
2016-05-25 10:00:00;34,16;38,95;-4,79;39366;7827;0.1988;12678;-4851;45870;1056;0.023;1513;-457
2016-05-25 11:00:00;33,07;38,88;-5,81;39366;9550;0.2426;14574;-5024;45870;881;0.0192;1318;-437
2016-05-25 12:00:00;31,02;36,43;-5,41;39366;10850;0.2756;15651;-4801;45870;801;0.0175;1182;-381
2016-05-25 13:00:00;28,95;33,64;-4,69;39366;11762;0.2988;15944;-4182;45870;764;0.0167;1089;-325
2016-05-25 14:00:00;30,13;32,66;-2,53;39366;11894;0.3021;15461;-3567;45870;670;0.0146;1038;-368
2016-05-25 15:00:00;30,12;32,42;-2,3;39366;11460;0.2911;14162;-2702;45870;608;0.0133;1057;-449
2016-05-25 16:00:00;30,9;31,98;-1,08;39366;9634;0.2447;12031;-2397;45870;596;0.013;1058;-462
2016-05-25 17:00:00;32,92;34,18;-1,26;39366;6965;0.177;9076;-2111;45870;625;0.0136;1031;-406
2016-05-25 18:00:00;35,8;35,15;0,65;39366;4409;0.112;5602;-1193;45870;682;0.0149;1037;-355
2016-05-25 19:00:00;36,61;31,84;4,77;39366;2134;0.0542;2566;-432;45870;652;0.0142;1076;-424
2016-05-25 20:00:00;36,76;31,79;4,97;39366;554;0.014;628;-74;45870;561;0.0122;1167;-606
2016-05-25 21:00:00;35,49;32,82;2,67;39366;18;0.0004;18;0;45870;638;0.0139;1346;-708
2016-05-25 22:00:00;34,92;33,23;1,69;39366;0;0;0;0;45870;832;0.0181;1568;-736
2016-05-25 23:00:00;28,06;29,88;-1,82;39366;0;0;0;0;45870;938;0.0204;1681;-743
2016-05-26 00:00:00;25,74;26,53;-0,79;39366;0;0;0;0;45939;956;0.0208;1264;-308
2016-05-26 01:00:00;24,16;24,33;-0,17;39366;0;0;0;0;45939;936;0.0204;1250;-314
2016-05-26 02:00:00;23,42;22,86;0,56;39366;0;0;0;0;45939;894;0.0195;1225;-331
2016-05-26 03:00:00;23,27;23,42;-0,15;39366;0;0;0;0;45939;800;0.0174;1226;-426
2016-05-26 04:00:00;23,33;20,76;2,57;39366;0;0;1;-1;45939;693;0.0151;1228;-535
2016-05-26 05:00:00;23,79;22,04;1,75;39366;149;0.0038;145;4;45939;771;0.0168;1158;-387
2016-05-26 06:00:00;26,15;26,35;-0,2;39366;1312;0.0333;1313;-1;45939;706;0.0154;997;-291
2016-05-26 07:00:00;30,96;32,6;-1,64;39366;3922;0.0996;4184;-262;45939;533;0.0116;786;-253
2016-05-26 08:00:00;30,97;29,49;1,48;39366;7952;0.202;8339;-387;45939;420;0.0092;677;-257
2016-05-26 09:00:00;27,94;24,97;2,97;39366;12727;0.3233;12704;23;45939;421;0.0091;646;-225
2016-05-26 10:00:00;25,57;22,74;2,83;39366;16612;0.422;16275;337;45939;452;0.0098;631;-179
2016-05-26 11:00:00;24,79;21,26;3,53;39366;18514;0.4703;18586;-72;45939;476;0.0104;651;-175
2016-05-26 12:00:00;25,46;22,61;2,85;39366;19143;0.4863;19673;-530;45939;580;0.0127;709;-129
2016-05-26 13:00:00;24,71;22,66;2,05;39366;18831;0.4783;19587;-756;45939;674;0.0146;804;-130
2016-05-26 14:00:00;24,69;24,64;0,05;39366;18224;0.4629;18439;-215;45939;684;0.0149;926;-242
2016-05-26 15:00:00;25,16;23,59;1,57;39366;16804;0.4268;16370;434;45939;617;0.0134;1091;-474
2016-05-26 16:00:00;25,76;22,76;3,0;39366;14283;0.3628;13492;791;45939;600;0.0131;1209;-609
2016-05-26 17:00:00;28,07;26,33;1,74;39366;10622;0.2698;9888;734;45939;565;0.0123;1253;-688
2016-05-26 18:00:00;34,0;32,48;1,52;39366;6397;0.1625;5941;456;45939;612;0.0134;1219;-607
2016-05-26 19:00:00;35,27;35,95;-0,68;39366;2848;0.0724;2664;184;45939;710;0.0154;1186;-476
2016-05-26 20:00:00;34,95;37,61;-2,66;39366;731;0.0186;680;51;45939;940;0.0204;1245;-305
2016-05-26 21:00:00;32,94;35,26;-2,32;39366;27;0.0007;26;1;45939;1307;0.0284;1450;-143
2016-05-26 22:00:00;33,1;30,29;2,81;39366;0;0;0;0;45939;1750;0.0381;1663;87
2016-05-26 23:00:00;26,94;25,48;1,46;39366;0;0;0;0;45939;2147;0.0468;1740;407
2016-05-27 00:00:00;24,43;23,52;0,91;39368;0;0;0;0;45954;2232;0.0486;1809;423
2016-05-27 01:00:00;23,42;23,03;0,39;39368;0;0;0;0;45954;2116;0.046;1815;301
2016-05-27 02:00:00;21,95;23,01;-1,06;39368;0;0;0;0;45954;1899;0.0413;1802;97
2016-05-27 03:00:00;20,61;23,6;-2,99;39368;0;0;0;0;45954;1884;0.041;1794;90
2016-05-27 04:00:00;21,69;22,46;-0,77;39368;0;0;1;-1;45954;1741;0.0378;1803;-62
2016-05-27 05:00:00;23,45;24,79;-1,34;39368;184;0.0047;179;5;45954;1632;0.0355;1775;-143
2016-05-27 06:00:00;27,88;32,35;-4,47;39368;1384;0.0352;1396;-12;45954;1442;0.0314;1670;-228
2016-05-27 07:00:00;32,99;33,96;-0,97;39368;3523;0.0895;3773;-250;45954;1261;0.0274;1493;-232
2016-05-27 08:00:00;35,48;35,04;0,44;39368;5980;0.1519;6565;-585;45954;1094;0.0238;1249;-155
2016-05-27 09:00:00;34,26;35,75;-1,49;39368;8822;0.2241;9625;-803;45954;843;0.0184;1010;-167
2016-05-27 10:00:00;32,95;34,65;-1,7;39368;12160;0.3089;12498;-338;45954;642;0.014;834;-192
2016-05-27 11:00:00;32,91;33,09;-0,18;39368;15428;0.3919;14763;665;45954;494;0.0108;723;-229
2016-05-27 12:00:00;30,37;29,17;1,2;39368;17498;0.4445;16108;1390;45954;471;0.0103;698;-227
2016-05-27 13:00:00;27,2;24,95;2,25;39368;17994;0.4571;16173;1821;45954;526;0.0114;701;-175
2016-05-27 14:00:00;26,64;24,09;2,55;39368;16799;0.4267;15280;1519;45954;645;0.014;742;-97
2016-05-27 15:00:00;26,86;24,44;2,42;39368;14445;0.367;13710;735;45954;814;0.0177;860;-46
2016-05-27 16:00:00;27,68;24,26;3,42;39368;11724;0.2978;11418;306;45954;1096;0.0238;1021;75
2016-05-27 17:00:00;30,96;25,96;5,0;39368;8659;0.22;8508;151;45954;1508;0.0328;1269;239
2016-05-27 18:00:00;32,91;27,9;5,01;39368;5476;0.1392;5278;198;45954;1727;0.0376;1635;92
2016-05-27 19:00:00;33,2;29,33;3,87;39368;2664;0.0676;2476;188;45954;1767;0.0384;2017;-250
2016-05-27 20:00:00;32,19;29,15;3,04;39368;632;0.0161;617;15;45954;1942;0.0422;2319;-377
2016-05-27 21:00:00;31,85;29,4;2,45;39368;25;0.0006;25;0;45954;2404;0.0523;2758;-354
2016-05-27 22:00:00;30,23;31,01;-0,78;39368;0;0;0;0;45954;2714;0.059;3198;-484
2016-05-27 23:00:00;25,99;30,08;-4,09;39368;0;0;0;0;45954;2842;0.0618;3421;-579
2016-05-28 00:00:00;28,92;26,67;2,25;39368;0;0;0;0;45970;2894;0.063;4003;-1109
2016-05-28 01:00:00;24,38;26,53;-2,15;39368;0;0;0;0;45970;2989;0.065;3992;-1003
2016-05-28 02:00:00;22,79;22,92;-0,13;39368;0;0;0;0;45970;2940;0.064;4042;-1102
2016-05-28 03:00:00;22,14;21,0;1,14;39368;0;0;0;0;45970;2807;0.061;4041;-1234
2016-05-28 04:00:00;21,69;20,45;1,24;39368;1;0;1;0;45970;2474;0.0538;3960;-1486
2016-05-28 05:00:00;21,91;20,88;1,03;39368;241;0.0061;220;21;45970;2330;0.0507;3845;-1515
2016-05-28 06:00:00;22,56;23,73;-1,17;39368;1565;0.0398;1560;5;45970;2147;0.0467;3446;-1299
2016-05-28 07:00:00;24,02;28,29;-4,27;39368;3870;0.0983;4286;-416;45970;1752;0.0381;2767;-1015
2016-05-28 08:00:00;26,57;28,84;-2,27;39368;7047;0.179;7779;-732;45970;1316;0.0286;2493;-1177
2016-05-28 09:00:00;26,95;26,42;0,53;39368;11538;0.2931;11440;98;45970;1024;0.0223;2510;-1486
2016-05-28 10:00:00;24,46;23,05;1,41;39368;15880;0.4034;14449;1431;45970;1006;0.0219;2649;-1643
2016-05-28 11:00:00;23,49;23,38;0,11;39368;18700;0.475;16655;2045;45970;1186;0.0258;2900;-1714
2016-05-28 12:00:00;22,87;21,38;1,49;39368;19773;0.5022;17902;1871;45970;1318;0.0286;3212;-1894
2016-05-28 13:00:00;22,06;20,74;1,32;39368;19102;0.4852;18054;1048;45970;1487;0.0323;3511;-2024
2016-05-28 14:00:00;21,47;21,22;0,25;39368;17575;0.4464;17371;204;45970;1780;0.0387;3817;-2037
2016-05-28 15:00:00;20,42;19,25;1,17;39368;15013;0.3814;15565;-552;45970;2322;0.0505;4178;-1856
2016-05-28 16:00:00;20,0;19,07;0,93;39368;12108;0.3076;12780;-672;45970;3006;0.0654;4581;-1575
2016-05-28 17:00:00;22,01;25,05;-3,04;39368;9032;0.2294;9292;-260;45970;3712;0.0808;5049;-1337
2016-05-28 18:00:00;25,57;27,01;-1,44;39368;5704;0.1449;5601;103;45970;4270;0.0929;5583;-1313
2016-05-28 19:00:00;26,42;27,24;-0,82;39368;2692;0.0684;2574;118;45970;4393;0.0956;6274;-1881
2016-05-28 20:00:00;27,1;29,03;-1,93;39368;724;0.0184;688;36;45970;4969;0.1081;7276;-2307
2016-05-28 21:00:00;25,69;28,69;-3,0;39368;28;0.0007;29;-1;45970;6622;0.1441;7949;-1327
2016-05-28 22:00:00;23,37;27,54;-4,17;39368;0;0;0;0;45970;8090;0.176;8383;-293
2016-05-28 23:00:00;22,31;21,13;1,18;39368;0;0;0;0;45970;8500;0.1849;8455;45
2016-05-29 00:00:00;18,03;13,99;4,04;39368;0;0;0;0;45970;8257;0.1796;8483;-226
2016-05-29 01:00:00;13,15;10,88;2,27;39368;0;0;0;0;45970;7760;0.1688;8219;-459
2016-05-29 02:00:00;12,97;9,37;3,6;39368;0;0;0;0;45970;6962;0.1514;7985;-1023
2016-05-29 03:00:00;13,17;12,1;1,07;39368;0;0;0;0;45970;5831;0.1268;7761;-1930
2016-05-29 04:00:00;8,9;11,3;-2,4;39368;1;0;2;-1;45970;5300;0.1153;7538;-2238
2016-05-29 05:00:00;6,16;10,92;-4,76;39368;190;0.0048;218;-28;45970;5209;0.1133;7210;-2001
2016-05-29 06:00:00;10,58;11,85;-1,27;39368;1388;0.0353;1481;-93;45970;4847;0.1054;6805;-1958
2016-05-29 07:00:00;13,87;14,51;-0,64;39368;3648;0.0927;3800;-152;45970;4381;0.0953;6397;-2016
2016-05-29 08:00:00;14,67;15,96;-1,29;39368;6687;0.1699;6521;166;45970;4066;0.0885;6153;-2087
2016-05-29 09:00:00;15,23;16,21;-0,98;39368;9564;0.2429;9256;308;45970;4062;0.0884;6291;-2229
2016-05-29 10:00:00;12,87;16,99;-4,12;39368;12429;0.3157;11485;944;45970;4111;0.0894;6646;-2535
2016-05-29 11:00:00;14,03;17,55;-3,52;39368;14874;0.3778;13177;1697;45970;4447;0.0967;7171;-2724
2016-05-29 12:00:00;10,46;17,38;-6,92;39368;15355;0.39;14011;1344;45970;5064;0.1102;8038;-2974
2016-05-29 13:00:00;8,57;17,89;-9,32;39368;14450;0.367;13917;533;45970;5311;0.1155;8900;-3589
2016-05-29 14:00:00;4,6;17,53;-12,93;39368;13282;0.3374;12904;378;45970;5551;0.1208;9515;-3964
2016-05-29 15:00:00;3,78;15,78;-12,0;39368;11906;0.3024;11279;627;45970;5870;0.1277;10040;-4170
2016-05-29 16:00:00;5,32;15,09;-9,77;39368;9417;0.2392;9022;395;45970;6390;0.139;10322;-3932
2016-05-29 17:00:00;8,42;20,24;-11,82;39368;6198;0.1575;6467;-269;45970;7482;0.1628;10536;-3054
2016-05-29 18:00:00;18,08;25,23;-7,15;39368;3531;0.0897;4025;-494;45970;8197;0.1783;10791;-2594
2016-05-29 19:00:00;21,88;29,07;-7,19;39368;1594;0.0405;1940;-346;45970;9076;0.1974;11070;-1994
2016-05-29 20:00:00;22,77;28,81;-6,04;39368;395;0.01;504;-109;45970;9423;0.205;11443;-2020
2016-05-29 21:00:00;23,04;29,69;-6,65;39368;20;0.0005;23;-3;45970;9830;0.2138;12015;-2185
2016-05-29 22:00:00;23,1;30,35;-7,25;39368;0;0;0;0;45970;10196;0.2218;12644;-2448
2016-05-29 23:00:00;19,73;25,61;-5,88;39368;0;0;0;0;45970;10082;0.2193;12986;-2904
2016-05-30 00:00:00;18,07;14,08;3,99;39371;0;0;0;0;46029;10460;0.2272;11082;-622
2016-05-30 01:00:00;13,87;10,19;3,68;39371;0;0;0;0;46029;10955;0.238;11005;-50
2016-05-30 02:00:00;12,27;6,31;5,96;39371;0;0;0;0;46029;11037;0.2398;11090;-53
2016-05-30 03:00:00;11,28;4,21;7,07;39371;0;0;0;0;46029;10737;0.2332;11333;-596
2016-05-30 04:00:00;11,86;4,17;7,69;39371;1;0;2;-1;46029;11376;0.2472;11609;-233
2016-05-30 05:00:00;18,01;8,59;9,42;39371;213;0.0054;201;12;46029;11175;0.2428;11857;-682
2016-05-30 06:00:00;26,16;21,9;4,26;39371;1244;0.0316;1062;182;46029;10410;0.2262;11926;-1516
2016-05-30 07:00:00;34,94;30,15;4,79;39371;2996;0.0761;2751;245;46029;9582;0.2082;11835;-2253
2016-05-30 08:00:00;35,25;35,45;-0,2;39371;5310;0.1349;4846;464;46029;8552;0.1858;11800;-3248
2016-05-30 09:00:00;35,43;35,2;0,23;39371;8051;0.2045;7081;970;46029;8235;0.1789;12319;-4084
2016-05-30 10:00:00;34,79;32,91;1,88;39371;10646;0.2704;9099;1547;46029;8269;0.1796;12835;-4566
2016-05-30 11:00:00;34,25;33,26;0,99;39371;12256;0.3113;10670;1586;46029;9307;0.2022;13194;-3887
2016-05-30 12:00:00;29,0;32,41;-3,41;39371;13067;0.3319;11715;1352;46029;10367;0.2252;13648;-3281
2016-05-30 13:00:00;26,33;30,05;-3,72;39371;14124;0.3588;12133;1991;46029;11174;0.2428;14028;-2854
2016-05-30 14:00:00;25,08;29,47;-4,39;39371;13731;0.3488;11909;1822;46029;11303;0.2456;14341;-3038
2016-05-30 15:00:00;24,67;29,36;-4,69;39371;12690;0.3223;10969;1721;46029;11537;0.2506;14279;-2742
2016-05-30 16:00:00;25,06;30,09;-5,03;39371;11058;0.2809;9293;1765;46029;11168;0.2426;13800;-2632
2016-05-30 17:00:00;25,47;29,24;-3,77;39371;8089;0.2055;7075;1014;46029;11254;0.2445;13098;-1844
2016-05-30 18:00:00;28,74;32,43;-3,69;39371;4835;0.1228;4565;270;46029;10798;0.2346;12301;-1503
2016-05-30 19:00:00;28,99;34,43;-5,44;39371;2229;0.0566;2269;-40;46029;10525;0.2286;11790;-1265
2016-05-30 20:00:00;25,48;33,71;-8,23;39371;572;0.0145;640;-68;46029;10031;0.2179;11646;-1615
2016-05-30 21:00:00;24,68;31,88;-7,2;39371;25;0.0006;33;-8;46029;10225;0.2221;11763;-1538
2016-05-30 22:00:00;23,9;32,05;-8,15;39371;0;0;0;0;46029;10122;0.2199;11836;-1714
2016-05-30 23:00:00;21,94;28,85;-6,91;39371;0;0;0;0;46029;10289;0.2236;11562;-1273
2016-05-31 00:00:00;21,17;22,72;-1,55;39382;0;0;0;0;46041;9488;0.206;9766;-278
2016-05-31 01:00:00;19,25;20,02;-0,77;39382;0;0;0;0;46041;9058;0.1967;9133;-75
2016-05-31 02:00:00;16,44;16,52;-0,08;39382;0;0;0;0;46041;8139;0.1768;8507;-368
2016-05-31 03:00:00;16,09;17,19;-1,1;39382;0;0;0;0;46041;7410;0.161;7916;-506
2016-05-31 04:00:00;17,31;16,64;0,67;39382;1;0;4;-3;46041;6867;0.1492;7308;-441
2016-05-31 05:00:00;20,98;22,04;-1,06;39382;242;0.0061;267;-25;46041;6286;0.1366;6832;-546
2016-05-31 06:00:00;24,52;34,26;-9,74;39382;1552;0.0394;1735;-183;46041;5496;0.1194;6141;-645
2016-05-31 07:00:00;32,93;41,57;-8,64;39382;4310;0.1094;4611;-301;46041;4574;0.0994;5294;-720
2016-05-31 08:00:00;35,81;46,86;-11,05;39382;8156;0.2071;8305;-149;46041;3570;0.0775;4713;-1143
2016-05-31 09:00:00;35,47;43,37;-7,9;39382;11729;0.2978;11882;-153;46041;3306;0.0718;4511;-1205
2016-05-31 10:00:00;34,94;41,01;-6,07;39382;14163;0.3596;14494;-331;46041;3268;0.071;4313;-1045
2016-05-31 11:00:00;35,8;39,23;-3,43;39382;15052;0.3822;15984;-932;46041;3140;0.0682;4092;-952
2016-05-31 12:00:00;32,78;38,16;-5,38;39382;15302;0.3886;16386;-1084;46041;2764;0.06;3923;-1159
2016-05-31 13:00:00;30,94;37,64;-6,7;39382;15273;0.3878;16463;-1190;46041;2631;0.0571;3753;-1122
2016-05-31 14:00:00;30,57;37,05;-6,48;39382;14863;0.3774;15824;-961;46041;2557;0.0556;3551;-994
2016-05-31 15:00:00;28,82;37,19;-8,37;39382;13350;0.3389;14307;-957;46041;2865;0.0622;3396;-531
2016-05-31 16:00:00;29,26;35,51;-6,25;39382;11023;0.2799;11858;-835;46041;3159;0.0686;3262;-103
2016-05-31 17:00:00;32,37;35,46;-3,09;39382;8200;0.2082;8839;-639;46041;3800;0.0825;3177;623
2016-05-31 18:00:00;34,94;37,14;-2,2;39382;4983;0.1265;5527;-544;46041;4077;0.0886;3199;878
2016-05-31 19:00:00;35,92;36,91;-0,99;39382;2468;0.0626;2690;-222;46041;4241;0.0921;3226;1015
2016-05-31 20:00:00;32,95;35,65;-2,7;39382;696;0.0177;751;-55;46041;4064;0.0883;3357;707
2016-05-31 21:00:00;31,98;32,63;-0,65;39382;43;0.0011;39;4;46041;4278;0.0929;3743;535
2016-05-31 22:00:00;30,78;36,29;-5,51;39382;0;0;0;0;46041;4413;0.0958;4118;295
2016-05-31 23:00:00;26,15;29,59;-3,44;39382;0;0;0;0;46041;4760;0.1034;4354;406
2016-01-06 00:00:00;24,0;24,67;-0,67;39384;0;0;0;0;46062;4972;0.1079;5663;-691
2016-01-06 01:00:00;22,23;22,19;0,04;39384;0;0;0;0;46062;5542;0.1203;5859;-317
2016-01-06 02:00:00;21,07;21,99;-0,92;39384;0;0;0;0;46062;5412;0.1175;6034;-622
2016-01-06 03:00:00;20,08;20,11;-0,03;39384;0;0;0;0;46062;5319;0.1155;6112;-793
2016-01-06 04:00:00;20,18;18,2;1,98;39384;1;0;1;0;46062;5506;0.1196;6133;-627
2016-01-06 05:00:00;23,1;20,88;2,22;39384;144;0.0036;152;-8;46062;5466;0.1186;6181;-715
2016-01-06 06:00:00;29,9;24,2;5,7;39384;1024;0.026;1047;-23;46062;4840;0.1051;6207;-1367
2016-01-06 07:00:00;37,49;35,27;2,22;39384;2714;0.0689;2848;-134;46062;4349;0.0944;6200;-1851
2016-01-06 08:00:00;40,87;38,83;2,04;39384;4796;0.1218;5023;-227;46062;4223;0.0917;6216;-1993
2016-01-06 09:00:00;41,0;40,28;0,72;39384;6928;0.1759;7159;-231;46062;4548;0.0987;6375;-1827
2016-01-06 10:00:00;40,44;39,29;1,15;39384;8741;0.222;8934;-193;46062;5391;0.117;6662;-1271
2016-01-06 11:00:00;40,51;40,62;-0,11;39384;9984;0.2535;10264;-280;46062;6141;0.1333;7147;-1006
2016-01-06 12:00:00;36,64;37,09;-0,45;39384;10712;0.272;11185;-473;46062;7010;0.1521;7908;-898
2016-01-06 13:00:00;32,11;31,95;0,16;39384;10961;0.2783;11438;-477;46062;8250;0.1791;8698;-448
2016-01-06 14:00:00;30,9;31,27;-0,37;39384;10588;0.2689;11017;-429;46062;9155;0.1988;9339;-184
2016-01-06 15:00:00;28,96;27,18;1,78;39384;10356;0.2629;10009;347;46062;10272;0.223;9846;426
2016-01-06 16:00:00;28,12;25,07;3,05;39384;8953;0.2273;8548;405;46062;10764;0.2337;10106;658
2016-01-06 17:00:00;30,11;28,56;1,55;39384;6658;0.169;6571;87;46062;10290;0.2234;10227;63
2016-01-06 18:00:00;32,66;31,48;1,18;39384;4126;0.1048;4253;-127;46062;9812;0.213;10120;-308
2016-01-06 19:00:00;32,92;33,6;-0,68;39384;1904;0.0484;2150;-246;46062;9470;0.2056;9978;-508
2016-01-06 20:00:00;30,95;34,0;-3,05;39384;487;0.0124;599;-112;46062;8960;0.1945;9973;-1013
2016-01-06 21:00:00;29,57;33,9;-4,33;39384;37;0.0009;32;5;46062;8926;0.1938;9822;-896
2016-01-06 22:00:00;30,9;34,04;-3,14;39384;0;0;0;0;46062;8627;0.1873;9624;-997
2016-01-06 23:00:00;26,64;29,65;-3,01;39384;0;0;0;0;46062;7972;0.1731;9379;-1407
2016-02-06 00:00:00;21,96;21,15;0,81;39386;0;0;0;0;46083;7429;0.1612;7852;-423
2016-02-06 01:00:00;20,75;19,16;1,59;39386;0;0;0;0;46083;6608;0.1434;7286;-678
2016-02-06 02:00:00;20,06;19,6;0,46;39386;0;0;0;0;46083;5591;0.1213;6718;-1127
2016-02-06 03:00:00;20,0;17,59;2,41;39386;0;0;0;0;46083;5079;0.1102;6197;-1118
2016-02-06 04:00:00;20,0;16,71;3,29;39386;2;0;5;-3;46083;4817;0.1046;5693;-876
2016-02-06 05:00:00;22,37;18,82;3,55;39386;200;0.0051;237;-37;46083;4539;0.0985;5162;-623
2016-02-06 06:00:00;29,03;29,26;-0,23;39386;1173;0.0298;1433;-260;46083;4486;0.0974;4552;-66
2016-02-06 07:00:00;37,97;43,33;-5,36;39386;2832;0.0719;3744;-912;46083;4074;0.0884;4011;63
2016-02-06 08:00:00;39,54;48,33;-8,79;39386;4896;0.1243;6564;-1668;46083;3594;0.078;3643;-49
2016-02-06 09:00:00;37,98;53,8;-15,82;39386;7375;0.1872;9567;-2192;46083;3737;0.0811;3446;291
2016-02-06 10:00:00;37,09;50,35;-13,26;39386;9850;0.2501;12225;-2375;46083;3806;0.0826;3404;402
2016-02-06 11:00:00;36,37;43,9;-7,53;39386;12123;0.3078;14149;-2026;46083;3804;0.0825;3547;257
2016-02-06 12:00:00;32,08;40,07;-7,99;39386;13778;0.3498;15310;-1532;46083;4250;0.0922;3846;404
2016-02-06 13:00:00;28,67;36,18;-7,51;39386;14200;0.3605;15697;-1497;46083;4698;0.102;4174;524
2016-02-06 14:00:00;26,68;32,14;-5,46;39386;13461;0.3418;15147;-1686;46083;5143;0.1116;4444;699
2016-02-06 15:00:00;25,95;32,28;-6,33;39386;12171;0.309;13607;-1436;46083;5738;0.1245;4767;971
2016-02-06 16:00:00;25,92;31,24;-5,32;39386;11200;0.2844;11265;-65;46083;5825;0.1264;5079;746
2016-02-06 17:00:00;28,22;33,49;-5,27;39386;8704;0.221;8341;363;46083;5332;0.1157;5259;73
2016-02-06 18:00:00;31,84;37,24;-5,4;39386;5468;0.1389;5272;196;46083;4950;0.1074;5280;-330
2016-02-06 19:00:00;32,96;39,07;-6,11;39386;2675;0.0679;2623;52;46083;4446;0.0965;5084;-638
2016-02-06 20:00:00;31,96;37,86;-5,9;39386;734;0.0186;764;-30;46083;4100;0.089;4826;-726
2016-02-06 21:00:00;29,46;34,59;-5,13;39386;53;0.0013;41;12;46083;4205;0.0912;5024;-819
2016-02-06 22:00:00;29,16;35,3;-6,14;39386;0;0;0;0;46083;4207;0.0913;5402;-1195
2016-02-06 23:00:00;24,59;28,57;-3,98;39386;0;0;0;0;46083;4099;0.089;5676;-1577
2016-03-06 00:00:00;24,1;27,27;-3,17;39388;0;0;0;0;46110;3924;0.0851;5777;-1853
2016-03-06 01:00:00;21,68;25,14;-3,46;39388;0;0;0;0;46110;3919;0.085;5662;-1743
2016-03-06 02:00:00;21,22;25,1;-3,88;39388;0;0;0;0;46110;4064;0.0881;5429;-1365
2016-03-06 03:00:00;20,64;21,46;-0,82;39388;0;0;0;0;46110;4114;0.0892;5127;-1013
2016-03-06 04:00:00;20,9;19,67;1,23;39388;2;0;5;-3;46110;3937;0.0854;4814;-877
2016-03-06 05:00:00;22,5;24,2;-1,7;39388;228;0.0058;250;-22;46110;3663;0.0794;4489;-826
2016-03-06 06:00:00;27,46;30,19;-2,73;39388;1444;0.0367;1601;-157;46110;3176;0.0689;4018;-842
2016-03-06 07:00:00;35,45;39,09;-3,64;39388;3838;0.0975;4194;-356;46110;2344;0.0508;3511;-1167
2016-03-06 08:00:00;40,08;49,69;-9,61;39388;6819;0.1731;7263;-444;46110;1706;0.037;3256;-1550
2016-03-06 09:00:00;39,93;47,48;-7,55;39388;10228;0.2597;10362;-134;46110;1928;0.0418;3317;-1389
2016-03-06 10:00:00;36,44;41,54;-5,1;39388;13003;0.3302;12985;18;46110;3028;0.0657;3570;-542
2016-03-06 11:00:00;35,64;36,42;-0,78;39388;15014;0.3812;14779;235;46110;4149;0.09;4008;141
2016-03-06 12:00:00;30,92;30,26;0,66;39388;16386;0.416;15747;639;46110;4907;0.1064;4527;380
2016-03-06 13:00:00;27,77;26,97;0,8;39388;16437;0.4173;15844;593;46110;5236;0.1135;4985;251
2016-03-06 14:00:00;25,28;26,21;-0,93;39388;15611;0.3964;15035;576;46110;5702;0.1236;5234;468
2016-03-06 15:00:00;25,26;26,49;-1,23;39388;14251;0.3618;13545;706;46110;6460;0.1401;5435;1025
2016-03-06 16:00:00;25,49;27,1;-1,61;39388;11861;0.3011;11347;514;46110;6318;0.137;5709;609
2016-03-06 17:00:00;28,0;28,49;-0,49;39388;9016;0.2289;8395;621;46110;6382;0.1384;5695;687
2016-03-06 18:00:00;31,82;30,39;1,43;39388;5549;0.1409;5163;386;46110;5913;0.1282;5266;647
2016-03-06 19:00:00;33,61;30,58;3,03;39388;2718;0.069;2487;231;46110;4959;0.1076;4819;140
2016-03-06 20:00:00;31,98;29,81;2,17;39388;762;0.0194;738;24;46110;4129;0.0895;4521;-392
2016-03-06 21:00:00;30,66;29,19;1,47;39388;46;0.0012;48;-2;46110;4443;0.0964;4738;-295
2016-03-06 22:00:00;32,16;30,19;1,97;39388;0;0;0;0;46110;4396;0.0953;5050;-654
2016-03-06 23:00:00;28,94;27,41;1,53;39388;0;0;0;0;46110;4234;0.0919;5187;-953
2016-04-06 00:00:00;23,72;25,55;-1,83;39389;0;0;0;0;46110;3752;0.0814;5081;-1329
2016-04-06 01:00:00;23,21;24,16;-0,95;39389;0;0;0;0;46110;3386;0.0734;4748;-1362
2016-04-06 02:00:00;21,63;22,78;-1,15;39389;0;0;0;0;46110;3175;0.0689;4436;-1261
2016-04-06 03:00:00;21,29;22,39;-1,1;39389;0;0;0;0;46110;2806;0.0608;4080;-1274
2016-04-06 04:00:00;21,26;22,21;-0,95;39389;3;0.0001;6;-3;46110;2547;0.0552;3672;-1125
2016-04-06 05:00:00;21,3;21,68;-0,38;39389;300;0.0076;305;-5;46110;2225;0.0482;3158;-933
2016-04-06 06:00:00;21,53;22,43;-0,9;39389;1733;0.044;1742;-9;46110;1851;0.0402;2478;-627
2016-04-06 07:00:00;23,5;23,01;0,49;39389;4692;0.1191;4732;-40;46110;1141;0.0247;1682;-541
2016-04-06 08:00:00;27,49;24,66;2,83;39389;8480;0.2153;8564;-84;46110;570;0.0124;1071;-501
2016-04-06 09:00:00;28,98;31,32;-2,34;39389;12736;0.3234;12413;323;46110;509;0.0111;927;-418
2016-04-06 10:00:00;26,56;30,16;-3,6;39389;16574;0.4208;15561;1013;46110;747;0.0162;1024;-277
2016-04-06 11:00:00;26,91;28,36;-1,45;39389;18794;0.4772;17523;1271;46110;1169;0.0254;1241;-72
2016-04-06 12:00:00;25,73;26,59;-0,86;39389;19918;0.5057;18424;1494;46110;1541;0.0334;1537;4
2016-04-06 13:00:00;22,78;25,7;-2,92;39389;19704;0.5002;18580;1124;46110;1708;0.037;1848;-140
2016-04-06 14:00:00;21,58;28,02;-6,44;39389;18826;0.478;17688;1138;46110;2013;0.0436;2171;-158
2016-04-06 15:00:00;21,41;27,76;-6,35;39389;16881;0.4286;15693;1188;46110;2430;0.0527;2532;-102
2016-04-06 16:00:00;21,53;27,57;-6,04;39389;14079;0.3574;12985;1094;46110;2978;0.0646;2873;105
2016-04-06 17:00:00;25,29;27,5;-2,21;39389;10295;0.2614;9605;690;46110;3328;0.0721;3177;151
2016-04-06 18:00:00;28,19;29,04;-0,85;39389;6364;0.1616;5977;387;46110;3348;0.0726;3471;-123
2016-04-06 19:00:00;30,07;31,17;-1,1;39389;3086;0.0784;2927;159;46110;3416;0.0741;3621;-205
2016-04-06 20:00:00;29,87;32,16;-2,29;39389;897;0.0228;847;50;46110;2854;0.0619;3544;-690
2016-04-06 21:00:00;29,88;32,37;-2,49;39389;60;0.0016;53;7;46110;2888;0.0627;3630;-742
2016-04-06 22:00:00;30,99;34,06;-3,07;39389;0;0;0;0;46110;3108;0.0674;3734;-626
2016-04-06 23:00:00;28,88;31,69;-2,81;39389;0;0;0;0;46110;3064;0.0665;3627;-563
2016-05-06 00:00:00;24,43;21,1;3,33;39389;0;0;0;0;46110;2608;0.0566;2974;-366
2016-05-06 01:00:00;22,0;19,66;2,34;39389;0;0;0;0;46110;2224;0.0482;2543;-319
2016-05-06 02:00:00;20,08;18,18;1,9;39389;0;0;0;0;46110;1914;0.0415;2160;-246
2016-05-06 03:00:00;19,08;15,35;3,73;39389;0;0;0;0;46110;1589;0.0344;1894;-305
2016-05-06 04:00:00;18,03;15,44;2,59;39389;3;0.0001;6;-3;46110;1368;0.0296;1651;-283
2016-05-06 05:00:00;16,61;13,72;2,89;39389;318;0.0081;318;0;46110;1242;0.0269;1434;-192
2016-05-06 06:00:00;16,09;10,22;5,87;39389;1764;0.0448;1800;-36;46110;1137;0.0246;1184;-47
2016-05-06 07:00:00;17,78;16,24;1,54;39389;4653;0.1181;4972;-319;46110;872;0.0189;889;-17
2016-05-06 08:00:00;17,89;19,83;-1,94;39389;8148;0.2069;9029;-881;46110;604;0.0131;632;-28
2016-05-06 09:00:00;17,08;22,36;-5,28;39389;11892;0.3019;13133;-1241;46110;605;0.0131;525;80
2016-05-06 10:00:00;17,84;22,39;-4,55;39389;15441;0.392;16503;-1062;46110;718;0.0156;535;183
2016-05-06 11:00:00;18,48;23,43;-4,95;39389;18225;0.4627;18786;-561;46110;894;0.0194;618;276
2016-05-06 12:00:00;17,94;22,19;-4,25;39389;20234;0.5137;19993;241;46110;1144;0.0248;764;380
2016-05-06 13:00:00;15,15;20,96;-5,81;39389;20901;0.5306;20044;857;46110;1478;0.032;954;524
2016-05-06 14:00:00;14,47;17,82;-3,35;39389;20130;0.5111;18761;1369;46110;1814;0.0394;1201;613
2016-05-06 15:00:00;14,03;13,56;0,47;39389;17920;0.455;16470;1450;46110;2452;0.0532;1551;901
2016-05-06 16:00:00;14,54;14,19;0,35;39389;15126;0.384;13604;1522;46110;3077;0.0668;1934;1143
2016-05-06 17:00:00;18,62;19,28;-0,66;39389;11061;0.2808;9973;1088;46110;3559;0.0772;2318;1241
2016-05-06 18:00:00;23,91;30,5;-6,59;39389;6590;0.1673;6104;486;46110;3525;0.0764;2603;922
2016-05-06 19:00:00;26,92;35,1;-8,18;39389;3165;0.0803;2876;289;46110;3330;0.0722;2836;494
2016-05-06 20:00:00;28,85;32,76;-3,91;39389;994;0.0252;863;131;46110;3349;0.0726;2762;587
2016-05-06 21:00:00;29,14;34,17;-5,03;39389;72;0.0018;60;12;46110;3646;0.0791;2880;766
2016-05-06 22:00:00;30,74;36,03;-5,29;39389;0;0;0;0;46110;3784;0.082;3137;647
2016-05-06 23:00:00;27,93;31,37;-3,44;39389;0;0;0;0;46110;3281;0.0712;3244;37
2016-06-06 00:00:00;24,59;26,27;-1,68;39391;0;0;0;0;46113;2884;0.0625;3112;-228
2016-06-06 01:00:00;22,76;25,71;-2,95;39391;0;0;0;0;46113;2764;0.0599;2954;-190
2016-06-06 02:00:00;21,87;25,74;-3,87;39391;0;0;0;0;46113;2657;0.0576;2935;-278
2016-06-06 03:00:00;21,19;24,53;-3,34;39391;0;0;0;0;46113;2495;0.0541;3000;-505
2016-06-06 04:00:00;21,15;22,1;-0,95;39391;3;0.0001;6;-3;46113;2690;0.0584;3066;-376
2016-06-06 05:00:00;22,71;26,64;-3,93;39391;354;0.009;359;-5;46113;2780;0.0603;3014;-234
2016-06-06 06:00:00;29,98;34,74;-4,76;39391;1932;0.0491;2005;-73;46113;2558;0.0555;2677;-119
2016-06-06 07:00:00;36,16;39,4;-3,24;39391;5612;0.1425;5782;-170;46113;1781;0.0386;2209;-428
2016-06-06 08:00:00;37,82;42,77;-4,95;39391;10620;0.2696;10951;-331;46113;1366;0.0296;1895;-529
2016-06-06 09:00:00;34,94;36,2;-1,26;39391;15891;0.4034;16216;-325;46113;1035;0.0224;1757;-722
2016-06-06 10:00:00;32,57;31,01;1,56;39391;20674;0.5248;20479;195;46113;936;0.0203;1716;-780
2016-06-06 11:00:00;31,93;28,64;3,29;39391;23960;0.6082;23223;737;46113;1174;0.0255;1777;-603
2016-06-06 12:00:00;28,63;24,84;3,79;39391;25468;0.6465;24518;950;46113;1517;0.0329;1902;-385
2016-06-06 13:00:00;28,08;25,21;2,87;39391;25389;0.6445;24354;1035;46113;1785;0.0387;2043;-258
2016-06-06 14:00:00;28,78;25,67;3,11;39391;23967;0.6084;22776;1191;46113;1946;0.0422;2195;-249
2016-06-06 15:00:00;29,63;25,57;4,06;39391;20985;0.5328;20042;943;46113;2355;0.0511;2410;-55
2016-06-06 16:00:00;30,99;24,84;6,15;39391;17340;0.4402;16407;933;46113;2871;0.0622;2677;194
2016-06-06 17:00:00;34,68;29,2;5,48;39391;12581;0.3194;11826;755;46113;3180;0.069;3067;113
2016-06-06 18:00:00;38,76;32,5;6,26;39391;7677;0.1949;6926;751;46113;3598;0.078;3599;-1
2016-06-06 19:00:00;41,06;34,76;6,3;39391;3657;0.0928;3070;587;46113;3800;0.0824;4138;-338
2016-06-06 20:00:00;37,31;32,37;4,94;39391;1168;0.0296;972;196;46113;3762;0.0816;4502;-740
2016-06-06 21:00:00;34,2;29,45;4,75;39391;69;0.0018;67;2;46113;4434;0.0962;5068;-634
2016-06-06 22:00:00;33,81;29,05;4,76;39391;0;0;0;0;46113;5331;0.1156;5645;-314
2016-06-06 23:00:00;28,79;25,54;3,25;39391;0;0;0;0;46113;5519;0.1197;5902;-383
2016-07-06 00:00:00;24,85;26,9;-2,05;39393;0;0;0;0;46130;5262;0.1141;5594;-332
2016-07-06 01:00:00;23,34;25,48;-2,14;39393;0;0;0;0;46130;4730;0.1026;5209;-479
2016-07-06 02:00:00;22,59;23,18;-0,59;39393;0;0;0;0;46130;4051;0.0878;4774;-723
2016-07-06 03:00:00;21,58;22,16;-0,58;39393;0;0;0;0;46130;3544;0.0768;4394;-850
2016-07-06 04:00:00;21,67;22,67;-1,0;39393;4;0.0001;6;-2;46130;3103;0.0672;4029;-926
2016-07-06 05:00:00;22,09;26,55;-4,46;39393;386;0.0098;379;7;46130;2738;0.0594;3568;-830
2016-07-06 06:00:00;29,68;31,33;-1,65;39393;2062;0.0524;1985;77;46130;2232;0.0484;2850;-618
2016-07-06 07:00:00;35,82;34,17;1,65;39393;6152;0.1562;5925;227;46130;1220;0.0265;1951;-731
2016-07-06 08:00:00;39,48;34,98;4,5;39393;11657;0.296;11336;321;46130;474;0.0103;1256;-782
2016-07-06 09:00:00;34,49;29,7;4,79;39393;16908;0.4292;16699;209;46130;246;0.0053;956;-710
2016-07-06 10:00:00;29,15;29,43;-0,28;39393;21267;0.5399;20972;295;46130;270;0.0059;827;-557
2016-07-06 11:00:00;28,8;27,63;1,17;39393;24148;0.613;23661;487;46130;422;0.0092;757;-335
2016-07-06 12:00:00;25,94;25,65;0,29;39393;25522;0.6478;24846;676;46130;606;0.0131;712;-106
2016-07-06 13:00:00;25,59;25,64;-0,05;39393;25261;0.6412;24635;626;46130;772;0.0167;655;117
2016-07-06 14:00:00;25,18;26,14;-0,96;39393;23341;0.5925;23182;159;46130;956;0.0207;652;304
2016-07-06 15:00:00;26,41;27,66;-1,25;39393;20241;0.5138;20516;-275;46130;1244;0.027;747;497
2016-07-06 16:00:00;27,53;28,59;-1,06;39393;16041;0.4072;16742;-701;46130;1726;0.0374;865;861
2016-07-06 17:00:00;32,13;30,21;1,92;39393;11286;0.2865;11991;-705;46130;2059;0.0446;993;1066
2016-07-06 18:00:00;36,02;33,51;2,51;39393;6743;0.1712;6933;-190;46130;2076;0.045;1119;957
2016-07-06 19:00:00;38,48;33,3;5,18;39393;3004;0.0763;2965;39;46130;2168;0.047;1248;920
2016-07-06 20:00:00;34,9;30,77;4,13;39393;842;0.0214;964;-122;46130;1970;0.0427;1534;436
2016-07-06 21:00:00;32,97;30,42;2,55;39393;62;0.0016;72;-10;46130;2454;0.0532;1965;489
2016-07-06 22:00:00;32,59;29,83;2,76;39393;0;0;0;0;46130;3046;0.066;2396;650
2016-07-06 23:00:00;27,54;25,28;2,26;39393;0;0;0;0;46130;3601;0.078;2692;909
2016-08-06 00:00:00;25,98;21,3;4,68;39398;0;0;0;0;46154;3747;0.0812;3226;521
2016-08-06 01:00:00;23,89;20,58;3,31;39398;0;0;0;0;46154;3814;0.0826;3426;388
2016-08-06 02:00:00;22,83;18,9;3,93;39398;0;0;0;0;46154;3908;0.0847;3568;340
2016-08-06 03:00:00;21,68;18,24;3,44;39398;0;0;0;0;46154;4038;0.0875;3608;430
2016-08-06 04:00:00;21,54;17,61;3,93;39398;4;0.0001;7;-3;46154;4530;0.0982;3620;910
2016-08-06 05:00:00;23,38;17,28;6,1;39398;335;0.0085;345;-10;46154;4465;0.0968;3519;946
2016-08-06 06:00:00;28,21;19,79;8,42;39398;1838;0.0466;1806;32;46154;4028;0.0872;3301;727
2016-08-06 07:00:00;35,07;30,58;4,49;39398;4628;0.1175;4954;-326;46154;3832;0.083;3075;757
2016-08-06 08:00:00;41,31;36,16;5,15;39398;7851;0.1992;8840;-989;46154;3420;0.0741;3021;399
2016-08-06 09:00:00;37,33;34,18;3,15;39398;11260;0.2858;12694;-1434;46154;3675;0.0796;3281;394
2016-08-06 10:00:00;34,25;35,62;-1,37;39398;14509;0.3682;15861;-1352;46154;4316;0.0935;3783;533
2016-08-06 11:00:00;32,99;35,47;-2,48;39398;16657;0.4228;18176;-1519;46154;5231;0.1133;4481;750
2016-08-06 12:00:00;28,52;31,34;-2,82;39398;17973;0.4562;19546;-1573;46154;6042;0.1309;5417;625
2016-08-06 13:00:00;27,6;29,94;-2,34;39398;18585;0.4717;19731;-1146;46154;7180;0.1556;6475;705
2016-08-06 14:00:00;27,18;29,16;-1,98;39398;17964;0.456;18736;-772;46154;8371;0.1814;7542;829
2016-08-06 15:00:00;26,37;27,27;-0,9;39398;16098;0.4086;16593;-495;46154;9445;0.2046;8551;894
2016-08-06 16:00:00;26,0;26,31;-0,31;39398;13339;0.3386;13689;-350;46154;10300;0.2232;9353;947
2016-08-06 17:00:00;28,24;25,86;2,38;39398;9641;0.2447;9936;-295;46154;11170;0.242;9775;1395
2016-08-06 18:00:00;30,68;26,24;4,44;39398;5755;0.1461;6034;-279;46154;11254;0.2438;9701;1553
2016-08-06 19:00:00;32,9;28,07;4,83;39398;2770;0.0703;2803;-33;46154;10750;0.2329;9411;1339
2016-08-06 20:00:00;32,12;27,87;4,25;39398;896;0.0228;870;26;46154;9704;0.2102;9034;670
2016-08-06 21:00:00;32,55;29,37;3,18;39398;84;0.0021;76;8;46154;8933;0.1936;8942;-9
2016-08-06 22:00:00;30,9;28,65;2,25;39398;0;0;0;0;46154;8501;0.1842;9051;-550
2016-08-06 23:00:00;26,5;26,01;0,49;39398;0;0;0;0;46154;7578;0.1642;9018;-1440
2016-09-06 00:00:00;23,67;23,01;0,66;39411;0;0;0;0;46182;6638;0.1438;7808;-1170
2016-09-06 01:00:00;21,87;20,57;1,3;39411;0;0;0;0;46182;5422;0.1174;7350;-1928
2016-09-06 02:00:00;20,81;22,09;-1,28;39411;0;0;0;0;46182;4714;0.1021;6824;-2110
2016-09-06 03:00:00;20,58;21,62;-1,04;39411;0;0;0;0;46182;4202;0.091;6276;-2074
2016-09-06 04:00:00;21,11;23,14;-2,03;39411;2;0.0001;5;-3;46182;3895;0.0844;5700;-1805
2016-09-06 05:00:00;23,06;23,38;-0,32;39411;249;0.0063;256;-7;46182;3652;0.0791;5122;-1470
2016-09-06 06:00:00;28,03;31,0;-2,97;39411;1436;0.0364;1455;-19;46182;3312;0.0717;4432;-1120
2016-09-06 07:00:00;33,97;38,15;-4,18;39411;3490;0.0885;3677;-187;46182;2608;0.0565;3667;-1059
2016-09-06 08:00:00;43,08;42,25;0,83;39411;6138;0.1558;6404;-266;46182;2031;0.044;2937;-906
2016-09-06 09:00:00;44,0;43,54;0,46;39411;8811;0.2236;9331;-520;46182;1712;0.0371;2600;-888
2016-09-06 10:00:00;42,89;39,75;3,14;39411;11842;0.3005;12262;-420;46182;1676;0.0363;2513;-837
2016-09-06 11:00:00;41,4;36,87;4,53;39411;14738;0.374;14846;-108;46182;1793;0.0388;2504;-711
2016-09-06 12:00:00;34,99;32,14;2,85;39411;16717;0.4242;16762;-45;46182;2107;0.0456;2600;-493
2016-09-06 13:00:00;33,93;30,63;3,3;39411;17662;0.4481;17893;-231;46182;2771;0.06;2965;-194
2016-09-06 14:00:00;30,2;29,42;0,78;39411;17501;0.444;18060;-559;46182;3621;0.0784;3656;-35
2016-09-06 15:00:00;27,34;25,57;1,77;39411;16810;0.4265;16963;-153;46182;3898;0.0844;4579;-681
2016-09-06 16:00:00;27,01;24,41;2,6;39411;15037;0.3816;14598;439;46182;4671;0.1011;5457;-786
2016-09-06 17:00:00;28,84;26,13;2,71;39411;11868;0.3012;11068;800;46182;5332;0.1154;6004;-672
2016-09-06 18:00:00;32,95;28,11;4,84;39411;7763;0.197;6941;822;46182;5794;0.1255;6239;-445
2016-09-06 19:00:00;34,94;30,42;4,52;39411;3833;0.0972;3206;627;46182;5741;0.1243;6266;-525
2016-09-06 20:00:00;33,7;30,44;3,26;39411;1240;0.0315;995;245;46182;5360;0.1161;6165;-805
2016-09-06 21:00:00;31,51;28,41;3,1;39411;100;0.0025;87;13;46182;5502;0.1192;6041;-539
2016-09-06 22:00:00;30,49;29,67;0,82;39411;0;0;0;0;46182;5922;0.1282;6037;-115
2016-09-06 23:00:00;25,89;26,46;-0,57;39411;0;0;0;0;46182;6701;0.1451;6176;525
2016-10-06 00:00:00;23,55;23,49;0,06;39414;0;0;0;0;46196;6849;0.1482;7227;-378
2016-10-06 01:00:00;21,57;21,05;0,52;39414;0;0;0;0;46196;6884;0.1491;7718;-834
2016-10-06 02:00:00;21,03;22,06;-1,03;39414;0;0;0;0;46196;7027;0.1521;8339;-1312
2016-10-06 03:00:00;19,91;20,69;-0,78;39414;0;0;0;0;46196;7284;0.1577;8883;-1599
2016-10-06 04:00:00;19,16;19,85;-0,69;39414;4;0.0001;7;-3;46196;7421;0.1606;9315;-1894
2016-10-06 05:00:00;20,97;23,21;-2,24;39414;352;0.0089;360;-8;46196;7491;0.1621;9648;-2157
2016-10-06 06:00:00;27,25;35,64;-8,39;39414;2062;0.0523;2050;12;46196;7348;0.1591;10001;-2653
2016-10-06 07:00:00;33,94;37,59;-3,65;39414;5709;0.1448;5711;-2;46196;7376;0.1597;10434;-3058
2016-10-06 08:00:00;35,95;37,48;-1,53;39414;10741;0.2725;10669;72;46196;7458;0.1614;10637;-3179
2016-10-06 09:00:00;30,97;33,51;-2,54;39414;16228;0.4117;15729;499;46196;7372;0.1596;10630;-3258
2016-10-06 10:00:00;24,68;27,81;-3,13;39414;20808;0.5279;19813;995;46196;7068;0.153;10691;-3623
2016-10-06 11:00:00;24,47;28,47;-4,0;39414;23633;0.5996;22531;1102;46196;7026;0.1521;10787;-3761
2016-10-06 12:00:00;22,52;26,36;-3,84;39414;25260;0.6409;23922;1338;46196;6908;0.1495;10930;-4022
2016-10-06 13:00:00;21,37;25,8;-4,43;39414;25412;0.6447;23994;1418;46196;6987;0.1512;11083;-4096
2016-10-06 14:00:00;21,06;24,87;-3,81;39414;24322;0.6171;22677;1645;46196;7203;0.1559;11145;-3942
2016-10-06 15:00:00;21,8;25,09;-3,29;39414;21913;0.556;20159;1754;46196;7459;0.1615;11179;-3720
2016-10-06 16:00:00;23,09;24,91;-1,82;39414;17940;0.4552;16631;1309;46196;7297;0.158;10886;-3589
2016-10-06 17:00:00;26,29;29,87;-3,58;39414;13150;0.3336;12130;1020;46196;6534;0.1414;10242;-3708
2016-10-06 18:00:00;30,01;33,85;-3,84;39414;8152;0.2068;7267;885;46196;5732;0.1241;9163;-3431
2016-10-06 19:00:00;32,85;35,25;-2,4;39414;3879;0.0984;3275;604;46196;4458;0.0965;7951;-3493
2016-10-06 20:00:00;32,06;33,45;-1,39;39414;1195;0.0303;1032;163;46196;3295;0.0713;6963;-3668
2016-10-06 21:00:00;31,67;34,04;-2,37;39414;84;0.0021;79;5;46196;2878;0.0623;6245;-3367
2016-10-06 22:00:00;32,86;35,75;-2,89;39414;0;0;0;0;46196;2914;0.0631;5590;-2676
2016-10-06 23:00:00;29,45;33,03;-3,58;39414;0;0;0;0;46196;2737;0.0592;4965;-2228
2016-11-06 00:00:00;26,14;25,88;0,26;39414;0;0;0;0;46214;2338;0.0506;2794;-456
2016-11-06 01:00:00;24,2;24,74;-0,54;39414;0;0;0;0;46214;1977;0.0428;2427;-450
2016-11-06 02:00:00;23,01;25,52;-2,51;39414;0;0;0;0;46214;1817;0.0393;2123;-306
2016-11-06 03:00:00;21,57;23,57;-2,0;39414;0;0;0;0;46214;1856;0.0402;1897;-41
2016-11-06 04:00:00;21,71;22,74;-1,03;39414;4;0.0001;7;-3;46214;1985;0.0429;1706;279
2016-11-06 05:00:00;21,25;21,7;-0,45;39414;276;0.007;295;-19;46214;2042;0.0442;1531;511
2016-11-06 06:00:00;21,82;21,04;0,78;39414;1629;0.0413;1658;-29;46214;1913;0.0414;1325;588
2016-11-06 07:00:00;22,85;23,42;-0,57;39414;3914;0.0993;4221;-307;46214;1348;0.0292;1074;274
2016-11-06 08:00:00;26,06;30,07;-4,01;39414;6513;0.1652;7150;-637;46214;1162;0.0252;851;311
2016-11-06 09:00:00;29,47;31,68;-2,21;39414;9416;0.2389;9894;-478;46214;1042;0.0226;713;329
2016-11-06 10:00:00;29,46;31,22;-1,76;39414;11994;0.3043;12043;-49;46214;764;0.0165;629;135
2016-11-06 11:00:00;30,03;28,85;1,18;39414;13733;0.3484;13476;257;46214;582;0.0126;571;11
2016-11-06 12:00:00;28,49;27,63;0,86;39414;14552;0.3692;14229;323;46214;564;0.0122;552;12
2016-11-06 13:00:00;25,69;25,95;-0,26;39414;14952;0.3794;14106;846;46214;596;0.0129;547;49
2016-11-06 14:00:00;23,85;24,37;-0,52;39414;14800;0.3755;13373;1427;46214;661;0.0143;590;71
2016-11-06 15:00:00;23,8;23,45;0,35;39414;13548;0.3437;12044;1504;46214;789;0.0171;733;56
2016-11-06 16:00:00;24,06;24,38;-0,32;39414;11603;0.2944;10128;1475;46214;936;0.0203;922;14
2016-11-06 17:00:00;27,92;25,26;2,66;39414;8636;0.2191;7643;993;46214;1218;0.0264;1149;69
2016-11-06 18:00:00;30,23;30,29;-0,06;39414;5600;0.1421;4898;702;46214;1672;0.0362;1420;252
2016-11-06 19:00:00;31,47;32,73;-1,26;39414;2709;0.0687;2401;308;46214;2119;0.0459;1810;309
2016-11-06 20:00:00;31,85;30,54;1,31;39414;829;0.021;767;62;46214;2392;0.0518;2261;131
2016-11-06 21:00:00;29,47;30,86;-1,39;39414;66;0.0017;67;-1;46214;2677;0.0579;2736;-59
2016-11-06 22:00:00;30,94;31,68;-0,74;39414;0;0;0;0;46214;3588;0.0777;3207;381
2016-11-06 23:00:00;27,73;25,69;2,04;39414;0;0;0;0;46214;4045;0.0875;3439;606
2016-12-06 00:00:00;22,74;22,76;-0,02;39414;0;0;0;0;46239;4022;0.087;4601;-579
2016-12-06 01:00:00;18,6;18,85;-0,25;39414;0;0;0;0;46239;4063;0.0878;4571;-508
2016-12-06 02:00:00;18,58;18,8;-0,22;39414;0;0;0;0;46239;3867;0.0836;4406;-539
2016-12-06 03:00:00;18,58;18,5;0,08;39414;0;0;0;0;46239;3728;0.0806;4114;-386
2016-12-06 04:00:00;18,54;17,18;1,36;39414;3;0.0001;7;-4;46239;3380;0.0731;3826;-446
2016-12-06 05:00:00;17,5;15,95;1,55;39414;249;0.0063;254;-5;46239;3074;0.0665;3508;-434
2016-12-06 06:00:00;17,58;14,33;3,25;39414;1462;0.0371;1347;115;46239;2700;0.0584;3078;-378
2016-12-06 07:00:00;19,16;17,86;1,3;39414;3424;0.0869;3200;224;46239;2294;0.0496;2619;-325
2016-12-06 08:00:00;21,57;23,58;-2,01;39414;5806;0.1473;5196;610;46239;2094;0.0453;2350;-256
2016-12-06 09:00:00;22,91;25,34;-2,43;39414;8478;0.2151;7166;1312;46239;2240;0.0485;2232;8
2016-12-06 10:00:00;21,19;20,89;0,3;39414;10971;0.2783;9015;1956;46239;2460;0.0532;2171;289
2016-12-06 11:00:00;25,3;21,15;4,15;39414;12931;0.3281;10550;2381;46239;2686;0.0581;2178;508
2016-12-06 12:00:00;22,94;18,52;4,42;39414;14353;0.3642;11744;2609;46239;2982;0.0645;2264;718
2016-12-06 13:00:00;19,16;12,25;6,91;39414;14576;0.3698;12292;2284;46239;3335;0.0722;2392;943
2016-12-06 14:00:00;18,53;10,69;7,84;39414;13624;0.3456;12076;1548;46239;3586;0.0776;2509;1077
2016-12-06 15:00:00;19,07;12,3;6,77;39414;11686;0.2965;11036;650;46239;3701;0.0801;2667;1034
2016-12-06 16:00:00;21,06;15,54;5,52;39414;9021;0.2289;9147;-126;46239;3547;0.0767;2852;695
2016-12-06 17:00:00;23,93;21,39;2,54;39414;6613;0.1678;6878;-265;46239;3751;0.0812;3104;647
2016-12-06 18:00:00;27,52;26,27;1,25;39414;4316;0.1095;4458;-142;46239;3916;0.0847;3446;470
2016-12-06 19:00:00;29,78;26,59;3,19;39414;2232;0.0566;2291;-59;46239;3881;0.0839;3875;6
2016-12-06 20:00:00;31,33;26,48;4,85;39414;581;0.0148;698;-117;46239;4013;0.0868;4367;-354
2016-12-06 21:00:00;29,4;25,73;3,67;39414;37;0.001;51;-14;46239;4185;0.0905;4874;-689
2016-12-06 22:00:00;29,81;28,12;1,69;39414;0;0;0;0;46239;4821;0.1043;5258;-437
2016-12-06 23:00:00;23,24;22,41;0,83;39414;0;0;0;0;46239;5003;0.1082;5463;-460
2016-06-13 00:00:00;21,34;18,47;2,87;39417;0;0;0;0;46263;5055;0.1093;5255;-200
2016-06-13 01:00:00;19,46;18,54;0,92;39417;0;0;0;0;46263;4764;0.103;5241;-477
2016-06-13 02:00:00;17,63;17,45;0,18;39417;0;0;0;0;46263;4471;0.0967;5127;-656
2016-06-13 03:00:00;18,37;16,26;2,11;39417;0;0;0;0;46263;4312;0.0932;4903;-591
2016-06-13 04:00:00;18,57;16,76;1,81;39417;2;0.0001;3;-1;46263;4197;0.0908;4710;-513
2016-06-13 05:00:00;21,03;18,53;2,5;39417;186;0.0047;170;16;46263;4354;0.0941;4551;-197
2016-06-13 06:00:00;27,31;28,98;-1,67;39417;1107;0.0281;1030;77;46263;4174;0.0902;4380;-206
2016-06-13 07:00:00;33,49;32,2;1,29;39417;2573;0.0652;2580;-7;46263;3791;0.0819;4152;-361
2016-06-13 08:00:00;37,13;34,23;2,9;39417;4477;0.1136;4288;189;46263;3468;0.075;3916;-448
2016-06-13 09:00:00;39,91;35,78;4,13;39417;6794;0.1724;6056;738;46263;3752;0.0811;3697;55
2016-06-13 10:00:00;38,17;37,3;0,87;39417;9366;0.2376;7792;1574;46263;3819;0.0825;3559;260
2016-06-13 11:00:00;39,09;34,84;4,25;39417;12024;0.3051;9397;2627;46263;3826;0.0827;3557;269
2016-06-13 12:00:00;34,23;32,66;1,57;39417;14138;0.3587;10656;3482;46263;4059;0.0877;3743;316
2016-06-13 13:00:00;32,32;29,71;2,61;39417;14885;0.3776;11434;3451;46263;4256;0.092;3966;290
2016-06-13 14:00:00;31,68;28,69;2,99;39417;13887;0.3523;11747;2140;46263;4680;0.1012;4196;484
2016-06-13 15:00:00;30,89;29,9;0,99;39417;11996;0.3043;10956;1040;46263;4953;0.1071;4460;493
2016-06-13 16:00:00;29,38;31,0;-1,62;39417;9153;0.2322;9102;51;46263;4877;0.1054;4695;182
2016-06-13 17:00:00;30,45;32,39;-1,94;39417;7282;0.1847;6841;441;46263;5028;0.1087;4792;236
2016-06-13 18:00:00;31,75;31,44;0,31;39417;5159;0.1309;4477;682;46263;5179;0.112;4838;341
2016-06-13 19:00:00;32,97;31,84;1,13;39417;2629;0.0667;2309;320;46263;5111;0.1105;4832;279
2016-06-13 20:00:00;32,58;32,64;-0,06;39417;732;0.0186;711;21;46263;4852;0.1049;4666;186
2016-06-13 21:00:00;29,98;29,47;0,51;39417;52;0.0014;59;-7;46263;4650;0.1005;4687;-37
2016-06-13 22:00:00;29,31;32,13;-2,82;39417;0;0;0;0;46263;4647;0.1004;4772;-125
2016-06-13 23:00:00;26,14;28,58;-2,44;39417;0;0;0;0;46263;4420;0.0955;4782;-362
2016-06-14 00:00:00;24,82;25,79;-0,97;39419;0;0;0;0;46286;4468;0.0965;5041;-573
2016-06-14 01:00:00;22,76;22,82;-0,06;39419;0;0;0;0;46286;4303;0.093;4994;-691
2016-06-14 02:00:00;21,88;22,32;-0,44;39419;0;0;0;0;46286;4053;0.0876;4868;-815
2016-06-14 03:00:00;21,64;19,14;2,5;39419;0;0;0;0;46286;3808;0.0822;4664;-856
2016-06-14 04:00:00;22,04;21,39;0,65;39419;2;0.0001;5;-3;46286;3518;0.076;4462;-944
2016-06-14 05:00:00;23,0;22,88;0,12;39419;222;0.0057;230;-8;46286;3390;0.0732;4256;-866
2016-06-14 06:00:00;27,4;30,28;-2,88;39419;1393;0.0354;1272;121;46286;3163;0.0684;4000;-837
2016-06-14 07:00:00;35,29;38,85;-3,56;39419;3281;0.0832;3047;234;46286;2943;0.0636;3763;-820
2016-06-14 08:00:00;38,39;40,08;-1,69;39419;5829;0.1479;5110;719;46286;2700;0.0583;3514;-814
2016-06-14 09:00:00;38,44;39,54;-1,1;39419;8935;0.2267;7347;1588;46286;2529;0.0546;3202;-673
2016-06-14 10:00:00;37,25;35,19;2,06;39419;11851;0.3006;9823;2028;46286;2397;0.0518;2927;-530
2016-06-14 11:00:00;35,83;32,4;3,43;39419;14004;0.3552;12221;1783;46286;2364;0.0511;2746;-382
2016-06-14 12:00:00;32,0;32,34;-0,34;39419;15114;0.3834;14186;928;46286;2494;0.0539;2712;-218
2016-06-14 13:00:00;29,37;32,18;-2,81;39419;16073;0.4077;15205;868;46286;2664;0.0575;2744;-80
2016-06-14 14:00:00;27,55;30,94;-3,39;39419;15744;0.3994;15181;563;46286;2713;0.0586;2782;-69
2016-06-14 15:00:00;27,38;27,8;-0,42;39419;13720;0.348;13808;-88;46286;3020;0.0652;2714;306
2016-06-14 16:00:00;28,64;28,76;-0,12;39419;11278;0.2861;11369;-91;46286;2830;0.0612;2565;265
2016-06-14 17:00:00;32,51;30,56;1,95;39419;8376;0.2125;8504;-128;46286;2706;0.0585;2324;382
2016-06-14 18:00:00;35,08;34,79;0,29;39419;5358;0.136;5426;-68;46286;2284;0.0494;1940;344
2016-06-14 19:00:00;37,5;36,51;0,99;39419;2842;0.0721;2781;61;46286;2176;0.047;1615;561
2016-06-14 20:00:00;36,0;33,1;2,9;39419;906;0.023;900;6;46286;1908;0.0412;1573;335
2016-06-14 21:00:00;32,01;30,04;1,97;39419;76;0.0019;76;0;46286;1983;0.0428;1875;108
2016-06-14 22:00:00;30,1;28,9;1,2;39419;0;0;0;0;46286;2279;0.0492;2299;-20
2016-06-14 23:00:00;26,59;26,49;0,1;39419;0;0;0;0;46286;2668;0.0576;2676;-8
2016-06-15 00:00:00;26,19;23,65;2,54;39427;0;0;0;0;46302;2995;0.0647;2839;156
2016-06-15 01:00:00;25,34;23,33;2,01;39427;0;0;0;0;46302;2974;0.0642;2915;59
2016-06-15 02:00:00;24,32;30,74;-6,42;39427;0;0;0;0;46302;2964;0.064;2829;135
2016-06-15 03:00:00;23,73;24,94;-1,21;39427;0;0;0;0;46302;2762;0.0596;2557;205
2016-06-15 04:00:00;23,52;21,52;2,0;39427;3;0.0001;5;-2;46302;2489;0.0538;2280;209
2016-06-15 05:00:00;25,31;22,94;2,37;39427;228;0.0058;254;-26;46302;2253;0.0486;2001;252
2016-06-15 06:00:00;28,37;31,95;-3,58;39427;1461;0.037;1452;9;46302;1944;0.042;1716;228
2016-06-15 07:00:00;35,91;35,19;0,72;39427;3727;0.0945;3544;183;46302;1295;0.028;1470;-175
2016-06-15 08:00:00;38,79;39,08;-0,29;39427;6543;0.166;6113;430;46302;897;0.0194;1325;-428
2016-06-15 09:00:00;36,2;36,47;-0,27;39427;9676;0.2454;8995;681;46302;914;0.0197;1308;-394
2016-06-15 10:00:00;35,91;35,83;0,08;39427;12342;0.313;11768;574;46302;988;0.0213;1337;-349
2016-06-15 11:00:00;35,51;34,93;0,58;39427;14159;0.3591;14010;149;46302;1314;0.0284;1407;-93
2016-06-15 12:00:00;30,21;30,12;0,09;39427;14574;0.3696;15487;-913;46302;1798;0.0388;1584;214
2016-06-15 13:00:00;28,29;30,67;-2,38;39427;14920;0.3784;15974;-1054;46302;2206;0.0476;1783;423
2016-06-15 14:00:00;27,99;30,48;-2,49;39427;15284;0.3877;15439;-155;46302;2558;0.0552;1972;586
2016-06-15 15:00:00;27,73;30,65;-2,92;39427;14876;0.3773;13903;973;46302;2916;0.063;2131;785
2016-06-15 16:00:00;29,12;30,03;-0,91;39427;13119;0.3327;11721;1398;46302;3022;0.0653;2179;843
2016-06-15 17:00:00;31,0;29,44;1,56;39427;10283;0.2608;8956;1327;46302;3144;0.0679;2099;1045
2016-06-15 18:00:00;34,53;33,7;0,83;39427;6463;0.1639;5783;680;46302;2847;0.0615;1895;952
2016-06-15 19:00:00;36,91;35,48;1,43;39427;3289;0.0834;2948;341;46302;2317;0.05;1654;663
2016-06-15 20:00:00;35,49;35,64;-0,15;39427;1096;0.0278;972;124;46302;1836;0.0396;1524;312
2016-06-15 21:00:00;33,25;33,57;-0,32;39427;90;0.0023;76;14;46302;1636;0.0353;1778;-142
2016-06-15 22:00:00;33,02;37,32;-4,3;39427;0;0;0;0;46302;1856;0.0401;2237;-381
2016-06-15 23:00:00;27,33;29,2;-1,87;39427;0;0;0;0;46302;2521;0.0544;2688;-167
2016-06-16 00:00:00;26,46;28,33;-1,87;39430;0;0;0;0;46376;2912;0.0628;3160;-248
2016-06-16 01:00:00;25,64;26,87;-1,23;39430;0;0;0;0;46376;3036;0.0655;3456;-420
2016-06-16 02:00:00;24,6;25,69;-1,09;39430;0;0;0;0;46376;3104;0.067;3609;-505
2016-06-16 03:00:00;23,61;23,98;-0,37;39430;0;0;0;0;46376;3168;0.0683;3516;-348
2016-06-16 04:00:00;23,99;21,98;2,01;39430;5;0.0001;7;-2;46376;3105;0.067;3265;-160
2016-06-16 05:00:00;24,95;24,19;0,76;39430;339;0.0086;330;9;46376;2817;0.0608;2823;-6
2016-06-16 06:00:00;29,84;31,04;-1,2;39430;1841;0.0467;1828;13;46376;2302;0.0496;2211;91
2016-06-16 07:00:00;37,82;34,64;3,18;39430;4999;0.1268;4927;72;46376;1155;0.0249;1556;-401
2016-06-16 08:00:00;39,74;35,51;4,23;39430;8774;0.2225;8929;-155;46376;590;0.0127;1124;-534
2016-06-16 09:00:00;35,43;33,1;2,33;39430;11960;0.3033;12978;-1018;46376;419;0.009;957;-538
2016-06-16 10:00:00;34,88;34,21;0,67;39430;14598;0.3702;16226;-1628;46376;598;0.0129;913;-315
2016-06-16 11:00:00;33,76;35,12;-1,36;39430;16319;0.4139;18143;-1824;46376;736;0.0159;961;-225
2016-06-16 12:00:00;29,71;34,08;-4,37;39430;16198;0.4108;18864;-2666;46376;738;0.0159;1039;-301
2016-06-16 13:00:00;26,98;33,94;-6,96;39430;14895;0.3778;18567;-3672;46376;701;0.0152;1093;-392
2016-06-16 14:00:00;27,44;35,14;-7,7;39430;12950;0.3284;17242;-4292;46376;690;0.0149;1070;-380
2016-06-16 15:00:00;28,47;35,65;-7,18;39430;10966;0.2781;14986;-4020;46376;718;0.0154;977;-259
2016-06-16 16:00:00;31,75;36,49;-4,74;39430;8592;0.2179;11815;-3223;46376;694;0.015;853;-159
2016-06-16 17:00:00;33,03;37,52;-4,49;39430;6652;0.1687;8242;-1590;46376;921;0.0198;851;70
2016-06-16 18:00:00;34,71;36,19;-1,48;39430;4286;0.1087;5023;-737;46376;1083;0.0234;1034;49
2016-06-16 19:00:00;35,2;36,39;-1,19;39430;2157;0.0547;2600;-443;46376;972;0.021;1367;-395
2016-06-16 20:00:00;35,28;37,48;-2,2;39430;629;0.016;855;-226;46376;972;0.021;1970;-998
2016-06-16 21:00:00;33,02;34,04;-1,02;39430;71;0.0018;73;-2;46376;928;0.02;2815;-1887
2016-06-16 22:00:00;31,05;34,04;-2,99;39430;0;0;0;0;46376;868;0.0187;3743;-2875
2016-06-16 23:00:00;26,62;28,55;-1,93;39430;0;0;0;0;46376;952;0.0205;4502;-3550
2016-06-17 00:00:00;25,9;28,22;-2,32;39434;0;0;0;0;46403;1226;0.0264;3245;-2019
2016-06-17 01:00:00;23,73;26,18;-2,45;39434;0;0;0;0;46403;1606;0.0346;3593;-1987
2016-06-17 02:00:00;22,16;25,18;-3,02;39434;0;0;0;0;46403;1992;0.043;3939;-1947
2016-06-17 03:00:00;21,37;22,96;-1,59;39434;0;0;0;0;46403;2484;0.0536;4190;-1706
2016-06-17 04:00:00;21,72;22,66;-0,94;39434;2;0.0001;1;1;46403;2816;0.0607;4459;-1643
2016-06-17 05:00:00;22,45;24,64;-2,19;39434;130;0.0033;129;1;46403;3308;0.0713;4788;-1480
2016-06-17 06:00:00;27,85;31,55;-3,7;39434;899;0.0228;845;54;46403;3913;0.0844;5176;-1263
2016-06-17 07:00:00;35,3;42,85;-7,55;39434;2284;0.0579;2210;74;46403;4043;0.0871;5551;-1508
2016-06-17 08:00:00;39,7;47,26;-7,56;39434;3787;0.096;3939;-152;46403;4596;0.099;5989;-1393
2016-06-17 09:00:00;37,5;44,77;-7,27;39434;5703;0.1446;5926;-223;46403;5152;0.111;6754;-1602
2016-06-17 10:00:00;34,94;43,47;-8,53;39434;7863;0.1994;8196;-333;46403;5903;0.1272;7697;-1794
2016-06-17 11:00:00;33,25;43,1;-9,85;39434;9765;0.2476;10626;-861;46403;6810;0.1468;8485;-1675
2016-06-17 12:00:00;28,81;36,12;-7,31;39434;12211;0.3097;12783;-572;46403;7632;0.1645;9057;-1425
2016-06-17 13:00:00;24,97;29,82;-4,85;39434;13702;0.3475;14136;-434;46403;8110;0.1748;9501;-1391
2016-06-17 14:00:00;23,92;26,22;-2,3;39434;14487;0.3674;14518;-31;46403;9093;0.196;9637;-544
2016-06-17 15:00:00;23,01;22,59;0,42;39434;13642;0.3459;13656;-14;46403;9249;0.1993;9543;-294
2016-06-17 16:00:00;23,06;21,23;1,83;39434;11884;0.3014;11615;269;46403;9138;0.197;9431;-293
2016-06-17 17:00:00;26,55;25,66;0,89;39434;9698;0.2459;8775;923;46403;9211;0.1985;9038;173
2016-06-17 18:00:00;30,72;29,06;1,66;39434;6957;0.1764;5664;1293;46403;8854;0.1908;8267;587
2016-06-17 19:00:00;32,15;30,51;1,64;39434;3610;0.0915;2934;676;46403;8321;0.1793;7385;936
2016-06-17 20:00:00;30,59;28,68;1,91;39434;1159;0.0294;994;165;46403;7924;0.1707;6760;1164
2016-06-17 21:00:00;28,16;27,52;0,64;39434;99;0.0025;83;16;46403;7930;0.1709;6848;1082
2016-06-17 22:00:00;29,08;27,83;1,25;39434;0;0;0;0;46403;8368;0.1803;7148;1220
2016-06-17 23:00:00;26,07;24,11;1,96;39434;0;0;0;0;46403;8754;0.1887;7463;1291
2016-06-18 00:00:00;23,06;19,62;3,44;39434;0;0;0;0;46407;8756;0.1887;7893;863
2016-06-18 01:00:00;22,45;18,23;4,22;39434;0;0;0;0;46407;8812;0.1899;7745;1067
2016-06-18 02:00:00;21,02;17,76;3,26;39434;0;0;0;0;46407;8712;0.1877;7478;1234
2016-06-18 03:00:00;20,09;15,09;5,0;39434;0;0;0;0;46407;8331;0.1795;7146;1185
2016-06-18 04:00:00;20,06;14,59;5,47;39434;5;0.0001;7;-2;46407;8149;0.1756;6734;1415
2016-06-18 05:00:00;18,75;12,47;6,28;39434;353;0.009;377;-24;46407;7738;0.1668;6189;1549
2016-06-18 06:00:00;20,73;13,55;7,18;39434;1973;0.0501;2039;-66;46407;6799;0.1465;5594;1205
2016-06-18 07:00:00;22,75;20,21;2,54;39434;5190;0.1316;5325;-135;46407;5916;0.1275;5132;784
2016-06-18 08:00:00;24,47;27,69;-3,22;39434;9287;0.2356;9416;-129;46407;5639;0.1215;5026;613
2016-06-18 09:00:00;23,0;25,1;-2,1;39434;13260;0.3363;13390;-130;46407;6078;0.131;5172;906
2016-06-18 10:00:00;21,64;22,7;-1,06;39434;16082;0.4078;16434;-352;46407;6466;0.1394;5398;1068
2016-06-18 11:00:00;21,08;22,94;-1,86;39434;17514;0.4442;18367;-853;46407;7028;0.1514;5590;1438
2016-06-18 12:00:00;16,04;19,03;-2,99;39434;18162;0.4606;19456;-1294;46407;7201;0.1552;5666;1535
2016-06-18 13:00:00;12,85;19,69;-6,84;39434;17975;0.4558;19322;-1347;46407;6969;0.1502;5673;1296
2016-06-18 14:00:00;15,93;19,92;-3,99;39434;17110;0.4339;18023;-913;46407;6466;0.1393;5550;916
2016-06-18 15:00:00;18,67;21,89;-3,22;39434;15310;0.3882;15710;-400;46407;6055;0.1305;5308;747
2016-06-18 16:00:00;21,49;20,98;0,51;39434;13090;0.332;12769;321;46407;5417;0.1168;4963;454
2016-06-18 17:00:00;23,38;22,03;1,35;39434;9944;0.2522;9399;545;46407;4792;0.1032;4488;304
2016-06-18 18:00:00;26,53;25,99;0,54;39434;6802;0.1725;6023;779;46407;4344;0.0936;4023;321
2016-06-18 19:00:00;27,28;21,82;5,46;39434;3565;0.0904;3144;421;46407;3676;0.0792;3654;22
2016-06-18 20:00:00;26,83;25,64;1,19;39434;1159;0.0294;1087;72;46407;3333;0.0718;3518;-185
2016-06-18 21:00:00;26,97;27,7;-0,73;39434;104;0.0026;94;10;46407;3374;0.0727;3665;-291
2016-06-18 22:00:00;28,0;28,21;-0,21;39434;0;0;0;0;46407;3924;0.0845;3935;-11
2016-06-18 23:00:00;24,48;23,39;1,09;39434;0;0;0;0;46407;4496;0.0968;4236;260
2016-06-19 00:00:00;20,64;15,36;5,28;39435;0;0;0;0;46407;5131;0.1106;4490;641
2016-06-19 01:00:00;15,16;8,9;6,26;39435;0;0;0;0;46407;5430;0.117;4856;574
2016-06-19 02:00:00;13,04;7,76;5,28;39435;0;0;0;0;46407;5250;0.1131;5005;245
2016-06-19 03:00:00;10,88;7,5;3,38;39435;0;0;0;0;46407;5162;0.1112;4921;241
2016-06-19 04:00:00;15,04;8,72;6,32;39435;4;0.0001;6;-2;46407;4957;0.1068;4745;212
2016-06-19 05:00:00;13,1;7,04;6,06;39435;278;0.0071;295;-17;46407;4891;0.1054;4531;360
2016-06-19 06:00:00;10,16;6,07;4,09;39435;1570;0.0398;1622;-52;46407;4542;0.0979;4349;193
2016-06-19 07:00:00;10,13;6,13;4,0;39435;3983;0.101;3864;119;46407;3955;0.0852;4110;-155
2016-06-19 08:00:00;14,29;11,27;3,02;39435;6811;0.1727;6488;323;46407;3663;0.0789;3999;-336
2016-06-19 09:00:00;16,98;12,08;4,9;39435;9469;0.2401;9198;271;46407;3742;0.0806;3943;-201
2016-06-19 10:00:00;17,55;13,05;4,5;39435;11592;0.2939;11687;-95;46407;3844;0.0829;3919;-75
2016-06-19 11:00:00;19,08;16,4;2,68;39435;12774;0.3239;13755;-981;46407;3640;0.0784;4030;-390
2016-06-19 12:00:00;17,12;20,37;-3,25;39435;13536;0.3432;15243;-1707;46407;3851;0.083;4320;-469
2016-06-19 13:00:00;11,63;16,5;-4,87;39435;14604;0.3703;16016;-1412;46407;4035;0.087;4637;-602
2016-06-19 14:00:00;9,04;14,13;-5,09;39435;15082;0.3824;15777;-695;46407;4332;0.0933;4793;-461
2016-06-19 15:00:00;8,9;12,05;-3,15;39435;14432;0.366;14661;-229;46407;4228;0.0911;4867;-639
2016-06-19 16:00:00;11,79;9,54;2,25;39435;12696;0.3219;12620;76;46407;4051;0.0873;4904;-853
2016-06-19 17:00:00;19,04;18,45;0,59;39435;9999;0.2536;9758;241;46407;3495;0.0753;4675;-1180
2016-06-19 18:00:00;22,97;22,06;0,91;39435;6741;0.171;6420;321;46407;3093;0.0666;4076;-983
2016-06-19 19:00:00;26,95;29,04;-2,09;39435;3622;0.0918;3407;215;46407;2796;0.0602;3427;-631
2016-06-19 20:00:00;27,8;28,67;-0,87;39435;1229;0.0312;1185;44;46407;2170;0.0468;2809;-639
2016-06-19 21:00:00;29,88;30,83;-0,95;39435;116;0.003;105;11;46407;1862;0.0401;2491;-629
2016-06-19 22:00:00;29,26;32,71;-3,45;39435;0;0;0;0;46407;1953;0.0421;2345;-392
2016-06-19 23:00:00;27,14;26,66;0,48;39435;0;0;0;0;46407;2140;0.0461;2305;-165
2016-06-20 00:00:00;24,92;24,12;0,8;39437;0;0;0;0;46418;2487;0.0536;2199;288
2016-06-20 01:00:00;21,6;20,6;1,0;39437;0;0;0;0;46418;3210;0.0691;2664;546
2016-06-20 02:00:00;20,4;19,15;1,25;39437;0;0;0;0;46418;4589;0.0989;3269;1320
2016-06-20 03:00:00;17,45;13,23;4,22;39437;0;0;0;0;46418;6012;0.1295;4039;1973
2016-06-20 04:00:00;17,05;10,2;6,85;39437;5;0.0001;8;-3;46418;7128;0.1536;4865;2263
2016-06-20 05:00:00;19,99;14,28;5,71;39437;363;0.0092;382;-19;46418;7604;0.1638;5531;2073
2016-06-20 06:00:00;28,97;23,69;5,28;39437;1962;0.0498;2094;-132;46418;7503;0.1617;5842;1661
2016-06-20 07:00:00;34,42;33,66;0,76;39437;5731;0.1453;5775;-44;46418;6896;0.1486;5957;939
2016-06-20 08:00:00;34,94;34,34;0,6;39437;11000;0.2789;10618;382;46418;6729;0.145;6182;547
2016-06-20 09:00:00;29,44;27,87;1,57;39437;16074;0.4076;15213;861;46418;7923;0.1707;6848;1075
2016-06-20 10:00:00;26,84;25,37;1,47;39437;19011;0.4821;18059;952;46418;9060;0.1952;7707;1353
2016-06-20 11:00:00;26,95;23,67;3,28;39437;20184;0.5118;19248;936;46418;9656;0.208;8498;1158
2016-06-20 12:00:00;25,51;24,11;1,4;39437;20658;0.5238;19336;1322;46418;9932;0.214;9121;811
2016-06-20 13:00:00;25,24;25,11;0,13;39437;20724;0.5255;18831;1893;46418;10456;0.2252;9674;782
2016-06-20 14:00:00;25,44;23,4;2,04;39437;19561;0.496;17510;2051;46418;10557;0.2274;10076;481
2016-06-20 15:00:00;25,49;24,31;1,18;39437;17071;0.4329;15427;1644;46418;10738;0.2313;10423;315
2016-06-20 16:00:00;25,19;24,75;0,44;39437;13935;0.3533;12613;1322;46418;10788;0.2324;10590;198
2016-06-20 17:00:00;27,74;25,71;2,03;39437;10170;0.2579;9149;1021;46418;10880;0.2344;10491;389
2016-06-20 18:00:00;32,97;29,86;3,11;39437;5830;0.1478;5597;233;46418;10836;0.2334;10320;516
2016-06-20 19:00:00;34,96;31,44;3,52;39437;2512;0.0637;2705;-193;46418;10950;0.2359;10192;758
2016-06-20 20:00:00;33,57;28,9;4,67;39437;662;0.0168;895;-233;46418;10978;0.2365;10334;644
2016-06-20 21:00:00;31,76;27,99;3,77;39437;39;0.001;65;-26;46418;11358;0.2447;10360;998
2016-06-20 22:00:00;30,74;27,12;3,62;39437;0;0;0;0;46418;11889;0.2561;10302;1587
2016-06-20 23:00:00;25,38;24,4;0,98;39437;0;0;0;0;46418;11647;0.2509;10054;1593
2016-06-21 00:00:00;24,23;25,05;-0,82;39439;0;0;0;0;46446;11206;0.2413;10039;1167
2016-06-21 01:00:00;23,37;21,64;1,73;39439;0;0;0;0;46446;10296;0.2217;9218;1078
2016-06-21 02:00:00;22,34;20,83;1,51;39439;0;0;0;0;46446;9378;0.2019;8262;1116
2016-06-21 03:00:00;21,23;18,63;2,6;39439;0;0;0;0;46446;8753;0.1885;7223;1530
2016-06-21 04:00:00;21,89;18,18;3,71;39439;2;0;1;1;46446;8074;0.1738;6307;1767
2016-06-21 05:00:00;23,93;19,09;4,84;39439;129;0.0033;113;16;46446;7145;0.1538;5622;1523
2016-06-21 06:00:00;29,54;22,58;6,96;39439;907;0.023;630;277;46446;6198;0.1335;5055;1143
2016-06-21 07:00:00;38,73;36,3;2,43;39439;2513;0.0637;1607;906;46446;5135;0.1106;4519;616
2016-06-21 08:00:00;40,78;38,67;2,11;39439;4764;0.1208;2830;1934;46446;4672;0.1006;4025;647
2016-06-21 09:00:00;42,59;35,29;7,3;39439;7299;0.185;4257;3042;46446;4408;0.0949;3553;855
2016-06-21 10:00:00;41,79;34,02;7,77;39439;10188;0.2583;5955;4233;46446;4388;0.0945;3191;1197
2016-06-21 11:00:00;43,73;33,17;10,56;39439;12465;0.316;7659;4806;46446;4349;0.0936;2953;1396
2016-06-21 12:00:00;39,59;31,35;8,24;39439;13951;0.3537;9159;4792;46446;4038;0.087;2764;1274
2016-06-21 13:00:00;37,64;30,25;7,39;39439;14669;0.372;10280;4389;46446;3761;0.081;2593;1168
2016-06-21 14:00:00;35,84;30,1;5,74;39439;15485;0.3926;10922;4563;46446;3183;0.0685;2397;786
2016-06-21 15:00:00;34,16;29,38;4,78;39439;14840;0.3762;10714;4126;46446;2679;0.0576;2195;484
2016-06-21 16:00:00;32,45;30,08;2,37;39439;12798;0.3245;9571;3227;46446;2115;0.0456;1954;161
2016-06-21 17:00:00;33,05;32,53;0,52;39439;10155;0.2575;7713;2442;46446;1834;0.0395;1696;138
2016-06-21 18:00:00;34,94;36,62;-1,68;39439;6596;0.1673;5312;1284;46446;1508;0.0325;1443;65
2016-06-21 19:00:00;35,91;37,6;-1,69;39439;3288;0.0834;2914;374;46446;1168;0.0251;1202;-34
2016-06-21 20:00:00;37,44;38,81;-1,37;39439;1040;0.0264;985;55;46446;1162;0.025;1165;-3
2016-06-21 21:00:00;34,98;36,72;-1,74;39439;88;0.0022;88;0;46446;1415;0.0304;1566;-151
2016-06-21 22:00:00;33,93;38,38;-4,45;39439;0;0;0;0;46446;1710;0.0368;2167;-457
2016-06-21 23:00:00;30,0;33,77;-3,77;39439;0;0;0;0;46446;2299;0.0495;2836;-537
2016-06-22 00:00:00;28,06;29,78;-1,72;39442;0;0;0;0;46467;2824;0.0608;2525;299
2016-06-22 01:00:00;24,95;27,98;-3,03;39442;0;0;0;0;46467;3379;0.0727;2846;533
2016-06-22 02:00:00;23,95;26,48;-2,53;39442;0;0;0;0;46467;3426;0.0738;3055;371
2016-06-22 03:00:00;23,14;25,34;-2,2;39442;0;0;0;0;46467;3472;0.0748;3033;439
2016-06-22 04:00:00;22,97;26,24;-3,27;39442;4;0.0001;4;0;46467;3435;0.0739;2880;555
2016-06-22 05:00:00;24,06;28,73;-4,67;39442;254;0.0064;260;-6;46467;3167;0.0682;2588;579
2016-06-22 06:00:00;29,98;35,25;-5,27;39442;1580;0.0401;1595;-15;46467;2960;0.0637;2215;745
2016-06-22 07:00:00;40,0;45,25;-5,25;39442;4336;0.11;4036;300;46467;2546;0.0548;1695;851
2016-06-22 08:00:00;42,0;45,7;-3,7;39442;8228;0.2086;7285;943;46467;1989;0.0428;1315;674
2016-06-22 09:00:00;40,0;41,07;-1,07;39442;12638;0.3204;10893;1745;46467;2203;0.0474;1356;847
2016-06-22 10:00:00;37,27;34,84;2,43;39442;16653;0.4222;14026;2627;46467;2422;0.0521;1457;965
2016-06-22 11:00:00;36,62;31,96;4,66;39442;19186;0.4864;16457;2729;46467;2857;0.0615;1617;1240
2016-06-22 12:00:00;33,6;28,95;4,65;39442;20158;0.5111;17924;2234;46467;3274;0.0704;1778;1496
2016-06-22 13:00:00;30,29;26,72;3,57;39442;20657;0.5237;18433;2224;46467;3082;0.0663;1856;1226
2016-06-22 14:00:00;28,94;27,05;1,89;39442;20357;0.5161;18152;2205;46467;2749;0.0592;1768;981
2016-06-22 15:00:00;28,93;27,32;1,61;39442;18740;0.4751;16891;1849;46467;2371;0.051;1605;766
2016-06-22 16:00:00;30,31;30,16;0,15;39442;16407;0.416;14676;1731;46467;1849;0.0398;1332;517
2016-06-22 17:00:00;33,7;34,69;-0,99;39442;12741;0.323;11351;1390;46467;1326;0.0285;1072;254
2016-06-22 18:00:00;38,12;40,65;-2,53;39442;8248;0.2091;7289;959;46467;745;0.016;838;-93
2016-06-22 19:00:00;39,8;42,04;-2,24;39442;4057;0.1028;3580;477;46467;409;0.0088;672;-263
2016-06-22 20:00:00;38,3;40,19;-1,89;39442;1282;0.0325;1232;50;46467;327;0.007;766;-439
2016-06-22 21:00:00;37,39;40,18;-2,79;39442;109;0.0028;114;-5;46467;464;0.01;1264;-800
2016-06-22 22:00:00;35,98;41,39;-5,41;39442;0;0;0;0;46467;920;0.0198;1987;-1067
2016-06-22 23:00:00;30,35;34,81;-4,46;39442;0;0;0;0;46467;1728;0.0372;2831;-1103
2016-06-23 00:00:00;28,09;32,69;-4,6;39447;0;0;0;0;46501;2889;0.0621;3121;-232
2016-06-23 01:00:00;25,64;30,19;-4,55;39447;0;0;0;0;46501;4046;0.087;4019;27
2016-06-23 02:00:00;24,38;30,28;-5,9;39447;0;0;0;0;46501;5099;0.1096;4803;296
2016-06-23 03:00:00;23,3;26,22;-2,92;39447;0;0;0;0;46501;6137;0.132;5408;729
2016-06-23 04:00:00;23,24;19,28;3,96;39447;4;0.0001;7;-3;46501;6750;0.1452;5871;879
2016-06-23 05:00:00;24,14;24,06;0,08;39447;378;0.0096;366;12;46501;7312;0.1572;6001;1311
2016-06-23 06:00:00;28,16;31,02;-2,86;39447;2075;0.0526;2083;-8;46501;7210;0.1551;5753;1457
2016-06-23 07:00:00;35,91;35,66;0,25;39447;6141;0.1557;6009;132;46501;5956;0.1281;5085;871
2016-06-23 08:00:00;35,91;37,01;-1,1;39447;11640;0.2951;11398;242;46501;3970;0.0854;4254;-284
2016-06-23 09:00:00;34,97;31,71;3,26;39447;17208;0.4362;16770;438;46501;3515;0.0756;4082;-567
2016-06-23 10:00:00;29,78;29,74;0,04;39447;21720;0.5507;21157;563;46501;4308;0.0926;4165;143
2016-06-23 11:00:00;27,95;26,44;1,51;39447;24675;0.6255;24158;517;46501;4918;0.1058;4405;513
2016-06-23 12:00:00;25,62;25,64;-0,02;39447;25972;0.6584;25726;246;46501;5325;0.1145;4817;508
2016-06-23 13:00:00;25,08;25,31;-0,23;39447;26011;0.6594;25911;100;46501;5498;0.1182;5164;334
2016-06-23 14:00:00;25,37;26,6;-1,23;39447;24540;0.6221;24877;-337;46501;5612;0.1207;5366;246
2016-06-23 15:00:00;25,71;27,49;-1,78;39447;22335;0.5662;22486;-151;46501;5306;0.1141;5540;-234
2016-06-23 16:00:00;27,31;30,22;-2,91;39447;18882;0.4787;18585;297;46501;5204;0.1119;5391;-187
2016-06-23 17:00:00;30,83;34,93;-4,1;39447;14170;0.3592;13487;683;46501;5147;0.1107;5060;87
2016-06-23 18:00:00;35,92;45,02;-9,1;39447;8676;0.2199;7830;846;46501;5233;0.1126;4824;409
2016-06-23 19:00:00;40,06;49,87;-9,81;39447;3869;0.0981;3403;466;46501;5447;0.1171;4739;708
2016-06-23 20:00:00;38,04;48,78;-10,74;39447;1285;0.0326;1091;194;46501;5920;0.1273;5146;774
2016-06-23 21:00:00;32,72;41,53;-8,81;39447;133;0.0034;114;19;46501;7596;0.1634;6578;1018
2016-06-23 22:00:00;30,77;38,9;-8,13;39447;0;0;0;0;46501;9414;0.2024;8089;1325
2016-06-23 23:00:00;26,99;29,85;-2,86;39447;0;0;0;0;46501;9832;0.2114;8789;1043
2016-06-24 00:00:00;26,03;28,86;-2,83;39450;0;0;0;0;46534;9807;0.2108;8680;1127
2016-06-24 01:00:00;24,56;25,69;-1,13;39450;0;0;0;0;46534;9429;0.2026;8134;1295
2016-06-24 02:00:00;24,08;26,25;-2,17;39450;0;0;0;0;46534;8804;0.1892;7431;1373
2016-06-24 03:00:00;23,36;25,57;-2,21;39450;0;0;0;0;46534;8218;0.1766;6727;1491
2016-06-24 04:00:00;23,91;24,7;-0,79;39450;4;0.0001;7;-3;46534;6893;0.1481;6108;785
2016-06-24 05:00:00;26,43;27,13;-0,7;39450;350;0.0089;352;-2;46534;6524;0.1402;5557;967
2016-06-24 06:00:00;31,86;35,0;-3,14;39450;1990;0.0504;2025;-35;46534;6697;0.1439;4846;1851
2016-06-24 07:00:00;37,03;39,01;-1,98;39450;5610;0.1422;5850;-240;46534;5859;0.1259;3964;1895
2016-06-24 08:00:00;38,84;37,52;1,32;39450;10126;0.2567;11050;-924;46534;4402;0.0946;3094;1308
2016-06-24 09:00:00;34,46;35,62;-1,16;39450;15051;0.3815;16231;-1180;46534;3485;0.0749;2733;752
2016-06-24 10:00:00;31,96;36,39;-4,43;39450;19211;0.487;20382;-1171;46534;2800;0.0602;2501;299
2016-06-24 11:00:00;30,01;35,62;-5,61;39450;21818;0.553;23055;-1237;46534;2431;0.0522;2472;-41
2016-06-24 12:00:00;29,93;35,27;-5,34;39450;22940;0.5815;24328;-1388;46534;2417;0.052;2675;-258
2016-06-24 13:00:00;28,27;34,0;-5,73;39450;22722;0.576;24156;-1434;46534;2218;0.0477;3032;-814
2016-06-24 14:00:00;28,66;34,5;-5,84;39450;20906;0.5299;22732;-1826;46534;2521;0.0542;3165;-644
2016-06-24 15:00:00;28,38;34,79;-6,41;39450;18559;0.4704;20247;-1688;46534;2355;0.0506;3061;-706
2016-06-24 16:00:00;29,63;34,89;-5,26;39450;15648;0.3966;16693;-1045;46534;2541;0.0546;2952;-411
2016-06-24 17:00:00;31,65;37,05;-5,4;39450;11654;0.2954;12083;-429;46534;2860;0.0614;2737;123
2016-06-24 18:00:00;34,98;38,98;-4,0;39450;7171;0.1818;7197;-26;46534;3393;0.0729;2523;870
2016-06-24 19:00:00;35,53;41,21;-5,68;39450;3217;0.0816;3334;-117;46534;4010;0.0862;2364;1646
2016-06-24 20:00:00;34,95;36,98;-2,03;39450;1001;0.0254;1135;-134;46534;3506;0.0753;2443;1063
2016-06-24 21:00:00;33,28;36,33;-3,05;39450;89;0.0022;102;-13;46534;3694;0.0794;2806;888
2016-06-24 22:00:00;34,12;38,27;-4,15;39450;0;0;0;0;46534;4052;0.0871;3124;928
2016-06-24 23:00:00;32,04;32,52;-0,48;39450;0;0;0;0;46534;4011;0.0862;3224;787
2016-06-25 00:00:00;30,14;30,73;-0,59;39450;0;0;0;0;46536;3477;0.0747;3606;-129
2016-06-25 01:00:00;28,97;30,63;-1,66;39450;0;0;0;0;46536;3292;0.0708;3355;-63
2016-06-25 02:00:00;26,64;27,29;-0,65;39450;0;0;0;0;46536;2842;0.0611;3110;-268
2016-06-25 03:00:00;24,28;28,08;-3,8;39450;0;0;0;0;46536;2780;0.0598;2995;-215
2016-06-25 04:00:00;23,35;27,99;-4,64;39450;4;0.0001;4;0;46536;3099;0.0666;2961;138
2016-06-25 05:00:00;23,0;26,24;-3,24;39450;281;0.0072;284;-3;46536;3090;0.0664;2858;232
2016-06-25 06:00:00;24,0;25,62;-1,62;39450;1514;0.0384;1497;17;46536;2889;0.0621;2578;311
2016-06-25 07:00:00;26,93;28,17;-1,24;39450;3778;0.0957;3744;34;46536;2523;0.0542;2223;300
2016-06-25 08:00:00;30,25;30,92;-0,67;39450;7056;0.1788;6429;627;46536;2059;0.0442;1927;132
2016-06-25 09:00:00;32,96;32,09;0,87;39450;10295;0.261;9111;1184;46536;2023;0.0435;1878;145
2016-06-25 10:00:00;33,86;30,6;3,26;39450;12918;0.3274;11361;1557;46536;1987;0.0427;1895;92
2016-06-25 11:00:00;32,95;30,65;2,3;39450;15383;0.3899;12989;2394;46536;2344;0.0504;2024;320
2016-06-25 12:00:00;30,06;28,88;1,18;39450;16708;0.4235;14003;2705;46536;2901;0.0623;2370;531
2016-06-25 13:00:00;27,81;24,06;3,75;39450;16802;0.4259;14046;2756;46536;3402;0.0731;2977;425
2016-06-25 14:00:00;25,08;22,1;2,98;39450;15680;0.3974;13204;2476;46536;4308;0.0926;3728;580
2016-06-25 15:00:00;24,43;22,97;1,46;39450;12873;0.3263;11625;1248;46536;6062;0.1302;4357;1705
2016-06-25 16:00:00;24,43;23,47;0,96;39450;9631;0.2442;9475;156;46536;7551;0.1623;4901;2650
2016-06-25 17:00:00;27,31;23,74;3,57;39450;6242;0.1582;6990;-748;46536;8718;0.1874;5078;3640
2016-06-25 18:00:00;29,42;26,0;3,42;39450;3406;0.0864;4589;-1183;46536;8671;0.1863;5050;3621
2016-06-25 19:00:00;30,53;26,58;3,95;39450;1707;0.0433;2474;-767;46536;8218;0.1766;5003;3215
2016-06-25 20:00:00;29,8;25,89;3,91;39450;620;0.0157;832;-212;46536;8288;0.1781;4811;3477
2016-06-25 21:00:00;28,81;24,12;4,69;39450;69;0.0017;69;0;46536;8500;0.1826;4698;3802
2016-06-25 22:00:00;29,61;25,67;3,94;39450;0;0;0;0;46536;8435;0.1812;4907;3528
2016-06-25 23:00:00;27,02;24,26;2,76;39450;0;0;0;0;46536;9669;0.2078;5330;4339
2016-06-26 00:00:00;17,29;20,4;-3,11;39450;0;0;0;0;46542;10132;0.2177;8919;1213
2016-06-26 01:00:00;12,78;14,44;-1,66;39450;0;0;0;0;46542;11063;0.2377;8984;2079
2016-06-26 02:00:00;14,25;9,32;4,93;39450;0;0;0;0;46542;10658;0.229;8763;1895
2016-06-26 03:00:00;13,35;6,97;6,38;39450;0;0;0;0;46542;10255;0.2203;8403;1852
2016-06-26 04:00:00;13,08;5,6;7,48;39450;2;0;2;0;46542;10067;0.2163;7949;2118
2016-06-26 05:00:00;12,43;4,12;8,31;39450;266;0.0067;289;-23;46542;8661;0.1861;7496;1165
2016-06-26 06:00:00;11,53;5,35;6,18;39450;1586;0.0402;1697;-111;46542;7674;0.1649;6986;688
2016-06-26 07:00:00;12,63;7,81;4,82;39450;4296;0.1089;4421;-125;46542;6792;0.1459;6496;296
2016-06-26 08:00:00;13,46;12,36;1,1;39450;8271;0.2097;8000;271;46542;7144;0.1535;6240;904
2016-06-26 09:00:00;13,51;8,9;4,61;39450;12239;0.3103;11691;548;46542;8051;0.173;6264;1787
2016-06-26 10:00:00;9,79;5,83;3,96;39450;15651;0.3967;14680;971;46542;8768;0.1884;6390;2378
2016-06-26 11:00:00;12,86;5,52;7,34;39450;17484;0.4432;16602;882;46542;8729;0.1876;6640;2089
2016-06-26 12:00:00;12,08;4,84;7,24;39450;18278;0.4633;17641;637;46542;8559;0.1839;6851;1708
2016-06-26 13:00:00;9,29;5,61;3,68;39450;18004;0.4564;17867;137;46542;7758;0.1667;6886;872
2016-06-26 14:00:00;8,05;5,36;2,69;39450;16886;0.428;17083;-197;46542;7609;0.1635;6771;838
2016-06-26 15:00:00;9,19;11,15;-1,96;39450;14500;0.3676;15321;-821;46542;7406;0.1591;6447;959
2016-06-26 16:00:00;11,67;12,41;-0,74;39450;12186;0.3089;12755;-569;46542;6670;0.1433;6030;640
2016-06-26 17:00:00;15,79;18,36;-2,57;39450;9532;0.2416;9579;-47;46542;5910;0.127;5492;418
2016-06-26 18:00:00;23,76;23,86;-0,1;39450;6556;0.1662;6167;389;46542;5124;0.1101;4903;221
2016-06-26 19:00:00;26,79;24,07;2,72;39450;3423;0.0868;3202;221;46542;4533;0.0974;4448;85
2016-06-26 20:00:00;29,97;27,98;1,99;39450;1139;0.0288;1110;29;46542;3785;0.0814;4361;-576
2016-06-26 21:00:00;28,46;29,35;-0,89;39450;108;0.0027;107;1;46542;3834;0.0824;4576;-742
2016-06-26 22:00:00;31,91;32,05;-0,14;39450;0;0;0;0;46542;4290;0.0922;4984;-694
2016-06-26 23:00:00;28,12;30,39;-2,27;39450;0;0;0;0;46542;4913;0.1056;5565;-652
2016-06-27 00:00:00;24,1;24,5;-0,4;39454;0;0;0;0;46587;5117;0.1098;4675;442
2016-06-27 01:00:00;20,99;17,58;3,41;39454;0;0;0;0;46587;5266;0.113;5118;148
2016-06-27 02:00:00;19,04;18,94;0,1;39454;0;0;0;0;46587;5562;0.1194;5508;54
2016-06-27 03:00:00;16,29;17,06;-0,77;39454;0;0;0;0;46587;6422;0.1378;5782;640
2016-06-27 04:00:00;16,12;16,16;-0,04;39454;3;0.0001;6;-3;46587;6733;0.1445;5983;750
2016-06-27 05:00:00;19,02;15,47;3,55;39454;268;0.0068;311;-43;46587;6836;0.1467;6039;797
2016-06-27 06:00:00;27,75;23,91;3,84;39454;1720;0.0436;1795;-75;46587;6469;0.1389;6016;453
2016-06-27 07:00:00;33,07;35,83;-2,76;39454;4950;0.1254;4920;30;46587;5622;0.1207;6150;-528
2016-06-27 08:00:00;34,26;38,09;-3,83;39454;9347;0.2369;9151;196;46587;5554;0.1192;6642;-1088
2016-06-27 09:00:00;31,02;32,1;-1,08;39454;13766;0.3489;13156;610;46587;7029;0.1509;7475;-446
2016-06-27 10:00:00;26,57;27,67;-1,1;39454;16870;0.4276;15971;899;46587;8566;0.1839;8495;71
2016-06-27 11:00:00;26,29;25,16;1,13;39454;18508;0.4691;17384;1124;46587;9529;0.2045;9303;226
2016-06-27 12:00:00;24,82;23,02;1,8;39454;19469;0.4934;17702;1767;46587;10300;0.2211;9819;481
2016-06-27 13:00:00;25,38;22,71;2,67;39454;18832;0.4773;17228;1604;46587;10719;0.2301;10186;533
2016-06-27 14:00:00;24,87;22,07;2,8;39454;17152;0.4348;15879;1273;46587;10898;0.234;10187;711
2016-06-27 15:00:00;25,95;22,98;2,97;39454;15202;0.3853;13797;1405;46587;10557;0.2266;9839;718
2016-06-27 16:00:00;25,92;23,95;1,97;39454;12753;0.3232;11296;1457;46587;10091;0.2166;9163;928
2016-06-27 17:00:00;28,08;25,4;2,68;39454;9728;0.2466;8351;1377;46587;9334;0.2004;8413;921
2016-06-27 18:00:00;34,98;30,16;4,82;39454;6274;0.159;5297;977;46587;7809;0.1676;7476;333
2016-06-27 19:00:00;39,05;32,4;6,65;39454;2998;0.076;2589;409;46587;6177;0.1326;6540;-363
2016-06-27 20:00:00;38,31;31,46;6,85;39454;914;0.0232;918;-4;46587;4830;0.1037;5659;-829
2016-06-27 21:00:00;36,52;30,32;6,2;39454;81;0.0021;81;0;46587;4258;0.0914;5035;-777
2016-06-27 22:00:00;36,4;30,99;5,41;39454;0;0;0;0;46587;4574;0.0982;4693;-119
2016-06-27 23:00:00;31,69;25,75;5,94;39454;0;0;0;0;46587;5155;0.1106;4600;555
2016-06-28 00:00:00;26,84;26,34;0,5;39458;0;0;0;0;46604;5382;0.1154;4938;444
2016-06-28 01:00:00;24,4;24,77;-0,37;39458;0;0;0;0;46604;5522;0.1185;4909;613
2016-06-28 02:00:00;24,09;23,35;0,74;39458;0;0;0;0;46604;5505;0.1182;4955;550
2016-06-28 03:00:00;23,13;21,36;1,77;39458;0;0;0;0;46604;5087;0.1092;4665;422
2016-06-28 04:00:00;22,76;21,41;1,35;39458;2;0;2;0;46604;4638;0.0995;4199;439
2016-06-28 05:00:00;24,19;23,3;0,89;39458;260;0.0066;246;14;46604;3997;0.0858;3655;342
2016-06-28 06:00:00;30,0;32,04;-2,04;39458;1666;0.0422;1567;99;46604;3674;0.0788;3010;664
2016-06-28 07:00:00;40,08;42,76;-2,68;39458;4378;0.1109;4031;347;46604;2944;0.0632;2337;607
2016-06-28 08:00:00;41,91;42,04;-0,13;39458;8024;0.2034;7269;755;46604;2991;0.0642;1953;1038
2016-06-28 09:00:00;41,98;38,02;3,96;39458;12258;0.3106;10876;1382;46604;3237;0.0694;1829;1408
2016-06-28 10:00:00;38,94;37,08;1,86;39458;15964;0.4045;14026;1938;46604;3493;0.075;1760;1733
2016-06-28 11:00:00;37,88;36,35;1,53;39458;18658;0.4729;16399;2259;46604;3760;0.0807;1748;2012
2016-06-28 12:00:00;35,36;33,35;2,01;39458;20440;0.518;17741;2699;46604;3525;0.0756;1752;1773
2016-06-28 13:00:00;34,08;31,28;2,8;39458;20119;0.5099;18073;2046;46604;3090;0.0663;1745;1345
2016-06-28 14:00:00;32,62;31,35;1,27;39458;19192;0.4864;17358;1834;46604;2786;0.0598;1696;1090
2016-06-28 15:00:00;31,37;31,73;-0,36;39458;17665;0.4477;15630;2035;46604;2388;0.0512;1604;784
2016-06-28 16:00:00;30,89;28,14;2,75;39458;15017;0.3806;13098;1919;46604;2150;0.0461;1417;733
2016-06-28 17:00:00;36,04;32,23;3,81;39458;11554;0.2928;9910;1644;46604;2052;0.044;1242;810
2016-06-28 18:00:00;39,85;35,24;4,61;39458;7393;0.1874;6368;1025;46604;1917;0.0411;1113;804
2016-06-28 19:00:00;41,74;35,63;6,11;39458;3616;0.0916;3270;346;46604;2030;0.0436;1094;936
2016-06-28 20:00:00;38,99;33,58;5,41;39458;1158;0.0293;1121;37;46604;2490;0.0534;1389;1101
2016-06-28 21:00:00;34,56;31,64;2,92;39458;93;0.0024;98;-5;46604;3747;0.0804;2248;1499
2016-06-28 22:00:00;33,84;30,98;2,86;39458;0;0;0;0;46604;5422;0.1163;3479;1943
2016-06-28 23:00:00;28,34;24,99;3,35;39458;0;0;0;0;46604;7172;0.1539;5041;2131
2016-06-29 00:00:00;24,03;19,09;4,94;39467;0;0;0;0;46686;8410;0.1802;7062;1348
2016-06-29 01:00:00;22,14;16,68;5,46;39467;0;0;0;0;46686;9270;0.1986;7993;1277
2016-06-29 02:00:00;20,64;13,31;7,33;39467;0;0;0;0;46686;9414;0.2016;8676;738
2016-06-29 03:00:00;19,91;9,0;10,91;39467;0;0;0;0;46686;9029;0.1934;9191;-162
2016-06-29 04:00:00;19,17;7,01;12,16;39467;2;0;1;1;46686;9238;0.1979;9529;-291
2016-06-29 05:00:00;19,99;15,58;4,41;39467;183;0.0046;212;-29;46686;9646;0.2066;9583;63
2016-06-29 06:00:00;24,58;27,42;-2,84;39467;1340;0.034;1506;-166;46686;9320;0.1996;9384;-64
2016-06-29 07:00:00;32,91;35,05;-2,14;39467;3720;0.0943;4024;-304;46686;8942;0.1916;9264;-322
2016-06-29 08:00:00;34,94;37,88;-2,94;39467;7748;0.1963;7473;275;46686;9684;0.2074;9384;300
2016-06-29 09:00:00;31,82;32,49;-0,67;39467;12264;0.3107;11343;921;46686;11556;0.2476;10043;1513
2016-06-29 10:00:00;26,05;25,62;0,43;39467;15337;0.3886;14970;367;46686;13277;0.2844;10865;2412
2016-06-29 11:00:00;24,71;24,54;0,17;39467;17414;0.4412;17456;-42;46686;14440;0.3093;11447;2993
2016-06-29 12:00:00;23,92;24,08;-0,16;39467;19723;0.4997;18831;892;46686;15306;0.3279;11638;3668
2016-06-29 13:00:00;23,6;22,51;1,09;39467;20642;0.523;19421;1221;46686;15294;0.3276;11637;3657
2016-06-29 14:00:00;23,4;21,58;1,82;39467;20648;0.5231;19063;1585;46686;14542;0.3114;11265;3277
2016-06-29 15:00:00;23,96;23,76;0,2;39467;19637;0.4976;17568;2069;46686;14184;0.3038;10539;3645
2016-06-29 16:00:00;23,71;22,9;0,81;39467;16724;0.4237;15053;1671;46686;12992;0.2783;9614;3378
2016-06-29 17:00:00;26,54;24,09;2,45;39467;12754;0.3232;11499;1255;46686;11555;0.2475;8350;3205
2016-06-29 18:00:00;33,46;30,67;2,79;39467;8251;0.2091;7256;995;46686;9318;0.1996;6663;2655
2016-06-29 19:00:00;38,99;35,0;3,99;39467;3968;0.1005;3552;416;46686;6676;0.143;4954;1722
2016-06-29 20:00:00;37,49;33,1;4,39;39467;1193;0.0302;1226;-33;46686;4634;0.0992;3894;740
2016-06-29 21:00:00;34,98;32,78;2,2;39467;87;0.0022;110;-23;46686;3986;0.0854;3620;366
2016-06-29 22:00:00;34,94;33,38;1,56;39467;0;0;0;0;46686;4541;0.0972;3821;720
2016-06-29 23:00:00;29,96;27,66;2,3;39467;0;0;0;0;46686;5098;0.1092;4445;653
2016-06-30 00:00:00;25,16;25,05;0,11;39479;0;0;0;0;46776;5565;0.119;6098;-533
2016-06-30 01:00:00;23,34;23,37;-0,03;39479;0;0;0;0;46776;5634;0.1204;6816;-1182
2016-06-30 02:00:00;22,08;22,69;-0,61;39479;0;0;0;0;46776;6143;0.1313;7507;-1364
2016-06-30 03:00:00;20,11;22,0;-1,89;39479;0;0;0;0;46776;6946;0.1485;7972;-1026
2016-06-30 04:00:00;19,82;20,98;-1,16;39479;2;0;2;0;46776;7513;0.1606;8362;-849
2016-06-30 05:00:00;21,58;21,11;0,47;39479;222;0.0056;212;10;46776;8043;0.1719;8518;-475
2016-06-30 06:00:00;26,61;25,96;0,65;39479;1215;0.0308;1283;-68;46776;8444;0.1805;8425;19
2016-06-30 07:00:00;34,94;33,04;1,9;39479;2815;0.0713;3131;-316;46776;7588;0.1622;8254;-666
2016-06-30 08:00:00;39,86;38,8;1,06;39479;4436;0.1124;5195;-759;46776;6479;0.1385;8112;-1633
2016-06-30 09:00:00;38,24;52,34;-14,1;39479;6444;0.1632;7385;-941;46776;6235;0.1333;8080;-1845
2016-06-30 10:00:00;38,49;54,19;-15,7;39479;9517;0.2411;9671;-154;46776;6811;0.1456;8198;-1387
2016-06-30 11:00:00;36,0;44,06;-8,06;39479;12713;0.322;11842;871;46776;7984;0.1707;8556;-572
2016-06-30 12:00:00;30,69;36,01;-5,32;39479;13994;0.3544;13541;453;46776;8686;0.1857;9020;-334
2016-06-30 13:00:00;27,63;32,13;-4,5;39479;14008;0.3548;14285;-277;46776;8679;0.1855;9473;-794
2016-06-30 14:00:00;25,8;31,17;-5,37;39479;13874;0.3514;14096;-222;46776;8275;0.1769;9440;-1165
2016-06-30 15:00:00;26,17;33,07;-6,9;39479;13491;0.3417;12983;508;46776;7489;0.1601;8859;-1370
2016-06-30 16:00:00;26,28;34,26;-7,98;39479;11645;0.295;10884;761;46776;6302;0.1347;8112;-1810
2016-06-30 17:00:00;29,77;37,81;-8,04;39479;9033;0.2288;8285;748;46776;5209;0.1114;7302;-2093
2016-06-30 18:00:00;34,23;41,78;-7,55;39479;5926;0.1501;5402;524;46776;4309;0.0921;6326;-2017
2016-06-30 19:00:00;38,28;46,36;-8,08;39479;2996;0.0759;2778;218;46776;3307;0.0707;5437;-2130
2016-06-30 20:00:00;34,91;42,9;-7,99;39479;964;0.0244;898;66;46776;2898;0.062;4999;-2101
2016-06-30 21:00:00;31,11;37,67;-6,56;39479;83;0.0021;72;11;46776;2958;0.0632;4873;-1915
2016-06-30 22:00:00;32,38;37,52;-5,14;39479;0;0;0;0;46776;3808;0.0814;5026;-1218
2016-06-30 23:00:00;27,72;32,69;-4,97;39479;0;0;0;0;46776;4919;0.1052;5362;-443
2016-01-07 00:00:00;29,36;30,6;-1,24;39484;0;0;0;0;46779;5920;0.1266;5538;382
2016-01-07 01:00:00;24,69;26,66;-1,97;39484;0;0;0;0;46779;6709;0.1434;6325;384
2016-01-07 02:00:00;23,42;24,64;-1,22;39484;0;0;0;0;46779;7328;0.1567;7065;263
2016-01-07 03:00:00;21,91;24,69;-2,78;39484;0;0;0;0;46779;8343;0.1784;7731;612
2016-01-07 04:00:00;20,19;24,06;-3,87;39484;2;0;4;-2;46779;9724;0.2079;8459;1265
2016-01-07 05:00:00;22,44;23,81;-1,37;39484;280;0.0071;274;6;46779;11197;0.2394;9091;2106
2016-01-07 06:00:00;26,84;30,13;-3,29;39484;1776;0.045;1750;26;46779;11860;0.2535;9514;2346
2016-01-07 07:00:00;33,58;35,61;-2,03;39484;4822;0.1221;4626;196;46779;11548;0.2468;9914;1634
2016-01-07 08:00:00;35,78;40,78;-5,0;39484;8921;0.226;8349;572;46779;11663;0.2493;10749;914
2016-01-07 09:00:00;29,8;32,25;-2,45;39484;12914;0.327;12191;723;46779;12706;0.2716;12134;572
2016-01-07 10:00:00;24,0;26,28;-2,28;39484;15993;0.405;15112;881;46779;13786;0.2947;13412;374
2016-01-07 11:00:00;23,26;24,88;-1,62;39484;17254;0.437;16913;341;46779;13926;0.2977;14284;-358
2016-01-07 12:00:00;22,56;26,76;-4,2;39484;17090;0.4328;17816;-726;46779;13954;0.2982;14487;-533
2016-01-07 13:00:00;22,09;27,7;-5,61;39484;17215;0.436;17978;-763;46779;13072;0.2794;14305;-1233
2016-01-07 14:00:00;22,09;27,17;-5,08;39484;17188;0.4353;17283;-95;46779;11862;0.2536;13765;-1903
2016-01-07 15:00:00;24,22;26,05;-1,83;39484;16384;0.415;15667;717;46779;11170;0.2388;12868;-1698
2016-01-07 16:00:00;27,0;26,27;0,73;39484;14304;0.3623;13306;998;46779;10317;0.2206;11576;-1259
2016-01-07 17:00:00;28,75;29,13;-0,38;39484;11121;0.2816;10121;1000;46779;9205;0.1967;10075;-870
2016-01-07 18:00:00;32,43;31,92;0,51;39484;7246;0.1835;6475;771;46779;8418;0.1799;8497;-79
2016-01-07 19:00:00;33,95;32,41;1,54;39484;3556;0.09;3256;300;46779;7212;0.1541;7150;62
2016-01-07 20:00:00;32,67;28,04;4,63;39484;1108;0.028;1100;8;46779;6627;0.1417;6556;71
2016-01-07 21:00:00;30,07;25,82;4,25;39484;76;0.0019;84;-8;46779;6931;0.1482;6705;226
2016-01-07 22:00:00;31,91;27,22;4,69;39484;0;0;0;0;46779;8514;0.182;7166;1348
2016-01-07 23:00:00;27,59;23,33;4,26;39484;0;0;0;0;46779;9950;0.2127;7769;2181
2016-02-07 00:00:00;22,03;24,92;-2,89;39485;0;0;0;0;46779;11192;0.2392;10332;860
2016-02-07 01:00:00;20,38;22,84;-2,46;39485;0;0;0;0;46779;12481;0.2668;11575;906
2016-02-07 02:00:00;19,4;18,32;1,08;39485;0;0;0;0;46779;12865;0.275;12405;460
2016-02-07 03:00:00;17,09;14,03;3,06;39485;0;0;0;0;46779;12621;0.2698;12752;-131
2016-02-07 04:00:00;16,79;13,43;3,36;39485;2;0;2;0;46779;12467;0.2665;12963;-496
2016-02-07 05:00:00;16,58;16,33;0,25;39485;208;0.0053;215;-7;46779;12828;0.2742;12896;-68
2016-02-07 06:00:00;17,99;15,48;2,51;39485;1361;0.0345;1341;20;46779;12932;0.2765;12384;548
2016-02-07 07:00:00;20,05;15,99;4,06;39485;3195;0.0809;3478;-283;46779;11329;0.2422;11821;-492
2016-02-07 08:00:00;21,41;20,59;0,82;39485;5251;0.133;6016;-765;46779;10936;0.2338;11664;-728
2016-02-07 09:00:00;23,71;29,5;-5,79;39485;7354;0.1862;8484;-1130;46779;11603;0.248;11993;-390
2016-02-07 10:00:00;22,04;26,77;-4,73;39485;9060;0.2294;10419;-1359;46779;11998;0.2565;12387;-389
2016-02-07 11:00:00;22,03;29,38;-7,35;39485;10146;0.257;11789;-1643;46779;12652;0.2705;12391;261
2016-02-07 12:00:00;21,87;28,43;-6,56;39485;10881;0.2756;12461;-1580;46779;12461;0.2664;11976;485
2016-02-07 13:00:00;20,86;25,46;-4,6;39485;10519;0.2664;12454;-1935;46779;12435;0.2658;11603;832
2016-02-07 14:00:00;19,4;22,84;-3,44;39485;10641;0.2695;12015;-1374;46779;12436;0.2658;11356;1080
2016-02-07 15:00:00;18,52;22,6;-4,08;39485;10160;0.2573;11004;-844;46779;11884;0.254;11150;734
2016-02-07 16:00:00;17,95;21,55;-3,6;39485;9088;0.2302;9729;-641;46779;11201;0.2394;10994;207
2016-02-07 17:00:00;19,96;25,02;-5,06;39485;7576;0.1919;7936;-360;46779;10357;0.2214;10539;-182
2016-02-07 18:00:00;23,11;27,51;-4,4;39485;5615;0.1422;5552;63;46779;9954;0.2128;9847;107
2016-02-07 19:00:00;25,33;28,69;-3,36;39485;3022;0.0765;3068;-46;46779;8697;0.1859;8987;-290
2016-02-07 20:00:00;25,48;27,82;-2,34;39485;1126;0.0285;1054;72;46779;7807;0.1669;8171;-364
2016-02-07 21:00:00;25,03;28,85;-3,82;39485;124;0.0032;96;28;46779;7379;0.1577;7959;-580
2016-02-07 22:00:00;25,97;29,27;-3,3;39485;0;0;0;0;46779;8403;0.1796;8379;24
2016-02-07 23:00:00;22,4;24,5;-2,1;39485;0;0;0;0;46779;10014;0.2141;9030;984
2016-03-07 00:00:00;18,07;16,7;1,37;39485;0;0;0;0;46779;10602;0.2266;10389;213
2016-03-07 01:00:00;9,32;7,75;1,57;39485;0;0;0;0;46779;11305;0.2417;10900;405
2016-03-07 02:00:00;7,88;6,94;0,94;39485;0;0;0;0;46779;11548;0.2468;11092;456
2016-03-07 03:00:00;6,97;5,31;1,66;39485;0;0;0;0;46779;11142;0.2382;10892;250
2016-03-07 04:00:00;8,82;4,65;4,17;39485;2;0;4;-2;46779;10598;0.2265;10503;95
2016-03-07 05:00:00;7,77;4,04;3,73;39485;276;0.007;303;-27;46779;10000;0.2138;9966;34
2016-03-07 06:00:00;8,14;3,63;4,51;39485;1891;0.0479;1915;-24;46779;8615;0.1842;9245;-630
2016-03-07 07:00:00;8,82;5,77;3,05;39485;5339;0.1352;5476;-137;46779;6756;0.1444;8364;-1608
2016-03-07 08:00:00;12,2;9,4;2,8;39485;9776;0.2476;10101;-325;46779;6416;0.1371;8090;-1674
2016-03-07 09:00:00;9,92;7,78;2,14;39485;14069;0.3563;14481;-412;46779;6933;0.1482;8490;-1557
2016-03-07 10:00:00;8,92;6,27;2,65;39485;16676;0.4224;17639;-963;46779;8145;0.1741;8991;-846
2016-03-07 11:00:00;8,86;7,46;1,4;39485;17642;0.4468;19446;-1804;46779;8705;0.1861;9356;-651
2016-03-07 12:00:00;8,92;8,24;0,68;39485;17807;0.451;19900;-2093;46779;9123;0.195;9526;-403
2016-03-07 13:00:00;7,09;8,99;-1,9;39485;16786;0.4251;19196;-2410;46779;9938;0.2124;9626;312
2016-03-07 14:00:00;6,98;8,36;-1,38;39485;15179;0.3844;17820;-2641;46779;10018;0.2142;9696;322
2016-03-07 15:00:00;7,14;8,79;-1,65;39485;13884;0.3517;15853;-1969;46779;10229;0.2186;9513;716
2016-03-07 16:00:00;8,97;9,28;-0,31;39485;11979;0.3034;13355;-1376;46779;9412;0.2012;8975;437
2016-03-07 17:00:00;18,08;16,42;1,66;39485;9374;0.2374;10165;-791;46779;8086;0.1728;8070;16
2016-03-07 18:00:00;22,02;24,2;-2,18;39485;6240;0.158;6586;-346;46779;7390;0.158;6862;528
2016-03-07 19:00:00;26,76;29,47;-2,71;39485;3197;0.081;3401;-204;46779;6053;0.1294;5583;470
2016-03-07 20:00:00;27,97;28,84;-0,87;39485;1077;0.0273;1177;-100;46779;4533;0.0969;4676;-143
2016-03-07 21:00:00;30,49;29,02;1,47;39485;98;0.0025;103;-5;46779;4042;0.0864;4422;-380
2016-03-07 22:00:00;32,35;30,32;2,03;39485;0;0;0;0;46779;4086;0.0874;4604;-518
2016-03-07 23:00:00;29,37;29,9;-0,53;39485;0;0;0;0;46779;4346;0.0929;4922;-576
2016-04-07 00:00:00;25,73;23,05;2,68;39487;0;0;0;0;46779;4430;0.0947;5164;-734
2016-04-07 01:00:00;22,73;18,55;4,18;39487;0;0;0;0;46779;4259;0.091;5429;-1170
2016-04-07 02:00:00;22,26;19,81;2,45;39487;0;0;0;0;46779;4388;0.0938;5510;-1122
2016-04-07 03:00:00;21,65;18,82;2,83;39487;0;0;0;0;46779;4330;0.0926;5357;-1027
2016-04-07 04:00:00;21,69;17,99;3,7;39487;2;0;4;-2;46779;4296;0.0918;5083;-787
2016-04-07 05:00:00;23,37;18,14;5,23;39487;234;0.0059;266;-32;46779;3901;0.0834;4589;-688
2016-04-07 06:00:00;31,93;28,52;3,41;39487;1595;0.0404;1592;3;46779;3360;0.0718;3946;-586
2016-04-07 07:00:00;35,19;34,05;1,14;39487;4482;0.1135;4413;69;46779;2548;0.0544;3278;-730
2016-04-07 08:00:00;37,93;41,38;-3,45;39487;8621;0.2183;8162;459;46779;2058;0.044;2854;-796
2016-04-07 09:00:00;33,54;35,32;-1,78;39487;13730;0.3477;12039;1691;46779;2104;0.045;2945;-841
2016-04-07 10:00:00;32,91;29,98;2,93;39487;18274;0.4628;15214;3060;46779;2427;0.0519;3293;-866
2016-04-07 11:00:00;31,68;27,61;4,07;39487;20731;0.525;17317;3414;46779;2626;0.0562;3616;-990
2016-04-07 12:00:00;29,98;26,76;3,22;39487;20588;0.5214;18429;2159;46779;2676;0.0572;3747;-1071
2016-04-07 13:00:00;29,33;26,92;2,41;39487;19859;0.5029;18598;1261;46779;2595;0.0554;3725;-1130
2016-04-07 14:00:00;29,75;28,94;0,81;39487;18722;0.4741;17982;740;46779;2657;0.0568;3579;-922
2016-04-07 15:00:00;29,26;29,91;-0,65;39487;17392;0.4404;16490;902;46779;2445;0.0522;3218;-773
2016-04-07 16:00:00;30,47;31,09;-0,62;39487;14887;0.377;14252;635;46779;2062;0.0441;2815;-753
2016-04-07 17:00:00;32,9;32,95;-0,05;39487;11446;0.2898;10997;449;46779;1539;0.0329;2343;-804
2016-04-07 18:00:00;35,98;37,15;-1,17;39487;7700;0.195;7090;610;46779;1062;0.0227;1814;-752
2016-04-07 19:00:00;38,41;40,31;-1,9;39487;3907;0.099;3585;322;46779;591;0.0126;1334;-743
2016-04-07 20:00:00;38,65;37,49;1,16;39487;1248;0.0316;1239;9;46779;394;0.0084;919;-525
2016-04-07 21:00:00;35,56;35,59;-0,03;39487;106;0.0027;108;-2;46779;592;0.0126;861;-269
2016-04-07 22:00:00;34,96;35,55;-0,59;39487;0;0;0;0;46779;890;0.019;1043;-153
2016-04-07 23:00:00;33,98;31,26;2,72;39487;0;0;0;0;46779;1396;0.0298;1270;126
2016-05-07 00:00:00;29,93;26,59;3,34;39489;0;0;0;0;46785;2040;0.0436;1851;189
2016-05-07 01:00:00;27,0;25,4;1,6;39489;0;0;0;0;46785;2871;0.0614;2289;582
2016-05-07 02:00:00;25,46;22,59;2,87;39489;0;0;0;0;46785;3506;0.075;2663;843
2016-05-07 03:00:00;23,88;21,22;2,66;39489;0;0;0;0;46785;3971;0.0849;2970;1001
2016-05-07 04:00:00;23,43;19,45;3,98;39489;1;0;2;-1;46785;4234;0.0905;3222;1012
2016-05-07 05:00:00;25,31;21,21;4,1;39489;196;0.005;235;-39;46785;4358;0.0931;3410;948
2016-05-07 06:00:00;30,28;27,03;3,25;39489;1540;0.039;1589;-49;46785;4412;0.0943;3566;846
2016-05-07 07:00:00;34,94;31,24;3,7;39489;4254;0.1077;4128;126;46785;4051;0.0866;3631;420
2016-05-07 08:00:00;36,46;30,99;5,47;39489;8367;0.2119;7393;974;46785;3750;0.0802;3856;-106
2016-05-07 09:00:00;35,05;27,49;7,56;39489;12817;0.3246;10913;1904;46785;5045;0.1078;4773;272
2016-05-07 10:00:00;32,54;25,46;7,08;39489;16074;0.407;14024;2050;46785;7143;0.1527;6237;906
2016-05-07 11:00:00;31,46;25,36;6,1;39489;17054;0.4319;16284;770;46785;9724;0.2078;7925;1799
2016-05-07 12:00:00;28,6;25,78;2,82;39489;16718;0.4234;17611;-893;46785;12166;0.26;9697;2469
2016-05-07 13:00:00;26,52;26,67;-0,15;39489;16857;0.4269;18043;-1186;46785;14407;0.308;11424;2983
2016-05-07 14:00:00;24,34;25,66;-1,32;39489;17231;0.4364;17677;-446;46785;16937;0.362;13050;3887
2016-05-07 15:00:00;22,28;22,58;-0,3;39489;16742;0.424;16355;387;46785;19304;0.4126;14529;4775
2016-05-07 16:00:00;22,14;16,56;5,58;39489;14956;0.3787;13964;992;46785;21094;0.4508;15532;5562
2016-05-07 17:00:00;23,01;13,37;9,64;39489;11412;0.289;10663;749;46785;22552;0.482;15878;6674
2016-05-07 18:00:00;24,6;17,92;6,68;39489;7257;0.1838;6849;408;46785;23199;0.4959;15473;7726
2016-05-07 19:00:00;27,57;22,73;4,84;39489;3590;0.0909;3474;116;46785;23592;0.5043;14946;8646
2016-05-07 20:00:00;26,9;21,9;5,0;39489;1076;0.0273;1170;-94;46785;23115;0.4941;14104;9011
2016-05-07 21:00:00;23,95;20,98;2,97;39489;71;0.0018;96;-25;46785;22085;0.472;13710;8375
2016-05-07 22:00:00;22,89;20,5;2,39;39489;0;0;0;0;46785;21904;0.4682;13627;8277
2016-05-07 23:00:00;18,96;13,68;5,28;39489;0;0;0;0;46785;22570;0.4824;13776;8794
2016-06-07 00:00:00;8,18;4,11;4,07;39491;0;0;0;0;46785;22158;0.4736;20872;1286
2016-06-07 01:00:00;9,26;7,16;2,1;39491;0;0;0;0;46785;21798;0.466;20963;835
2016-06-07 02:00:00;8,17;6,07;2,1;39491;0;0;0;0;46785;21624;0.4622;20884;740
2016-06-07 03:00:00;5,84;4,46;1,38;39491;0;0;0;0;46785;20844;0.4455;20675;169
2016-06-07 04:00:00;4,9;7,22;-2,32;39491;1;0;3;-2;46785;20292;0.4338;20476;-184
2016-06-07 05:00:00;10,72;12,15;-1,43;39491;210;0.0053;239;-29;46785;19564;0.4182;20496;-932
2016-06-07 06:00:00;20,09;21,38;-1,29;39491;1600;0.0405;1679;-79;46785;18910;0.4042;20839;-1929
2016-06-07 07:00:00;24,54;33,35;-8,81;39491;4395;0.1113;4532;-137;46785;19218;0.4108;21344;-2126
2016-06-07 08:00:00;24,15;34,2;-10,05;39491;8390;0.2124;8425;-35;46785;19494;0.4167;21984;-2490
2016-06-07 09:00:00;20,12;28,13;-8,01;39491;12594;0.3189;12621;-27;46785;20835;0.4453;22564;-1729
2016-06-07 10:00:00;13,19;20,78;-7,59;39491;16374;0.4146;16235;139;46785;21476;0.459;22930;-1454
2016-06-07 11:00:00;13,15;20,44;-7,29;39491;18332;0.4642;18834;-502;46785;21704;0.4639;23230;-1526
2016-06-07 12:00:00;9,36;18,69;-9,33;39491;19345;0.4899;20431;-1086;46785;22084;0.472;23473;-1389
2016-06-07 13:00:00;8,17;18,84;-10,67;39491;19907;0.5041;20757;-850;46785;22063;0.4716;23677;-1614
2016-06-07 14:00:00;2,55;14,34;-11,79;39491;19671;0.4981;20022;-351;46785;21679;0.4634;23699;-2020
2016-06-07 15:00:00;9,23;16,56;-7,33;39491;18570;0.4702;18309;261;46785;21372;0.4568;23713;-2341
2016-06-07 16:00:00;11,6;18,2;-6,6;39491;16265;0.4119;15658;607;46785;20650;0.4414;23375;-2725
2016-06-07 17:00:00;14,73;22,36;-7,63;39491;12725;0.3222;11964;761;46785;20018;0.4279;22656;-2638
2016-06-07 18:00:00;23,32;30,9;-7,58;39491;8196;0.2076;7619;577;46785;19061;0.4074;21480;-2419
2016-06-07 19:00:00;28,27;32,15;-3,88;39491;4133;0.1046;3754;379;46785;17209;0.3678;19900;-2691
2016-06-07 20:00:00;29,32;32,4;-3,08;39491;1311;0.0332;1274;37;46785;14330;0.3063;18116;-3786
2016-06-07 21:00:00;29,6;33,66;-4,06;39491;98;0.0025;110;-12;46785;11690;0.2499;16421;-4731
2016-06-07 22:00:00;31,75;36,95;-5,2;39491;0;0;0;0;46785;10250;0.2191;14657;-4407
2016-06-07 23:00:00;28,84;32,84;-4,0;39491;0;0;0;0;46785;9598;0.2052;13199;-3601
2016-07-07 00:00:00;29,09;31,57;-2,48;39493;0;0;0;0;46791;8565;0.183;10371;-1806
2016-07-07 01:00:00;25,56;30,4;-4,84;39493;0;0;0;0;46791;8000;0.171;9577;-1577
2016-07-07 02:00:00;24,21;29,66;-5,45;39493;0;0;0;0;46791;7646;0.1634;9011;-1365
2016-07-07 03:00:00;22,11;23,67;-1,56;39493;0;0;0;0;46791;7685;0.1643;8613;-928
2016-07-07 04:00:00;22,98;23,4;-0,42;39493;1;0;3;-2;46791;7153;0.1528;8148;-995
2016-07-07 05:00:00;23,74;28,35;-4,61;39493;249;0.0063;288;-39;46791;6467;0.1382;7591;-1124
2016-07-07 06:00:00;30,6;33,73;-3,13;39493;1808;0.0458;1914;-106;46791;5196;0.111;6976;-1780
2016-07-07 07:00:00;34,28;39,55;-5,27;39493;5638;0.1428;5661;-23;46791;3699;0.0791;6515;-2816
2016-07-07 08:00:00;35,71;38,22;-2,51;39493;11128;0.2818;10952;176;46791;3962;0.0847;6508;-2546
2016-07-07 09:00:00;31,51;32,49;-0,98;39493;16440;0.4163;16260;180;46791;4816;0.1029;6805;-1989
2016-07-07 10:00:00;28,83;29,52;-0,69;39493;20142;0.51;20180;-38;46791;5215;0.1114;7026;-1811
2016-07-07 11:00:00;28,79;29,14;-0,35;39493;22473;0.569;22494;-21;46791;5072;0.1084;7197;-2125
2016-07-07 12:00:00;26,91;28,39;-1,48;39493;24024;0.6083;23576;448;46791;5282;0.1129;7326;-2044
2016-07-07 13:00:00;25,97;27,4;-1,43;39493;24868;0.6297;23640;1228;46791;5554;0.1187;7508;-1954
2016-07-07 14:00:00;24,66;26,22;-1,56;39493;23966;0.6068;22482;1484;46791;5597;0.1196;7642;-2045
2016-07-07 15:00:00;25,41;26,43;-1,02;39493;21869;0.5538;20050;1819;46791;5564;0.1189;7719;-2155
2016-07-07 16:00:00;27,01;27,83;-0,82;39493;18235;0.4617;16657;1578;46791;5389;0.1152;7678;-2289
2016-07-07 17:00:00;30,42;31,35;-0,93;39493;13471;0.3411;12362;1109;46791;5392;0.1152;7316;-1924
2016-07-07 18:00:00;34,68;34,4;0,28;39493;8296;0.21;7586;710;46791;5096;0.1089;6597;-1501
2016-07-07 19:00:00;37,77;38,85;-1,08;39493;3833;0.0971;3594;239;46791;4142;0.0885;5803;-1661
2016-07-07 20:00:00;37,91;36,45;1,46;39493;1204;0.0305;1188;16;46791;2952;0.0631;5030;-2078
2016-07-07 21:00:00;32,49;33,43;-0,94;39493;91;0.0023;98;-7;46791;2199;0.047;4497;-2298
2016-07-07 22:00:00;36,53;34,58;1,95;39493;0;0;0;0;46791;1879;0.0402;4237;-2358
2016-07-07 23:00:00;32,8;31,32;1,48;39493;0;0;0;0;46791;1888;0.0403;4221;-2333
2016-08-07 00:00:00;28,62;30,63;-2,01;39496;0;0;0;0;46803;2240;0.0478;3536;-1296
2016-08-07 01:00:00;26,52;29,56;-3,04;39496;0;0;0;0;46803;2908;0.0621;4032;-1124
2016-08-07 02:00:00;25,04;25,78;-0,74;39496;0;0;0;0;46803;3623;0.0774;4607;-984
2016-08-07 03:00:00;23,46;24,46;-1,0;39496;0;0;0;0;46803;4438;0.0948;5273;-835
2016-08-07 04:00:00;23,18;25,22;-2,04;39496;1;0;1;0;46803;5086;0.1086;5806;-720
2016-08-07 05:00:00;25,02;24,68;0,34;39496;210;0.0054;228;-18;46803;5344;0.1142;5946;-602
2016-08-07 06:00:00;30,0;32,17;-2,17;39496;1678;0.0425;1693;-15;46803;5038;0.1076;5690;-652
2016-08-07 07:00:00;34,99;37,58;-2,59;39496;4814;0.1219;4794;20;46803;4143;0.0885;5169;-1026
2016-08-07 08:00:00;38,62;38,11;0,51;39496;9150;0.2317;9114;36;46803;3029;0.0647;4345;-1316
2016-08-07 09:00:00;35,26;36,18;-0,92;39496;13530;0.3426;13681;-151;46803;2288;0.0489;3824;-1536
2016-08-07 10:00:00;33,36;35,95;-2,59;39496;17471;0.4424;17508;-37;46803;2938;0.0628;3911;-973
2016-08-07 11:00:00;32,93;33,68;-0,75;39496;20200;0.5114;19938;262;46803;4558;0.0974;4473;85
2016-08-07 12:00:00;30,15;29,16;0,99;39496;20805;0.5268;20817;-12;46803;6838;0.1461;5499;1339
2016-08-07 13:00:00;27,91;26,07;1,84;39496;19902;0.5039;20045;-143;46803;9092;0.1943;6757;2335
2016-08-07 14:00:00;26,53;24,78;1,75;39496;17624;0.4462;18141;-517;46803;11394;0.2434;8099;3295
2016-08-07 15:00:00;25,91;22,89;3,02;39496;15028;0.3805;15441;-413;46803;13100;0.2799;9389;3711
2016-08-07 16:00:00;26,94;22,95;3,99;39496;11964;0.3029;12350;-386;46803;13711;0.2929;10464;3247
2016-08-07 17:00:00;27,38;24,63;2,75;39496;8840;0.2238;8931;-91;46803;14765;0.3155;11134;3631
2016-08-07 18:00:00;28,54;26,39;2,15;39496;5587;0.1415;5519;68;46803;15807;0.3377;11460;4347
2016-08-07 19:00:00;29,79;26,4;3,39;39496;2960;0.075;2728;232;46803;15503;0.3313;11696;3807
2016-08-07 20:00:00;28,1;25,98;2,12;39496;1010;0.0256;867;143;46803;15125;0.3232;12058;3067
2016-08-07 21:00:00;26,91;26,16;0,75;39496;78;0.002;65;13;46803;14965;0.3197;11842;3123
2016-08-07 22:00:00;28,08;26,28;1,8;39496;0;0;0;0;46803;14604;0.312;11633;2971
2016-08-07 23:00:00;24,61;24,57;0,04;39496;0;0;0;0;46803;14892;0.3182;11678;3214
2016-09-07 00:00:00;20,7;23,83;-3,13;39496;0;0;0;0;46803;15196;0.3247;15821;-625
2016-09-07 01:00:00;18,61;19,99;-1,38;39496;0;0;0;0;46803;14576;0.3114;15958;-1382
2016-09-07 02:00:00;17,39;19,22;-1,83;39496;0;0;0;0;46803;13614;0.2909;15752;-2138
2016-09-07 03:00:00;19,0;20,91;-1,91;39496;0;0;0;0;46803;12722;0.2718;15127;-2405
2016-09-07 04:00:00;17,1;24,37;-7,27;39496;0;0;1;-1;46803;12424;0.2654;14424;-2000
2016-09-07 05:00:00;17,01;22,72;-5,71;39496;177;0.0045;221;-44;46803;11517;0.246;13790;-2273
2016-09-07 06:00:00;18,12;22,66;-4,54;39496;1471;0.0373;1677;-206;46803;10118;0.2162;13178;-3060
2016-09-07 07:00:00;22,32;28,28;-5,96;39496;4188;0.1061;4796;-608;46803;8785;0.1877;12551;-3766
2016-09-07 08:00:00;21,99;46,88;-24,89;39496;8217;0.208;9181;-964;46803;9176;0.196;12085;-2909
2016-09-07 09:00:00;21,78;45,16;-23,38;39496;12691;0.3213;13787;-1096;46803;10210;0.2182;11930;-1720
2016-09-07 10:00:00;16,99;28,16;-11,17;39496;16081;0.4071;17322;-1241;46803;11050;0.2361;11844;-794
2016-09-07 11:00:00;16,99;23,61;-6,62;39496;18759;0.475;19457;-698;46803;10853;0.2319;11627;-774
2016-09-07 12:00:00;15,32;19,44;-4,12;39496;20453;0.5178;20558;-105;46803;10538;0.2252;11343;-805
2016-09-07 13:00:00;8,98;14,39;-5,41;39496;20711;0.5244;20710;1;46803;10334;0.2208;11169;-835
2016-09-07 14:00:00;11,64;18,21;-6,57;39496;19875;0.5032;19898;-23;46803;9891;0.2113;10885;-994
2016-09-07 15:00:00;11,25;21,69;-10,44;39496;18426;0.4665;17954;472;46803;9340;0.1996;10388;-1048
2016-09-07 16:00:00;16,9;21,47;-4,57;39496;15583;0.3945;14983;600;46803;8301;0.1774;9614;-1313
2016-09-07 17:00:00;22,0;26,67;-4,67;39496;11674;0.2956;11206;468;46803;7680;0.1641;8343;-663
2016-09-07 18:00:00;27,92;32,46;-4,54;39496;7506;0.19;7041;465;46803;6261;0.1338;6836;-575
2016-09-07 19:00:00;30,63;35,42;-4,79;39496;3670;0.093;3465;205;46803;4620;0.0987;5253;-633
2016-09-07 20:00:00;30,25;37,18;-6,93;39496;1068;0.027;1146;-78;46803;3162;0.0676;3976;-814
2016-09-07 21:00:00;29,86;35,28;-5,42;39496;60;0.0016;86;-26;46803;3016;0.0645;3553;-537
2016-09-07 22:00:00;30,61;37,26;-6,65;39496;0;0;0;0;46803;3328;0.0711;3696;-368
2016-09-07 23:00:00;28,0;36,67;-8,67;39496;0;0;0;0;46803;4105;0.0877;4345;-240
2016-10-07 00:00:00;23,17;34,04;-10,87;39496;0;0;0;0;46816;5047;0.1078;6945;-1898
2016-10-07 01:00:00;18,54;25,13;-6,59;39496;0;0;0;0;46816;6175;0.1319;8411;-2236
2016-10-07 02:00:00;15,04;20,39;-5,35;39496;0;0;0;0;46816;7123;0.1522;9594;-2471
2016-10-07 03:00:00;11,96;18,84;-6,88;39496;0;0;0;0;46816;7882;0.1683;10348;-2466
2016-10-07 04:00:00;11,17;14,88;-3,71;39496;1;0;1;0;46816;8532;0.1822;10866;-2334
2016-10-07 05:00:00;9,91;13,62;-3,71;39496;188;0.0048;209;-21;46816;8749;0.1869;11008;-2259
2016-10-07 06:00:00;10,63;13,22;-2,59;39496;1576;0.0399;1641;-65;46816;8506;0.1817;10675;-2169
2016-10-07 07:00:00;10,1;13,92;-3,82;39496;4930;0.1248;4985;-55;46816;7905;0.1689;10146;-2241
2016-10-07 08:00:00;12,36;13,19;-0,83;39496;10133;0.2566;9829;304;46816;6883;0.147;9656;-2773
2016-10-07 09:00:00;10,64;14,46;-3,82;39496;15665;0.3966;15047;618;46816;7007;0.1496;9564;-2557
2016-10-07 10:00:00;7,62;11,81;-4,19;39496;20024;0.507;19492;532;46816;8323;0.1778;9714;-1391
2016-10-07 11:00:00;9,12;12,55;-3,43;39496;22986;0.582;22585;401;46816;9098;0.1944;9849;-751
2016-10-07 12:00:00;6,88;6,91;-0,03;39496;24400;0.6178;24221;179;46816;9400;0.2008;9968;-568
2016-10-07 13:00:00;-0,08;3,08;-3,16;39496;24506;0.6205;24513;-7;46816;9482;0.2026;10056;-574
2016-10-07 14:00:00;-0,9;1,0;-1,9;39496;23604;0.5976;23550;54;46816;9242;0.1975;9874;-632
2016-10-07 15:00:00;3,96;1,31;2,65;39496;21385;0.5415;21319;66;46816;8812;0.1882;9269;-457
2016-10-07 16:00:00;10,14;7,25;2,89;39496;17915;0.4536;17875;40;46816;7925;0.1693;8342;-417
2016-10-07 17:00:00;19,5;16,68;2,82;39496;13098;0.3316;13141;-43;46816;7098;0.1516;7146;-48
2016-10-07 18:00:00;24,18;25,74;-1,56;39496;7944;0.2011;7884;60;46816;5618;0.12;5948;-330
2016-10-07 19:00:00;29,93;33,48;-3,55;39496;3548;0.0898;3598;-50;46816;4685;0.1001;4933;-248
2016-10-07 20:00:00;30,91;35,28;-4,37;39496;1052;0.0266;1170;-118;46816;4410;0.0942;4604;-194
2016-10-07 21:00:00;30,92;35,62;-4,7;39496;69;0.0017;89;-20;46816;5434;0.1161;5209;225
2016-10-07 22:00:00;31,49;37,09;-5,6;39496;0;0;0;0;46816;6721;0.1436;6255;466
2016-10-07 23:00:00;29,81;34,87;-5,06;39496;0;0;0;0;46816;8490;0.1813;7317;1173
2016-11-07 00:00:00;20,6;27,99;-7,39;39498;0;0;0;0;46816;10364;0.2214;9932;432
2016-11-07 01:00:00;20,56;21,82;-1,26;39498;0;0;0;0;46816;11395;0.2434;10469;926
2016-11-07 02:00:00;21,08;20,65;0,43;39498;0;0;0;0;46816;12163;0.2598;10640;1523
2016-11-07 03:00:00;19,96;17,49;2,47;39498;0;0;0;0;46816;11660;0.249;10605;1055
2016-11-07 04:00:00;19,77;17,27;2,5;39498;0;0;1;-1;46816;10904;0.2329;10428;476
2016-11-07 05:00:00;22,1;20,96;1,14;39498;175;0.0044;207;-32;46816;10740;0.2294;10169;571
2016-11-07 06:00:00;27,67;29,38;-1,71;39498;1560;0.0395;1622;-62;46816;10830;0.2314;9895;935
2016-11-07 07:00:00;32,03;30,96;1,07;39498;4480;0.1134;4604;-124;46816;10010;0.2138;9730;280
2016-11-07 08:00:00;32,94;35,99;-3,05;39498;8514;0.2155;8525;-11;46816;10446;0.2231;10108;338
2016-11-07 09:00:00;29,95;32,63;-2,68;39498;12858;0.3256;12601;257;46816;12096;0.2584;11314;782
2016-11-07 10:00:00;26,28;28,02;-1,74;39498;16820;0.4258;16008;812;46816;14018;0.2994;13103;915
2016-11-07 11:00:00;24,91;24,74;0,17;39498;19524;0.4943;18256;1268;46816;16318;0.3486;14914;1404
2016-11-07 12:00:00;22,09;19,7;2,39;39498;19980;0.5058;19214;766;46816;17868;0.3817;16554;1314
2016-11-07 13:00:00;20,4;20,12;0,28;39498;19172;0.4854;19020;152;46816;19066;0.4072;17953;1113
2016-11-07 14:00:00;20,08;24,11;-4,03;39498;17613;0.4459;17818;-205;46816;19576;0.4182;18754;822
2016-11-07 15:00:00;20,34;24,7;-4,36;39498;15564;0.394;15645;-81;46816;19496;0.4164;19089;407
2016-11-07 16:00:00;22,23;27,33;-5,1;39498;12370;0.3132;12664;-294;46816;19128;0.4086;18885;243
2016-11-07 17:00:00;25,45;29,51;-4,06;39498;8964;0.227;9192;-228;46816;18268;0.3902;18115;153
2016-11-07 18:00:00;28,8;35,71;-6,91;39498;6020;0.1524;5863;157;46816;17016;0.3635;16815;201
2016-11-07 19:00:00;31,25;36,1;-4,85;39498;3112;0.0788;3064;48;46816;14866;0.3176;15351;-485
2016-11-07 20:00:00;31,48;36,28;-4,8;39498;1025;0.026;990;35;46816;12273;0.2622;14100;-1827
2016-11-07 21:00:00;30,02;35,27;-5,25;39498;78;0.002;73;5;46816;10874;0.2322;13437;-2563
2016-11-07 22:00:00;28,5;36,07;-7,57;39498;0;0;0;0;46816;10609;0.2266;13153;-2544
2016-11-07 23:00:00;26,97;32,52;-5,55;39498;0;0;0;0;46816;10872;0.2322;12996;-2124
2016-12-07 00:00:00;25,09;26,42;-1,33;39500;0;0;0;0;46816;10670;0.2279;12045;-1375
2016-12-07 01:00:00;23,98;23,99;-0,01;39500;0;0;0;0;46816;10430;0.2228;11690;-1260
2016-12-07 02:00:00;22,39;23,23;-0,84;39500;0;0;0;0;46816;9544;0.2039;11182;-1638
2016-12-07 03:00:00;22,59;21,06;1,53;39500;0;0;0;0;46816;9088;0.1941;10554;-1466
2016-12-07 04:00:00;22,58;23,76;-1,18;39500;0;0;1;-1;46816;8665;0.1851;9953;-1288
2016-12-07 05:00:00;24,51;24,47;0,04;39500;121;0.0031;159;-38;46816;8047;0.1719;9393;-1346
2016-12-07 06:00:00;28,53;28,6;-0,07;39500;1057;0.0268;1246;-189;46816;7910;0.169;8883;-973
2016-12-07 07:00:00;33,63;34,64;-1,01;39500;3022;0.0765;3545;-523;46816;7211;0.154;8507;-1296
2016-12-07 08:00:00;34,94;38,09;-3,15;39500;5848;0.1481;6522;-674;46816;7075;0.1511;8409;-1334
2016-12-07 09:00:00;31,98;37,68;-5,7;39500;8766;0.2219;9603;-837;46816;7647;0.1634;8463;-816
2016-12-07 10:00:00;31,96;35,01;-3,05;39500;11442;0.2896;12083;-641;46816;8590;0.1835;8569;21
2016-12-07 11:00:00;32,7;33,94;-1,24;39500;13230;0.3349;13688;-458;46816;9524;0.2034;8648;876
2016-12-07 12:00:00;31,44;32,53;-1,09;39500;14485;0.3667;14451;34;46816;9676;0.2067;8506;1170
2016-12-07 13:00:00;29,99;31,84;-1,85;39500;14406;0.3647;14404;2;46816;9483;0.2026;8236;1247
2016-12-07 14:00:00;30,22;33,12;-2,9;39500;13041;0.3302;13796;-755;46816;8737;0.1866;7841;896
2016-12-07 15:00:00;30,42;36,38;-5,96;39500;10992;0.2783;12522;-1530;46816;7855;0.1678;7279;576
2016-12-07 16:00:00;30,32;35,76;-5,44;39500;8549;0.2164;10388;-1839;46816;6277;0.1341;6649;-372
2016-12-07 17:00:00;31,91;38,31;-6,4;39500;6016;0.1523;7787;-1771;46816;4710;0.1006;5779;-1069
2016-12-07 18:00:00;33,03;46,98;-13,95;39500;4014;0.1016;5069;-1055;46816;3869;0.0826;4631;-762
2016-12-07 19:00:00;33,61;42,56;-8,95;39500;2232;0.0565;2618;-386;46816;2926;0.0625;3633;-707
2016-12-07 20:00:00;33,06;38,75;-5,69;39500;766;0.0194;836;-70;46816;2346;0.0501;2818;-472
2016-12-07 21:00:00;33,67;37,6;-3,93;39500;64;0.0016;63;1;46816;1998;0.0427;2413;-415
2016-12-07 22:00:00;33,38;37,73;-4,35;39500;0;0;0;0;46816;2202;0.047;2227;-25
2016-12-07 23:00:00;30,84;32,45;-1,61;39500;0;0;0;0;46816;2285;0.0488;2122;163
2016-07-13 00:00:00;27,95;19,57;8,38;39503;0;0;0;0;46828;2215;0.0473;1877;338
2016-07-13 01:00:00;27,16;21,69;5,47;39503;0;0;0;0;46828;1934;0.0413;1756;178
2016-07-13 02:00:00;26,05;22,88;3,17;39503;0;0;0;0;46828;1555;0.0332;1660;-105
2016-07-13 03:00:00;25,0;23,54;1,46;39503;0;0;0;0;46828;1430;0.0305;1599;-169
2016-07-13 04:00:00;25,1;24,01;1,09;39503;0;0;1;-1;46828;1313;0.028;1536;-223
2016-07-13 05:00:00;26,18;23,86;2,32;39503;130;0.0032;150;-20;46828;1371;0.0293;1437;-66
2016-07-13 06:00:00;31,85;27,8;4,05;39503;1166;0.0295;1278;-112;46828;1591;0.034;1310;281
2016-07-13 07:00:00;34,94;33,61;1,33;39503;3308;0.0838;3666;-358;46828;1348;0.0288;1189;159
2016-07-13 08:00:00;40,42;34,04;6,38;39503;6281;0.159;6794;-513;46828;960;0.0205;1161;-201
2016-07-13 09:00:00;40,62;36,91;3,71;39503;9905;0.2508;10024;-119;46828;945;0.0202;1257;-312
2016-07-13 10:00:00;39,36;35,14;4,22;39503;12949;0.3278;12678;271;46828;1120;0.0239;1438;-318
2016-07-13 11:00:00;39,66;35,05;4,61;39503;14550;0.3683;14466;84;46828;1356;0.029;1698;-342
2016-07-13 12:00:00;36,03;33,58;2,45;39503;14938;0.3782;15353;-415;46828;2248;0.048;2026;222
2016-07-13 13:00:00;36,05;33,79;2,26;39503;13561;0.3433;15272;-1711;46828;2946;0.0629;2362;584
2016-07-13 14:00:00;35,36;32,83;2,53;39503;12464;0.3155;14170;-1706;46828;3134;0.0669;2750;384
2016-07-13 15:00:00;32,87;30,11;2,76;39503;11267;0.2852;12485;-1218;46828;3240;0.0692;3141;99
2016-07-13 16:00:00;31,94;31,31;0,63;39503;9255;0.2343;10274;-1019;46828;3688;0.0787;3502;186
2016-07-13 17:00:00;32,94;32,12;0,82;39503;6627;0.1677;7648;-1021;46828;3706;0.0791;3822;-116
2016-07-13 18:00:00;34,22;31,81;2,41;39503;4196;0.1062;4855;-659;46828;4207;0.0898;4082;125
2016-07-13 19:00:00;35,06;31,76;3,3;39503;2105;0.0533;2466;-361;46828;4092;0.0874;4345;-253
2016-07-13 20:00:00;33,01;32,55;0,46;39503;628;0.0159;771;-143;46828;3829;0.0818;4355;-526
2016-07-13 21:00:00;30,81;30,04;0,77;39503;54;0.0013;54;0;46828;3672;0.0784;4316;-644
2016-07-13 22:00:00;31,4;29,45;1,95;39503;0;0;0;0;46828;3744;0.0799;4364;-620
2016-07-13 23:00:00;27,86;27,62;0,24;39503;0;0;0;0;46828;4242;0.0906;4564;-322
2016-07-14 00:00:00;23,46;26,11;-2,65;39509;0;0;0;0;46844;4907;0.1048;5120;-213
2016-07-14 01:00:00;23,24;24,95;-1,71;39509;0;0;0;0;46844;5724;0.1222;5503;221
2016-07-14 02:00:00;22,1;22,66;-0,56;39509;0;0;0;0;46844;6492;0.1386;5929;563
2016-07-14 03:00:00;21,83;19,75;2,08;39509;0;0;0;0;46844;7004;0.1495;6515;489
2016-07-14 04:00:00;21,06;16,6;4,46;39509;0;0;0;0;46844;7224;0.1542;7212;12
2016-07-14 05:00:00;22,05;18,57;3,48;39509;80;0.002;100;-20;46844;7760;0.1656;7843;-83
2016-07-14 06:00:00;24,06;22,88;1,18;39509;777;0.0196;922;-145;46844;7946;0.1696;8220;-274
2016-07-14 07:00:00;29,42;28,25;1,17;39509;2354;0.0596;2835;-481;46844;7934;0.1694;8652;-718
2016-07-14 08:00:00;32,05;30,49;1,56;39509;4736;0.1199;5493;-757;46844;8125;0.1734;9529;-1404
2016-07-14 09:00:00;31,02;26,4;4,62;39509;7311;0.1851;8414;-1103;46844;9444;0.2016;10484;-1040
2016-07-14 10:00:00;29,8;26,97;2,83;39509;9613;0.2433;11156;-1543;46844;11309;0.2414;11345;-36
2016-07-14 11:00:00;30,43;26,64;3,79;39509;11424;0.2892;13486;-2062;46844;12829;0.2739;12120;709
2016-07-14 12:00:00;27,58;26,18;1,4;39509;12532;0.3172;15006;-2474;46844;13359;0.2852;12879;480
2016-07-14 13:00:00;25,06;23,17;1,89;39509;13088;0.3313;15448;-2360;46844;14037;0.2996;13726;311
2016-07-14 14:00:00;22,54;21,75;0,79;39509;13302;0.3366;15146;-1844;46844;14240;0.304;14440;-200
2016-07-14 15:00:00;20,65;19,35;1,3;39509;12553;0.3177;13946;-1393;46844;14467;0.3088;14815;-348
2016-07-14 16:00:00;20,66;18,6;2,06;39509;11188;0.2832;11786;-598;46844;14696;0.3137;14969;-273
2016-07-14 17:00:00;22,09;18,93;3,16;39509;8875;0.2246;8939;-64;46844;15183;0.3241;14977;206
2016-07-14 18:00:00;25,74;21,47;4,27;39509;5828;0.1475;5784;44;46844;15774;0.3367;14710;1064
2016-07-14 19:00:00;28,95;23,72;5,23;39509;2838;0.0718;2929;-91;46844;15963;0.3408;14457;1506
2016-07-14 20:00:00;27,93;21,6;6,33;39509;820;0.0208;882;-62;46844;16035;0.3423;14252;1783
2016-07-14 21:00:00;25,65;20,42;5,23;39509;42;0.0011;51;-9;46844;16488;0.352;14396;2092
2016-07-14 22:00:00;25,56;22,13;3,43;39509;0;0;0;0;46844;16997;0.3628;14724;2273
2016-07-14 23:00:00;21,85;20,87;0,98;39509;0;0;0;0;46844;17158;0.3663;15105;2053
2016-07-15 00:00:00;18,92;14,19;4,73;39512;0;0;0;0;46856;16964;0.362;15398;1566
2016-07-15 01:00:00;19,87;14,01;5,86;39512;0;0;0;0;46856;16722;0.3569;15578;1144
2016-07-15 02:00:00;17,02;11,55;5,47;39512;0;0;0;0;46856;16765;0.3578;15704;1061
2016-07-15 03:00:00;13,16;4,4;8,76;39512;0;0;0;0;46856;16503;0.3522;15771;732
2016-07-15 04:00:00;15,06;6,64;8,42;39512;0;0;1;-1;46856;16514;0.3524;15845;669
2016-07-15 05:00:00;18,88;9,65;9,23;39512;81;0.002;114;-33;46856;16422;0.3505;15983;439
2016-07-15 06:00:00;23,44;15,05;8,39;39512;956;0.0242;1152;-196;46856;16367;0.3493;16231;136
2016-07-15 07:00:00;29,08;25,21;3,87;39512;3001;0.076;3439;-438;46856;15611;0.3331;16425;-814
2016-07-15 08:00:00;30,08;31,9;-1,82;39512;6051;0.1532;6392;-341;46856;15273;0.326;16675;-1402
2016-07-15 09:00:00;31,82;31,54;0,28;39512;9287;0.235;9537;-250;46856;15243;0.3253;16944;-1701
2016-07-15 10:00:00;29,94;28,91;1,03;39512;11822;0.2992;12230;-408;46856;15242;0.3253;16978;-1736
2016-07-15 11:00:00;29,73;28,68;1,05;39512;13015;0.3294;14246;-1231;46856;14916;0.3183;16783;-1867
2016-07-15 12:00:00;27,39;30,93;-3,54;39512;13336;0.3375;15436;-2100;46856;14964;0.3194;16420;-1456
2016-07-15 13:00:00;23,8;27,62;-3,82;39512;13687;0.3464;15890;-2203;46856;15018;0.3205;16060;-1042
2016-07-15 14:00:00;22,93;27,13;-4,2;39512;13735;0.3476;15589;-1854;46856;14504;0.3096;15725;-1221
2016-07-15 15:00:00;22,02;24,56;-2,54;39512;12934;0.3274;14332;-1398;46856;13998;0.2988;15430;-1432
2016-07-15 16:00:00;22,82;22,89;-0,07;39512;11430;0.2892;12240;-810;46856;13182;0.2814;14847;-1665
2016-07-15 17:00:00;27,71;25,54;2,17;39512;9049;0.229;9438;-389;46856;11868;0.2533;13755;-1887
2016-07-15 18:00:00;31,92;29,68;2,24;39512;6230;0.1577;6168;62;46856;9982;0.213;12104;-2122
2016-07-15 19:00:00;34,67;31,04;3,63;39512;3305;0.0836;3109;196;46856;7507;0.1602;10279;-2772
2016-07-15 20:00:00;32,73;32,03;0,7;39512;1024;0.0259;943;81;46856;5638;0.1204;8565;-2927
2016-07-15 21:00:00;32,25;32,15;0,1;39512;61;0.0016;54;7;46856;4470;0.0954;7394;-2924
2016-07-15 22:00:00;34,94;34,14;0,8;39512;0;0;0;0;46856;4244;0.0906;6520;-2276
2016-07-15 23:00:00;33,78;29,1;4,68;39512;0;0;0;0;46856;4306;0.0919;6037;-1731
2016-07-16 00:00:00;27,53;32,57;-5,04;39512;0;0;0;0;46865;4572;0.0976;5257;-685
2016-07-16 01:00:00;23,82;23,49;0,33;39512;0;0;0;0;46865;4844;0.1034;5525;-681
2016-07-16 02:00:00;23,0;22,72;0,28;39512;0;0;0;0;46865;5283;0.1127;5994;-711
2016-07-16 03:00:00;22,0;21,42;0,58;39512;0;0;0;0;46865;5720;0.122;6450;-730
2016-07-16 04:00:00;21,91;20,11;1,8;39512;0;0;1;-1;46865;6142;0.131;6719;-577
2016-07-16 05:00:00;21,79;19,3;2,49;39512;123;0.0031;160;-37;46865;6188;0.132;6717;-529
2016-07-16 06:00:00;22,01;19,1;2,91;39512;1204;0.0305;1422;-218;46865;6091;0.13;6555;-464
2016-07-16 07:00:00;22,47;20,82;1,65;39512;3908;0.0989;4533;-625;46865;5513;0.1176;6389;-876
2016-07-16 08:00:00;23,34;22,63;0,71;39512;8041;0.2035;8883;-842;46865;5129;0.1094;6200;-1071
2016-07-16 09:00:00;22,96;22,4;0,56;39512;12340;0.3123;13215;-875;46865;5591;0.1193;6133;-542
2016-07-16 10:00:00;21,99;20,57;1,42;39512;15500;0.3922;16292;-792;46865;6477;0.1382;6108;369
2016-07-16 11:00:00;21,93;19,33;2,6;39512;16360;0.4141;17841;-1481;46865;6645;0.1418;6042;603
2016-07-16 12:00:00;22,89;19,47;3,42;39512;17014;0.4306;18355;-1341;46865;6228;0.1329;5981;247
2016-07-16 13:00:00;21,98;18,97;3,01;39512;17560;0.4444;18068;-508;46865;5947;0.1269;5992;-45
2016-07-16 14:00:00;21,93;18,27;3,66;39512;17199;0.4352;16973;226;46865;5808;0.124;6036;-228
2016-07-16 15:00:00;22,21;18,43;3,78;39512;15894;0.4022;15045;849;46865;5689;0.1214;6094;-405
2016-07-16 16:00:00;23,36;18,11;5,25;39512;13340;0.3376;12351;989;46865;5477;0.1168;6031;-554
2016-07-16 17:00:00;25,38;20,77;4,61;39512;9728;0.2462;9056;672;46865;5547;0.1184;5753;-206
2016-07-16 18:00:00;30,3;26,2;4,1;39512;5840;0.1478;5505;335;46865;5425;0.1157;5251;174
2016-07-16 19:00:00;31,92;27,84;4,08;39512;2742;0.0694;2549;193;46865;4951;0.1056;4715;236
2016-07-16 20:00:00;30,61;25,74;4,87;39512;716;0.0181;748;-32;46865;4206;0.0898;4222;-16
2016-07-16 21:00:00;30,99;27,23;3,76;39512;34;0.0009;38;-4;46865;3921;0.0836;3971;-50
2016-07-16 22:00:00;32,16;26,39;5,77;39512;0;0;0;0;46865;3813;0.0814;3914;-101
2016-07-16 23:00:00;27,78;23,73;4,05;39512;0;0;0;0;46865;3750;0.08;3903;-153
2016-07-17 00:00:00;24,53;20,72;3,81;39512;0;0;0;0;46890;3420;0.0729;3940;-520
2016-07-17 01:00:00;21,04;18,97;2,07;39512;0;0;0;0;46890;3384;0.0722;3815;-431
2016-07-17 02:00:00;21,03;19,3;1,73;39512;0;0;0;0;46890;3395;0.0724;3648;-253
2016-07-17 03:00:00;20,17;18,53;1,64;39512;0;0;0;0;46890;3012;0.0642;3510;-498
2016-07-17 04:00:00;19,57;19,88;-0,31;39512;0;0;0;0;46890;2869;0.0612;3315;-446
2016-07-17 05:00:00;19,4;20,0;-0,6;39512;73;0.0018;88;-15;46890;2502;0.0534;3041;-539
2016-07-17 06:00:00;19,01;19,5;-0,49;39512;780;0.0197;898;-118;46890;2110;0.045;2787;-677
2016-07-17 07:00:00;20,96;19,91;1,05;39512;2610;0.0661;2769;-159;46890;1871;0.0399;2678;-807
2016-07-17 08:00:00;21,13;20,88;0,25;39512;5352;0.1354;5328;24;46890;1769;0.0377;2753;-984
2016-07-17 09:00:00;22,3;22,26;0,04;39512;9042;0.2288;8253;789;46890;2099;0.0448;3115;-1016
2016-07-17 10:00:00;20,77;20,17;0,6;39512;12543;0.3174;10998;1545;46890;2864;0.061;3777;-913
2016-07-17 11:00:00;21,99;19,51;2,48;39512;15062;0.3812;13186;1876;46890;3796;0.0809;4555;-759
2016-07-17 12:00:00;21,03;17,34;3,69;39512;16059;0.4064;14564;1495;46890;5096;0.1086;5264;-168
2016-07-17 13:00:00;16,19;11,92;4,27;39512;15844;0.401;14949;895;46890;6084;0.1297;5934;150
2016-07-17 14:00:00;13,06;9,27;3,79;39512;15239;0.3857;14692;547;46890;7280;0.1552;6359;921
2016-07-17 15:00:00;13,06;8,42;4,64;39512;14144;0.358;13678;466;46890;7924;0.169;6489;1435
2016-07-17 16:00:00;13,02;9,03;3,99;39512;12744;0.3226;11885;859;46890;7811;0.1666;6514;1297
2016-07-17 17:00:00;20,03;14,97;5,06;39512;10038;0.2541;9298;740;46890;7542;0.1608;6355;1187
2016-07-17 18:00:00;22,4;20,74;1,66;39512;6827;0.1728;6054;773;46890;6670;0.1422;5875;795
2016-07-17 19:00:00;27,37;24,56;2,81;39512;3411;0.0863;2998;413;46890;5454;0.1163;5180;274
2016-07-17 20:00:00;28,07;26,98;1,09;39512;997;0.0252;888;109;46890;4748;0.1013;4550;198
2016-07-17 21:00:00;30,09;28,97;1,12;39512;56;0.0014;48;8;46890;4570;0.0975;4172;398
2016-07-17 22:00:00;30,57;26,83;3,74;39512;0;0;0;0;46890;4313;0.092;4075;238
2016-07-17 23:00:00;29,0;27,33;1,67;39512;0;0;0;0;46890;4129;0.088;4121;8
2016-07-18 00:00:00;26,03;24,34;1,69;39514;0;0;0;0;46909;3879;0.0827;4195;-316
2016-07-18 01:00:00;24,05;24,61;-0,56;39514;0;0;0;0;46909;3776;0.0805;4104;-328
2016-07-18 02:00:00;23,31;24,95;-1,64;39514;0;0;0;0;46909;3865;0.0824;4146;-281
2016-07-18 03:00:00;22,58;24,16;-1,58;39514;0;0;0;0;46909;3914;0.0834;4260;-346
2016-07-18 04:00:00;23,02;24,37;-1,35;39514;0;0;1;-1;46909;3828;0.0816;4341;-513
2016-07-18 05:00:00;23,81;27,88;-4,07;39514;96;0.0024;130;-34;46909;3883;0.0828;4298;-415
2016-07-18 06:00:00;28,82;33,95;-5,13;39514;1149;0.0291;1344;-195;46909;3903;0.0832;4158;-255
2016-07-18 07:00:00;33,09;39,56;-6,47;39514;3768;0.0954;4223;-455;46909;3332;0.071;3994;-662
2016-07-18 08:00:00;35,39;38,89;-3,5;39514;7698;0.1948;8400;-702;46909;3001;0.064;3997;-996
2016-07-18 09:00:00;32,98;38,09;-5,11;39514;12696;0.3213;13220;-524;46909;3422;0.073;4588;-1166
2016-07-18 10:00:00;30,53;34,69;-4,16;39514;17311;0.4381;17350;-39;46909;4189;0.0893;5251;-1062
2016-07-18 11:00:00;30,22;33,01;-2,79;39514;19740;0.4996;19915;-175;46909;5187;0.1106;5849;-662
2016-07-18 12:00:00;27,17;30,7;-3,53;39514;20477;0.5182;21048;-571;46909;5903;0.1258;6320;-417
2016-07-18 13:00:00;27,92;31,36;-3,44;39514;20532;0.5196;21364;-832;46909;6482;0.1382;6706;-224
2016-07-18 14:00:00;26,4;30,23;-3,83;39514;20360;0.5153;20826;-466;46909;6816;0.1453;6873;-57
2016-07-18 15:00:00;26,51;27,91;-1,4;39514;19208;0.4861;19237;-29;46909;6547;0.1396;6776;-229
2016-07-18 16:00:00;26,76;26,5;0,26;39514;16647;0.4213;16454;193;46909;6466;0.1378;6512;-46
2016-07-18 17:00:00;29,95;29,46;0,49;39514;12846;0.3251;12497;349;46909;6243;0.1331;5955;288
2016-07-18 18:00:00;33,0;31,52;1,48;39514;8090;0.2047;7713;377;46909;5466;0.1165;5071;395
2016-07-18 19:00:00;39,39;35,44;3,95;39514;3703;0.0937;3485;218;46909;4579;0.0976;4127;452
2016-07-18 20:00:00;40,0;35,49;4,51;39514;1006;0.0254;1010;-4;46909;3179;0.0678;3230;-51
2016-07-18 21:00:00;38,61;36,74;1,87;39514;56;0.0014;57;-1;46909;2613;0.0557;2810;-197
2016-07-18 22:00:00;35,9;36,26;-0,36;39514;0;0;0;0;46909;2540;0.0542;2655;-115
2016-07-18 23:00:00;30,45;31,29;-0,84;39514;0;0;0;0;46909;2573;0.0548;2634;-61
2016-07-19 00:00:00;27,59;30,25;-2,66;39517;0;0;0;0;46930;2590;0.0552;2971;-381
2016-07-19 01:00:00;27,09;28,14;-1,05;39517;0;0;0;0;46930;2628;0.056;2902;-274
2016-07-19 02:00:00;26,41;21,59;4,82;39517;0;0;0;0;46930;2392;0.051;2778;-386
2016-07-19 03:00:00;25,89;23,18;2,71;39517;0;0;0;0;46930;2213;0.0472;2605;-392
2016-07-19 04:00:00;25,61;22,08;3,53;39517;0;0;1;-1;46930;1950;0.0416;2392;-442
2016-07-19 05:00:00;26,14;22,54;3,6;39517;109;0.0028;148;-39;46930;1692;0.0361;2111;-419
2016-07-19 06:00:00;31,0;30,58;0,42;39517;1264;0.032;1461;-197;46930;1526;0.0325;1776;-250
2016-07-19 07:00:00;36,99;34,53;2,46;39517;4510;0.1141;5002;-492;46930;1212;0.0258;1437;-225
2016-07-19 08:00:00;40,01;35,78;4,23;39517;9473;0.2397;10416;-943;46930;849;0.0181;1156;-307
2016-07-19 09:00:00;35,7;33,4;2,3;39517;14558;0.3684;15968;-1410;46930;801;0.0171;1177;-376
2016-07-19 10:00:00;32,99;32,74;0,25;39517;19030;0.4816;20246;-1216;46930;1059;0.0226;1300;-241
2016-07-19 11:00:00;32,91;33,85;-0,94;39517;22091;0.559;22837;-746;46930;1284;0.0274;1432;-148
2016-07-19 12:00:00;31,38;34,07;-2,69;39517;23807;0.6024;24054;-247;46930;1493;0.0318;1534;-41
2016-07-19 13:00:00;30,91;33,1;-2,19;39517;24179;0.6119;24235;-56;46930;1645;0.035;1626;19
2016-07-19 14:00:00;30,08;31,86;-1,78;39517;23256;0.5885;23269;-13;46930;1784;0.038;1700;84
2016-07-19 15:00:00;31,28;32,46;-1,18;39517;21344;0.5401;21075;269;46930;1716;0.0366;1712;4
2016-07-19 16:00:00;32,4;32,04;0,36;39517;18034;0.4564;17818;216;46930;1484;0.0316;1631;-147
2016-07-19 17:00:00;35,25;35,43;-0,18;39517;13544;0.3427;13334;210;46930;1330;0.0283;1462;-132
2016-07-19 18:00:00;39,91;36,03;3,88;39517;8432;0.2134;8044;388;46930;1181;0.0252;1264;-83
2016-07-19 19:00:00;44,0;40,31;3,69;39517;3707;0.0938;3493;214;46930;1086;0.0232;1158;-72
2016-07-19 20:00:00;37,03;40,66;-3,63;39517;1009;0.0255;994;15;46930;1163;0.0248;1305;-142
2016-07-19 21:00:00;37,0;38,8;-1,8;39517;57;0.0015;55;2;46930;1894;0.0404;1889;5
2016-07-19 22:00:00;32,92;37,12;-4,2;39517;0;0;0;0;46930;2826;0.0602;2681;145
2016-07-19 23:00:00;27,91;32,25;-4,34;39517;0;0;0;0;46930;3349;0.0714;3253;96
2016-07-20 00:00:00;28,01;31,95;-3,94;39520;0;0;0;0;46939;3644;0.0776;3838;-194
2016-07-20 01:00:00;26,32;30,07;-3,75;39520;0;0;0;0;46939;3783;0.0806;4029;-246
2016-07-20 02:00:00;25,1;29,45;-4,35;39520;0;0;0;0;46939;3924;0.0836;4094;-170
2016-07-20 03:00:00;24,79;28,2;-3,41;39520;0;0;0;0;46939;3941;0.084;4154;-213
2016-07-20 04:00:00;24,83;27,53;-2,7;39520;0;0;1;-1;46939;4127;0.0879;4311;-184
2016-07-20 05:00:00;25,85;28,44;-2,59;39520;117;0.003;147;-30;46939;4348;0.0926;4532;-184
2016-07-20 06:00:00;29,35;33,59;-4,24;39520;1314;0.0332;1459;-145;46939;4430;0.0944;4626;-196
2016-07-20 07:00:00;33,52;39,07;-5,55;39520;4882;0.1235;5212;-330;46939;3828;0.0815;4216;-388
2016-07-20 08:00:00;36,79;37,1;-0,31;39520;10407;0.2633;10952;-545;46939;2712;0.0578;3407;-695
2016-07-20 09:00:00;34,1;34,29;-0,19;39520;16139;0.4084;16896;-757;46939;2648;0.0564;3101;-453
2016-07-20 10:00:00;32,39;33,07;-0,68;39520;20690;0.5236;21726;-1036;46939;2923;0.0622;3234;-311
2016-07-20 11:00:00;31,43;32,0;-0,57;39520;23670;0.599;24718;-1048;46939;3397;0.0724;3502;-105
2016-07-20 12:00:00;28,02;29,61;-1,59;39520;25143;0.6362;25967;-824;46939;4024;0.0857;3939;85
2016-07-20 13:00:00;26,63;28,14;-1,51;39520;25580;0.6473;26263;-683;46939;4735;0.1008;4387;348
2016-07-20 14:00:00;25,93;27,11;-1,18;39520;24824;0.6281;25525;-701;46939;5268;0.1122;4811;457
2016-07-20 15:00:00;26,43;27,27;-0,84;39520;22834;0.5778;23280;-446;46939;5956;0.1269;5240;716
2016-07-20 16:00:00;28,08;28,62;-0,54;39520;19299;0.4883;19624;-325;46939;6564;0.1398;5727;837
2016-07-20 17:00:00;31,66;31,76;-0,1;39520;14461;0.3659;14443;18;46939;6998;0.1491;6235;763
2016-07-20 18:00:00;33,3;34,97;-1,67;39520;8435;0.2135;8388;47;46939;6905;0.1471;6773;132
2016-07-20 19:00:00;34,48;37,58;-3,1;39520;3231;0.0818;3392;-161;46939;6579;0.1402;7559;-980
2016-07-20 20:00:00;33,41;42,41;-9,0;39520;690;0.0174;936;-246;46939;7966;0.1697;8588;-622
2016-07-20 21:00:00;31,96;37,72;-5,76;39520;30;0.0008;51;-21;46939;9748;0.2077;10176;-428
2016-07-20 22:00:00;28,94;38,31;-9,37;39520;0;0;0;0;46939;10569;0.2252;11502;-933
2016-07-20 23:00:00;25,35;30,64;-5,29;39520;0;0;0;0;46939;10228;0.2179;11895;-1667
2016-07-21 00:00:00;26,43;27,2;-0,77;39523;0;0;0;0;46950;9168;0.1952;10413;-1245
2016-07-21 01:00:00;26,46;31,35;-4,89;39523;0;0;0;0;46950;8206;0.1748;9595;-1389
2016-07-21 02:00:00;25,9;32,44;-6,54;39523;0;0;0;0;46950;7508;0.1599;8381;-873
2016-07-21 03:00:00;25,52;30,39;-4,87;39523;0;0;0;0;46950;7436;0.1584;7197;239
2016-07-21 04:00:00;25,55;28,69;-3,14;39523;0;0;0;0;46950;6632;0.1412;6330;302
2016-07-21 05:00:00;27,49;29,88;-2,39;39523;82;0.0021;99;-17;46950;6100;0.13;5414;686
2016-07-21 06:00:00;32,84;34,43;-1,59;39523;972;0.0246;1034;-62;46950;5821;0.124;4427;1394
2016-07-21 07:00:00;36,61;39,22;-2,61;39523;2889;0.0731;3271;-382;46950;4112;0.0876;3259;853
2016-07-21 08:00:00;39,16;38,34;0,82;39523;5137;0.13;6229;-1092;46950;2637;0.0562;2091;546
2016-07-21 09:00:00;36,04;38,67;-2,63;39523;7881;0.1994;9306;-1425;46950;2435;0.0518;1585;850
2016-07-21 10:00:00;37,02;38,97;-1,95;39523;11200;0.2834;11846;-646;46950;2539;0.0541;1496;1043
2016-07-21 11:00:00;36,01;36,61;-0,6;39523;13846;0.3503;13721;125;46950;2671;0.0569;1408;1263
2016-07-21 12:00:00;35,04;35,74;-0,7;39523;16012;0.4052;14805;1207;46950;2643;0.0563;1303;1340
2016-07-21 13:00:00;34,24;35,33;-1,09;39523;17190;0.4349;15176;2014;46950;2455;0.0523;1236;1219
2016-07-21 14:00:00;32,94;33,04;-0,1;39523;16421;0.4155;14915;1506;46950;2206;0.047;1214;992
2016-07-21 15:00:00;33,0;34,57;-1,57;39523;14671;0.3712;13953;718;46950;1894;0.0403;1254;640
2016-07-21 16:00:00;33,31;37,65;-4,34;39523;12986;0.3286;12080;906;46950;1710;0.0364;1332;378
2016-07-21 17:00:00;34,37;38,86;-4,49;39523;9900;0.2504;9325;575;46950;1990;0.0424;1432;558
2016-07-21 18:00:00;34,76;40,19;-5,43;39523;6435;0.1628;5932;503;46950;2554;0.0544;1577;977
2016-07-21 19:00:00;38,38;44,1;-5,72;39523;3156;0.0798;2851;305;46950;2522;0.0537;1732;790
2016-07-21 20:00:00;35,95;41,18;-5,23;39523;848;0.0215;799;49;46950;2546;0.0542;1842;704
2016-07-21 21:00:00;35,7;37,96;-2,26;39523;37;0.0009;36;1;46950;2727;0.0581;2009;718
2016-07-21 22:00:00;32,92;36,91;-3,99;39523;0;0;0;0;46950;3050;0.0649;2214;836
2016-07-21 23:00:00;31,01;33,69;-2,68;39523;0;0;0;0;46950;3068;0.0654;2333;735
2016-07-22 00:00:00;29,26;28,17;1,09;39526;0;0;0;0;46950;2924;0.0623;2211;713
2016-07-22 01:00:00;27,24;31,85;-4,61;39526;0;0;0;0;46950;2670;0.0568;2138;532
2016-07-22 02:00:00;27,1;29,0;-1,9;39526;0;0;0;0;46950;2437;0.0519;2074;363
2016-07-22 03:00:00;26,56;26,96;-0,4;39526;0;0;0;0;46950;2144;0.0457;2000;144
2016-07-22 04:00:00;26,5;28,17;-1,67;39526;0;0;0;0;46950;1958;0.0417;1883;75
2016-07-22 05:00:00;28,06;29,29;-1,23;39526;91;0.0023;106;-15;46950;1905;0.0406;1731;174
2016-07-22 06:00:00;32,36;34,25;-1,89;39526;1214;0.0307;1250;-36;46950;1970;0.042;1513;457
2016-07-22 07:00:00;35,99;37,92;-1,93;39526;4158;0.1052;4205;-47;46950;1636;0.0348;1176;460
2016-07-22 08:00:00;36,81;39,7;-2,89;39526;8200;0.2075;8408;-208;46950;1338;0.0285;846;492
2016-07-22 09:00:00;36,0;35,24;0,76;39526;12898;0.3263;12910;-12;46950;1547;0.033;773;774
2016-07-22 10:00:00;35,16;33,28;1,88;39526;17034;0.431;16745;289;46950;1789;0.0381;789;1000
2016-07-22 11:00:00;34,41;31,4;3,01;39526;19854;0.5023;19406;448;46950;2018;0.043;800;1218
2016-07-22 12:00:00;32,15;30,09;2,06;39526;20994;0.5312;20818;176;46950;2046;0.0436;862;1184
2016-07-22 13:00:00;30,78;29,83;0,95;39526;21078;0.5332;20940;138;46950;2132;0.0454;937;1195
2016-07-22 14:00:00;30,68;29,36;1,32;39526;19807;0.5011;20010;-203;46950;2184;0.0465;1066;1118
2016-07-22 15:00:00;31,19;31,54;-0,35;39526;17202;0.4352;17710;-508;46950;2456;0.0523;1381;1075
2016-07-22 16:00:00;31,62;32,34;-0,72;39526;13316;0.3369;14199;-883;46950;2731;0.0582;1785;946
2016-07-22 17:00:00;32,93;35,94;-3,01;39526;8972;0.227;10000;-1028;46950;3671;0.0782;2235;1436
2016-07-22 18:00:00;34,91;33,65;1,26;39526;5084;0.1286;5846;-762;46950;4250;0.0905;2726;1524
2016-07-22 19:00:00;35,96;33,41;2,55;39526;2336;0.0591;2663;-327;46950;4705;0.1002;3099;1606
2016-07-22 20:00:00;33,26;32,6;0,66;39526;610;0.0155;723;-113;46950;4414;0.094;3425;989
2016-07-22 21:00:00;31,97;33,29;-1,32;39526;35;0.0009;31;4;46950;4499;0.0958;4125;374
2016-07-22 22:00:00;31,96;35,31;-3,35;39526;0;0;0;0;46950;4695;0.1;4793;-98
2016-07-22 23:00:00;29,0;30,87;-1,87;39526;0;0;0;0;46950;4728;0.1007;4966;-238
2016-07-23 00:00:00;31,8;31,34;0,46;39526;0;0;0;0;46950;4064;0.0866;5137;-1073
2016-07-23 01:00:00;30,83;31,17;-0,34;39526;0;0;0;0;46950;3666;0.0781;4806;-1140
2016-07-23 02:00:00;29,1;29,53;-0,43;39526;0;0;0;0;46950;3358;0.0715;4455;-1097
2016-07-23 03:00:00;27,02;27,03;-0,01;39526;0;0;0;0;46950;2954;0.0629;4154;-1200
2016-07-23 04:00:00;25,77;26,58;-0,81;39526;0;0;0;0;46950;2706;0.0577;3878;-1172
2016-07-23 05:00:00;25,65;26,99;-1,34;39526;72;0.0018;93;-21;46950;2498;0.0532;3504;-1006
2016-07-23 06:00:00;26,22;28,9;-2,68;39526;986;0.025;1089;-103;46950;2125;0.0453;3038;-913
2016-07-23 07:00:00;30,32;32,5;-2,18;39526;3256;0.0824;3664;-408;46950;1415;0.0301;2467;-1052
2016-07-23 08:00:00;31,96;33,46;-1,5;39526;6304;0.1595;7236;-932;46950;804;0.0171;1906;-1102
2016-07-23 09:00:00;32,53;32,9;-0,37;39526;9826;0.2486;11004;-1178;46950;706;0.015;1608;-902
2016-07-23 10:00:00;32,26;33,32;-1,06;39526;12946;0.3276;14321;-1375;46950;843;0.018;1562;-719
2016-07-23 11:00:00;31,97;33,73;-1,76;39526;14766;0.3736;16791;-2025;46950;1084;0.0231;1546;-462
2016-07-23 12:00:00;29,02;33,01;-3,99;39526;15471;0.3914;18170;-2699;46950;1237;0.0264;1629;-392
2016-07-23 13:00:00;25,25;30,65;-5,4;39526;15785;0.3994;18340;-2555;46950;1200;0.0256;1681;-481
2016-07-23 14:00:00;24,52;29,5;-4,98;39526;15384;0.3892;17349;-1965;46950;1164;0.0248;1718;-554
2016-07-23 15:00:00;24,97;29,05;-4,08;39526;14370;0.3636;15267;-897;46950;1139;0.0242;1859;-720
2016-07-23 16:00:00;27,72;29,7;-1,98;39526;12091;0.3059;12374;-283;46950;1185;0.0252;2018;-833
2016-07-23 17:00:00;30,57;31,27;-0,7;39526;8705;0.2202;9016;-311;46950;1368;0.0292;2231;-863
2016-07-23 18:00:00;31,86;34,27;-2,41;39526;5343;0.1352;5513;-170;46950;1411;0.03;2518;-1107
2016-07-23 19:00:00;33,62;36,1;-2,48;39526;2543;0.0643;2587;-44;46950;1559;0.0332;2805;-1246
2016-07-23 20:00:00;32,9;35,99;-3,09;39526;662;0.0167;684;-22;46950;1712;0.0364;3170;-1458
2016-07-23 21:00:00;32,38;36,35;-3,97;39526;34;0.0009;28;6;46950;1916;0.0408;3739;-1823
2016-07-23 22:00:00;32,14;36,61;-4,47;39526;0;0;0;0;46950;2079;0.0443;4176;-2097
2016-07-23 23:00:00;29,07;32,66;-3,59;39526;0;0;0;0;46950;1888;0.0402;4157;-2269
2016-07-24 00:00:00;30,11;32,31;-2,2;39526;0;0;0;0;46950;1616;0.0344;3163;-1547
2016-07-24 01:00:00;28,11;31,04;-2,93;39526;0;0;0;0;46950;1263;0.0269;2812;-1549
2016-07-24 02:00:00;25,99;27,19;-1,2;39526;0;0;0;0;46950;1061;0.0226;2517;-1456
2016-07-24 03:00:00;24,93;27,06;-2,13;39526;0;0;0;0;46950;895;0.019;2221;-1326
2016-07-24 04:00:00;24,25;26,05;-1,8;39526;0;0;0;0;46950;799;0.017;1912;-1113
2016-07-24 05:00:00;23,98;25,42;-1,44;39526;56;0.0014;83;-27;46950;837;0.0178;1626;-789
2016-07-24 06:00:00;23,92;24,78;-0,86;39526;874;0.0221;1047;-173;46950;820;0.0174;1323;-503
2016-07-24 07:00:00;24,79;27,73;-2,94;39526;3010;0.0762;3608;-598;46950;539;0.0115;967;-428
2016-07-24 08:00:00;25,67;29,1;-3,43;39526;6197;0.1568;7298;-1101;46950;255;0.0054;583;-328
2016-07-24 09:00:00;25,95;30,22;-4,27;39526;10283;0.2602;11377;-1094;46950;192;0.0041;413;-221
2016-07-24 10:00:00;24,87;29,23;-4,36;39526;14240;0.3603;15112;-872;46950;153;0.0033;420;-267
2016-07-24 11:00:00;25,13;27,99;-2,86;39526;17428;0.441;18063;-635;46950;135;0.0029;441;-306
2016-07-24 12:00:00;23,47;26,06;-2,59;39526;19753;0.4997;19881;-128;46950;166;0.0036;467;-301
2016-07-24 13:00:00;23,82;24,8;-0,98;39526;20422;0.5167;20412;10;46950;265;0.0057;500;-235
2016-07-24 14:00:00;23,3;24,19;-0,89;39526;19698;0.4984;19709;-11;46950;427;0.0091;571;-144
2016-07-24 15:00:00;23,48;24,96;-1,48;39526;17318;0.4381;17690;-372;46950;602;0.0128;734;-132
2016-07-24 16:00:00;24,76;25,08;-0,32;39526;14403;0.3644;14585;-182;46950;883;0.0188;920;-37
2016-07-24 17:00:00;26,42;28,99;-2,57;39526;10680;0.2702;10629;51;46950;967;0.0206;1130;-163
2016-07-24 18:00:00;29,91;31,27;-1,36;39526;6614;0.1673;6395;219;46950;1008;0.0215;1391;-383
2016-07-24 19:00:00;31,94;33,49;-1,55;39526;3048;0.0772;2930;118;46950;861;0.0183;1683;-822
2016-07-24 20:00:00;32,95;32,89;0,06;39526;766;0.0194;765;1;46950;861;0.0183;1978;-1117
2016-07-24 21:00:00;33,22;34,09;-0,87;39526;31;0.0008;29;2;46950;982;0.0209;2362;-1380
2016-07-24 22:00:00;35,93;35,15;0,78;39526;0;0;0;0;46950;1088;0.0232;2652;-1564
2016-07-24 23:00:00;33,3;31,47;1,83;39526;0;0;0;0;46950;1129;0.0241;2780;-1651
2016-07-25 00:00:00;29,8;30,18;-0,38;39531;0;0;0;0;46956;1098;0.0234;1429;-331
2016-07-25 01:00:00;27,32;29,24;-1,92;39531;0;0;0;0;46956;1019;0.0217;1391;-372
2016-07-25 02:00:00;26,32;29,15;-2,83;39531;0;0;0;0;46956;978;0.0208;1372;-394
2016-07-25 03:00:00;25,93;27,11;-1,18;39531;0;0;0;0;46956;932;0.0198;1335;-403
2016-07-25 04:00:00;25,92;24,94;0,98;39531;0;0;0;0;46956;883;0.0188;1294;-411
2016-07-25 05:00:00;27,8;27,13;0,67;39531;68;0.0017;81;-13;46956;987;0.021;1222;-235
2016-07-25 06:00:00;35,0;32,09;2,91;39531;1037;0.0262;1108;-71;46956;1041;0.0222;1138;-97
2016-07-25 07:00:00;38,08;37,25;0,83;39531;3629;0.0918;3751;-122;46956;1072;0.0228;1054;18
2016-07-25 08:00:00;39,52;38,16;1,36;39531;7361;0.1862;7412;-51;46956;944;0.0201;919;25
2016-07-25 09:00:00;37,94;35,19;2,75;39531;11659;0.2949;11259;400;46956;1160;0.0247;969;191
2016-07-25 10:00:00;36,47;33,34;3,13;39531;16032;0.4056;14490;1542;46956;1401;0.0298;1105;296
2016-07-25 11:00:00;36,05;31,63;4,42;39531;18652;0.4718;16647;2005;46956;1627;0.0346;1281;346
2016-07-25 12:00:00;33,64;29,92;3,72;39531;19490;0.493;17651;1839;46956;1897;0.0404;1499;398
2016-07-25 13:00:00;32,95;30,22;2,73;39531;18934;0.479;17746;1188;46956;2511;0.0535;1757;754
2016-07-25 14:00:00;32,35;31,47;0,88;39531;17178;0.4346;16930;248;46956;2671;0.0569;2073;598
2016-07-25 15:00:00;32,6;36,34;-3,74;39531;14919;0.3774;15053;-134;46956;2746;0.0585;2447;299
2016-07-25 16:00:00;33,32;36,78;-3,46;39531;11902;0.3011;12580;-678;46956;2985;0.0636;2710;275
2016-07-25 17:00:00;35,18;36,4;-1,22;39531;9000;0.2277;9479;-479;46956;3061;0.0652;2779;282
2016-07-25 18:00:00;35,99;37,55;-1,56;39531;5829;0.1474;5931;-102;46956;3129;0.0666;2715;414
2016-07-25 19:00:00;36,59;37,93;-1,34;39531;2793;0.0707;2839;-46;46956;2887;0.0615;2539;348
2016-07-25 20:00:00;36,47;37,1;-0,63;39531;702;0.0178;719;-17;46956;2484;0.0529;2031;453
2016-07-25 21:00:00;36,08;38,04;-1,96;39531;24;0.0006;25;-1;46956;2218;0.0472;1822;396
2016-07-25 22:00:00;35,47;37,22;-1,75;39531;0;0;0;0;46956;2065;0.044;1803;262
2016-07-25 23:00:00;30,4;33,97;-3,57;39531;0;0;0;0;46956;1962;0.0418;1769;193
2016-07-26 00:00:00;27,98;29,22;-1,24;39534;0;0;0;0;46966;2092;0.0445;1682;410
2016-07-26 01:00:00;27,5;27,76;-0,26;39534;0;0;0;0;46966;2224;0.0474;1659;565
2016-07-26 02:00:00;26,38;25,45;0,93;39534;0;0;0;0;46966;2342;0.0498;1670;672
2016-07-26 03:00:00;25,88;24,1;1,78;39534;0;0;0;0;46966;2441;0.052;1697;744
2016-07-26 04:00:00;25,91;24,08;1,83;39534;0;0;0;0;46966;2452;0.0522;1657;795
2016-07-26 05:00:00;26,53;27,56;-1,03;39534;52;0.0013;61;-9;46966;2445;0.0521;1512;933
2016-07-26 06:00:00;30,97;29,4;1,57;39534;900;0.0228;913;-13;46966;2103;0.0448;1281;822
2016-07-26 07:00:00;35,9;36,77;-0,87;39534;3166;0.0801;3166;0;46966;1600;0.034;1042;558
2016-07-26 08:00:00;39,16;40,05;-0,89;39534;6958;0.176;6276;682;46966;1190;0.0253;854;336
2016-07-26 09:00:00;37,45;40,81;-3,36;39534;11051;0.2795;9791;1260;46966;1145;0.0244;781;364
2016-07-26 10:00:00;36,46;37,17;-0,71;39534;14554;0.3682;13092;1462;46966;1233;0.0262;804;429
2016-07-26 11:00:00;37,01;37,35;-0,34;39534;16965;0.4291;15782;1183;46966;1451;0.0309;934;517
2016-07-26 12:00:00;33,13;35,24;-2,11;39534;17604;0.4453;17403;201;46966;1716;0.0365;1222;494
2016-07-26 13:00:00;32,91;35,85;-2,94;39534;17344;0.4387;17726;-382;46966;1695;0.0361;1586;109
2016-07-26 14:00:00;31,8;36,79;-4,99;39534;16312;0.4126;16884;-572;46966;1717;0.0366;1866;-149
2016-07-26 15:00:00;32,92;38,23;-5,31;39534;14858;0.3758;15180;-322;46966;1670;0.0356;2057;-387
2016-07-26 16:00:00;32,26;35,97;-3,71;39534;12755;0.3226;12625;130;46966;1734;0.0369;2104;-370
2016-07-26 17:00:00;34,07;36,39;-2,32;39534;9354;0.2366;9342;12;46966;1528;0.0325;2004;-476
2016-07-26 18:00:00;37,13;38,15;-1,02;39534;5952;0.1506;5774;178;46966;1386;0.0295;1733;-347
2016-07-26 19:00:00;39,3;40,73;-1,43;39534;2744;0.0694;2661;83;46966;1116;0.0238;1450;-334
2016-07-26 20:00:00;37,28;38,65;-1,37;39534;655;0.0166;669;-14;46966;1043;0.0222;1130;-87
2016-07-26 21:00:00;36,54;37,09;-0,55;39534;19;0.0005;22;-3;46966;1158;0.0247;1115;43
2016-07-26 22:00:00;35,81;36,58;-0,77;39534;0;0;0;0;46966;1274;0.0271;1182;92
2016-07-26 23:00:00;30,2;32,02;-1,82;39534;0;0;0;0;46966;1350;0.0288;1155;195
2016-07-27 00:00:00;28,12;29,02;-0,9;39538;0;0;0;0;46975;1622;0.0345;1290;332
2016-07-27 01:00:00;27,61;28,24;-0,63;39538;0;0;0;0;46975;1674;0.0356;1321;353
2016-07-27 02:00:00;26,53;27,51;-0,98;39538;0;0;0;0;46975;1576;0.0335;1355;221
2016-07-27 03:00:00;25,87;27,47;-1,6;39538;0;0;0;0;46975;1614;0.0344;1418;196
2016-07-27 04:00:00;26,0;27,21;-1,21;39538;0;0;0;0;46975;1824;0.0388;1523;301
2016-07-27 05:00:00;26,63;29,13;-2,5;39538;38;0.001;53;-15;46975;2143;0.0456;1636;507
2016-07-27 06:00:00;31,53;32,11;-0,58;39538;785;0.0199;812;-27;46975;2522;0.0537;1736;786
2016-07-27 07:00:00;36,43;37,44;-1,01;39538;2809;0.071;2861;-52;46975;2474;0.0526;1793;681
2016-07-27 08:00:00;39,11;37,89;1,22;39538;5765;0.1458;5690;75;46975;2181;0.0464;1757;424
2016-07-27 09:00:00;40,67;36,5;4,17;39538;9406;0.2379;8851;555;46975;2095;0.0446;1799;296
2016-07-27 10:00:00;40,92;35,52;5,4;39538;13334;0.3372;11822;1512;46975;2731;0.0581;1989;742
2016-07-27 11:00:00;41,25;33,89;7,36;39538;16524;0.4179;14187;2337;46975;3262;0.0694;2210;1052
2016-07-27 12:00:00;37,09;29,76;7,33;39538;17930;0.4535;15725;2205;46975;3617;0.077;2544;1073
2016-07-27 13:00:00;36,53;28,01;8,52;39538;17719;0.4482;16376;1343;46975;4400;0.0937;2964;1436
2016-07-27 14:00:00;33,19;27,52;5,67;39538;16610;0.4201;16163;447;46975;5400;0.115;3391;2009
2016-07-27 15:00:00;32,6;27,41;5,19;39538;14520;0.3672;14809;-289;46975;6412;0.1365;3809;2603
2016-07-27 16:00:00;32,7;27,57;5,13;39538;12029;0.3042;12395;-366;46975;6600;0.1405;4158;2442
2016-07-27 17:00:00;33,15;29,15;4,0;39538;8914;0.2254;9205;-291;46975;6101;0.1298;4242;1859
2016-07-27 18:00:00;35,97;32,65;3,32;39538;5465;0.1382;5652;-187;46975;5376;0.1144;3983;1393
2016-07-27 19:00:00;36,61;33,56;3,05;39538;2501;0.0633;2560;-59;46975;4548;0.0968;3642;906
2016-07-27 20:00:00;36,37;33,72;2,65;39538;617;0.0156;610;7;46975;3770;0.0802;3366;404
2016-07-27 21:00:00;35,56;33,43;2,13;39538;14;0.0004;18;-4;46975;3469;0.0738;3247;222
2016-07-27 22:00:00;34,04;31,58;2,46;39538;0;0;0;0;46975;3803;0.081;3148;655
2016-07-27 23:00:00;29,94;26,42;3,52;39538;0;0;0;0;46975;3884;0.0827;3119;765
2016-07-28 00:00:00;26,9;25,63;1,27;39541;0;0;0;0;46982;3499;0.0745;3643;-144
2016-07-28 01:00:00;26,39;24,43;1,96;39541;0;0;0;0;46982;3208;0.0683;3538;-330
2016-07-28 02:00:00;25,8;24,94;0,86;39541;0;0;0;0;46982;2944;0.0626;3352;-408
2016-07-28 03:00:00;25,29;22,38;2,91;39541;0;0;0;0;46982;2590;0.0551;3061;-471
2016-07-28 04:00:00;25,26;22,62;2,64;39541;0;0;0;0;46982;2362;0.0503;2710;-348
2016-07-28 05:00:00;26,39;23,29;3,1;39541;44;0.0011;58;-14;46982;2056;0.0438;2289;-233
2016-07-28 06:00:00;29,92;24,71;5,21;39541;868;0.0219;940;-72;46982;1727;0.0368;1926;-199
2016-07-28 07:00:00;34,91;29,29;5,62;39541;3283;0.083;3392;-109;46982;1362;0.029;1627;-265
2016-07-28 08:00:00;36,94;32,77;4,17;39541;6588;0.1666;6844;-256;46982;871;0.0185;1438;-567
2016-07-28 09:00:00;35,79;32,82;2,97;39541;10454;0.2644;10523;-69;46982;678;0.0144;1388;-710
2016-07-28 10:00:00;33,93;32,14;1,79;39541;14160;0.3581;13639;521;46982;764;0.0162;1422;-658
2016-07-28 11:00:00;33,75;32,07;1,68;39541;16050;0.4059;15800;250;46982;1098;0.0234;1529;-431
2016-07-28 12:00:00;33,81;33,05;0,76;39541;16430;0.4155;17118;-688;46982;1564;0.0333;1647;-83
2016-07-28 13:00:00;31,79;35,11;-3,32;39541;15865;0.4012;17632;-1767;46982;1874;0.0399;1775;99
2016-07-28 14:00:00;30,97;34,14;-3,17;39541;15070;0.3811;17050;-1980;46982;2032;0.0433;1835;197
2016-07-28 15:00:00;31,43;32,5;-1,07;39541;13931;0.3523;15388;-1457;46982;2051;0.0436;1828;223
2016-07-28 16:00:00;31,43;31,76;-0,33;39541;12224;0.3091;12714;-490;46982;1996;0.0425;1743;253
2016-07-28 17:00:00;32,98;30,8;2,18;39541;9447;0.2389;9378;69;46982;2044;0.0435;1578;466
2016-07-28 18:00:00;34,97;31,85;3,12;39541;5831;0.1475;5693;138;46982;1762;0.0375;1445;317
2016-07-28 19:00:00;36,72;32,48;4,24;39541;2614;0.0661;2525;89;46982;1650;0.0351;1351;299
2016-07-28 20:00:00;35,5;32,4;3,1;39541;552;0.014;583;-31;46982;1664;0.0354;1350;314
2016-07-28 21:00:00;34,04;31,98;2,06;39541;17;0.0004;14;3;46982;2124;0.0452;1673;451
2016-07-28 22:00:00;33,93;32,08;1,85;39541;0;0;0;0;46982;2634;0.056;2190;444
2016-07-28 23:00:00;29,92;29,46;0,46;39541;0;0;0;0;46982;3127;0.0666;2769;358
2016-07-29 00:00:00;28,21;30,17;-1,96;39545;0;0;0;0;47034;3606;0.0767;4046;-440
2016-07-29 01:00:00;27,04;26,73;0,31;39545;0;0;0;0;47034;3707;0.0788;4414;-707
2016-07-29 02:00:00;26,03;26,05;-0,02;39545;0;0;0;0;47034;3734;0.0794;4608;-874
2016-07-29 03:00:00;24,58;25,04;-0,46;39545;0;0;0;0;47034;3916;0.0833;4650;-734
2016-07-29 04:00:00;24,84;26,81;-1,97;39545;0;0;0;0;47034;3885;0.0826;4659;-774
2016-07-29 05:00:00;25,95;28,62;-2,67;39545;36;0.0009;50;-14;47034;3646;0.0775;4674;-1028
2016-07-29 06:00:00;29,68;31,89;-2,21;39545;722;0.0183;840;-118;47034;3841;0.0816;4672;-831
2016-07-29 07:00:00;33,99;37,09;-3,1;39545;2681;0.0678;3063;-382;47034;3543;0.0753;4671;-1128
2016-07-29 08:00:00;36,13;39,39;-3,26;39545;5963;0.1508;6391;-428;47034;3236;0.0688;4897;-1661
2016-07-29 09:00:00;36,09;39,59;-3,5;39545;9668;0.2445;10133;-465;47034;3727;0.0792;5477;-1750
2016-07-29 10:00:00;33,75;36,67;-2,92;39545;12888;0.3259;13420;-532;47034;4717;0.1003;6199;-1482
2016-07-29 11:00:00;33,21;34,24;-1,03;39545;14855;0.3756;15686;-831;47034;5210;0.1107;6832;-1622
2016-07-29 12:00:00;31,67;34,85;-3,18;39545;16553;0.4186;17015;-462;47034;6206;0.132;7401;-1195
2016-07-29 13:00:00;29,5;31,81;-2,31;39545;17723;0.4482;17364;359;47034;6944;0.1476;8133;-1189
2016-07-29 14:00:00;27,94;28,24;-0,3;39545;17617;0.4455;16810;807;47034;7661;0.1628;8759;-1098
2016-07-29 15:00:00;27,37;26,31;1,06;39545;16419;0.4152;15350;1069;47034;8212;0.1746;9041;-829
2016-07-29 16:00:00;28,09;26,87;1,22;39545;14339;0.3626;12893;1446;47034;8222;0.1748;9115;-893
2016-07-29 17:00:00;29,11;31,64;-2,53;39545;10640;0.269;9505;1135;47034;7854;0.167;8761;-907
2016-07-29 18:00:00;31,5;35,53;-4,03;39545;6424;0.1624;5662;762;47034;7028;0.1494;7871;-843
2016-07-29 19:00:00;34,13;36,05;-1,92;39545;2778;0.0703;2441;337;47034;5675;0.1207;6831;-1156
2016-07-29 20:00:00;32,98;36,09;-3,11;39545;584;0.0148;575;9;47034;4191;0.0891;5998;-1807
2016-07-29 21:00:00;30,86;36,57;-5,71;39545;13;0.0003;13;0;47034;3926;0.0834;5956;-2030
2016-07-29 22:00:00;29,81;35,51;-5,7;39545;0;0;0;0;47034;4440;0.0944;6293;-1853
2016-07-29 23:00:00;28,87;33,75;-4,88;39545;0;0;0;0;47034;5056;0.1075;6778;-1722
2016-07-30 00:00:00;31,07;29,23;1,84;39546;0;0;0;0;47109;5202;0.1104;6401;-1199
2016-07-30 01:00:00;26,51;26,11;0,4;39546;0;0;0;0;47109;5392;0.1145;6749;-1357
2016-07-30 02:00:00;25,59;24,78;0,81;39546;0;0;0;0;47109;5581;0.1184;6955;-1374
2016-07-30 03:00:00;24,56;22,44;2,12;39546;0;0;0;0;47109;5862;0.1244;7016;-1154
2016-07-30 04:00:00;24,17;23,4;0,77;39546;0;0;0;0;47109;5927;0.1258;6984;-1057
2016-07-30 05:00:00;24,39;23,56;0,83;39546;34;0.0009;48;-14;47109;6032;0.128;6903;-871
2016-07-30 06:00:00;24,72;23,31;1,41;39546;878;0.0222;862;16;47109;6031;0.128;6620;-589
2016-07-30 07:00:00;25,46;22,26;3,2;39546;3459;0.0875;3285;174;47109;5483;0.1164;6227;-744
2016-07-30 08:00:00;26,74;26,42;0,32;39546;7604;0.1923;6962;642;47109;5061;0.1074;5958;-897
2016-07-30 09:00:00;28,97;27,11;1,86;39546;11876;0.3003;11153;723;47109;5197;0.1103;5966;-769
2016-07-30 10:00:00;28,38;26,69;1,69;39546;15233;0.3852;14683;550;47109;5816;0.1234;6178;-362
2016-07-30 11:00:00;27,93;26,18;1,75;39546;17422;0.4406;17145;277;47109;6009;0.1276;6285;-276
2016-07-30 12:00:00;26,33;26,53;-0,2;39546;18311;0.463;18478;-167;47109;6083;0.1291;6234;-151
2016-07-30 13:00:00;24,79;25,83;-1,04;39546;18376;0.4647;18900;-524;47109;6234;0.1323;6162;72
2016-07-30 14:00:00;23,99;25,52;-1,53;39546;18462;0.4668;18337;125;47109;6402;0.1359;5964;438
2016-07-30 15:00:00;24,04;23,17;0,87;39546;17248;0.4361;16598;650;47109;6573;0.1396;5597;976
2016-07-30 16:00:00;25,04;22,63;2,41;39546;14526;0.3673;13853;673;47109;6389;0.1356;5036;1353
2016-07-30 17:00:00;26,1;24,02;2,08;39546;10816;0.2735;10190;626;47109;5824;0.1236;4220;1604
2016-07-30 18:00:00;30,51;26,39;4,12;39546;6480;0.1638;6029;451;47109;4675;0.0992;3287;1388
2016-07-30 19:00:00;31,92;30,69;1,23;39546;2651;0.067;2538;113;47109;3295;0.07;2299;996
2016-07-30 20:00:00;32,55;31,62;0,93;39546;568;0.0144;567;1;47109;1995;0.0424;1573;422
2016-07-30 21:00:00;32,09;33,84;-1,75;39546;10;0.0003;12;-2;47109;1378;0.0292;1355;23
2016-07-30 22:00:00;36,02;33,82;2,2;39546;0;0;0;0;47109;1076;0.0228;1282;-206
2016-07-30 23:00:00;32,96;30,91;2,05;39546;0;0;0;0;47109;838;0.0178;1235;-397
2016-07-31 00:00:00;28,08;28,23;-0,15;39546;0;0;0;0;47128;617;0.0131;1217;-600
2016-07-31 01:00:00;25,36;24,54;0,82;39546;0;0;0;0;47128;575;0.0122;1122;-547
2016-07-31 02:00:00;23,8;24,72;-0,92;39546;0;0;0;0;47128;551;0.0117;1081;-530
2016-07-31 03:00:00;22,56;24,71;-2,15;39546;0;0;0;0;47128;549;0.0116;1067;-518
2016-07-31 04:00:00;22,14;22,69;-0,55;39546;0;0;0;0;47128;732;0.0155;1035;-303
2016-07-31 05:00:00;21,65;23,65;-2,0;39546;25;0.0006;41;-16;47128;878;0.0186;965;-87
2016-07-31 06:00:00;20,98;23,8;-2,82;39546;672;0.017;755;-83;47128;1031;0.0219;882;149
2016-07-31 07:00:00;21,99;22,6;-0,61;39546;2567;0.0649;2807;-240;47128;947;0.0201;820;127
2016-07-31 08:00:00;23,8;22,63;1,17;39546;4845;0.1225;5635;-790;47128;717;0.0152;772;-55
2016-07-31 09:00:00;25,12;25,94;-0,82;39546;7128;0.1802;8682;-1554;47128;636;0.0135;799;-163
2016-07-31 10:00:00;25,28;27,91;-2,63;39546;9108;0.2303;11135;-2027;47128;826;0.0175;900;-74
2016-07-31 11:00:00;26,77;28,36;-1,59;39546;10299;0.2604;12763;-2464;47128;992;0.021;1101;-109
2016-07-31 12:00:00;26,34;28,13;-1,79;39546;10651;0.2693;13599;-2948;47128;1219;0.0259;1373;-154
2016-07-31 13:00:00;25,56;27,84;-2,28;39546;10664;0.2696;13542;-2878;47128;1627;0.0345;1700;-73
2016-07-31 14:00:00;24,35;26,87;-2,52;39546;9498;0.2402;12679;-3181;47128;2296;0.0487;2085;211
2016-07-31 15:00:00;23,32;26,29;-2,97;39546;9098;0.23;11059;-1961;47128;3080;0.0653;2618;462
2016-07-31 16:00:00;22,78;24,78;-2,0;39546;7974;0.2017;8940;-966;47128;3731;0.0792;3125;606
2016-07-31 17:00:00;25,25;24,27;0,98;39546;6800;0.172;6571;229;47128;4526;0.096;3489;1037
2016-07-31 18:00:00;25,09;25,99;-0,9;39546;4560;0.1153;4065;495;47128;5136;0.109;3759;1377
2016-07-31 19:00:00;28,23;27,87;0,36;39546;2220;0.0561;1855;365;47128;5468;0.116;3921;1547
2016-07-31 20:00:00;28,92;28,11;0,81;39546;520;0.0132;414;106;47128;5358;0.1137;4120;1238
2016-07-31 21:00:00;30,19;27,84;2,35;39546;11;0.0003;10;1;47128;5188;0.1101;4442;746
2016-07-31 22:00:00;31,39;27,98;3,41;39546;0;0;0;0;47128;5830;0.1237;4936;894
2016-07-31 23:00:00;27,78;25,37;2,41;39546;0;0;0;0;47128;6239;0.1324;5542;697
2016-01-08 00:00:00;24,91;22,45;2,46;39549;0;0;0;0;47168;6245;0.1324;5439;806
2016-01-08 01:00:00;23,79;21,05;2,74;39549;0;0;0;0;47168;6528;0.1384;5806;722
2016-01-08 02:00:00;22,55;19,77;2,78;39549;0;0;0;0;47168;7010;0.1486;5993;1017
2016-01-08 03:00:00;22,14;18,87;3,27;39549;0;0;0;0;47168;7466;0.1583;6090;1376
2016-01-08 04:00:00;22,42;18,51;3,91;39549;0;0;0;0;47168;7610;0.1614;6200;1410
2016-01-08 05:00:00;23,93;19,04;4,89;39549;33;0.0008;46;-13;47168;7356;0.156;6095;1261
2016-01-08 06:00:00;29,06;23,25;5,81;39549;904;0.0229;947;-43;47168;7100;0.1505;5810;1290
2016-01-08 07:00:00;32,17;28,34;3,83;39549;3845;0.0972;3920;-75;47168;6083;0.1289;5543;540
2016-01-08 08:00:00;35,0;31,4;3,6;39549;8502;0.215;8623;-121;47168;5277;0.1118;5328;-51
2016-01-08 09:00:00;33,21;30,05;3,16;39549;13681;0.346;13856;-175;47168;5619;0.1191;5390;229
2016-01-08 10:00:00;30,13;27,55;2,58;39549;17481;0.442;18133;-652;47168;6261;0.1327;5537;724
2016-01-08 11:00:00;29,8;26,64;3,16;39549;19362;0.4896;20881;-1519;47168;6553;0.1389;5703;850
2016-01-08 12:00:00;27,92;26,82;1,1;39549;19810;0.5009;22033;-2223;47168;7048;0.1494;6172;876
2016-01-08 13:00:00;25,93;27,62;-1,69;39549;19428;0.4912;21774;-2346;47168;7168;0.152;6678;490
2016-01-08 14:00:00;27,03;27,9;-0,87;39549;18645;0.4714;20393;-1748;47168;7622;0.1616;6879;743
2016-01-08 15:00:00;27,01;28,53;-1,52;39549;16450;0.416;18014;-1564;47168;7573;0.1606;6853;720
2016-01-08 16:00:00;28,48;28,37;0,11;39549;13556;0.3428;14678;-1122;47168;7336;0.1555;6623;713
2016-01-08 17:00:00;32,05;30,9;1,15;39549;10087;0.255;10547;-460;47168;6559;0.139;6014;545
2016-01-08 18:00:00;35,97;34,13;1,84;39549;6432;0.1626;6118;314;47168;5374;0.1139;5010;364
2016-01-08 19:00:00;37,15;35,92;1,23;39549;2939;0.0743;2528;411;47168;4026;0.0853;3986;40
2016-01-08 20:00:00;38,33;35,74;2,59;39549;572;0.0144;538;34;47168;2941;0.0624;3215;-274
2016-01-08 21:00:00;36,95;35,78;1,17;39549;9;0.0002;10;-1;47168;2723;0.0577;2872;-149
2016-01-08 22:00:00;35,99;36,4;-0,41;39549;0;0;0;0;47168;2791;0.0591;2814;-23
2016-01-08 23:00:00;31,63;33,8;-2,17;39549;0;0;0;0;47168;2931;0.0622;2872;59
2016-02-08 00:00:00;27,56;28,36;-0,8;39551;0;0;0;0;47189;2880;0.061;3241;-361
2016-02-08 01:00:00;25,79;26,8;-1,01;39551;0;0;0;0;47189;2801;0.0594;3309;-508
2016-02-08 02:00:00;25,35;26,45;-1,1;39551;0;0;0;0;47189;2808;0.0595;3221;-413
2016-02-08 03:00:00;24,7;24,61;0,09;39551;0;0;0;0;47189;2800;0.0593;3061;-261
2016-02-08 04:00:00;24,27;23,7;0,57;39551;0;0;0;0;47189;2708;0.0574;2961;-253
2016-02-08 05:00:00;25,9;25,1;0,8;39551;19;0.0005;29;-10;47189;2567;0.0544;2880;-313
2016-02-08 06:00:00;30,43;27,13;3,3;39551;537;0.0136;578;-41;47189;2615;0.0554;2831;-216
2016-02-08 07:00:00;34,87;36,07;-1,2;39551;2183;0.0552;2211;-28;47189;2622;0.0555;2876;-254
2016-02-08 08:00:00;36,87;37,71;-0,84;39551;4210;0.1064;4364;-154;47189;2483;0.0526;2952;-469
2016-02-08 09:00:00;36,92;36,74;0,18;39551;6319;0.1598;6437;-118;47189;2540;0.0538;3093;-553
2016-02-08 10:00:00;36,97;36,6;0,37;39551;8252;0.2086;7919;333;47189;2504;0.0531;3306;-802
2016-02-08 11:00:00;38,09;37,09;1,0;39551;9501;0.2402;8857;644;47189;2994;0.0634;3701;-707
2016-02-08 12:00:00;37,83;35,69;2,14;39551;10612;0.2683;9299;1313;47189;3286;0.0696;4247;-961
2016-02-08 13:00:00;36,85;35,04;1,81;39551;9832;0.2486;9046;786;47189;3663;0.0776;4744;-1081
2016-02-08 14:00:00;35,98;33,57;2,41;39551;8711;0.2202;8188;523;47189;4030;0.0854;4936;-906
2016-02-08 15:00:00;35,73;33,1;2,63;39551;7714;0.195;7012;702;47189;4102;0.087;4944;-842
2016-02-08 16:00:00;34,92;33,11;1,81;39551;6117;0.1547;5518;599;47189;3986;0.0845;4866;-880
2016-02-08 17:00:00;35,94;34,06;1,88;39551;4244;0.1073;3913;331;47189;4140;0.0877;4760;-620
2016-02-08 18:00:00;35,92;34,71;1,21;39551;2544;0.0643;2318;226;47189;4182;0.0886;4659;-477
2016-02-08 19:00:00;34,95;33,84;1,11;39551;1107;0.028;973;134;47189;4178;0.0885;4633;-455
2016-02-08 20:00:00;32,83;31,31;1,52;39551;218;0.0055;201;17;47189;4252;0.0901;4766;-514
2016-02-08 21:00:00;32,4;31,72;0,68;39551;3;0.0001;3;0;47189;4754;0.1008;5185;-431
2016-02-08 22:00:00;31,19;30,79;0,4;39551;0;0;0;0;47189;5183;0.1098;5723;-540
2016-02-08 23:00:00;28,98;29,43;-0,45;39551;0;0;0;0;47189;5758;0.122;6306;-548
2016-03-08 00:00:00;26,03;24,22;1,81;39553;0;0;0;0;47197;6398;0.1355;5647;751
2016-03-08 01:00:00;24,53;22,98;1,55;39553;0;0;0;0;47197;6732;0.1426;6101;631
2016-03-08 02:00:00;23,74;20,0;3,74;39553;0;0;0;0;47197;7013;0.1486;6517;496
2016-03-08 03:00:00;22,69;18,09;4,6;39553;0;0;0;0;47197;7270;0.154;6869;401
2016-03-08 04:00:00;22,48;19,37;3,11;39553;0;0;0;0;47197;7524;0.1594;7297;227
2016-03-08 05:00:00;23,66;23,17;0,49;39553;9;0.0002;13;-4;47197;8265;0.1752;7871;394
2016-03-08 06:00:00;27,06;24,82;2,24;39553;390;0.0098;353;37;47197;9180;0.1945;8603;577
2016-03-08 07:00:00;31,82;29,94;1,88;39553;1905;0.0482;1502;403;47197;10060;0.2131;9385;675
2016-03-08 08:00:00;33,95;31,28;2,67;39553;4409;0.1115;3294;1115;47197;10230;0.2167;10211;19
2016-03-08 09:00:00;34,97;30,65;4,32;39553;7028;0.1777;5375;1653;47197;10630;0.2252;11107;-477
2016-03-08 10:00:00;35,02;30,89;4,13;39553;9640;0.2438;7377;2263;47197;11900;0.2521;12074;-174
2016-03-08 11:00:00;34,95;30,02;4,93;39553;11560;0.2923;9163;2397;47197;13172;0.2791;12934;238
2016-03-08 12:00:00;33,57;26,54;7,03;39553;12263;0.31;10415;1848;47197;14214;0.3012;13483;731
2016-03-08 13:00:00;30,04;23,68;6,36;39553;11982;0.303;10859;1123;47197;14639;0.3102;13765;874
2016-03-08 14:00:00;28,13;24,54;3,59;39553;11422;0.2888;10642;780;47197;14782;0.3132;13693;1089
2016-03-08 15:00:00;28,38;26,93;1,45;39553;10154;0.2567;9680;474;47197;14698;0.3114;13393;1305
2016-03-08 16:00:00;28,45;27,82;0,63;39553;8808;0.2227;8132;676;47197;14854;0.3147;13022;1832
2016-03-08 17:00:00;29,95;28,88;1,07;39553;6429;0.1626;6156;273;47197;13812;0.2926;12584;1228
2016-03-08 18:00:00;32,52;29,95;2,57;39553;3864;0.0977;3744;120;47197;13004;0.2755;12064;940
2016-03-08 19:00:00;33,0;31,6;1,4;39553;1655;0.0418;1543;112;47197;12559;0.2661;11538;1021
2016-03-08 20:00:00;31,25;30,77;0,48;39553;334;0.0084;286;48;47197;11932;0.2528;11401;531
2016-03-08 21:00:00;30,33;30,52;-0,19;39553;6;0.0001;3;3;47197;11431;0.2422;11459;-28
2016-03-08 22:00:00;28,99;29,62;-0,63;39553;0;0;0;0;47197;11212;0.2376;11474;-262
2016-03-08 23:00:00;26,91;27,47;-0,56;39553;0;0;0;0;47197;11105;0.2353;11443;-338
2016-04-08 00:00:00;23,55;28,9;-5,35;39556;0;0;0;0;47212;10793;0.2286;12478;-1685
2016-04-08 01:00:00;22,43;26,97;-4,54;39556;0;0;0;0;47212;11296;0.2393;12699;-1403
2016-04-08 02:00:00;20,05;24,38;-4,33;39556;0;0;0;0;47212;11279;0.2389;12798;-1519
2016-04-08 03:00:00;19,42;22,11;-2,69;39556;0;0;0;0;47212;10978;0.2326;12658;-1680
2016-04-08 04:00:00;19,83;21,15;-1,32;39556;0;0;0;0;47212;10873;0.2303;12508;-1635
2016-04-08 05:00:00;22,42;25,57;-3,15;39556;16;0.0004;26;-10;47212;10598;0.2244;12380;-1782
2016-04-08 06:00:00;25,49;28,47;-2,98;39556;644;0.0163;727;-83;47212;10858;0.23;12272;-1414
2016-04-08 07:00:00;30,01;32,28;-2,27;39556;3035;0.0768;3150;-115;47212;10708;0.2268;12265;-1557
2016-04-08 08:00:00;33,05;35,08;-2,03;39556;6624;0.1674;6828;-204;47212;10640;0.2254;12502;-1862
2016-04-08 09:00:00;32,03;34,84;-2,81;39556;10690;0.2702;10813;-123;47212;11142;0.236;12979;-1837
2016-04-08 10:00:00;29,01;33,92;-4,91;39556;14353;0.3628;14254;99;47212;12100;0.2563;13473;-1373
2016-04-08 11:00:00;27,98;31,79;-3,81;39556;16539;0.4181;16763;-224;47212;13152;0.2786;13980;-828
2016-04-08 12:00:00;25,45;29,15;-3,7;39556;17444;0.441;18138;-694;47212;13580;0.2876;14386;-806
2016-04-08 13:00:00;23,58;28,87;-5,29;39556;16769;0.4239;18116;-1347;47212;13461;0.2851;14648;-1187
2016-04-08 14:00:00;23,97;30,92;-6,95;39556;15324;0.3874;16952;-1628;47212;12857;0.2723;14322;-1465
2016-04-08 15:00:00;27,02;32,83;-5,81;39556;12969;0.3279;14715;-1746;47212;12346;0.2615;13605;-1259
2016-04-08 16:00:00;29,29;34,29;-5,0;39556;9925;0.2509;11457;-1532;47212;11252;0.2383;12444;-1192
2016-04-08 17:00:00;32,98;36,36;-3,38;39556;6739;0.1704;7768;-1029;47212;10334;0.2189;10893;-559
2016-04-08 18:00:00;34,58;36,87;-2,29;39556;3648;0.0922;4303;-655;47212;9046;0.1917;9286;-240
2016-04-08 19:00:00;34,9;36,54;-1,64;39556;1488;0.0376;1713;-225;47212;7774;0.1646;7983;-209
2016-04-08 20:00:00;34,58;36,21;-1,63;39556;286;0.0072;307;-21;47212;6571;0.1392;7221;-650
2016-04-08 21:00:00;34,46;36,69;-2,23;39556;6;0.0001;4;2;47212;6412;0.1358;6894;-482
2016-04-08 22:00:00;33,91;37,08;-3,17;39556;0;0;0;0;47212;6152;0.1303;6746;-594
2016-04-08 23:00:00;29,37;31,93;-2,56;39556;0;0;0;0;47212;5744;0.1217;6645;-901
2016-05-08 00:00:00;28,13;26,32;1,81;39558;0;0;0;0;47235;5210;0.1103;5876;-666
2016-05-08 01:00:00;26,83;25,84;0,99;39558;0;0;0;0;47235;4639;0.0982;5760;-1121
2016-05-08 02:00:00;25,12;23,97;1,15;39558;0;0;0;0;47235;4363;0.0924;5574;-1211
2016-05-08 03:00:00;23,95;22,35;1,6;39558;0;0;0;0;47235;4198;0.0889;5385;-1187
2016-05-08 04:00:00;24,07;22,44;1,63;39558;0;0;0;0;47235;4172;0.0883;5188;-1016
2016-05-08 05:00:00;26,24;28,0;-1,76;39558;6;0.0002;13;-7;47235;4540;0.0961;4985;-445
2016-05-08 06:00:00;30,45;29,22;1,23;39558;313;0.0079;357;-44;47235;4333;0.0918;4772;-439
2016-05-08 07:00:00;34,01;33,81;0,2;39558;1557;0.0394;1650;-93;47235;3979;0.0842;4531;-552
2016-05-08 08:00:00;37,19;37,76;-0,57;39558;3435;0.0868;3656;-221;47235;3435;0.0727;4354;-919
2016-05-08 09:00:00;38,69;38,91;-0,22;39558;5746;0.1452;5965;-219;47235;3425;0.0725;4348;-923
2016-05-08 10:00:00;38,54;39,64;-1,1;39558;8170;0.2066;8378;-208;47235;4000;0.0847;4456;-456
2016-05-08 11:00:00;38,0;40,15;-2,15;39558;10319;0.2608;10598;-279;47235;4676;0.099;4798;-122
2016-05-08 12:00:00;36,0;36,15;-0,15;39558;11524;0.2914;12183;-659;47235;5616;0.1189;5375;241
2016-05-08 13:00:00;33,96;34,85;-0,89;39558;12727;0.3217;12855;-128;47235;6078;0.1287;6006;72
2016-05-08 14:00:00;31,39;31,77;-0,38;39558;12509;0.3162;12883;-374;47235;6707;0.142;6540;167
2016-05-08 15:00:00;28,23;28,76;-0,53;39558;11801;0.2983;12037;-236;47235;7482;0.1584;7019;463
2016-05-08 16:00:00;28,46;26,69;1,77;39558;10612;0.2682;10240;372;47235;7645;0.1618;7246;399
2016-05-08 17:00:00;31,29;26,89;4,4;39558;8194;0.2072;7737;457;47235;7986;0.169;7149;837
2016-05-08 18:00:00;33,89;29,32;4,57;39558;5028;0.1271;4807;221;47235;7518;0.1592;6765;753
2016-05-08 19:00:00;34,4;30,54;3,86;39558;2164;0.0547;2085;79;47235;7477;0.1583;6380;1097
2016-05-08 20:00:00;34,15;30,52;3,63;39558;410;0.0104;385;25;47235;6914;0.1463;6358;556
2016-05-08 21:00:00;33,02;30,15;2,87;39558;5;0.0001;5;0;47235;6302;0.1334;6716;-414
2016-05-08 22:00:00;32,3;29,83;2,47;39558;0;0;0;0;47235;6135;0.1299;7124;-989
2016-05-08 23:00:00;28,84;29,11;-0,27;39558;0;0;0;0;47235;6567;0.139;7458;-891
2016-06-08 00:00:00;29,58;24,16;5,42;39558;0;0;0;0;47235;6525;0.1381;6826;-301
2016-06-08 01:00:00;26,68;24,68;2,0;39558;0;0;0;0;47235;6022;0.1275;6960;-938
2016-06-08 02:00:00;25,34;22,05;3,29;39558;0;0;0;0;47235;5673;0.1201;6978;-1305
2016-06-08 03:00:00;23,77;20,23;3,54;39558;0;0;0;0;47235;5460;0.1156;6868;-1408
2016-06-08 04:00:00;22,4;18,8;3,6;39558;0;0;0;0;47235;5286;0.1119;6717;-1431
2016-06-08 05:00:00;22,01;18,2;3,81;39558;15;0.0004;23;-8;47235;5133;0.1086;6602;-1469
2016-06-08 06:00:00;22,97;18,7;4,27;39558;615;0.0155;709;-94;47235;5486;0.1161;6269;-783
2016-06-08 07:00:00;25,02;21,3;3,72;39558;2989;0.0756;3212;-223;47235;5233;0.1108;5791;-558
2016-06-08 08:00:00;26,36;21,49;4,87;39558;6631;0.1676;7034;-403;47235;4590;0.0972;5544;-954
2016-06-08 09:00:00;26,47;23,68;2,79;39558;10575;0.2673;11271;-696;47235;5150;0.109;5792;-642
2016-06-08 10:00:00;24,94;23,48;1,46;39558;13684;0.346;14864;-1180;47235;6332;0.134;6288;44
2016-06-08 11:00:00;23,71;21,95;1,76;39558;15620;0.3948;17210;-1590;47235;7284;0.1542;7012;272
2016-06-08 12:00:00;22,07;19,89;2,18;39558;16174;0.4089;18394;-2220;47235;7466;0.158;7852;-386
2016-06-08 13:00:00;19,81;18,5;1,31;39558;16249;0.4107;18529;-2280;47235;8128;0.172;8736;-608
2016-06-08 14:00:00;18,38;17,43;0,95;39558;15640;0.3954;17703;-2063;47235;8730;0.1848;9587;-857
2016-06-08 15:00:00;17,83;15,6;2,23;39558;14326;0.3621;15812;-1486;47235;9162;0.194;10399;-1237
2016-06-08 16:00:00;17,18;13,51;3,67;39558;12120;0.3064;13047;-927;47235;9915;0.2099;10972;-1057
2016-06-08 17:00:00;22,03;19,92;2,11;39558;8948;0.2262;9471;-523;47235;10206;0.2161;10869;-663
2016-06-08 18:00:00;26,32;25,57;0,75;39558;5494;0.1389;5555;-61;47235;9489;0.2009;10168;-679
2016-06-08 19:00:00;28,96;26,48;2,48;39558;2338;0.0591;2257;81;47235;7852;0.1662;9244;-1392
2016-06-08 20:00:00;28,92;27,95;0,97;39558;418;0.0106;399;19;47235;6074;0.1286;8732;-2658
2016-06-08 21:00:00;30,32;30,81;-0,49;39558;1;0;5;-4;47235;6005;0.1271;8410;-2405
2016-06-08 22:00:00;30,44;30,36;0,08;39558;0;0;0;0;47235;6201;0.1313;8156;-1955
2016-06-08 23:00:00;28,12;26,72;1,4;39558;0;0;0;0;47235;6065;0.1284;7936;-1871
2016-07-08 00:00:00;24,6;22,79;1,81;39558;0;0;0;0;47235;5631;0.1192;5669;-38
2016-07-08 01:00:00;20,05;20,73;-0,68;39558;0;0;0;0;47235;5595;0.1184;5648;-53
2016-07-08 02:00:00;17,99;16,71;1,28;39558;0;0;0;0;47235;5743;0.1216;5658;85
2016-07-08 03:00:00;12,86;10,87;1,99;39558;0;0;0;0;47235;6218;0.1317;5897;321
2016-07-08 04:00:00;12,38;9,28;3,1;39558;0;0;0;0;47235;6653;0.1408;6122;531
2016-07-08 05:00:00;12,35;8,79;3,56;39558;14;0.0004;26;-12;47235;7174;0.1519;6274;900
2016-07-08 06:00:00;12,51;8,61;3,9;39558;693;0.0175;797;-104;47235;7887;0.167;6457;1430
2016-07-08 07:00:00;11,93;7,02;4,91;39558;3594;0.0908;3858;-264;47235;7417;0.157;6713;704
2016-07-08 08:00:00;12,25;6,18;6,07;39558;8540;0.2159;8891;-351;47235;6472;0.137;7243;-771
2016-07-08 09:00:00;12,79;7,45;5,34;39558;14254;0.3604;14481;-227;47235;7582;0.1605;8001;-419
2016-07-08 10:00:00;9,95;2,66;7,29;39558;18866;0.4769;19130;-264;47235;9253;0.1959;8918;335
2016-07-08 11:00:00;8,83;0,27;8,56;39558;22227;0.5619;22209;18;47235;10584;0.224;9643;941
2016-07-08 12:00:00;5,93;-3,66;9,59;39558;24084;0.6088;23784;300;47235;11362;0.2405;10214;1148
2016-07-08 13:00:00;0,02;-14,76;14,78;39558;24258;0.6132;24042;216;47235;12121;0.2566;10671;1450
2016-07-08 14:00:00;0,04;-15,15;15,19;39558;23046;0.5826;22925;121;47235;12095;0.2561;10930;1165
2016-07-08 15:00:00;2,35;-17,77;20,12;39558;20516;0.5187;20375;141;47235;11882;0.2515;10959;923
2016-07-08 16:00:00;5,67;-10,97;16,64;39558;16745;0.4233;16485;260;47235;11484;0.2432;10652;832
2016-07-08 17:00:00;12,84;4,34;8,5;39558;11817;0.2987;11521;296;47235;10766;0.2279;10045;721
2016-07-08 18:00:00;24,7;20,47;4,23;39558;6598;0.1668;6188;410;47235;9772;0.2069;9204;568
2016-07-08 19:00:00;27,77;25,59;2,18;39558;2412;0.061;2165;247;47235;8550;0.181;8407;143
2016-07-08 20:00:00;30,48;27,35;3,13;39558;401;0.0102;372;29;47235;7324;0.155;8396;-1072
2016-07-08 21:00:00;32,37;28,0;4,37;39558;0;0;5;-5;47235;7530;0.1594;8800;-1270
2016-07-08 22:00:00;32,65;28,57;4,08;39558;0;0;0;0;47235;8727;0.1848;9517;-790
2016-07-08 23:00:00;26,33;25,5;0,83;39558;0;0;0;0;47235;10156;0.215;10227;-71
2016-08-08 00:00:00;20,62;18,61;2,01;39563;0;0;0;0;47235;11204;0.2372;10595;609
2016-08-08 01:00:00;16,44;13,37;3,07;39563;0;0;0;0;47235;11491;0.2432;11495;-4
2016-08-08 02:00:00;12,91;12,45;0,46;39563;0;0;0;0;47235;11687;0.2474;12469;-782
2016-08-08 03:00:00;8,16;12,09;-3,93;39563;0;0;0;0;47235;12538;0.2654;13446;-908
2016-08-08 04:00:00;8,12;13,8;-5,68;39563;0;0;0;0;47235;13730;0.2907;14390;-660
2016-08-08 05:00:00;8,94;13,43;-4,49;39563;10;0.0002;19;-9;47235;14715;0.3115;15178;-463
2016-08-08 06:00:00;17,85;16,31;1,54;39563;592;0.015;678;-86;47235;15433;0.3268;15795;-362
2016-08-08 07:00:00;23,71;24,84;-1,13;39563;3171;0.0802;3379;-208;47235;15394;0.3259;16265;-871
2016-08-08 08:00:00;26,29;29,46;-3,17;39563;7688;0.1944;7711;-23;47235;15250;0.3228;16914;-1664
2016-08-08 09:00:00;24,02;27,21;-3,19;39563;12582;0.318;12424;158;47235;16229;0.3436;17917;-1688
2016-08-08 10:00:00;20,26;22,07;-1,81;39563;16748;0.4234;16355;393;47235;16916;0.3582;18977;-2061
2016-08-08 11:00:00;18,73;21,76;-3,03;39563;19736;0.4988;19055;681;47235;18238;0.3861;19919;-1681
2016-08-08 12:00:00;14,28;17,65;-3,37;39563;20624;0.5213;20491;133;47235;19364;0.41;20595;-1231
2016-08-08 13:00:00;13,41;18,16;-4,75;39563;20346;0.5143;20545;-199;47235;19885;0.421;20857;-972
2016-08-08 14:00:00;12,89;17,53;-4,64;39563;19585;0.495;19372;213;47235;19683;0.4167;20741;-1058
2016-08-08 15:00:00;17,92;21,12;-3,2;39563;17778;0.4494;17179;599;47235;19577;0.4144;20508;-931
2016-08-08 16:00:00;20,82;21,99;-1,17;39563;14598;0.369;14041;557;47235;19090;0.4041;19722;-632
2016-08-08 17:00:00;26,52;24,49;2,03;39563;10550;0.2666;9959;591;47235;17711;0.375;18562;-851
2016-08-08 18:00:00;31,29;30,63;0,66;39563;6030;0.1524;5569;461;47235;16381;0.3468;16766;-385
2016-08-08 19:00:00;34,39;33,06;1,33;39563;2208;0.0558;2133;75;47235;14640;0.3099;14559;81
2016-08-08 20:00:00;33,23;31,29;1,94;39563;330;0.0084;343;-13;47235;12395;0.2624;12011;384
2016-08-08 21:00:00;34,0;33,39;0,61;39563;0;0;3;-3;47235;10344;0.219;10142;202
2016-08-08 22:00:00;33,93;33,17;0,76;39563;0;0;0;0;47235;9073;0.1921;8642;431
2016-08-08 23:00:00;31,75;29,9;1,85;39563;0;0;0;0;47235;8038;0.1702;7644;394
2016-09-08 00:00:00;23,88;24,51;-0,63;39567;0;0;0;0;47239;7212;0.1527;8615;-1403
2016-09-08 01:00:00;23,06;21,72;1,34;39567;0;0;0;0;47239;6509;0.1378;8216;-1707
2016-09-08 02:00:00;22,6;21,99;0,61;39567;0;0;0;0;47239;5968;0.1264;7857;-1889
2016-09-08 03:00:00;20,32;22,48;-2,16;39567;0;0;0;0;47239;5470;0.1158;7512;-2042
2016-09-08 04:00:00;19,94;21,75;-1,81;39567;0;0;0;0;47239;5263;0.1114;7116;-1853
2016-09-08 05:00:00;22,97;23,5;-0,53;39567;4;0.0001;11;-7;47239;5240;0.1109;6802;-1562
2016-09-08 06:00:00;28,33;25,69;2,64;39567;298;0.0075;400;-102;47239;5636;0.1193;6553;-917
2016-09-08 07:00:00;32,86;31,0;1,86;39567;1547;0.0391;1900;-353;47239;5128;0.1086;6413;-1285
2016-09-08 08:00:00;34,83;35,08;-0,25;39567;3563;0.09;4279;-716;47239;4615;0.0977;6399;-1784
2016-09-08 09:00:00;35,03;35,7;-0,67;39567;6210;0.157;6989;-779;47239;4776;0.1011;6744;-1968
2016-09-08 10:00:00;34,6;33,33;1,27;39567;9334;0.2359;9427;-93;47239;6046;0.128;7423;-1377
2016-09-08 11:00:00;34,26;30,28;3,98;39567;11736;0.2967;11305;431;47239;7687;0.1627;8111;-424
2016-09-08 12:00:00;33,6;28,84;4,76;39567;13348;0.3374;12513;835;47239;9328;0.1975;8882;446
2016-09-08 13:00:00;32,78;28,17;4,61;39567;14358;0.3629;12850;1508;47239;10340;0.2189;9650;690
2016-09-08 14:00:00;30,22;26,81;3,41;39567;14216;0.3593;12469;1747;47239;11310;0.2394;10334;976
2016-09-08 15:00:00;27,84;24,56;3,28;39567;12618;0.3189;11371;1247;47239;12266;0.2596;11047;1219
2016-09-08 16:00:00;25,97;23,61;2,36;39567;10014;0.2531;9544;470;47239;12399;0.2625;11646;753
2016-09-08 17:00:00;28,12;27,18;0,94;39567;7090;0.1792;7106;-16;47239;12230;0.2589;11833;397
2016-09-08 18:00:00;30,35;28,56;1,79;39567;4210;0.1064;4248;-38;47239;12075;0.2556;11426;649
2016-09-08 19:00:00;32,02;30,85;1,17;39567;1652;0.0418;1698;-46;47239;9966;0.211;11014;-1048
2016-09-08 20:00:00;30,91;30,22;0,69;39567;247;0.0062;259;-12;47239;8725;0.1847;10399;-1674
2016-09-08 21:00:00;30,47;31,35;-0,88;39567;0;0;2;-2;47239;7989;0.1691;9800;-1811
2016-09-08 22:00:00;29,1;30,87;-1,77;39567;0;0;0;0;47239;7769;0.1645;9389;-1620
2016-09-08 23:00:00;26,45;27,33;-0,88;39567;0;0;0;0;47239;7352;0.1556;9258;-1906
2016-10-08 00:00:00;23,35;23,26;0,09;39569;0;0;0;0;47265;6955;0.1471;7813;-858
2016-10-08 01:00:00;23,11;20,92;2,19;39569;0;0;0;0;47265;6782;0.1435;7751;-969
2016-10-08 02:00:00;22,0;19,51;2,49;39569;0;0;0;0;47265;6716;0.1421;7662;-946
2016-10-08 03:00:00;19,99;15,63;4,36;39569;0;0;0;0;47265;6661;0.1409;7443;-782
2016-10-08 04:00:00;20,19;16,39;3,8;39569;0;0;0;0;47265;6614;0.14;7355;-741
2016-10-08 05:00:00;23,18;22,68;0,5;39569;6;0.0002;14;-8;47265;6536;0.1382;7235;-699
2016-10-08 06:00:00;27,59;27,57;0,02;39569;396;0.01;513;-117;47265;6273;0.1328;7165;-892
2016-10-08 07:00:00;32,21;32,02;0,19;39569;2017;0.051;2620;-603;47265;5598;0.1185;6891;-1293
2016-10-08 08:00:00;33,95;34,94;-0,99;39569;4594;0.1161;5962;-1368;47265;5003;0.1058;6804;-1801
2016-10-08 09:00:00;33,5;36,8;-3,3;39569;8131;0.2055;9791;-1660;47265;4989;0.1056;7038;-2049
2016-10-08 10:00:00;32,01;33,76;-1,75;39569;11834;0.2991;13238;-1404;47265;5521;0.1168;7366;-1845
2016-10-08 11:00:00;31,87;32,19;-0,32;39569;14291;0.3612;15927;-1636;47265;6738;0.1426;7792;-1054
2016-10-08 12:00:00;29,66;31,55;-1,89;39569;15127;0.3823;17648;-2521;47265;8268;0.1749;8043;225
2016-10-08 13:00:00;26,91;29,9;-2,99;39569;14674;0.3708;18107;-3433;47265;9053;0.1915;8369;684
2016-10-08 14:00:00;25,43;29,39;-3,96;39569;14197;0.3588;17457;-3260;47265;9596;0.203;8869;727
2016-10-08 15:00:00;24,51;29,45;-4,94;39569;13410;0.3389;15611;-2201;47265;10330;0.2185;9303;1027
2016-10-08 16:00:00;24,31;27,0;-2,69;39569;11958;0.3022;12732;-774;47265;10642;0.2252;9590;1052
2016-10-08 17:00:00;27,33;28,2;-0,87;39569;9095;0.2298;9068;27;47265;10255;0.217;9351;904
2016-10-08 18:00:00;31,48;29,08;2,4;39569;5322;0.1345;5200;122;47265;9498;0.201;8803;695
2016-10-08 19:00:00;33,68;31,54;2,14;39569;2130;0.0538;2006;124;47265;8277;0.1751;7959;318
2016-10-08 20:00:00;33,72;30,97;2,75;39569;302;0.0076;292;10;47265;6676;0.1412;7402;-726
2016-10-08 21:00:00;33,93;31,47;2,46;39569;0;0;3;-3;47265;6186;0.1309;6928;-742
2016-10-08 22:00:00;32,93;30,84;2,09;39569;0;0;0;0;47265;6665;0.141;6561;104
2016-10-08 23:00:00;28,65;26,65;2,0;39569;0;0;0;0;47265;7144;0.1512;6503;641
2016-11-08 00:00:00;24,23;21,27;2,96;39572;0;0;0;0;47273;7904;0.1672;7007;897
2016-11-08 01:00:00;23,01;18,44;4,57;39572;0;0;0;0;47273;7718;0.1633;6975;743
2016-11-08 02:00:00;22,72;17,84;4,88;39572;0;0;0;0;47273;7493;0.1585;6984;509
2016-11-08 03:00:00;20,49;15,95;4,54;39572;0;0;0;0;47273;7444;0.1575;6984;460
2016-11-08 04:00:00;21,48;16,21;5,27;39572;0;0;0;0;47273;7608;0.1609;6990;618
2016-11-08 05:00:00;22,77;15,94;6,83;39572;8;0.0002;16;-8;47273;7476;0.1582;6811;665
2016-11-08 06:00:00;27,97;20,97;7,0;39572;566;0.0143;651;-85;47273;6782;0.1435;6343;439
2016-11-08 07:00:00;34,09;25,35;8,74;39572;3269;0.0826;3600;-331;47273;5487;0.116;5840;-353
2016-11-08 08:00:00;35,67;29,94;5,73;39572;7762;0.1961;8520;-758;47273;4174;0.0883;5639;-1465
2016-11-08 09:00:00;33,07;30,01;3,06;39572;12799;0.3234;13861;-1062;47273;4793;0.1014;6022;-1229
2016-11-08 10:00:00;30,86;28,59;2,27;39572;16272;0.4112;17634;-1362;47273;6296;0.1332;6958;-662
2016-11-08 11:00:00;30,48;27,83;2,65;39572;17253;0.436;19408;-2155;47273;8173;0.1729;8111;62
2016-11-08 12:00:00;28,57;28,52;0,05;39572;17279;0.4366;19834;-2555;47273;9703;0.2052;9232;471
2016-11-08 13:00:00;27,17;27,58;-0,41;39572;16811;0.4248;19180;-2369;47273;10694;0.2262;10191;503
2016-11-08 14:00:00;24,99;25,82;-0,83;39572;15727;0.3974;17426;-1699;47273;10918;0.231;11041;-123
2016-11-08 15:00:00;25,62;25,69;-0,07;39572;13814;0.3491;14739;-925;47273;11228;0.2375;11761;-533
2016-11-08 16:00:00;25,69;22,93;2,76;39572;10903;0.2755;11325;-422;47273;11144;0.2357;12018;-874
2016-11-08 17:00:00;31,4;28,5;2,9;39572;7498;0.1895;7541;-43;47273;10662;0.2255;11845;-1183
2016-11-08 18:00:00;34,37;30,48;3,89;39572;3911;0.0988;3960;-49;47273;9564;0.2023;11305;-1741
2016-11-08 19:00:00;34,95;30,88;4,07;39572;1308;0.033;1368;-60;47273;8417;0.1781;10791;-2374
2016-11-08 20:00:00;35,11;31,4;3,71;39572;124;0.0032;166;-42;47273;7787;0.1648;10912;-3125
2016-11-08 21:00:00;34,82;31,28;3,54;39572;0;0;1;-1;47273;7474;0.1581;11129;-3655
2016-11-08 22:00:00;33,87;30,2;3,67;39572;0;0;0;0;47273;7580;0.1604;11511;-3931
2016-11-08 23:00:00;28,82;26,43;2,39;39572;0;0;0;0;47273;7718;0.1632;12060;-4342
2016-12-08 00:00:00;24,07;24,11;-0,04;39575;0;0;0;0;47286;7759;0.1641;9353;-1594
2016-12-08 01:00:00;22,97;22,63;0,34;39575;0;0;0;0;47286;7307;0.1545;9544;-2237
2016-12-08 02:00:00;21,05;19,7;1,35;39575;0;0;0;0;47286;6806;0.144;9613;-2807
2016-12-08 03:00:00;19,9;17,14;2,76;39575;0;0;0;0;47286;6371;0.1347;9500;-3129
2016-12-08 04:00:00;20,05;19,29;0,76;39575;0;0;0;0;47286;6132;0.1297;9387;-3255
2016-12-08 05:00:00;22,98;25,33;-2,35;39575;2;0;2;0;47286;5789;0.1224;9282;-3493
2016-12-08 06:00:00;27,93;29,31;-1,38;39575;147;0.0037;138;9;47286;5580;0.118;9214;-3634
2016-12-08 07:00:00;32,55;37,13;-4,58;39575;869;0.022;675;194;47286;5344;0.113;9085;-3741
2016-12-08 08:00:00;33,8;37,07;-3,27;39575;2105;0.0532;1536;569;47286;5069;0.1072;9055;-3986
2016-12-08 09:00:00;34,04;36,0;-1,96;39575;3498;0.0884;2527;971;47286;5178;0.1095;9381;-4203
2016-12-08 10:00:00;34,91;36,33;-1,42;39575;5060;0.1278;3543;1517;47286;5847;0.1236;9756;-3909
2016-12-08 11:00:00;35,25;36,38;-1,13;39575;6309;0.1594;4487;1822;47286;6469;0.1368;10198;-3729
2016-12-08 12:00:00;34,95;34,11;0,84;39575;7221;0.1824;5219;2002;47286;7243;0.1532;10732;-3489
2016-12-08 13:00:00;32,1;32,8;-0,7;39575;7733;0.1954;5550;2183;47286;8526;0.1803;11223;-2697
2016-12-08 14:00:00;29,5;29,38;0,12;39575;7906;0.1998;5570;2336;47286;9446;0.1998;11576;-2130
2016-12-08 15:00:00;27,12;27,75;-0,63;39575;7586;0.1917;5288;2298;47286;9588;0.2027;12009;-2421
2016-12-08 16:00:00;24,2;25,98;-1,78;39575;6319;0.1597;4718;1601;47286;9831;0.2079;12214;-2383
2016-12-08 17:00:00;26,9;28,35;-1,45;39575;4735;0.1196;3826;909;47286;10040;0.2123;12099;-2059
2016-12-08 18:00:00;28,09;30,49;-2,4;39575;2833;0.0716;2448;385;47286;9874;0.2088;11660;-1786
2016-12-08 19:00:00;29,06;31,46;-2,4;39575;1146;0.029;988;158;47286;9713;0.2054;11138;-1425
2016-12-08 20:00:00;29,13;30,31;-1,18;39575;147;0.0037;142;5;47286;9598;0.203;10858;-1260
2016-12-08 21:00:00;28,99;30,78;-1,79;39575;0;0;1;-1;47286;9476;0.2004;10877;-1401
2016-12-08 22:00:00;28,34;31,24;-2,9;39575;0;0;0;0;47286;9434;0.1995;11124;-1690
2016-12-08 23:00:00;24,7;28,95;-4,25;39575;0;0;0;0;47286;9382;0.1984;11342;-1960
2016-08-13 00:00:00;21,7;23,91;-2,21;39575;0;0;0;0;47286;9754;0.2063;11145;-1391
2016-08-13 01:00:00;19,97;21,73;-1,76;39575;0;0;0;0;47286;10025;0.212;11414;-1389
2016-08-13 02:00:00;18,09;19,82;-1,73;39575;0;0;0;0;47286;10052;0.2126;11521;-1469
2016-08-13 03:00:00;16,89;19,17;-2,28;39575;0;0;0;0;47286;9826;0.2078;11415;-1589
2016-08-13 04:00:00;16,1;15,95;0,15;39575;0;0;0;0;47286;9574;0.2025;11309;-1735
2016-08-13 05:00:00;14,46;15,49;-1,03;39575;5;0.0001;10;-5;47286;9718;0.2055;11218;-1500
2016-08-13 06:00:00;16,08;17,87;-1,79;39575;459;0.0116;510;-51;47286;9834;0.208;11172;-1338
2016-08-13 07:00:00;18,05;22,3;-4,25;39575;2922;0.0738;2987;-65;47286;9727;0.2057;11072;-1345
2016-08-13 08:00:00;20,06;25,25;-5,19;39575;7313;0.1848;7194;119;47286;9546;0.2019;11407;-1861
2016-08-13 09:00:00;20,06;24,2;-4,14;39575;12613;0.3187;12146;467;47286;10548;0.2231;12524;-1976
2016-08-13 10:00:00;18,06;20,49;-2,43;39575;17117;0.4325;16391;726;47286;13110;0.2772;13666;-556
2016-08-13 11:00:00;15,85;13,98;1,87;39575;19655;0.4966;19197;458;47286;15193;0.3213;14621;572
2016-08-13 12:00:00;13,64;11,59;2,05;39575;20675;0.5224;20701;-26;47286;15693;0.3319;15203;490
2016-08-13 13:00:00;9,07;7,1;1,97;39575;21117;0.5336;21016;101;47286;16125;0.341;15549;576
2016-08-13 14:00:00;9,11;4,2;4,91;39575;20726;0.5237;20013;713;47286;15757;0.3333;15642;115
2016-08-13 15:00:00;10,54;5,9;4,64;39575;18762;0.4741;17764;998;47286;15448;0.3267;15639;-191
2016-08-13 16:00:00;12,52;18,12;-5,6;39575;15488;0.3914;14496;992;47286;14948;0.3161;15244;-296
2016-08-13 17:00:00;18,77;19,9;-1,13;39575;10879;0.2749;10209;670;47286;14072;0.2976;14456;-384
2016-08-13 18:00:00;24,72;26,88;-2,16;39575;5891;0.1488;5504;387;47286;12508;0.2645;13229;-721
2016-08-13 19:00:00;26,88;31,33;-4,45;39575;1872;0.0473;1859;13;47286;10627;0.2247;11787;-1160
2016-08-13 20:00:00;27,7;32,36;-4,66;39575;211;0.0053;230;-19;47286;9204;0.1946;10828;-1624
2016-08-13 21:00:00;29,08;33,61;-4,53;39575;0;0;1;-1;47286;8350;0.1766;10042;-1692
2016-08-13 22:00:00;28,31;31,13;-2,82;39575;0;0;0;0;47286;7329;0.155;9274;-1945
2016-08-13 23:00:00;25,73;29,04;-3,31;39575;0;0;0;0;47286;6285;0.1329;8677;-2392
2016-08-14 00:00:00;23,44;25,32;-1,88;39576;0;0;0;0;47286;5496;0.1162;6877;-1381
2016-08-14 01:00:00;21,18;23,18;-2,0;39576;0;0;0;0;47286;4658;0.0985;6244;-1586
2016-08-14 02:00:00;19,61;20,69;-1,08;39576;0;0;0;0;47286;4078;0.0863;5806;-1728
2016-08-14 03:00:00;19,03;20,68;-1,65;39576;0;0;0;0;47286;3675;0.0777;5383;-1708
2016-08-14 04:00:00;18,05;19,29;-1,24;39576;0;0;0;0;47286;3545;0.075;5001;-1456
2016-08-14 05:00:00;18,08;19,89;-1,81;39576;4;0.0001;8;-4;47286;3408;0.0721;4566;-1158
2016-08-14 06:00:00;18,06;20,08;-2,02;39576;452;0.0114;502;-50;47286;3307;0.07;4184;-877
2016-08-14 07:00:00;19,14;21,31;-2,17;39576;2940;0.0743;3007;-67;47286;3156;0.0667;3584;-428
2016-08-14 08:00:00;19,9;21,02;-1,12;39576;7448;0.1882;7202;246;47286;2798;0.0592;3169;-371
2016-08-14 09:00:00;18,99;20,32;-1,33;39576;12565;0.3175;11990;575;47286;3462;0.0732;3778;-316
2016-08-14 10:00:00;19,74;19,86;-0,12;39576;16442;0.4154;16038;404;47286;3738;0.079;4060;-322
2016-08-14 11:00:00;20,46;18,69;1,77;39576;19084;0.4822;18749;335;47286;4262;0.0901;4293;-31
2016-08-14 12:00:00;19,1;17,42;1,68;39576;19928;0.5035;20025;-97;47286;4470;0.0945;4616;-146
2016-08-14 13:00:00;17,41;13,18;4,23;39576;19710;0.498;19995;-285;47286;4831;0.1021;4974;-143
2016-08-14 14:00:00;15,99;13,05;2,94;39576;18742;0.4736;18841;-99;47286;5187;0.1097;5259;-72
2016-08-14 15:00:00;16,57;13,97;2,6;39576;17022;0.4301;16545;477;47286;5346;0.113;5412;-66
2016-08-14 16:00:00;16,89;15,15;1,74;39576;14235;0.3597;13373;862;47286;5275;0.1116;5460;-185
2016-08-14 17:00:00;20,13;19,26;0,87;39576;10316;0.2606;9384;932;47286;5247;0.111;5199;48
2016-08-14 18:00:00;26,75;25,92;0,83;39576;5798;0.1465;5108;690;47286;4789;0.1013;4742;47
2016-08-14 19:00:00;29,57;30,06;-0,49;39576;2018;0.051;1745;273;47286;4272;0.0904;4148;124
2016-08-14 20:00:00;31,56;31,48;0,08;39576;222;0.0056;199;23;47286;3862;0.0816;3416;446
2016-08-14 21:00:00;32,3;30,66;1,64;39576;0;0;1;-1;47286;4145;0.0876;3397;748
2016-08-14 22:00:00;31,56;31,66;-0,1;39576;0;0;0;0;47286;4139;0.0875;3273;866
2016-08-14 23:00:00;28,5;24,7;3,8;39576;0;0;0;0;47286;4068;0.086;3135;933
2016-08-15 00:00:00;25,15;23,53;1,62;39577;0;0;0;0;47297;3850;0.0814;2982;868
2016-08-15 01:00:00;22,94;23,75;-0,81;39577;0;0;0;0;47297;3504;0.0741;2863;641
2016-08-15 02:00:00;21,61;17,65;3,96;39577;0;0;0;0;47297;3240;0.0685;2825;415
2016-08-15 03:00:00;21,01;18,77;2,24;39577;0;0;0;0;47297;3164;0.0669;2840;324
2016-08-15 04:00:00;21,5;17,99;3,51;39577;0;0;0;0;47297;3132;0.0662;2877;255
2016-08-15 05:00:00;23,29;19,11;4,18;39577;3;0.0001;6;-3;47297;3097;0.0655;2774;323
2016-08-15 06:00:00;27,21;23,17;4,04;39577;429;0.0108;481;-52;47297;3092;0.0653;2492;600
2016-08-15 07:00:00;30,82;26,44;4,38;39577;2855;0.0721;3058;-203;47297;2487;0.0526;2032;455
2016-08-15 08:00:00;32,0;31,18;0,82;39577;7234;0.1828;7603;-369;47297;1440;0.0304;1465;-25
2016-08-15 09:00:00;30,59;30,94;-0,35;39577;12646;0.3196;12884;-238;47297;1105;0.0233;1425;-320
2016-08-15 10:00:00;28,65;28,56;0,09;39577;17458;0.4411;17113;345;47297;1298;0.0274;1577;-279
2016-08-15 11:00:00;28,32;26,67;1,65;39577;20296;0.5128;19707;589;47297;1530;0.0324;1734;-204
2016-08-15 12:00:00;27,02;23,68;3,34;39577;21129;0.5339;20916;213;47297;1631;0.0344;1850;-219
2016-08-15 13:00:00;25,0;23,04;1,96;39577;20626;0.5211;20932;-306;47297;1913;0.0404;2006;-93
2016-08-15 14:00:00;23,9;23,29;0,61;39577;19675;0.4971;19720;-45;47297;2262;0.0478;2239;23
2016-08-15 15:00:00;24,1;24,02;0,08;39577;17697;0.4472;17504;193;47297;2327;0.0492;2550;-223
2016-08-15 16:00:00;25,54;25,95;-0,41;39577;14586;0.3686;14289;297;47297;2538;0.0537;2810;-272
2016-08-15 17:00:00;30,62;28,84;1,78;39577;10669;0.2696;10091;578;47297;2796;0.0591;2906;-110
2016-08-15 18:00:00;33,98;31,04;2,94;39577;6142;0.1552;5477;665;47297;2939;0.0621;2900;39
2016-08-15 19:00:00;35,88;32,61;3,27;39577;2108;0.0532;1829;279;47297;2946;0.0623;2847;99
2016-08-15 20:00:00;34,32;33,51;0,81;39577;231;0.0058;199;32;47297;2980;0.063;2817;163
2016-08-15 21:00:00;34,47;32,88;1,59;39577;0;0;1;-1;47297;3772;0.0798;3078;694
2016-08-15 22:00:00;33,22;31,25;1,97;39577;0;0;0;0;47297;4172;0.0882;3161;1011
2016-08-15 23:00:00;30,42;26,25;4,17;39577;0;0;0;0;47297;4043;0.0855;3110;933
2016-08-16 00:00:00;26,26;24,1;2,16;39579;0;0;0;0;47300;3746;0.0792;3139;607
2016-08-16 01:00:00;23,99;22,35;1,64;39579;0;0;0;0;47300;3317;0.0701;2853;464
2016-08-16 02:00:00;22,94;21,47;1,47;39579;0;0;0;0;47300;2872;0.0607;2647;225
2016-08-16 03:00:00;22,03;19,84;2,19;39579;0;0;0;0;47300;2474;0.0523;2486;-12
2016-08-16 04:00:00;22,1;20,65;1,45;39579;0;0;0;0;47300;2227;0.0471;2366;-139
2016-08-16 05:00:00;24,1;24,4;-0,3;39579;2;0.0001;6;-4;47300;2149;0.0454;2209;-60
2016-08-16 06:00:00;28,71;29,72;-1,01;39579;443;0.0112;487;-44;47300;2131;0.0451;2002;129
2016-08-16 07:00:00;33,63;33,74;-0,11;39579;3135;0.0792;3181;-46;47300;1894;0.04;1698;196
2016-08-16 08:00:00;34,14;33,03;1,11;39579;8150;0.2059;7893;257;47300;1166;0.0246;1133;33
2016-08-16 09:00:00;33,9;30,49;3,41;39579;13981;0.3532;13420;561;47300;756;0.016;856;-100
2016-08-16 10:00:00;31,73;29,86;1,87;39579;18825;0.4756;17945;880;47300;928;0.0196;788;140
2016-08-16 11:00:00;30,13;28,36;1,77;39579;21417;0.5411;20762;655;47300;1175;0.0248;777;398
2016-08-16 12:00:00;29,09;29,12;-0,03;39579;22096;0.5583;21981;115;47300;1258;0.0266;780;478
2016-08-16 13:00:00;28,93;30,36;-1,43;39579;21745;0.5494;21926;-181;47300;1592;0.0336;810;782
2016-08-16 14:00:00;28,94;28,99;-0,05;39579;20887;0.5277;20671;216;47300;1936;0.0409;929;1007
2016-08-16 15:00:00;29,29;28,2;1,09;39579;18585;0.4696;18214;371;47300;2224;0.047;1184;1040
2016-08-16 16:00:00;30,58;29,17;1,41;39579;15332;0.3874;14688;644;47300;2593;0.0548;1503;1090
2016-08-16 17:00:00;33,12;32,3;0,82;39579;11174;0.2824;10205;969;47300;2860;0.0604;1910;950
2016-08-16 18:00:00;34,33;34,19;0,14;39579;6021;0.1521;5426;595;47300;2884;0.061;2336;548
2016-08-16 19:00:00;35,79;35,63;0,16;39579;1885;0.0476;1756;129;47300;3073;0.0649;2731;342
2016-08-16 20:00:00;34,81;36,32;-1,51;39579;204;0.0052;185;19;47300;3778;0.0798;3245;533
2016-08-16 21:00:00;34,36;35,54;-1,18;39579;0;0;1;-1;47300;4942;0.1045;3934;1008
2016-08-16 22:00:00;31,25;31,0;0,25;39579;0;0;0;0;47300;5369;0.1135;4417;952
2016-08-16 23:00:00;27,74;25,46;2,28;39579;0;0;0;0;47300;5108;0.108;4523;585
2016-08-17 00:00:00;25,03;22,84;2,19;39586;0;0;0;0;47327;4260;0.09;4090;170
2016-08-17 01:00:00;24,01;22,11;1,9;39586;0;0;0;0;47327;3659;0.0773;3737;-78
2016-08-17 02:00:00;23,51;19,76;3,75;39586;0;0;0;0;47327;3250;0.0687;3467;-217
2016-08-17 03:00:00;21,9;17,5;4,4;39586;0;0;0;0;47327;2870;0.0606;3124;-254
2016-08-17 04:00:00;22,56;19,25;3,31;39586;0;0;0;0;47327;2528;0.0534;2818;-290
2016-08-17 05:00:00;25,05;22,32;2,73;39586;2;0;6;-4;47327;2424;0.0512;2612;-188
2016-08-17 06:00:00;29,74;24,57;5,17;39586;398;0.01;453;-55;47327;2348;0.0496;2409;-61
2016-08-17 07:00:00;34,75;31,49;3,26;39586;2869;0.0725;3120;-251;47327;1946;0.0412;2088;-142
2016-08-17 08:00:00;36,1;34,44;1,66;39586;7368;0.1862;7916;-548;47327;1246;0.0263;1336;-90
2016-08-17 09:00:00;33,0;33,17;-0,17;39586;12728;0.3216;13477;-749;47327;652;0.0138;960;-308
2016-08-17 10:00:00;28,54;30,77;-2,23;39586;17798;0.4496;18222;-424;47327;547;0.0116;980;-433
2016-08-17 11:00:00;28,03;30,01;-1,98;39586;21366;0.5397;21390;-24;47327;558;0.0118;1035;-477
2016-08-17 12:00:00;27,79;26,86;0,93;39586;22908;0.5787;22856;52;47327;673;0.0142;1058;-385
2016-08-17 13:00:00;27,72;26,1;1,62;39586;23282;0.5881;22852;430;47327;759;0.0161;1074;-315
2016-08-17 14:00:00;27,05;25,14;1,91;39586;22286;0.5629;21668;618;47327;797;0.0168;1061;-264
2016-08-17 15:00:00;28,41;25,92;2,49;39586;20371;0.5146;19206;1165;47327;887;0.0188;1149;-262
2016-08-17 16:00:00;30,47;26,58;3,89;39586;16899;0.4269;15695;1204;47327;985;0.0208;1415;-430
2016-08-17 17:00:00;35,08;33,97;1,11;39586;11782;0.2977;11040;742;47327;1240;0.0262;1712;-472
2016-08-17 18:00:00;35,67;35,9;-0,23;39586;6210;0.1569;5825;385;47327;1483;0.0314;2058;-575
2016-08-17 19:00:00;37,07;36,95;0,12;39586;1870;0.0472;1805;65;47327;1568;0.0331;2422;-854
2016-08-17 20:00:00;36,45;35,64;0,81;39586;196;0.005;179;17;47327;2021;0.0427;2785;-764
2016-08-17 21:00:00;35,48;34,8;0,68;39586;0;0;1;-1;47327;2981;0.063;3298;-317
2016-08-17 22:00:00;32,42;32,02;0,4;39586;0;0;0;0;47327;3543;0.0749;3796;-253
2016-08-17 23:00:00;28,82;26,68;2,14;39586;0;0;0;0;47327;3687;0.0779;3784;-97
2016-08-18 00:00:00;25,16;24,75;0,41;39588;0;0;0;0;47344;3396;0.0717;3499;-103
2016-08-18 01:00:00;24,12;27,21;-3,09;39588;0;0;0;0;47344;3150;0.0665;3367;-217
2016-08-18 02:00:00;23,34;25,03;-1,69;39588;0;0;0;0;47344;2936;0.062;3259;-323
2016-08-18 03:00:00;21,83;24,51;-2,68;39588;0;0;0;0;47344;2806;0.0592;3142;-336
2016-08-18 04:00:00;22,49;21,69;0,8;39588;0;0;0;0;47344;2784;0.0588;3002;-218
2016-08-18 05:00:00;25,05;24,68;0,37;39588;1;0;5;-4;47344;2660;0.0562;2786;-126
2016-08-18 06:00:00;30,26;33,19;-2,93;39588;344;0.0087;395;-51;47344;2456;0.0519;2539;-83
2016-08-18 07:00:00;33,79;35,14;-1,35;39588;2764;0.0698;2801;-37;47344;2263;0.0478;2167;96
2016-08-18 08:00:00;35,67;36,01;-0,34;39588;7266;0.1836;7327;-61;47344;1848;0.039;1475;373
2016-08-18 09:00:00;35,33;34,54;0,79;39588;12484;0.3154;12492;-8;47344;1307;0.0276;1005;302
2016-08-18 10:00:00;33,38;29,21;4,17;39588;16799;0.4244;16695;104;47344;1251;0.0264;881;370
2016-08-18 11:00:00;30,84;27,91;2,93;39588;19812;0.5005;19499;313;47344;1346;0.0284;873;473
2016-08-18 12:00:00;29,15;28,28;0,87;39588;20615;0.5208;20891;-276;47344;1274;0.0269;955;319
2016-08-18 13:00:00;29,44;28,94;0,5;39588;19976;0.5046;20730;-754;47344;1292;0.0273;1077;215
2016-08-18 14:00:00;29,08;30,23;-1,15;39588;18540;0.4684;19264;-724;47344;1422;0.03;1218;204
2016-08-18 15:00:00;29,51;30,81;-1,3;39588;16072;0.406;16753;-681;47344;1522;0.0322;1354;168
2016-08-18 16:00:00;32,78;34,66;-1,88;39588;12708;0.321;13337;-629;47344;1616;0.0342;1469;147
2016-08-18 17:00:00;35,01;36,83;-1,82;39588;8466;0.2138;9081;-615;47344;1856;0.0392;1544;312
2016-08-18 18:00:00;36,05;38,11;-2,06;39588;4341;0.1096;4697;-356;47344;2087;0.0441;1584;503
2016-08-18 19:00:00;37,34;38,3;-0,96;39588;1364;0.0344;1439;-75;47344;2172;0.0459;1635;537
2016-08-18 20:00:00;36,85;37,49;-0,64;39588;127;0.0032;132;-5;47344;2415;0.051;1713;702
2016-08-18 21:00:00;36,01;37,12;-1,11;39588;0;0;0;0;47344;2607;0.0551;1895;712
2016-08-18 22:00:00;32,74;33,85;-1,11;39588;0;0;0;0;47344;2596;0.0548;2031;565
2016-08-18 23:00:00;28,92;29,56;-0,64;39588;0;0;0;0;47344;2242;0.0473;1942;300
2016-08-19 00:00:00;27,71;27,55;0,16;39593;0;0;0;0;47353;1686;0.0356;1782;-96
2016-08-19 01:00:00;26,62;27,17;-0,55;39593;0;0;0;0;47353;1367;0.0289;1552;-185
2016-08-19 02:00:00;25,0;27,31;-2,31;39593;0;0;0;0;47353;1238;0.0261;1367;-129
2016-08-19 03:00:00;23,91;26,78;-2,87;39593;0;0;0;0;47353;1000;0.0211;1225;-225
2016-08-19 04:00:00;24,96;26,54;-1,58;39593;0;0;0;0;47353;840;0.0177;1119;-279
2016-08-19 05:00:00;26,08;27,39;-1,31;39593;0;0;5;-5;47353;738;0.0156;1045;-307
2016-08-19 06:00:00;32,25;31,84;0,41;39593;300;0.0076;358;-58;47353;740;0.0156;1003;-263
2016-08-19 07:00:00;36,25;38,3;-2,05;39593;2529;0.0639;2733;-204;47353;744;0.0157;964;-220
2016-08-19 08:00:00;37,27;39,07;-1,8;39593;6668;0.1684;7055;-387;47353;578;0.0122;719;-141
2016-08-19 09:00:00;36,45;38,4;-1,95;39593;11864;0.2997;12062;-198;47353;308;0.0065;589;-281
2016-08-19 10:00:00;34,48;37,46;-2,98;39593;16476;0.4161;16543;-67;47353;332;0.007;559;-227
2016-08-19 11:00:00;31,56;35,56;-4,0;39593;19706;0.4977;19895;-189;47353;381;0.008;605;-224
2016-08-19 12:00:00;26,95;31,72;-4,77;39593;21198;0.5354;21833;-635;47353;439;0.0092;640;-201
2016-08-19 13:00:00;26,01;31,01;-5,0;39593;21240;0.5365;22048;-808;47353;484;0.0102;724;-240
2016-08-19 14:00:00;25,78;30,97;-5,19;39593;20253;0.5115;20748;-495;47353;623;0.0132;767;-144
2016-08-19 15:00:00;27,48;32,78;-5,3;39593;17812;0.4499;17962;-150;47353;944;0.0199;892;52
2016-08-19 16:00:00;31,76;34,37;-2,61;39593;13639;0.3445;14005;-366;47353;1242;0.0262;1110;132
2016-08-19 17:00:00;34,09;35,98;-1,89;39593;8832;0.2231;9274;-442;47353;1401;0.0296;1370;31
2016-08-19 18:00:00;36,09;36,74;-0,65;39593;4425;0.1118;4600;-175;47353;1587;0.0335;1807;-220
2016-08-19 19:00:00;36,46;36,57;-0,11;39593;1256;0.0317;1324;-68;47353;1960;0.0414;2361;-401
2016-08-19 20:00:00;34,99;35,85;-0,86;39593;76;0.0019;104;-28;47353;2777;0.0586;3753;-976
2016-08-19 21:00:00;34,32;37,17;-2,85;39593;0;0;0;0;47353;4427;0.0935;5583;-1156
2016-08-19 22:00:00;32,22;33,47;-1,25;39593;0;0;0;0;47353;6035;0.1274;7430;-1395
2016-08-19 23:00:00;28,87;28,43;0,44;39593;0;0;0;0;47353;6848;0.1446;8564;-1716
2016-08-20 00:00:00;26,54;24,72;1,82;39593;0;0;0;0;47353;7314;0.1545;7482;-168
2016-08-20 01:00:00;25,04;21,73;3,31;39593;0;0;0;0;47353;7586;0.1602;7425;161
2016-08-20 02:00:00;23,31;18,72;4,59;39593;0;0;0;0;47353;7660;0.1618;7042;618
2016-08-20 03:00:00;22,81;17,44;5,37;39593;0;0;0;0;47353;7249;0.1531;6548;701
2016-08-20 04:00:00;22,32;18,58;3,74;39593;0;0;0;0;47353;6470;0.1366;6281;189
2016-08-20 05:00:00;22,02;19,55;2,47;39593;0;0;2;-2;47353;6004;0.1268;6042;-38
2016-08-20 06:00:00;22,44;19,34;3,1;39593;194;0.0049;264;-70;47353;5682;0.12;5761;-79
2016-08-20 07:00:00;23,08;20,16;2,92;39593;1779;0.0449;2100;-321;47353;6036;0.1275;5586;450
2016-08-20 08:00:00;26,94;23,91;3,03;39593;4888;0.1234;5373;-485;47353;5388;0.1138;5340;48
2016-08-20 09:00:00;29,03;25,94;3,09;39593;9174;0.2318;9266;-92;47353;4740;0.1001;5001;-261
2016-08-20 10:00:00;25,79;26,52;-0,73;39593;12895;0.3257;12804;91;47353;5279;0.1115;5035;244
2016-08-20 11:00:00;24,22;25,59;-1,37;39593;15746;0.3977;15530;216;47353;5924;0.1251;5338;586
2016-08-20 12:00:00;23,12;22,7;0,42;39593;16389;0.4139;17009;-620;47353;6389;0.1349;5921;468
2016-08-20 13:00:00;22,09;20,38;1,71;39593;14460;0.3652;16338;-1878;47353;6480;0.1368;6516;-36
2016-08-20 14:00:00;21,71;20,88;0,83;39593;11331;0.2862;14398;-3067;47353;6374;0.1346;6773;-399
2016-08-20 15:00:00;22,0;22,77;-0,77;39593;8472;0.214;11905;-3433;47353;6013;0.127;6586;-573
2016-08-20 16:00:00;20,95;22,15;-1,2;39593;6656;0.1681;9002;-2346;47353;5892;0.1244;6261;-369
2016-08-20 17:00:00;22,73;24,65;-1,92;39593;4696;0.1186;5909;-1213;47353;5988;0.1265;5848;140
2016-08-20 18:00:00;26,99;29,05;-2,06;39593;2554;0.0645;3098;-544;47353;5468;0.1155;5379;89
2016-08-20 19:00:00;29,34;28,91;0,43;39593;861;0.0217;995;-134;47353;4907;0.1036;4993;-86
2016-08-20 20:00:00;30,0;27,89;2,11;39593;90;0.0023;75;15;47353;4194;0.0886;5026;-832
2016-08-20 21:00:00;30,38;28,27;2,11;39593;0;0;0;0;47353;5583;0.1179;5476;107
2016-08-20 22:00:00;29,11;26,84;2,27;39593;0;0;0;0;47353;6150;0.1299;6201;-51
2016-08-20 23:00:00;25,03;23,31;1,72;39593;0;0;0;0;47353;7269;0.1535;6943;326
2016-08-21 00:00:00;18,51;20,0;-1,49;39593;0;0;0;0;47353;7882;0.1664;7966;-84
2016-08-21 01:00:00;15,01;11,32;3,69;39593;0;0;0;0;47353;8586;0.1813;8344;242
2016-08-21 02:00:00;12,13;7,59;4,54;39593;0;0;0;0;47353;9684;0.2045;8554;1130
2016-08-21 03:00:00;9,72;6,78;2,94;39593;0;0;0;0;47353;10203;0.2155;8820;1383
2016-08-21 04:00:00;9,83;6,73;3,1;39593;0;0;0;0;47353;9877;0.2086;9185;692
2016-08-21 05:00:00;9,74;6,9;2,84;39593;0;0;3;-3;47353;10269;0.2168;9414;855
2016-08-21 06:00:00;9,62;6,35;3,27;39593;202;0.0051;266;-64;47353;10610;0.2241;9501;1109
2016-08-21 07:00:00;9,13;6,86;2,27;39593;1829;0.0462;2022;-193;47353;10297;0.2175;9314;983
2016-08-21 08:00:00;11,34;8,4;2,94;39593;5110;0.129;5441;-331;47353;9735;0.2056;8998;737
2016-08-21 09:00:00;11,55;10,16;1,39;39593;8984;0.2269;9404;-420;47353;10195;0.2153;9039;1156
2016-08-21 10:00:00;11,59;10,52;1,07;39593;11284;0.285;12921;-1637;47353;11052;0.2334;9611;1441
2016-08-21 11:00:00;11,6;14,95;-3,35;39593;13147;0.332;15417;-2270;47353;11710;0.2472;9972;1738
2016-08-21 12:00:00;11,45;15,48;-4,03;39593;14838;0.3747;16664;-1826;47353;12574;0.2655;10240;2334
2016-08-21 13:00:00;9,09;13,32;-4,23;39593;15407;0.3892;16524;-1117;47353;13281;0.2804;10462;2819
2016-08-21 14:00:00;7,19;10,08;-2,89;39593;14787;0.3735;15459;-672;47353;13970;0.295;10425;3545
2016-08-21 15:00:00;7,88;6,06;1,82;39593;13844;0.3496;13666;178;47353;13731;0.29;10281;3450
2016-08-21 16:00:00;8,94;4,18;4,76;39593;11735;0.2964;11088;647;47353;12754;0.2693;9750;3004
2016-08-21 17:00:00;10,86;8,99;1,87;39593;8454;0.2135;7648;806;47353;11801;0.2492;8974;2827
2016-08-21 18:00:00;22,04;18,62;3,42;39593;4867;0.123;4044;823;47353;10116;0.2136;7966;2150
2016-08-21 19:00:00;28,13;23,89;4,24;39593;1407;0.0355;1213;194;47353;7712;0.1628;6914;798
2016-08-21 20:00:00;30,74;28,88;1,86;39593;92;0.0023;75;17;47353;6715;0.1418;6395;320
2016-08-21 21:00:00;31,9;32,8;-0,9;39593;0;0;0;0;47353;7308;0.1543;6528;780
2016-08-21 22:00:00;30,59;32,06;-1,47;39593;0;0;0;0;47353;7794;0.1646;6940;854
2016-08-21 23:00:00;23,54;26,78;-3,24;39593;0;0;0;0;47353;8178;0.1727;7350;828
2016-08-22 00:00:00;20,68;24,99;-4,31;39595;0;0;0;0;47380;8534;0.1801;8720;-186
2016-08-22 01:00:00;19,04;22,66;-3,62;39595;0;0;0;0;47380;8659;0.1828;8745;-86
2016-08-22 02:00:00;18,78;20,91;-2,13;39595;0;0;0;0;47380;8603;0.1816;8726;-123
2016-08-22 03:00:00;17,5;13,35;4,15;39595;0;0;0;0;47380;8350;0.1762;8619;-269
2016-08-22 04:00:00;18,07;13,68;4,39;39595;0;0;0;0;47380;8004;0.169;8399;-395
2016-08-22 05:00:00;20,81;17,56;3,25;39595;0;0;3;-3;47380;7459;0.1574;7935;-476
2016-08-22 06:00:00;26,82;24,59;2,23;39595;215;0.0054;270;-55;47380;6740;0.1423;7336;-596
2016-08-22 07:00:00;31,42;32,52;-1,1;39595;1982;0.05;2301;-319;47380;6264;0.1322;6693;-429
2016-08-22 08:00:00;34,41;35,37;-0,96;39595;5190;0.1311;5912;-722;47380;5866;0.1238;6185;-319
2016-08-22 09:00:00;35,0;36,8;-1,8;39595;9039;0.2283;9925;-886;47380;6165;0.1301;6179;-14
2016-08-22 10:00:00;31,66;34,45;-2,79;39595;12261;0.3097;13008;-747;47380;6720;0.1418;6593;127
2016-08-22 11:00:00;29,06;32,5;-3,44;39595;14319;0.3616;14700;-381;47380;7564;0.1596;7181;383
2016-08-22 12:00:00;27,25;32,58;-5,33;39595;15548;0.3927;15353;195;47380;8032;0.1695;7738;294
2016-08-22 13:00:00;27,19;31,21;-4,02;39595;15442;0.39;14988;454;47380;8404;0.1774;8297;107
2016-08-22 14:00:00;27,3;29,18;-1,88;39595;14642;0.3698;13752;890;47380;8266;0.1744;8459;-193
2016-08-22 15:00:00;27,81;30,15;-2,34;39595;13019;0.3288;11871;1148;47380;7896;0.1667;8162;-266
2016-08-22 16:00:00;28,49;30,3;-1,81;39595;10590;0.2675;9551;1039;47380;7984;0.1685;7653;331
2016-08-22 17:00:00;32,9;33,35;-0,45;39595;7569;0.1912;6596;973;47380;8264;0.1744;7023;1241
2016-08-22 18:00:00;36,59;34,94;1,65;39595;4034;0.1019;3417;617;47380;7992;0.1687;6330;1662
2016-08-22 19:00:00;37,71;36,87;0,84;39595;1220;0.0308;957;263;47380;7554;0.1594;5615;1939
2016-08-22 20:00:00;37,64;36,31;1,33;39595;75;0.0019;52;23;47380;7314;0.1544;5104;2210
2016-08-22 21:00:00;35,02;34,49;0,53;39595;0;0;0;0;47380;7459;0.1574;4945;2514
2016-08-22 22:00:00;30,99;31,34;-0,35;39595;0;0;0;0;47380;7534;0.159;4935;2599
2016-08-22 23:00:00;27,92;28,41;-0,49;39595;0;0;0;0;47380;7465;0.1575;4882;2583
2016-08-23 00:00:00;23,68;23,39;0,29;39597;0;0;0;0;47392;6936;0.1464;7050;-114
2016-08-23 01:00:00;22,35;22,08;0,27;39597;0;0;0;0;47392;6459;0.1363;6836;-377
2016-08-23 02:00:00;21,62;22,77;-1,15;39597;0;0;0;0;47392;5806;0.1225;6453;-647
2016-08-23 03:00:00;20,29;23,75;-3,46;39597;0;0;0;0;47392;5023;0.106;5797;-774
2016-08-23 04:00:00;22,01;24,11;-2,1;39597;0;0;0;0;47392;4460;0.0941;5221;-761
2016-08-23 05:00:00;23,52;28,35;-4,83;39597;0;0;2;-2;47392;4126;0.0871;4706;-580
2016-08-23 06:00:00;30,56;35,83;-5,27;39597;202;0.0051;215;-13;47392;3877;0.0818;4208;-331
2016-08-23 07:00:00;35,24;38,58;-3,34;39597;2209;0.0558;2032;177;47392;3618;0.0764;3706;-88
2016-08-23 08:00:00;37,31;35,92;1,39;39597;6789;0.1715;6068;721;47392;2622;0.0553;3002;-380
2016-08-23 09:00:00;37,95;33,2;4,75;39597;12293;0.3104;11256;1037;47392;1837;0.0388;2531;-694
2016-08-23 10:00:00;34,94;31,95;2,99;39597;16860;0.4258;15716;1144;47392;1712;0.0361;2419;-707
2016-08-23 11:00:00;32,36;30,64;1,72;39597;20106;0.5078;18869;1237;47392;1709;0.0361;2387;-678
2016-08-23 12:00:00;28,78;29,12;-0,34;39597;21643;0.5466;20637;1006;47392;1632;0.0344;2304;-672
2016-08-23 13:00:00;28,07;28,39;-0,32;39597;21802;0.5506;20946;856;47392;1505;0.0318;2184;-679
2016-08-23 14:00:00;27,95;28,35;-0,4;39597;20579;0.5197;19942;637;47392;1372;0.029;1961;-589
2016-08-23 15:00:00;30,2;30,2;0,0;39597;18364;0.4638;17627;737;47392;1223;0.0258;1582;-359
2016-08-23 16:00:00;34,63;35,51;-0,88;39597;14692;0.371;14290;402;47392;1034;0.0218;1228;-194
2016-08-23 17:00:00;37,96;37,59;0,37;39597;10184;0.2572;9813;371;47392;758;0.016;953;-195
2016-08-23 18:00:00;40,2;37,96;2,24;39597;5189;0.131;4925;264;47392;542;0.0114;834;-292
2016-08-23 19:00:00;41,6;42,58;-0,98;39597;1391;0.0351;1301;90;47392;504;0.0106;799;-295
2016-08-23 20:00:00;42,0;43,13;-1,13;39597;81;0.002;75;6;47392;953;0.0201;1097;-144
2016-08-23 21:00:00;38,92;41,65;-2,73;39597;0;0;0;0;47392;1914;0.0404;1638;276
2016-08-23 22:00:00;33,38;36,04;-2,66;39597;0;0;0;0;47392;2704;0.0571;2185;519
2016-08-23 23:00:00;27,57;30,4;-2,83;39597;0;0;0;0;47392;3162;0.0667;2616;546
2016-08-24 00:00:00;26,19;29,17;-2,98;39603;0;0;0;0;47409;3585;0.0756;3040;545
2016-08-24 01:00:00;23,9;25,79;-1,89;39603;0;0;0;0;47409;3853;0.0813;3443;410
2016-08-24 02:00:00;22,82;24,38;-1,56;39603;0;0;0;0;47409;4022;0.0849;3782;240
2016-08-24 03:00:00;22,24;23,6;-1,36;39603;0;0;0;0;47409;4010;0.0846;3954;56
2016-08-24 04:00:00;22,25;23,63;-1,38;39603;0;0;0;0;47409;4060;0.0856;4151;-91
2016-08-24 05:00:00;24,23;26,16;-1,93;39603;0;0;2;-2;47409;4163;0.0878;4293;-130
2016-08-24 06:00:00;30,85;31,07;-0,22;39603;224;0.0057;252;-28;47409;4408;0.093;4385;23
2016-08-24 07:00:00;34,9;33,91;0,99;39603;2613;0.066;2470;143;47409;4541;0.0958;4303;238
2016-08-24 08:00:00;36,02;37,71;-1,69;39603;7981;0.2015;7620;361;47409;3684;0.0777;3870;-186
2016-08-24 09:00:00;34,93;34,78;0,15;39603;14112;0.3564;13736;376;47409;2667;0.0562;3178;-511
2016-08-24 10:00:00;29,96;34,06;-4,1;39603;19264;0.4864;18854;410;47409;2667;0.0562;3140;-473
2016-08-24 11:00:00;27,56;31,22;-3,66;39603;22677;0.5726;22424;253;47409;2999;0.0632;3246;-247
2016-08-24 12:00:00;26,83;30,48;-3,65;39603;24582;0.6207;24348;234;47409;2990;0.0631;3212;-222
2016-08-24 13:00:00;26,24;30,03;-3,79;39603;25076;0.6332;24779;297;47409;2980;0.0628;3115;-135
2016-08-24 14:00:00;26,0;30,34;-4,34;39603;23985;0.6056;23742;243;47409;2893;0.061;3016;-123
2016-08-24 15:00:00;30,48;31,74;-1,26;39603;21350;0.5391;21065;285;47409;2741;0.0578;2812;-71
2016-08-24 16:00:00;32,97;33,35;-0,38;39603;17273;0.4362;16934;339;47409;2754;0.0581;2633;121
2016-08-24 17:00:00;34,95;36,25;-1,3;39603;11652;0.2942;11303;349;47409;2922;0.0616;2710;212
2016-08-24 18:00:00;37,69;39,36;-1,67;39603;5612;0.1417;5349;263;47409;3135;0.0661;2997;138
2016-08-24 19:00:00;38,44;40,37;-1,93;39603;1369;0.0346;1325;44;47409;3542;0.0747;3585;-43
2016-08-24 20:00:00;37,99;38,95;-0,96;39603;70;0.0018;70;0;47409;5553;0.1171;5163;390
2016-08-24 21:00:00;34,01;35,88;-1,87;39603;0;0;0;0;47409;8476;0.1788;6850;1626
2016-08-24 22:00:00;28,61;27,84;0,77;39603;0;0;0;0;47409;10402;0.2194;8232;2170
2016-08-24 23:00:00;24,49;22,49;2,0;39603;0;0;0;0;47409;11250;0.2373;9025;2225
2016-08-25 00:00:00;21,96;21,87;0,09;39615;0;0;0;0;47418;11685;0.2464;11210;475
2016-08-25 01:00:00;21,86;20,32;1,54;39615;0;0;0;0;47418;11758;0.248;10887;871
2016-08-25 02:00:00;20,97;19,4;1,57;39615;0;0;0;0;47418;11214;0.2365;10347;867
2016-08-25 03:00:00;21,16;18,1;3,06;39615;0;0;0;0;47418;10459;0.2206;9731;728
2016-08-25 04:00:00;21,45;19,91;1,54;39615;0;0;0;0;47418;10137;0.2138;9260;877
2016-08-25 05:00:00;23,3;20,62;2,68;39615;0;0;2;-2;47418;10030;0.2115;8781;1249
2016-08-25 06:00:00;30,33;28,54;1,79;39615;227;0.0057;282;-55;47418;9710;0.2048;8392;1318
2016-08-25 07:00:00;34,2;32,85;1,35;39615;2716;0.0686;2870;-154;47418;8494;0.1791;7854;640
2016-08-25 08:00:00;35,7;33,04;2,66;39615;8109;0.2047;8219;-110;47418;5639;0.1189;6456;-817
2016-08-25 09:00:00;34,91;33,29;1,62;39615;14382;0.363;14427;-45;47418;3826;0.0807;4860;-1034
2016-08-25 10:00:00;29,26;30,88;-1,62;39615;19469;0.4915;19697;-228;47418;3822;0.0806;4291;-469
2016-08-25 11:00:00;27,78;26,22;1,56;39615;23114;0.5834;23335;-221;47418;3958;0.0835;3797;161
2016-08-25 12:00:00;26,81;24,49;2,32;39615;24960;0.6301;25262;-302;47418;3966;0.0836;3522;444
2016-08-25 13:00:00;25,42;24,09;1,33;39615;25225;0.6367;25635;-410;47418;4222;0.0891;3433;789
2016-08-25 14:00:00;24,98;23,11;1,87;39615;24024;0.6064;24483;-459;47418;4522;0.0954;3399;1123
2016-08-25 15:00:00;27,26;24,09;3,17;39615;21389;0.5399;21687;-298;47418;5026;0.106;3409;1617
2016-08-25 16:00:00;30,17;26,38;3,79;39615;17277;0.4361;17365;-88;47418;5469;0.1153;3427;2042
2016-08-25 17:00:00;34,0;29,2;4,8;39615;11606;0.293;11519;87;47418;5565;0.1174;3592;1973
2016-08-25 18:00:00;36,65;32,97;3,68;39615;5546;0.14;5422;124;47418;5344;0.1127;3998;1346
2016-08-25 19:00:00;38,78;37,69;1,09;39615;1298;0.0328;1284;14;47418;5415;0.1142;4648;767
2016-08-25 20:00:00;37,96;37,17;0,79;39615;62;0.0016;62;0;47418;7360;0.1552;5960;1400
2016-08-25 21:00:00;34,16;31,82;2,34;39615;0;0;0;0;47418;10014;0.2112;7406;2608
2016-08-25 22:00:00;27,98;26,38;1,6;39615;0;0;0;0;47418;11627;0.2452;8515;3112
2016-08-25 23:00:00;24,26;23,46;0,8;39615;0;0;0;0;47418;12046;0.254;9150;2896
2016-08-26 00:00:00;22,1;25,13;-3,03;39618;0;0;0;0;47424;11702;0.2467;11180;522
2016-08-26 01:00:00;20,34;24,66;-4,32;39618;0;0;0;0;47424;11394;0.2402;10980;414
2016-08-26 02:00:00;20,31;24,38;-4,07;39618;0;0;0;0;47424;10926;0.2304;10707;219
2016-08-26 03:00:00;20,23;22,96;-2,73;39618;0;0;0;0;47424;10600;0.2235;10417;183
2016-08-26 04:00:00;21,25;22,5;-1,25;39618;0;0;0;0;47424;10462;0.2206;10199;263
2016-08-26 05:00:00;23,1;24,94;-1,84;39618;0;0;2;-2;47424;10534;0.2221;9970;564
2016-08-26 06:00:00;29,0;29,67;-0,67;39618;208;0.0053;258;-50;47424;10544;0.2224;9699;845
2016-08-26 07:00:00;34,47;30,63;3,84;39618;2600;0.0656;2756;-156;47424;9225;0.1945;9077;148
2016-08-26 08:00:00;35,9;34,82;1,08;39618;7986;0.2016;8070;-84;47424;6626;0.1397;7640;-1014
2016-08-26 09:00:00;34,92;35,9;-0,98;39618;13976;0.3528;14253;-277;47424;4257;0.0898;5694;-1437
2016-08-26 10:00:00;32,55;34,63;-2,08;39618;18944;0.4782;19534;-590;47424;3529;0.0744;4224;-695
2016-08-26 11:00:00;28,87;31,76;-2,89;39618;22356;0.5643;23173;-817;47424;3420;0.0721;3594;-174
2016-08-26 12:00:00;26,67;29,79;-3,12;39618;24150;0.6096;25096;-946;47424;3222;0.0679;3422;-200
2016-08-26 13:00:00;25,13;28,73;-3,6;39618;24340;0.6144;25400;-1060;47424;2989;0.063;3404;-415
2016-08-26 14:00:00;24,49;27,81;-3,32;39618;23017;0.581;24159;-1142;47424;3304;0.0697;3478;-174
2016-08-26 15:00:00;26,68;27,9;-1,22;39618;20333;0.5132;21253;-920;47424;3278;0.0691;3601;-323
2016-08-26 16:00:00;29,73;30,2;-0,47;39618;16248;0.4101;16855;-607;47424;3067;0.0647;3636;-569
2016-08-26 17:00:00;34,92;35,89;-0,97;39618;10846;0.2738;11063;-217;47424;2819;0.0594;3628;-809
2016-08-26 18:00:00;38,45;38,37;0,08;39618;5096;0.1286;5181;-85;47424;2608;0.055;3725;-1117
2016-08-26 19:00:00;41,99;39,14;2,85;39618;1161;0.0293;1196;-35;47424;2542;0.0536;4161;-1619
2016-08-26 20:00:00;39,01;37,95;1,06;39618;51;0.0013;48;3;47424;3192;0.0673;4998;-1806
2016-08-26 21:00:00;37,06;36,35;0,71;39618;0;0;0;0;47424;3958;0.0835;5503;-1545
2016-08-26 22:00:00;32,09;31,71;0,38;39618;0;0;0;0;47424;4161;0.0878;5609;-1448
2016-08-26 23:00:00;27,22;28,4;-1,18;39618;0;0;0;0;47424;4170;0.0879;5303;-1133
2016-08-27 00:00:00;25,93;26,37;-0,44;39619;0;0;0;0;47424;3746;0.079;4522;-776
2016-08-27 01:00:00;24,05;25,14;-1,09;39619;0;0;0;0;47424;3394;0.0716;4092;-698
2016-08-27 02:00:00;23,0;23,25;-0,25;39619;0;0;0;0;47424;3102;0.0654;3715;-613
2016-08-27 03:00:00;23,07;25,27;-2,2;39619;0;0;0;0;47424;2950;0.0622;3354;-404
2016-08-27 04:00:00;23,28;23,97;-0,69;39619;0;0;0;0;47424;2707;0.0571;3056;-349
2016-08-27 05:00:00;23,18;21,97;1,21;39619;0;0;2;-2;47424;2584;0.0544;2782;-198
2016-08-27 06:00:00;25,28;22,84;2,44;39619;181;0.0046;224;-43;47424;2581;0.0544;2488;93
2016-08-27 07:00:00;26,84;25,91;0,93;39619;2430;0.0613;2460;-30;47424;2252;0.0475;2092;160
2016-08-27 08:00:00;29,5;29,26;0,24;39619;7388;0.1865;7427;-39;47424;1377;0.029;1653;-276
2016-08-27 09:00:00;29,56;28,82;0,74;39619;13284;0.3353;13282;2;47424;839;0.0177;1197;-358
2016-08-27 10:00:00;25,14;25,4;-0,26;39619;18226;0.46;18445;-219;47424;636;0.0134;854;-218
2016-08-27 11:00:00;23,02;23,2;-0,18;39619;21718;0.5481;22149;-431;47424;635;0.0134;720;-85
2016-08-27 12:00:00;21,93;21,11;0,82;39619;23641;0.5967;24217;-576;47424;739;0.0156;743;-4
2016-08-27 13:00:00;20,03;20,06;-0,03;39619;23914;0.6036;24619;-705;47424;864;0.0182;837;27
2016-08-27 14:00:00;19,96;19,65;0,31;39619;22769;0.5747;23474;-705;47424;1038;0.0219;993;45
2016-08-27 15:00:00;20,76;20,32;0,44;39619;20001;0.5048;20648;-647;47424;1374;0.029;1248;126
2016-08-27 16:00:00;23,03;21,06;1,97;39619;15882;0.4009;16272;-390;47424;1936;0.0408;1556;380
2016-08-27 17:00:00;28,41;24,47;3,94;39619;10353;0.2613;10552;-199;47424;2776;0.0586;1976;800
2016-08-27 18:00:00;34,94;32,28;2,66;39619;4715;0.119;4805;-90;47424;3199;0.0674;2585;614
2016-08-27 19:00:00;35,36;32,63;2,73;39619;1056;0.0266;1068;-12;47424;4030;0.085;3375;655
2016-08-27 20:00:00;34,95;32,27;2,68;39619;37;0.001;43;-6;47424;5870;0.1238;4352;1518
2016-08-27 21:00:00;33,61;29,72;3,89;39619;0;0;0;0;47424;7933;0.1673;5378;2555
2016-08-27 22:00:00;29,92;25,93;3,99;39619;0;0;0;0;47424;9571;0.2018;6259;3312
2016-08-27 23:00:00;24,73;23,15;1,58;39619;0;0;0;0;47424;11003;0.232;6891;4112
2016-08-28 00:00:00;23,14;23,71;-0,57;39619;0;0;0;0;47424;11104;0.2342;9540;1564
2016-08-28 01:00:00;20,98;20,12;0,86;39619;0;0;0;0;47424;10186;0.2148;9642;544
2016-08-28 02:00:00;21,01;22,3;-1,29;39619;0;0;0;0;47424;8349;0.176;9747;-1398
2016-08-28 03:00:00;21,29;20,93;0,36;39619;0;0;0;0;47424;7564;0.1595;9421;-1857
2016-08-28 04:00:00;19,85;23,59;-3,74;39619;0;0;0;0;47424;8143;0.1717;8933;-790
2016-08-28 05:00:00;19,83;22,51;-2,68;39619;0;0;1;-1;47424;8310;0.1752;8646;-336
2016-08-28 06:00:00;20,48;22,01;-1,53;39619;170;0.0043;216;-46;47424;8657;0.1826;8443;214
2016-08-28 07:00:00;20,18;20,55;-0,37;39619;2345;0.0592;2542;-197;47424;7682;0.162;8116;-434
2016-08-28 08:00:00;22,07;24,43;-2,36;39619;6610;0.1668;7458;-848;47424;7252;0.1529;7294;-42
2016-08-28 09:00:00;23,19;25,4;-2,21;39619;11715;0.2957;13229;-1514;47424;6157;0.1298;6131;26
2016-08-28 10:00:00;20,07;24,04;-3,97;39619;16547;0.4176;18225;-1678;47424;4952;0.1044;5140;-188
2016-08-28 11:00:00;20,09;21,83;-1,74;39619;19971;0.504;21588;-1617;47424;4338;0.0915;4500;-162
2016-08-28 12:00:00;13,38;13,05;0,33;39619;21820;0.5508;23148;-1328;47424;5151;0.1086;4429;722
2016-08-28 13:00:00;10,05;9,33;0,72;39619;21762;0.5493;22847;-1085;47424;6127;0.1292;4701;1426
2016-08-28 14:00:00;8,99;9,05;-0,06;39619;20170;0.5091;20956;-786;47424;7810;0.1647;5377;2433
2016-08-28 15:00:00;13,51;12,99;0,52;39619;16559;0.418;17713;-1154;47424;9312;0.1964;6381;2931
2016-08-28 16:00:00;18,15;17,4;0,75;39619;12594;0.3179;13365;-771;47424;10568;0.2228;7442;3126
2016-08-28 17:00:00;22,26;20,97;1,29;39619;7980;0.2014;8410;-430;47424;11495;0.2424;8511;2984
2016-08-28 18:00:00;29,01;29,0;0,01;39619;3488;0.0881;3887;-399;47424;12166;0.2566;9311;2855
2016-08-28 19:00:00;32,95;31,91;1,04;39619;745;0.0188;877;-132;47424;12640;0.2666;10044;2596
2016-08-28 20:00:00;33,92;31,89;2,03;39619;32;0.0008;27;5;47424;13685;0.2885;10730;2955
2016-08-28 21:00:00;33,25;28,11;5,14;39619;0;0;0;0;47424;13678;0.2884;11135;2543
2016-08-28 22:00:00;29,97;27,14;2,83;39619;0;0;0;0;47424;11486;0.2422;11566;-80
2016-08-28 23:00:00;23,3;24,55;-1,25;39619;0;0;0;0;47424;10658;0.2248;11839;-1181
2016-08-29 00:00:00;22,16;28,65;-6,49;39628;0;0;0;0;47453;9752;0.2055;12045;-2293
2016-08-29 01:00:00;23,02;29,63;-6,61;39628;0;0;0;0;47453;9544;0.2011;11349;-1805
2016-08-29 02:00:00;22,09;26,49;-4,4;39628;0;0;0;0;47453;9791;0.2063;10766;-975
2016-08-29 03:00:00;22,09;24,84;-2,75;39628;0;0;0;0;47453;9591;0.2021;10320;-729
2016-08-29 04:00:00;22,61;24,46;-1,85;39628;0;0;0;0;47453;9589;0.2021;10095;-506
2016-08-29 05:00:00;24,52;27,0;-2,48;39628;0;0;1;-1;47453;9744;0.2053;10135;-391
2016-08-29 06:00:00;34,95;35,84;-0,89;39628;94;0.0024;145;-51;47453;9578;0.2018;10302;-724
2016-08-29 07:00:00;40,26;41,35;-1,09;39628;1347;0.034;1642;-295;47453;9656;0.2035;10499;-843
2016-08-29 08:00:00;41,69;42,25;-0,56;39628;4104;0.1036;4629;-525;47453;9512;0.2005;10869;-1357
2016-08-29 09:00:00;35,32;42,21;-6,89;39628;7630;0.1926;8131;-501;47453;10394;0.219;11621;-1227
2016-08-29 10:00:00;30,98;41,61;-10,63;39628;10482;0.2645;11456;-974;47453;11282;0.2377;12407;-1125
2016-08-29 11:00:00;28,96;41,26;-12,3;39628;11806;0.2979;13951;-2145;47453;12163;0.2563;12957;-794
2016-08-29 12:00:00;26,33;41,9;-15,57;39628;12565;0.3171;15333;-2768;47453;12078;0.2545;13321;-1243
2016-08-29 13:00:00;24,95;42,14;-17,19;39628;13067;0.3297;15680;-2613;47453;12165;0.2564;13606;-1441
2016-08-29 14:00:00;22,98;39,58;-16,6;39628;13406;0.3383;15240;-1834;47453;12099;0.255;13724;-1625
2016-08-29 15:00:00;23,02;35,19;-12,17;39628;12780;0.3225;13667;-887;47453;11933;0.2514;13689;-1756
2016-08-29 16:00:00;22,99;35,1;-12,11;39628;10793;0.2724;11013;-220;47453;11820;0.2491;13471;-1651
2016-08-29 17:00:00;30,0;37,46;-7,46;39628;7327;0.1849;7456;-129;47453;11247;0.237;12803;-1556
2016-08-29 18:00:00;34,01;39,08;-5,07;39628;3577;0.0903;3648;-71;47453;10022;0.2112;11554;-1532
2016-08-29 19:00:00;36,64;41,74;-5,1;39628;807;0.0204;818;-11;47453;7995;0.1685;10139;-2144
2016-08-29 20:00:00;37,55;40,73;-3,18;39628;24;0.0006;22;2;47453;6879;0.145;9267;-2388
2016-08-29 21:00:00;34,09;37,27;-3,18;39628;0;0;0;0;47453;6580;0.1386;8494;-1914
2016-08-29 22:00:00;29,29;32,15;-2,86;39628;0;0;0;0;47453;6284;0.1324;7673;-1389
2016-08-29 23:00:00;24,19;25,54;-1,35;39628;0;0;0;0;47453;6269;0.1321;7052;-783
2016-08-30 00:00:00;24,85;23,51;1,34;39637;0;0;0;0;47460;6167;0.13;6045;122
2016-08-30 01:00:00;24,15;23,72;0,43;39637;0;0;0;0;47460;5925;0.1248;5830;95
2016-08-30 02:00:00;23,74;22,5;1,24;39637;0;0;0;0;47460;5636;0.1187;5693;-57
2016-08-30 03:00:00;23,35;22,3;1,05;39637;0;0;0;0;47460;5760;0.1214;5537;223
2016-08-30 04:00:00;22,74;22,99;-0,25;39637;0;0;0;0;47460;5984;0.1261;5405;579
2016-08-30 05:00:00;24,14;24,45;-0,31;39637;0;0;0;0;47460;6170;0.13;5127;1043
2016-08-30 06:00:00;32,65;34,16;-1,51;39637;128;0.0032;178;-50;47460;6061;0.1277;4764;1297
2016-08-30 07:00:00;40,59;39,71;0,88;39637;2172;0.0548;2260;-88;47460;5537;0.1166;4270;1267
2016-08-30 08:00:00;43,82;41,53;2,29;39637;6954;0.1754;7139;-185;47460;4004;0.0844;3448;556
2016-08-30 09:00:00;38,03;36,88;1,15;39637;12668;0.3196;12901;-233;47460;3233;0.0681;3059;174
2016-08-30 10:00:00;32,0;32,34;-0,34;39637;17621;0.4446;17711;-90;47460;3376;0.0711;3505;-129
2016-08-30 11:00:00;30,06;30,36;-0,3;39637;20876;0.5267;20897;-21;47460;3250;0.0685;3568;-318
2016-08-30 12:00:00;27,07;26,28;0,79;39637;22582;0.5697;22423;159;47460;3212;0.0677;3461;-249
2016-08-30 13:00:00;26,97;26,87;0,1;39637;22550;0.5689;22490;60;47460;3295;0.0695;3341;-46
2016-08-30 14:00:00;26,86;26,31;0,55;39637;21720;0.548;21339;381;47460;3372;0.071;3213;159
2016-08-30 15:00:00;28,96;27,35;1,61;39637;19342;0.488;18756;586;47460;3012;0.0635;3064;-52
2016-08-30 16:00:00;33,33;30,69;2,64;39637;15713;0.3964;15070;643;47460;2538;0.0535;2803;-265
2016-08-30 17:00:00;37,77;34,32;3,45;39637;10495;0.2648;9828;667;47460;2228;0.047;2466;-238
2016-08-30 18:00:00;40,6;38,48;2,12;39637;4822;0.1217;4403;419;47460;1771;0.0373;2116;-345
2016-08-30 19:00:00;43,71;39,92;3,79;39637;947;0.0239;873;74;47460;1464;0.0309;1865;-401
2016-08-30 20:00:00;44,83;38,98;5,85;39637;27;0.0007;22;5;47460;1922;0.0405;1971;-49
2016-08-30 21:00:00;40,83;37,96;2,87;39637;0;0;0;0;47460;2519;0.0531;2231;288
2016-08-30 22:00:00;32,96;29,87;3,09;39637;0;0;0;0;47460;2888;0.0608;2484;404
2016-08-30 23:00:00;26,64;25,83;0,81;39637;0;0;0;0;47460;3039;0.064;2659;380
2016-08-31 00:00:00;25,6;22,85;2,75;39648;0;0;0;0;47468;3156;0.0665;3138;18
2016-08-31 01:00:00;24,02;23,18;0,84;39648;0;0;0;0;47468;3222;0.0679;3371;-149
2016-08-31 02:00:00;23,48;22,76;0,72;39648;0;0;0;0;47468;3250;0.0685;3562;-312
2016-08-31 03:00:00;22,77;22,85;-0,08;39648;0;0;0;0;47468;3395;0.0715;3677;-282
2016-08-31 04:00:00;22,79;23,5;-0,71;39648;0;0;0;0;47468;3394;0.0715;3787;-393
2016-08-31 05:00:00;25,34;25,09;0,25;39648;0;0;0;0;47468;3383;0.0713;3891;-508
2016-08-31 06:00:00;32,98;33,48;-0,5;39648;126;0.0032;173;-47;47468;3528;0.0743;3999;-471
2016-08-31 07:00:00;40,46;40,11;0,35;39648;2300;0.058;2326;-26;47468;3668;0.0772;4056;-388
2016-08-31 08:00:00;42,04;42,34;-0,3;39648;7483;0.1887;7523;-40;47468;2968;0.0625;3675;-707
2016-08-31 09:00:00;36,13;33,17;2,96;39648;13598;0.3429;13768;-170;47468;1649;0.0347;2818;-1169
2016-08-31 10:00:00;29,59;28,66;0,93;39648;18670;0.4709;19105;-435;47468;1387;0.0292;2229;-842
2016-08-31 11:00:00;28,19;29,04;-0,85;39648;22344;0.5636;22699;-355;47468;1982;0.0418;2081;-99
2016-08-31 12:00:00;26,78;27,18;-0,4;39648;24361;0.6144;24403;-42;47468;2218;0.0467;1995;223
2016-08-31 13:00:00;27,06;26,26;0,8;39648;24667;0.6222;24454;213;47468;2336;0.0492;1882;454
2016-08-31 14:00:00;26,91;25,66;1,25;39648;23215;0.5856;22972;243;47468;2341;0.0493;1801;540
2016-08-31 15:00:00;27,05;25,89;1,16;39648;20364;0.5136;20016;348;47468;2424;0.051;1825;599
2016-08-31 16:00:00;30,79;28,54;2,25;39648;15886;0.4007;15628;258;47468;2250;0.0474;1870;380
2016-08-31 17:00:00;35,94;34,42;1,52;39648;10163;0.2563;9830;333;47468;2142;0.0451;1971;171
2016-08-31 18:00:00;38,96;38,43;0,53;39648;4433;0.1118;4208;225;47468;2069;0.0436;2207;-138
2016-08-31 19:00:00;40,94;41,92;-0,98;39648;842;0.0212;796;46;47468;1777;0.0374;2613;-836
2016-08-31 20:00:00;39,61;40,24;-0,63;39648;14;0.0004;18;-4;47468;2068;0.0436;3369;-1301
2016-08-31 21:00:00;35,96;36,18;-0,22;39648;0;0;0;0;47468;2642;0.0557;4216;-1574
2016-08-31 22:00:00;28,38;32,84;-4,46;39648;0;0;0;0;47468;2988;0.0629;4891;-1903
2016-08-31 23:00:00;24,2;27,43;-3,23;39648;0;0;0;0;47468;3374;0.0711;5180;-1806
2016-01-09 00:00:00;24,34;28,12;-3,78;39656;0;0;0;0;47499;3246;0.0684;5202;-1956
2016-01-09 01:00:00;23,73;25,94;-2,21;39656;0;0;0;0;47499;1664;0.035;5341;-3677
2016-01-09 02:00:00;23,37;26,03;-2,66;39656;0;0;0;0;47499;1628;0.0343;5253;-3625
2016-01-09 03:00:00;22,98;25,36;-2,38;39656;0;0;0;0;47499;1562;0.0329;4886;-3324
2016-01-09 04:00:00;23,59;24,33;-0,74;39656;0;0;0;0;47499;2171;0.0457;4652;-2481
2016-01-09 05:00:00;25,1;26,27;-1,17;39656;0;0;0;0;47499;2703;0.0569;4491;-1788
2016-01-09 06:00:00;32,95;34,69;-1,74;39656;101;0.0026;140;-39;47499;2595;0.0546;4318;-1723
2016-01-09 07:00:00;37,97;39,24;-1,27;39656;1849;0.0466;1915;-66;47499;2787;0.0587;4072;-1285
2016-01-09 08:00:00;41,08;40,29;0,79;39656;5826;0.1469;5786;40;47499;2630;0.0554;3518;-888
2016-01-09 09:00:00;38,24;37,5;0,74;39656;10376;0.2616;10349;27;47499;1698;0.0357;2933;-1235
2016-01-09 10:00:00;34,92;35,02;-0,1;39656;14536;0.3666;14490;46;47499;1641;0.0346;2868;-1227
2016-01-09 11:00:00;32,98;33,18;-0,2;39656;17966;0.453;17518;448;47499;2663;0.056;3282;-619
2016-01-09 12:00:00;29,93;30,48;-0,55;39656;19886;0.5015;19206;680;47499;4195;0.0883;4155;40
2016-01-09 13:00:00;28,68;27,99;0,69;39656;19391;0.489;19161;230;47499;4983;0.1049;5148;-165
2016-01-09 14:00:00;27,87;27,37;0,5;39656;17667;0.4455;17714;-47;47499;5386;0.1134;5836;-450
2016-01-09 15:00:00;27,88;27,64;0,24;39656;15250;0.3846;15112;138;47499;5249;0.1105;6000;-751
2016-01-09 16:00:00;28,96;28,5;0,46;39656;11994;0.3025;11802;192;47499;4918;0.1035;5851;-933
2016-01-09 17:00:00;34,06;34,93;-0,87;39656;7868;0.1984;7689;179;47499;4842;0.1019;5354;-512
2016-01-09 18:00:00;36,82;38,04;-1,22;39656;3628;0.0915;3524;104;47499;4153;0.0874;4595;-442
2016-01-09 19:00:00;38,96;41,06;-2,1;39656;742;0.0187;682;60;47499;3772;0.0794;3869;-97
2016-01-09 20:00:00;40,44;41,27;-0,83;39656;12;0.0003;13;-1;47499;3150;0.0663;3322;-172
2016-01-09 21:00:00;37,93;37,57;0,36;39656;0;0;0;0;47499;2943;0.062;3001;-58
2016-01-09 22:00:00;30,43;32,83;-2,4;39656;0;0;0;0;47499;3071;0.0646;2821;250
2016-01-09 23:00:00;26,93;25,86;1,07;39656;0;0;0;0;47499;3306;0.0696;2669;637
2016-02-09 00:00:00;25,64;27,5;-1,86;39658;0;0;0;0;47507;2912;0.0613;2461;451
2016-02-09 01:00:00;23,89;27,63;-3,74;39658;0;0;0;0;47507;2988;0.0629;2541;447
2016-02-09 02:00:00;23,76;26,45;-2,69;39658;0;0;0;0;47507;3260;0.0686;2674;586
2016-02-09 03:00:00;22,91;24,57;-1,66;39658;0;0;0;0;47507;3062;0.0644;2754;308
2016-02-09 04:00:00;23,1;24,54;-1,44;39658;0;0;0;0;47507;2795;0.0588;2764;31
2016-02-09 05:00:00;25,97;27,24;-1,27;39658;0;0;0;0;47507;3026;0.0637;2743;283
2016-02-09 06:00:00;33,08;36,29;-3,21;39658;96;0.0024;131;-35;47507;3589;0.0756;2792;797
2016-02-09 07:00:00;38,41;39,32;-0,91;39658;1953;0.0492;2010;-57;47507;3946;0.083;2925;1021
2016-02-09 08:00:00;40,5;38,53;1,97;39658;6360;0.1603;6400;-40;47507;3884;0.0818;2974;910
2016-02-09 09:00:00;37,91;35,66;2,25;39658;11894;0.2999;11661;233;47507;3735;0.0786;3085;650
2016-02-09 10:00:00;32,84;31,0;1,84;39658;16675;0.4204;16390;285;47507;4208;0.0886;3470;738
2016-02-09 11:00:00;29,59;29,01;0,58;39658;20137;0.5078;19732;405;47507;5011;0.1055;3939;1072
2016-02-09 12:00:00;26,81;26,85;-0,04;39658;21923;0.5528;21515;408;47507;5756;0.1211;4339;1417
2016-02-09 13:00:00;25,69;26,65;-0,96;39658;21628;0.5454;21685;-57;47507;5592;0.1177;4663;929
2016-02-09 14:00:00;25,85;27,33;-1,48;39658;20084;0.5064;20341;-257;47507;5027;0.1058;4709;318
2016-02-09 15:00:00;27,94;30,01;-2,07;39658;17568;0.443;17466;102;47507;4924;0.1036;4498;426
2016-02-09 16:00:00;29,17;31,03;-1,86;39658;13715;0.3459;13506;209;47507;4716;0.0993;4218;498
2016-02-09 17:00:00;34,01;35,67;-1,66;39658;8382;0.2114;8535;-153;47507;4644;0.0978;3896;748
2016-02-09 18:00:00;37,56;38,78;-1,22;39658;3345;0.0844;3698;-353;47507;4309;0.0907;3633;676
2016-02-09 19:00:00;37,98;39,01;-1,03;39658;541;0.0136;668;-127;47507;4235;0.0891;3477;758
2016-02-09 20:00:00;38,79;38,96;-0,17;39658;8;0.0002;12;-4;47507;4662;0.0982;3439;1223
2016-02-09 21:00:00;34,99;37,02;-2,03;39658;0;0;0;0;47507;4629;0.0974;3803;826
2016-02-09 22:00:00;29,09;31,84;-2,75;39658;0;0;0;0;47507;4501;0.0947;4414;87
2016-02-09 23:00:00;27,61;30,37;-2,76;39658;0;0;0;0;47507;4477;0.0943;4988;-511
2016-03-09 00:00:00;31,41;29,29;2,12;39658;0;0;0;0;47516;5263;0.1108;5491;-228
2016-03-09 01:00:00;28,04;28,57;-0,53;39658;0;0;0;0;47516;5302;0.1116;5610;-308
2016-03-09 02:00:00;25,37;26,67;-1,3;39658;0;0;0;0;47516;4638;0.0976;5416;-778
2016-03-09 03:00:00;24,88;27,8;-2,92;39658;0;0;0;0;47516;4367;0.0919;5004;-637
2016-03-09 04:00:00;24,02;27,57;-3,55;39658;0;0;0;0;47516;4509;0.0949;4655;-146
2016-03-09 05:00:00;24,92;24,89;0,03;39658;0;0;0;0;47516;4729;0.0995;4402;327
2016-03-09 06:00:00;25,65;25,75;-0,1;39658;76;0.0019;107;-31;47516;4430;0.0932;4359;71
2016-03-09 07:00:00;29,44;28,4;1,04;39658;1502;0.0379;1666;-164;47516;4498;0.0946;4366;132
2016-03-09 08:00:00;31,55;30,46;1,09;39658;4952;0.1248;5189;-237;47516;4305;0.0906;4223;82
2016-03-09 09:00:00;32,95;33,41;-0,46;39658;9535;0.2404;9378;157;47516;4168;0.0877;3960;208
2016-03-09 10:00:00;30,35;32,28;-1,93;39658;13340;0.3364;13332;8;47516;4982;0.1049;3957;1025
2016-03-09 11:00:00;29,06;29,5;-0,44;39658;15813;0.3988;16322;-509;47516;5012;0.1054;4300;712
2016-03-09 12:00:00;27,16;29,7;-2,54;39658;17262;0.4353;18093;-831;47516;5365;0.1129;4790;575
2016-03-09 13:00:00;25,09;26,54;-1,45;39658;18088;0.4561;18207;-119;47516;6003;0.1263;5199;804
2016-03-09 14:00:00;25,11;26,15;-1,04;39658;17270;0.4355;16972;298;47516;6303;0.1326;5463;840
2016-03-09 15:00:00;25,36;23,54;1,82;39658;15160;0.3823;14559;601;47516;6238;0.1313;5500;738
2016-03-09 16:00:00;26,85;23,62;3,23;39658;12022;0.3031;11321;701;47516;5461;0.1149;5234;227
2016-03-09 17:00:00;30,44;28,47;1,97;39658;7606;0.1918;7297;309;47516;4573;0.0962;4587;-14
2016-03-09 18:00:00;34,27;32,5;1,77;39658;3200;0.0807;3270;-70;47516;3506;0.0738;3574;-68
2016-03-09 19:00:00;37,56;36,42;1,14;39658;581;0.0146;592;-11;47516;2352;0.0495;2706;-354
2016-03-09 20:00:00;38,56;38,41;0,15;39658;9;0.0002;10;-1;47516;2407;0.0507;2320;87
2016-03-09 21:00:00;37,67;35,29;2,38;39658;0;0;0;0;47516;2890;0.0608;2396;494
2016-03-09 22:00:00;33,01;29,97;3,04;39658;0;0;0;0;47516;3564;0.075;2622;942
2016-03-09 23:00:00;28,93;26,56;2,37;39658;0;0;0;0;47516;4042;0.0851;2981;1061
2016-04-09 00:00:00;27,7;24,69;3,01;39658;0;0;0;0;47516;4984;0.1049;4416;568
2016-04-09 01:00:00;25,02;22,62;2,4;39658;0;0;0;0;47516;6112;0.1286;5717;395
2016-04-09 02:00:00;23,09;20,71;2,38;39658;0;0;0;0;47516;6978;0.1469;6826;152
2016-04-09 03:00:00;22,04;19,21;2,83;39658;0;0;0;0;47516;7792;0.164;7693;99
2016-04-09 04:00:00;20,81;18,54;2,27;39658;0;0;0;0;47516;9269;0.1951;8444;825
2016-04-09 05:00:00;20,09;18,81;1,28;39658;0;0;0;0;47516;9482;0.1996;8973;509
2016-04-09 06:00:00;20,03;19,42;0,61;39658;55;0.0014;72;-17;47516;9495;0.1998;9353;142
2016-04-09 07:00:00;22,02;21,77;0,25;39658;1177;0.0297;1162;15;47516;9190;0.1934;9782;-592
2016-04-09 08:00:00;22,38;21,62;0,76;39658;3827;0.0965;3588;239;47516;9185;0.1933;9921;-736
2016-04-09 09:00:00;23,5;22,77;0,73;39658;6552;0.1652;6197;355;47516;9486;0.1996;9981;-495
2016-04-09 10:00:00;23,58;24,28;-0,7;39658;8327;0.21;8101;226;47516;9747;0.2051;10520;-773
2016-04-09 11:00:00;24,99;25,96;-0,97;39658;8968;0.2261;9284;-316;47516;11265;0.2371;11289;-24
2016-04-09 12:00:00;24,85;26,84;-1,99;39658;9520;0.2401;9931;-411;47516;11884;0.2501;12267;-383
2016-04-09 13:00:00;23,49;26,34;-2,85;39658;8977;0.2264;9866;-889;47516;11303;0.2379;13135;-1832
2016-04-09 14:00:00;20,79;25,91;-5,12;39658;8938;0.2254;9118;-180;47516;11566;0.2434;13611;-2045
2016-04-09 15:00:00;20,52;26,33;-5,81;39658;8335;0.2102;7830;505;47516;13529;0.2847;13772;-243
2016-04-09 16:00:00;21,26;25,31;-4,05;39658;6636;0.1673;5972;664;47516;15320;0.3224;13884;1436
2016-04-09 17:00:00;22,94;25,83;-2,89;39658;3973;0.1002;3866;107;47516;15566;0.3276;13786;1780
2016-04-09 18:00:00;26,94;28,95;-2,01;39658;1527;0.0385;1765;-238;47516;14575;0.3068;13243;1332
2016-04-09 19:00:00;30,31;32,51;-2,2;39658;269;0.0068;332;-63;47516;13646;0.2872;12513;1133
2016-04-09 20:00:00;33,83;33,58;0,25;39658;6;0.0001;5;1;47516;13071;0.2751;11617;1454
2016-04-09 21:00:00;31,79;31,53;0,26;39658;0;0;0;0;47516;12364;0.2602;11184;1180
2016-04-09 22:00:00;29,53;27,48;2,05;39658;0;0;0;0;47516;11971;0.252;10941;1030
2016-04-09 23:00:00;25,06;23,32;1,74;39658;0;0;0;0;47516;11978;0.2521;10810;1168
2016-05-09 00:00:00;23,18;23,41;-0,23;39659;0;0;0;0;47532;12010;0.2527;11697;313
2016-05-09 01:00:00;22,3;22,08;0,22;39659;0;0;0;0;47532;11638;0.2448;11601;37
2016-05-09 02:00:00;22,42;20,69;1,73;39659;0;0;0;0;47532;11492;0.2418;11196;296
2016-05-09 03:00:00;21,73;19,23;2,5;39659;0;0;0;0;47532;11002;0.2315;10672;330
2016-05-09 04:00:00;22,96;16,97;5,99;39659;0;0;0;0;47532;10500;0.2209;10186;314
2016-05-09 05:00:00;24,96;20,06;4,9;39659;0;0;0;0;47532;10192;0.2144;9696;496
2016-05-09 06:00:00;33,6;34,22;-0,62;39659;32;0.0008;61;-29;47532;9475;0.1993;9208;267
2016-05-09 07:00:00;42,98;44,68;-1,7;39659;847;0.0214;992;-145;47532;8370;0.1761;8698;-328
2016-05-09 08:00:00;44,42;47,05;-2,63;39659;3080;0.0776;3285;-205;47532;7473;0.1572;8140;-667
2016-05-09 09:00:00;43,31;48,26;-4,95;39659;5849;0.1475;5916;-67;47532;7065;0.1486;7686;-621
2016-05-09 10:00:00;44,97;47,79;-2,82;39659;8279;0.2088;8378;-99;47532;6836;0.1438;7416;-580
2016-05-09 11:00:00;48,01;45,04;2,97;39659;10480;0.2642;10309;171;47532;6418;0.135;7106;-688
2016-05-09 12:00:00;45,98;44,03;1,95;39659;11976;0.302;11568;408;47532;5899;0.1241;6702;-803
2016-05-09 13:00:00;44,22;42,65;1,57;39659;12308;0.3103;11969;339;47532;5450;0.1146;6355;-905
2016-05-09 14:00:00;42,58;44,2;-1,62;39659;11905;0.3002;11589;316;47532;5030;0.1058;6085;-1055
2016-05-09 15:00:00;43,03;43,74;-0,71;39659;10805;0.2724;10300;505;47532;4650;0.0978;5916;-1266
2016-05-09 16:00:00;41,9;42,7;-0,8;39659;8506;0.2144;8118;388;47532;4511;0.0949;5703;-1192
2016-05-09 17:00:00;41,98;41,7;0,28;39659;5732;0.1445;5334;398;47532;3879;0.0816;5302;-1423
2016-05-09 18:00:00;39,92;41,93;-2,01;39659;2582;0.0651;2397;185;47532;3150;0.0662;4656;-1506
2016-05-09 19:00:00;43,12;43,15;-0,03;39659;417;0.0105;395;22;47532;2559;0.0538;4037;-1478
2016-05-09 20:00:00;44,08;43,62;0,46;39659;4;0.0001;5;-1;47532;2625;0.0552;3636;-1011
2016-05-09 21:00:00;40,0;39,32;0,68;39659;0;0;0;0;47532;2640;0.0556;3399;-759
2016-05-09 22:00:00;32,96;31,77;1,19;39659;0;0;0;0;47532;2429;0.0511;3231;-802
2016-05-09 23:00:00;28,07;28,39;-0,32;39659;0;0;0;0;47532;2142;0.0451;2983;-841
2016-06-09 00:00:00;27,68;29,76;-2,08;39661;0;0;0;0;47542;1824;0.0384;2178;-354
2016-06-09 01:00:00;25,98;27,51;-1,53;39661;0;0;0;0;47542;1703;0.0358;1981;-278
2016-06-09 02:00:00;24,84;25,92;-1,08;39661;0;0;0;0;47542;1630;0.0343;1843;-213
2016-06-09 03:00:00;23,76;24,31;-0,55;39661;0;0;0;0;47542;1641;0.0345;1777;-136
2016-06-09 04:00:00;23,92;23,62;0,3;39661;0;0;0;0;47542;1732;0.0364;1719;13
2016-06-09 05:00:00;26,43;24,86;1,57;39661;0;0;0;0;47542;1828;0.0384;1632;196
2016-06-09 06:00:00;34,37;34,01;0,36;39661;57;0.0015;88;-31;47542;1724;0.0363;1582;142
2016-06-09 07:00:00;42,97;38,34;4,63;39661;1473;0.0371;1699;-226;47542;1940;0.0408;1503;437
2016-06-09 08:00:00;44,63;42,01;2,62;39661;5434;0.137;5929;-495;47542;1764;0.0371;1332;432
2016-06-09 09:00:00;41,96;39,0;2,96;39661;10749;0.271;11137;-388;47542;1172;0.0246;1163;9
2016-06-09 10:00:00;35,9;33,78;2,12;39661;15364;0.3874;15824;-460;47542;1159;0.0244;1152;7
2016-06-09 11:00:00;33,76;32,17;1,59;39661;18416;0.4643;19141;-725;47542;1408;0.0296;1210;198
2016-06-09 12:00:00;28,48;29,89;-1,41;39661;20791;0.5242;20975;-184;47542;1590;0.0334;1300;290
2016-06-09 13:00:00;27,98;29,11;-1,13;39661;21509;0.5423;21403;106;47542;1502;0.0316;1340;162
2016-06-09 14:00:00;28,59;28,94;-0,35;39661;20311;0.5121;20442;-131;47542;1481;0.0312;1310;171
2016-06-09 15:00:00;29,02;28,77;0,25;39661;18142;0.4574;17970;172;47542;1324;0.0278;1230;94
2016-06-09 16:00:00;31,46;30,7;0,76;39661;14416;0.3635;14018;398;47542;1139;0.024;1127;12
2016-06-09 17:00:00;37,95;37,27;0,68;39661;9130;0.2302;8707;423;47542;973;0.0204;1080;-107
2016-06-09 18:00:00;42,01;41,85;0,16;39661;3752;0.0946;3503;249;47542;872;0.0183;1206;-334
2016-06-09 19:00:00;45,16;47,04;-1,88;39661;514;0.013;495;19;47542;1020;0.0215;1533;-513
2016-06-09 20:00:00;43,92;48,91;-4,99;39661;5;0.0001;6;-1;47542;1734;0.0365;2179;-445
2016-06-09 21:00:00;38,55;39,75;-1,2;39661;0;0;0;0;47542;2869;0.0603;3013;-144
2016-06-09 22:00:00;28,0;29,06;-1,06;39661;0;0;0;0;47542;4028;0.0847;3878;150
2016-06-09 23:00:00;26,82;26,92;-0,1;39661;0;0;0;0;47542;5082;0.1069;4555;527
2016-07-09 00:00:00;24,8;26,79;-1,99;39663;0;0;0;0;47545;5842;0.1229;5389;453
2016-07-09 01:00:00;23,64;23,04;0,6;39663;0;0;0;0;47545;6017;0.1266;5512;505
2016-07-09 02:00:00;23,32;22,61;0,71;39663;0;0;0;0;47545;5980;0.1258;5405;575
2016-07-09 03:00:00;23,16;22,02;1,14;39663;0;0;0;0;47545;5607;0.1179;5080;527
2016-07-09 04:00:00;23,18;23,08;0,1;39663;0;0;0;0;47545;4922;0.1035;4743;179
2016-07-09 05:00:00;25,11;25,11;0,0;39663;0;0;0;0;47545;4388;0.0923;4469;-81
2016-07-09 06:00:00;32,42;35,24;-2,82;39663;52;0.0014;88;-36;47545;4096;0.0862;4317;-221
2016-07-09 07:00:00;37,97;37,81;0,16;39663;1626;0.041;1922;-296;47545;3869;0.0814;4121;-252
2016-07-09 08:00:00;38,13;37,59;0,54;39663;6026;0.1519;6796;-770;47545;3008;0.0632;3448;-440
2016-07-09 09:00:00;34,07;34,8;-0,73;39663;11818;0.298;12757;-939;47545;1648;0.0347;2231;-583
2016-07-09 10:00:00;29,95;31,06;-1,11;39663;17314;0.4365;18041;-727;47545;1104;0.0232;1628;-524
2016-07-09 11:00:00;28,92;29,32;-0,4;39663;21346;0.5381;21763;-417;47545;1144;0.0241;1475;-331
2016-07-09 12:00:00;26,92;28,49;-1,57;39663;23588;0.5947;23791;-203;47545;1229;0.0258;1453;-224
2016-07-09 13:00:00;26,41;28,01;-1,6;39663;24247;0.6113;24142;105;47545;1258;0.0264;1497;-239
2016-07-09 14:00:00;27,25;28,12;-0,87;39663;23032;0.5807;22864;168;47545;1438;0.0302;1533;-95
2016-07-09 15:00:00;27,92;29,73;-1,81;39663;20116;0.5072;19870;246;47545;1526;0.0321;1525;1
2016-07-09 16:00:00;28,93;32,56;-3,63;39663;15604;0.3934;15237;367;47545;1642;0.0346;1483;159
2016-07-09 17:00:00;36,93;38,13;-1,2;39663;9605;0.2422;9232;373;47545;1750;0.0368;1512;238
2016-07-09 18:00:00;40,7;41,69;-0,99;39663;3767;0.095;3577;190;47545;1818;0.0382;1787;31
2016-07-09 19:00:00;44,35;45,14;-0,79;39663;479;0.0121;472;7;47545;2121;0.0446;2291;-170
2016-07-09 20:00:00;41,9;43,35;-1,45;39663;0;0;6;-6;47545;3420;0.072;3355;65
2016-07-09 21:00:00;36,94;40,04;-3,1;39663;0;0;0;0;47545;4766;0.1003;4794;-28
2016-07-09 22:00:00;28,85;30,38;-1,53;39663;0;0;0;0;47545;5335;0.1122;5860;-525
2016-07-09 23:00:00;26,59;29,4;-2,81;39663;0;0;0;0;47545;5534;0.1164;6469;-935
2016-08-09 00:00:00;25,59;26,98;-1,39;39668;0;0;0;0;47582;5492;0.1154;5263;229
2016-08-09 01:00:00;24,07;26,41;-2,34;39668;0;0;0;0;47582;5234;0.11;5158;76
2016-08-09 02:00:00;23,5;25,05;-1,55;39668;0;0;0;0;47582;5195;0.1092;5074;121
2016-08-09 03:00:00;23,08;23,57;-0,49;39668;0;0;0;0;47582;5043;0.106;5068;-25
2016-08-09 04:00:00;23,1;22,77;0,33;39668;0;0;0;0;47582;5235;0.11;5162;73
2016-08-09 05:00:00;24,24;25,01;-0,77;39668;0;0;0;0;47582;5302;0.1114;5327;-25
2016-08-09 06:00:00;31,91;37,27;-5,36;39668;48;0.0012;77;-29;47582;5498;0.1156;5656;-158
2016-08-09 07:00:00;38,71;42,3;-3,59;39668;1698;0.0428;1862;-164;47582;5948;0.125;5799;149
2016-08-09 08:00:00;39,62;41,72;-2,1;39668;6421;0.1619;6777;-356;47582;5816;0.1222;4947;869
2016-08-09 09:00:00;38,31;39,01;-0,7;39668;12498;0.3151;12854;-356;47582;3690;0.0775;3162;528
2016-08-09 10:00:00;32,92;35,46;-2,54;39668;17874;0.4506;18298;-424;47582;2884;0.0606;2806;78
2016-08-09 11:00:00;28,67;34,28;-5,61;39668;21738;0.548;22078;-340;47582;3010;0.0633;2733;277
2016-08-09 12:00:00;27,48;30,41;-2,93;39668;23751;0.5988;24040;-289;47582;3423;0.0719;3004;419
2016-08-09 13:00:00;26,28;29,31;-3,03;39668;23964;0.6041;24268;-304;47582;4266;0.0896;3299;967
2016-08-09 14:00:00;26,85;29,12;-2,27;39668;22590;0.5695;22871;-281;47582;4998;0.1051;3560;1438
2016-08-09 15:00:00;27,7;28,92;-1,22;39668;19539;0.4926;19758;-219;47582;5193;0.1091;3783;1410
2016-08-09 16:00:00;29,51;30,7;-1,19;39668;14934;0.3765;15042;-108;47582;5052;0.1062;3857;1195
2016-08-09 17:00:00;35,92;36,37;-0,45;39668;8988;0.2266;8998;-10;47582;4491;0.0944;3633;858
2016-08-09 18:00:00;40,41;40,49;-0,08;39668;3421;0.0862;3403;18;47582;3711;0.078;3504;207
2016-08-09 19:00:00;42,59;41,81;0,78;39668;397;0.01;422;-25;47582;3475;0.073;3574;-99
2016-08-09 20:00:00;41,3;43,06;-1,76;39668;0;0;6;-6;47582;4194;0.0882;4494;-300
2016-08-09 21:00:00;36,91;40,37;-3,46;39668;0;0;0;0;47582;5169;0.1086;5344;-175
2016-08-09 22:00:00;28,65;34,79;-6,14;39668;0;0;0;0;47582;5578;0.1172;5882;-304
2016-08-09 23:00:00;25,99;32,34;-6,35;39668;0;0;0;0;47582;5936;0.1247;6011;-75
2016-09-09 00:00:00;25,08;28,83;-3,75;39672;0;0;0;0;47603;5666;0.119;6902;-1236
2016-09-09 01:00:00;23,81;28,77;-4,96;39672;0;0;0;0;47603;5566;0.1169;6783;-1217
2016-09-09 02:00:00;23,49;27,77;-4,28;39672;0;0;0;0;47603;5258;0.1105;6480;-1222
2016-09-09 03:00:00;22,97;26,87;-3,9;39672;0;0;0;0;47603;4700;0.0988;6098;-1398
2016-09-09 04:00:00;23,26;27,59;-4,33;39672;0;0;0;0;47603;4207;0.0884;5756;-1549
2016-09-09 05:00:00;24,82;27,82;-3,0;39672;0;0;0;0;47603;3920;0.0824;5494;-1574
2016-09-09 06:00:00;33,77;40,12;-6,35;39672;34;0.0008;62;-28;47603;3659;0.0769;5292;-1633
2016-09-09 07:00:00;40,22;48,19;-7,97;39672;1371;0.0346;1600;-229;47603;3688;0.0775;4971;-1283
2016-09-09 08:00:00;41,94;46,56;-4,62;39672;5212;0.1314;5837;-625;47603;2877;0.0604;4098;-1221
2016-09-09 09:00:00;40,99;43,96;-2,97;39672;10296;0.2596;11058;-762;47603;1995;0.0419;2883;-888
2016-09-09 10:00:00;36,88;39,8;-2,92;39672;15173;0.3824;15939;-766;47603;1784;0.0375;2531;-747
2016-09-09 11:00:00;34,06;38,39;-4,33;39672;18925;0.477;19448;-523;47603;2245;0.0472;2536;-291
2016-09-09 12:00:00;31,8;34,03;-2,23;39672;20865;0.5259;21397;-532;47603;2788;0.0586;2553;235
2016-09-09 13:00:00;29,04;30,58;-1,54;39672;21070;0.5311;21614;-544;47603;2868;0.0602;2519;349
2016-09-09 14:00:00;27,86;29,14;-1,28;39672;19654;0.4954;20197;-543;47603;2684;0.0564;2413;271
2016-09-09 15:00:00;29,49;29,22;0,27;39672;17066;0.4302;17284;-218;47603;2234;0.0469;2170;64
2016-09-09 16:00:00;30,29;31,34;-1,05;39672;13270;0.3345;13160;110;47603;1903;0.04;1878;25
2016-09-09 17:00:00;35,89;38,89;-3,0;39672;8282;0.2088;7983;299;47603;1488;0.0312;1652;-164
2016-09-09 18:00:00;39,77;41,4;-1,63;39672;3208;0.0808;3072;136;47603;1186;0.0249;1484;-298
2016-09-09 19:00:00;41,92;43,36;-1,44;39672;363;0.0092;368;-5;47603;1034;0.0217;1502;-468
2016-09-09 20:00:00;41,42;43,79;-2,37;39672;0;0;2;-2;47603;1258;0.0264;1883;-625
2016-09-09 21:00:00;38,27;39,91;-1,64;39672;0;0;0;0;47603;1600;0.0336;2307;-707
2016-09-09 22:00:00;30,73;33,42;-2,69;39672;0;0;0;0;47603;1868;0.0392;2494;-626
2016-09-09 23:00:00;28,01;30,05;-2,04;39672;0;0;0;0;47603;2093;0.044;2716;-623
2016-10-09 00:00:00;33,02;28,27;4,75;39672;0;0;0;0;47621;2379;0.05;2465;-86
2016-10-09 01:00:00;27,11;26,13;0,98;39672;0;0;0;0;47621;2548;0.0535;2697;-149
2016-10-09 02:00:00;27,42;26,25;1,17;39672;0;0;0;0;47621;2741;0.0576;2824;-83
2016-10-09 03:00:00;24,25;25,38;-1,13;39672;0;0;0;0;47621;2891;0.0607;2831;60
2016-10-09 04:00:00;23,75;24,47;-0,72;39672;0;0;0;0;47621;2870;0.0602;2817;53
2016-10-09 05:00:00;24,2;25,78;-1,58;39672;0;0;0;0;47621;2656;0.0558;2799;-143
2016-10-09 06:00:00;25,51;27,04;-1,53;39672;33;0.0008;59;-26;47621;2288;0.048;2758;-470
2016-10-09 07:00:00;29,04;30,32;-1,28;39672;1430;0.036;1590;-160;47621;2087;0.0438;2678;-591
2016-10-09 08:00:00;29,75;31,41;-1,66;39672;5766;0.1454;6122;-356;47621;1874;0.0393;2349;-475
2016-10-09 09:00:00;29,94;33,24;-3,3;39672;11610;0.2926;12033;-423;47621;1388;0.0292;1623;-235
2016-10-09 10:00:00;25,22;26,7;-1,48;39672;16698;0.4209;17289;-591;47621;1052;0.0221;1294;-242
2016-10-09 11:00:00;23,69;28,0;-4,31;39672;20389;0.5139;20891;-502;47621;1115;0.0234;1233;-118
2016-10-09 12:00:00;23,08;26,92;-3,84;39672;22178;0.559;22760;-582;47621;1141;0.024;1228;-87
2016-10-09 13:00:00;23,06;25,72;-2,66;39672;22109;0.5573;22684;-575;47621;1306;0.0274;1203;103
2016-10-09 14:00:00;23,06;25,33;-2,27;39672;20490;0.5165;20932;-442;47621;1368;0.0287;1173;195
2016-10-09 15:00:00;25,61;25,86;-0,25;39672;17422;0.4392;17684;-262;47621;1356;0.0284;1177;179
2016-10-09 16:00:00;28,65;27,1;1,55;39672;13189;0.3325;13288;-99;47621;1221;0.0256;1194;27
2016-10-09 17:00:00;31,99;32,85;-0,86;39672;7921;0.1997;7889;32;47621;1146;0.0241;1317;-171
2016-10-09 18:00:00;34,05;35,63;-1,58;39672;2940;0.0741;2950;-10;47621;1177;0.0247;1705;-528
2016-10-09 19:00:00;38,7;38,15;0,55;39672;297;0.0075;331;-34;47621;1736;0.0364;2341;-605
2016-10-09 20:00:00;38,98;38,33;0,65;39672;0;0;2;-2;47621;2942;0.0618;3265;-323
2016-10-09 21:00:00;34,08;33,87;0,21;39672;0;0;0;0;47621;3914;0.0822;4105;-191
2016-10-09 22:00:00;30,65;31,33;-0,68;39672;0;0;0;0;47621;4493;0.0943;4875;-382
2016-10-09 23:00:00;26,76;29,19;-2,43;39672;0;0;0;0;47621;5129;0.1077;5328;-199
2016-11-09 00:00:00;24,05;23,86;0,19;39672;0;0;0;0;47621;5808;0.122;6139;-331
2016-11-09 01:00:00;22,87;22,24;0,63;39672;0;0;0;0;47621;6252;0.1313;6428;-176
2016-11-09 02:00:00;22,51;21,71;0,8;39672;0;0;0;0;47621;6587;0.1383;6340;247
2016-11-09 03:00:00;21,73;19,7;2,03;39672;0;0;0;0;47621;6696;0.1406;6014;682
2016-11-09 04:00:00;21,1;19,67;1,43;39672;0;0;0;0;47621;6562;0.1378;5554;1008
2016-11-09 05:00:00;22,09;19,78;2,31;39672;0;0;0;0;47621;6325;0.1328;4985;1340
2016-11-09 06:00:00;22,94;19,62;3,32;39672;27;0.0007;46;-19;47621;5742;0.1206;4390;1352
2016-11-09 07:00:00;22,93;19,85;3,08;39672;1229;0.031;1331;-102;47621;5170;0.1086;3839;1331
2016-11-09 08:00:00;24,07;21,54;2,53;39672;5094;0.1284;4974;120;47621;3932;0.0826;3141;791
2016-11-09 09:00:00;25,11;23,3;1,81;39672;10234;0.258;9530;704;47621;2374;0.0498;2040;334
2016-11-09 10:00:00;24,96;24,19;0,77;39672;15032;0.3789;13840;1192;47621;1638;0.0344;1366;272
2016-11-09 11:00:00;25,48;22,61;2,87;39672;18310;0.4615;16835;1475;47621;1205;0.0253;1336;-131
2016-11-09 12:00:00;25,16;22,05;3,11;39672;20015;0.5045;18275;1740;47621;901;0.0189;1047;-146
2016-11-09 13:00:00;24,54;21,75;2,79;39672;20026;0.5048;18416;1610;47621;639;0.0134;783;-144
2016-11-09 14:00:00;23,48;20,93;2,55;39672;18334;0.4621;17289;1045;47621;470;0.0098;594;-124
2016-11-09 15:00:00;23,42;20,84;2,58;39672;15779;0.3977;14849;930;47621;441;0.0092;535;-94
2016-11-09 16:00:00;24,01;19,18;4,83;39672;12194;0.3074;11262;932;47621;400;0.0084;486;-86
2016-11-09 17:00:00;28,73;25,81;2,92;39672;7493;0.1889;6744;749;47621;504;0.0106;542;-38
2016-11-09 18:00:00;36,36;34,94;1,42;39672;2734;0.0689;2544;190;47621;679;0.0142;757;-78
2016-11-09 19:00:00;39,85;37,83;2,02;39672;260;0.0065;272;-12;47621;976;0.0205;1106;-130
2016-11-09 20:00:00;42,57;40,84;1,73;39672;0;0;1;-1;47621;1600;0.0336;1496;104
2016-11-09 21:00:00;38,93;34,62;4,31;39672;0;0;0;0;47621;2430;0.051;1872;558
2016-11-09 22:00:00;35,94;31,89;4,05;39672;0;0;0;0;47621;3202;0.0672;2219;983
2016-11-09 23:00:00;31,27;28,38;2,89;39672;0;0;0;0;47621;3759;0.0789;2489;1270
2016-12-09 00:00:00;24,06;22,51;1,55;39674;0;0;0;0;47638;4400;0.0923;3953;447
2016-12-09 01:00:00;23,45;21,84;1,61;39674;0;0;0;0;47638;5003;0.105;4211;792
2016-12-09 02:00:00;22,88;21,35;1,53;39674;0;0;0;0;47638;5401;0.1134;4421;980
2016-12-09 03:00:00;22,15;21,48;0,67;39674;0;0;0;0;47638;5490;0.1152;4543;947
2016-12-09 04:00:00;22,75;20,51;2,24;39674;0;0;0;0;47638;5525;0.116;4711;814
2016-12-09 05:00:00;24,12;22,66;1,46;39674;0;0;0;0;47638;5572;0.117;4851;721
2016-12-09 06:00:00;36,69;40,13;-3,44;39674;24;0.0006;45;-21;47638;5077;0.1066;4891;186
2016-12-09 07:00:00;43,0;43,99;-0,99;39674;1339;0.0338;1471;-132;47638;4685;0.0983;4751;-66
2016-12-09 08:00:00;42,53;43,56;-1,03;39674;5851;0.1474;6088;-237;47638;3658;0.0768;3882;-224
2016-12-09 09:00:00;39,43;36,93;2,5;39674;11769;0.2966;12117;-348;47638;2126;0.0446;2487;-361
2016-12-09 10:00:00;33,5;30,19;3,31;39674;16992;0.4283;17463;-471;47638;1347;0.0283;1925;-578
2016-12-09 11:00:00;30,71;29,16;1,55;39674;20470;0.5159;21154;-684;47638;1138;0.0239;1641;-503
2016-12-09 12:00:00;30,16;30,02;0,14;39674;22300;0.5621;23028;-728;47638;1170;0.0246;1749;-579
2016-12-09 13:00:00;29,61;32,69;-3,08;39674;22555;0.5685;23101;-546;47638;1328;0.0279;2222;-894
2016-12-09 14:00:00;31,15;32,71;-1,56;39674;21076;0.5312;21524;-448;47638;1369;0.0288;2232;-863
2016-12-09 15:00:00;32,69;33,58;-0,89;39674;18138;0.4572;18339;-201;47638;1349;0.0283;1786;-437
2016-12-09 16:00:00;36,66;39,66;-3,0;39674;13567;0.3419;13714;-147;47638;1354;0.0284;1521;-167
2016-12-09 17:00:00;41,81;45,56;-3,75;39674;7919;0.1996;7948;-29;47638;1490;0.0313;1650;-160
2016-12-09 18:00:00;42,97;58,8;-15,83;39674;2744;0.0691;2793;-49;47638;1837;0.0386;2163;-326
2016-12-09 19:00:00;46,73;78,56;-31,83;39674;232;0.0058;273;-41;47638;2926;0.0614;3189;-263
2016-12-09 20:00:00;42,83;87,69;-44,86;39674;0;0;0;0;47638;5006;0.1051;4225;781
2016-12-09 21:00:00;37,93;46,05;-8,12;39674;0;0;0;0;47638;6567;0.1378;5125;1442
2016-12-09 22:00:00;30,65;31,28;-0,63;39674;0;0;0;0;47638;6944;0.1458;5768;1176
2016-12-09 23:00:00;26,59;25,73;0,86;39674;0;0;0;0;47638;6802;0.1428;5980;822
2016-09-13 00:00:00;26,64;29,1;-2,46;39676;0;0;0;0;47654;6476;0.1359;6314;162
2016-09-13 01:00:00;24,8;24,42;0,38;39676;0;0;0;0;47654;5924;0.1243;6081;-157
2016-09-13 02:00:00;24,01;23,92;0,09;39676;0;0;0;0;47654;5342;0.1121;5793;-451
2016-09-13 03:00:00;23,52;22,67;0,85;39676;0;0;0;0;47654;4872;0.1022;5553;-681
2016-09-13 04:00:00;23,55;21,64;1,91;39676;0;0;0;0;47654;4611;0.0968;5370;-759
2016-09-13 05:00:00;26,39;22,92;3,47;39676;0;0;0;0;47654;4563;0.0957;5257;-694
2016-09-13 06:00:00;37,48;32,55;4,93;39676;21;0.0005;43;-22;47654;4626;0.0971;5202;-576
2016-09-13 07:00:00;44,44;41,22;3,22;39676;1382;0.0348;1566;-184;47654;4631;0.0972;5091;-460
2016-09-13 08:00:00;42,76;46,78;-4,02;39676;5832;0.147;6397;-565;47654;4132;0.0867;4662;-530
2016-09-13 09:00:00;38,92;41,75;-2,83;39676;11638;0.2933;12436;-798;47654;2677;0.0562;3576;-899
2016-09-13 10:00:00;35,91;37,97;-2,06;39676;16749;0.4221;17786;-1037;47654;1722;0.0362;2697;-975
2016-09-13 11:00:00;32,74;38,38;-5,64;39676;20317;0.5121;21416;-1099;47654;2205;0.0463;2859;-654
2016-09-13 12:00:00;28,13;34,78;-6,65;39676;22250;0.5608;23290;-1040;47654;3506;0.0736;3602;-96
2016-09-13 13:00:00;27,62;31,86;-4,24;39676;22407;0.5648;23451;-1044;47654;4861;0.102;4524;337
2016-09-13 14:00:00;28,73;31,3;-2,57;39676;20966;0.5284;21998;-1032;47654;5281;0.1108;5080;201
2016-09-13 15:00:00;28,25;30,52;-2,27;39676;17992;0.4535;18843;-851;47654;5217;0.1094;5129;88
2016-09-13 16:00:00;30,23;33,75;-3,52;39676;13528;0.3409;14057;-529;47654;5177;0.1086;5094;83
2016-09-13 17:00:00;37,42;41,05;-3,63;39676;7843;0.1977;8068;-225;47654;5417;0.1136;5393;24
2016-09-13 18:00:00;40,42;43,33;-2,91;39676;2677;0.0674;2743;-66;47654;5882;0.1234;6250;-368
2016-09-13 19:00:00;41,93;43,62;-1,69;39676;241;0.0061;251;-10;47654;8052;0.169;7942;110
2016-09-13 20:00:00;38,94;42,13;-3,19;39676;0;0;0;0;47654;11722;0.246;9735;1987
2016-09-13 21:00:00;33,52;30,89;2,63;39676;0;0;0;0;47654;13932;0.2924;11009;2923
2016-09-13 22:00:00;25,76;24,14;1,62;39676;0;0;0;0;47654;14398;0.3021;11702;2696
2016-09-13 23:00:00;24,27;21,35;2,92;39676;0;0;0;0;47654;13952;0.2928;11798;2154
2016-09-14 00:00:00;23,0;21,33;1,67;39680;0;0;0;0;47659;13025;0.2733;11219;1806
2016-09-14 01:00:00;22,17;20,4;1,77;39680;0;0;0;0;47659;11892;0.2495;10825;1067
2016-09-14 02:00:00;21,34;20,28;1,06;39680;0;0;0;0;47659;10758;0.2258;10596;162
2016-09-14 03:00:00;21,85;20,83;1,02;39680;0;0;0;0;47659;9904;0.2078;10123;-219
2016-09-14 04:00:00;22,74;23,23;-0,49;39680;0;0;0;0;47659;9375;0.1967;9730;-355
2016-09-14 05:00:00;23,31;26,65;-3,34;39680;0;0;0;0;47659;8645;0.1814;9481;-836
2016-09-14 06:00:00;33,22;34,16;-0,94;39680;18;0.0005;37;-19;47659;8404;0.1763;9270;-866
2016-09-14 07:00:00;38,98;40,24;-1,26;39680;1262;0.0318;1480;-218;47659;8254;0.1732;8897;-643
2016-09-14 08:00:00;39,9;38,4;1,5;39680;5676;0.143;6220;-544;47659;6938;0.1456;8075;-1137
2016-09-14 09:00:00;34,95;34,89;0,06;39680;11406;0.2874;12205;-799;47659;4590;0.0963;6768;-2178
2016-09-14 10:00:00;31,8;33,79;-1,99;39680;16658;0.4198;17548;-890;47659;3610;0.0758;5862;-2252
2016-09-14 11:00:00;31,9;31,66;0,24;39680;20380;0.5136;21233;-853;47659;3903;0.0819;5784;-1881
2016-09-14 12:00:00;27,03;28,26;-1,23;39680;22110;0.5572;23180;-1070;47659;5330;0.1118;6572;-1242
2016-09-14 13:00:00;25,23;26,03;-0,8;39680;22200;0.5595;23392;-1192;47659;7236;0.1518;7573;-337
2016-09-14 14:00:00;26,22;25,57;0,65;39680;20739;0.5226;21907;-1168;47659;7892;0.1656;8196;-304
2016-09-14 15:00:00;26,95;25,78;1,17;39680;17640;0.4445;18736;-1096;47659;7721;0.162;8457;-736
2016-09-14 16:00:00;28,55;28,45;0,1;39680;13105;0.3303;13917;-812;47659;7428;0.1559;8730;-1302
2016-09-14 17:00:00;35,69;34,49;1,2;39680;7571;0.1908;7925;-354;47659;7566;0.1588;9431;-1865
2016-09-14 18:00:00;37,66;37,67;-0,01;39680;2482;0.0626;2630;-148;47659;8252;0.1732;10813;-2561
2016-09-14 19:00:00;37,44;37,11;0,33;39680;179;0.0045;227;-48;47659;10533;0.221;12448;-1915
2016-09-14 20:00:00;34,1;29,1;5,0;39680;0;0;0;0;47659;13806;0.2896;13744;62
2016-09-14 21:00:00;26,84;23,02;3,82;39680;0;0;0;0;47659;15708;0.3296;14685;1023
2016-09-14 22:00:00;24,27;22,04;2,23;39680;0;0;0;0;47659;15974;0.3352;15120;854
2016-09-14 23:00:00;22,96;23,16;-0,2;39680;0;0;0;0;47659;15610;0.3275;15018;592
2016-09-15 00:00:00;22,93;22,64;0,29;39683;0;0;0;0;47705;14932;0.313;14403;529
2016-09-15 01:00:00;21,88;22,02;-0,14;39683;0;0;0;0;47705;14132;0.2962;13652;480
2016-09-15 02:00:00;21,42;20,85;0,57;39683;0;0;0;0;47705;13398;0.2808;12990;408
2016-09-15 03:00:00;21,13;21,9;-0,77;39683;0;0;0;0;47705;12915;0.2707;12441;474
2016-09-15 04:00:00;21,35;24,04;-2,69;39683;0;0;0;0;47705;12914;0.2707;12080;834
2016-09-15 05:00:00;23,05;23,26;-0,21;39683;0;0;0;0;47705;12518;0.2624;11896;622
2016-09-15 06:00:00;27,01;25,55;1,46;39683;14;0.0004;35;-21;47705;12394;0.2598;11776;618
2016-09-15 07:00:00;37,08;34,93;2,15;39683;1246;0.0314;1428;-182;47705;11790;0.2472;11518;272
2016-09-15 08:00:00;37,01;36,77;0,24;39683;5712;0.1439;6134;-422;47705;9790;0.2052;10832;-1042
2016-09-15 09:00:00;33,71;33,66;0,05;39683;11664;0.294;12123;-459;47705;7181;0.1506;9912;-2731
2016-09-15 10:00:00;27,96;28,21;-0,25;39683;16943;0.427;17318;-375;47705;6961;0.1459;9671;-2710
2016-09-15 11:00:00;26,83;28,58;-1,75;39683;20236;0.5099;20885;-649;47705;9791;0.2052;10049;-258
2016-09-15 12:00:00;24,79;24,91;-0,12;39683;21634;0.5452;22494;-860;47705;11388;0.2387;10474;914
2016-09-15 13:00:00;24,71;24,29;0,42;39683;21070;0.531;22246;-1176;47705;10762;0.2256;10672;90
2016-09-15 14:00:00;23,99;25,77;-1,78;39683;19292;0.4862;20220;-928;47705;9992;0.2095;10614;-622
2016-09-15 15:00:00;26,63;28,9;-2,27;39683;15798;0.3981;16695;-897;47705;9687;0.2031;10448;-761
2016-09-15 16:00:00;26,99;28,15;-1,16;39683;11124;0.2803;12027;-903;47705;9934;0.2083;10369;-435
2016-09-15 17:00:00;32,15;30,25;1,9;39683;6159;0.1552;6630;-471;47705;10460;0.2193;10349;111
2016-09-15 18:00:00;37,22;40,19;-2,97;39683;2010;0.0506;2149;-139;47705;10342;0.2168;10501;-159
2016-09-15 19:00:00;38,86;36,86;2,0;39683;136;0.0034;175;-39;47705;11162;0.234;11245;-83
2016-09-15 20:00:00;37,41;34,53;2,88;39683;0;0;0;0;47705;13092;0.2744;12232;860
2016-09-15 21:00:00;29,0;26,17;2,83;39683;0;0;0;0;47705;13493;0.2828;12607;886
2016-09-15 22:00:00;25,06;24,5;0,56;39683;0;0;0;0;47705;12708;0.2664;12551;157
2016-09-15 23:00:00;23,02;22,11;0,91;39683;0;0;0;0;47705;11837;0.2481;12045;-208
2016-09-16 00:00:00;22,26;26,06;-3,8;39687;0;0;0;0;47727;10404;0.218;10814;-410
2016-09-16 01:00:00;21,24;24,92;-3,68;39687;0;0;0;0;47727;8936;0.1872;9864;-928
2016-09-16 02:00:00;21,22;25,24;-4,02;39687;0;0;0;0;47727;7876;0.165;8961;-1085
2016-09-16 03:00:00;21,29;22,31;-1,02;39687;0;0;0;0;47727;6822;0.143;8089;-1267
2016-09-16 04:00:00;20,35;23,56;-3,21;39687;0;0;0;0;47727;6052;0.1268;7242;-1190
2016-09-16 05:00:00;22,59;25,75;-3,16;39687;0;0;0;0;47727;5647;0.1183;6493;-846
2016-09-16 06:00:00;31,47;36,81;-5,34;39687;9;0.0002;20;-11;47727;5504;0.1153;5898;-394
2016-09-16 07:00:00;39,96;43,76;-3,8;39687;856;0.0216;876;-20;47727;5247;0.1099;5328;-81
2016-09-16 08:00:00;40,7;43,18;-2,48;39687;3642;0.0917;3714;-72;47727;4208;0.0882;4652;-444
2016-09-16 09:00:00;39,98;39,19;0,79;39687;7381;0.186;7260;121;47727;2876;0.0603;3930;-1054
2016-09-16 10:00:00;38,98;38,46;0,52;39687;11225;0.2828;10480;745;47727;2476;0.0519;3463;-987
2016-09-16 11:00:00;37,81;35,04;2,77;39687;14166;0.3569;12753;1413;47727;2415;0.0506;3215;-800
2016-09-16 12:00:00;36,0;31,65;4,35;39687;15460;0.3896;13947;1513;47727;2754;0.0577;3136;-382
2016-09-16 13:00:00;31,95;29,91;2,04;39687;14576;0.3673;13908;668;47727;2890;0.0605;3031;-141
2016-09-16 14:00:00;29,84;28,46;1,38;39687;11886;0.2995;12774;-888;47727;3069;0.0643;2867;202
2016-09-16 15:00:00;33,99;32,25;1,74;39687;9103;0.2294;10693;-1590;47727;2808;0.0588;2643;165
2016-09-16 16:00:00;35,61;39,56;-3,95;39687;6296;0.1587;7785;-1489;47727;2442;0.0512;2444;-2
2016-09-16 17:00:00;38,28;41,16;-2,88;39687;3448;0.0869;4473;-1025;47727;2285;0.0479;2433;-148
2016-09-16 18:00:00;40,1;42,65;-2,55;39687;1096;0.0276;1479;-383;47727;2019;0.0423;2692;-673
2016-09-16 19:00:00;41,75;41,3;0,45;39687;77;0.0019;115;-38;47727;2195;0.046;3153;-958
2016-09-16 20:00:00;40,99;40,66;0,33;39687;0;0;1;-1;47727;2460;0.0515;3641;-1181
2016-09-16 21:00:00;36,5;38,07;-1,57;39687;0;0;0;0;47727;2734;0.0573;3980;-1246
2016-09-16 22:00:00;30,74;33,07;-2,33;39687;0;0;0;0;47727;2977;0.0624;4230;-1253
2016-09-16 23:00:00;25,16;27,89;-2,73;39687;0;0;0;0;47727;3102;0.065;4399;-1297
2016-09-17 00:00:00;29,84;30,27;-0,43;39687;0;0;0;0;47730;3227;0.0676;3366;-139
2016-09-17 01:00:00;26,32;28,61;-2,29;39687;0;0;0;0;47730;3288;0.0689;3417;-129
2016-09-17 02:00:00;24,08;24,93;-0,85;39687;0;0;0;0;47730;3400;0.0713;3484;-84
2016-09-17 03:00:00;22,81;24,38;-1,57;39687;0;0;0;0;47730;3557;0.0745;3542;15
2016-09-17 04:00:00;22,25;23,22;-0,97;39687;0;0;0;0;47730;3654;0.0766;3650;4
2016-09-17 05:00:00;22,91;23,46;-0,55;39687;0;0;0;0;47730;3807;0.0797;3850;-43
2016-09-17 06:00:00;24,91;26,05;-1,14;39687;6;0.0002;10;-4;47730;4210;0.0882;4247;-37
2016-09-17 07:00:00;27,92;32,49;-4,57;39687;260;0.0066;382;-122;47730;4244;0.089;4746;-502
2016-09-17 08:00:00;31,41;38,57;-7,16;39687;1296;0.0327;1770;-474;47730;4564;0.0957;5290;-726
2016-09-17 09:00:00;36,93;40,54;-3,61;39687;2992;0.0754;3558;-566;47730;4856;0.1017;5819;-963
2016-09-17 10:00:00;36,91;41,6;-4,69;39687;4805;0.1211;5164;-359;47730;5325;0.1116;6345;-1020
2016-09-17 11:00:00;36,08;39,59;-3,51;39687;6425;0.1619;6393;32;47730;6014;0.126;6946;-932
2016-09-17 12:00:00;30,53;37,38;-6,85;39687;7834;0.1974;7081;753;47730;6612;0.1386;7680;-1068
2016-09-17 13:00:00;25,1;30,88;-5,78;39687;7743;0.1951;6960;783;47730;7533;0.1578;8444;-911
2016-09-17 14:00:00;24,79;29,54;-4,75;39687;6870;0.1731;6306;564;47730;8257;0.173;9097;-840
2016-09-17 15:00:00;24,14;28,36;-4,22;39687;5305;0.1336;5168;137;47730;8612;0.1804;9726;-1114
2016-09-17 16:00:00;24,93;28,69;-3,76;39687;3546;0.0893;3727;-181;47730;8918;0.1868;10215;-1297
2016-09-17 17:00:00;27,85;31,97;-4,12;39687;1838;0.0463;2135;-297;47730;9578;0.2007;10662;-1084
2016-09-17 18:00:00;27,03;33,05;-6,02;39687;510;0.0129;713;-203;47730;10056;0.2107;11206;-1150
2016-09-17 19:00:00;32,52;40,33;-7,81;39687;37;0.001;61;-24;47730;11198;0.2346;11875;-677
2016-09-17 20:00:00;31,98;37,08;-5,1;39687;0;0;1;-1;47730;12172;0.255;12127;45
2016-09-17 21:00:00;24,57;24,37;0,2;39687;0;0;0;0;47730;12266;0.257;12402;-136
2016-09-17 22:00:00;23,51;24,58;-1,07;39687;0;0;0;0;47730;11600;0.243;12497;-897
2016-09-17 23:00:00;23,19;25,11;-1,92;39687;0;0;0;0;47730;10994;0.2303;12301;-1307
2016-09-18 00:00:00;21,22;23,09;-1,87;39687;0;0;0;0;47730;10630;0.2227;12143;-1513
2016-09-18 01:00:00;22,39;22,45;-0,06;39687;0;0;0;0;47730;10205;0.2138;11652;-1447
2016-09-18 02:00:00;21,22;21,33;-0,11;39687;0;0;0;0;47730;10080;0.2112;11240;-1160
2016-09-18 03:00:00;20,0;20,22;-0,22;39687;0;0;0;0;47730;9962;0.2088;11002;-1040
2016-09-18 04:00:00;18,43;19,21;-0,78;39687;0;0;0;0;47730;10267;0.2151;10899;-632
2016-09-18 05:00:00;19,53;19,7;-0,17;39687;0;0;0;0;47730;10358;0.217;10799;-441
2016-09-18 06:00:00;20,43;20,51;-0,08;39687;5;0.0001;9;-4;47730;10447;0.2189;10597;-150
2016-09-18 07:00:00;20,73;20,78;-0,05;39687;431;0.0108;524;-93;47730;10174;0.2132;10288;-114
2016-09-18 08:00:00;22,77;19,96;2,81;39687;1951;0.0492;2398;-447;47730;9424;0.1975;9896;-472
2016-09-18 09:00:00;24,78;24,32;0,46;39687;4313;0.1087;4898;-585;47730;8966;0.1879;9602;-636
2016-09-18 10:00:00;24,56;24,47;0,09;39687;6630;0.167;7378;-748;47730;9176;0.1923;9395;-219
2016-09-18 11:00:00;24,98;24,77;0,21;39687;8638;0.2176;9301;-663;47730;9209;0.1929;8908;301
2016-09-18 12:00:00;24,0;24,73;-0,73;39687;9482;0.2389;10477;-995;47730;8728;0.1828;8350;378
2016-09-18 13:00:00;24,1;23,46;0,64;39687;9583;0.2414;10594;-1011;47730;8129;0.1703;7741;388
2016-09-18 14:00:00;23,15;24,47;-1,32;39687;8514;0.2145;9841;-1327;47730;7754;0.1624;7140;614
2016-09-18 15:00:00;22,93;24,05;-1,12;39687;6889;0.1736;8318;-1429;47730;7423;0.1555;6721;702
2016-09-18 16:00:00;23,2;24,05;-0,85;39687;4785;0.1206;6063;-1278;47730;7120;0.1492;6428;692
2016-09-18 17:00:00;27,16;26,15;1,01;39687;2541;0.064;3417;-876;47730;7033;0.1474;6182;851
2016-09-18 18:00:00;32,54;30,11;2,43;39687;832;0.021;1064;-232;47730;6475;0.1357;5983;492
2016-09-18 19:00:00;36,11;32,81;3,3;39687;56;0.0015;74;-18;47730;6081;0.1274;5915;166
2016-09-18 20:00:00;34,94;31,1;3,84;39687;0;0;1;-1;47730;6072;0.1272;5993;79
2016-09-18 21:00:00;31,1;29,29;1,81;39687;0;0;0;0;47730;5872;0.123;6085;-213
2016-09-18 22:00:00;27,94;25,78;2,16;39687;0;0;0;0;47730;5290;0.1108;5947;-657
2016-09-18 23:00:00;25,46;23,67;1,79;39687;0;0;0;0;47730;4531;0.0949;5500;-969
2016-09-19 00:00:00;24,56;24,73;-0,17;39696;0;0;0;0;47754;3991;0.0836;4820;-829
2016-09-19 01:00:00;24,15;24,4;-0,25;39696;0;0;0;0;47754;3617;0.0757;4352;-735
2016-09-19 02:00:00;23,78;23,69;0,09;39696;0;0;0;0;47754;3189;0.0668;3925;-736
2016-09-19 03:00:00;22,44;22,88;-0,44;39696;0;0;0;0;47754;2900;0.0607;3584;-684
2016-09-19 04:00:00;22,05;23,1;-1,05;39696;0;0;0;0;47754;2843;0.0595;3323;-480
2016-09-19 05:00:00;23,91;21,99;1,92;39696;0;0;0;0;47754;2915;0.0611;3138;-223
2016-09-19 06:00:00;36,06;31,56;4,5;39696;7;0.0002;9;-2;47754;2888;0.0605;3019;-131
2016-09-19 07:00:00;42,31;42,22;0,09;39696;314;0.0079;492;-178;47754;2916;0.061;2848;68
2016-09-19 08:00:00;44,6;49,01;-4,41;39696;1573;0.0397;2358;-785;47754;2642;0.0553;2552;90
2016-09-19 09:00:00;43,91;47,68;-3,77;39696;3693;0.093;4838;-1145;47754;2068;0.0433;2194;-126
2016-09-19 10:00:00;43,95;46,15;-2,2;39696;6258;0.1577;7241;-983;47754;1964;0.0411;1934;30
2016-09-19 11:00:00;43,97;43,92;0,05;39696;8380;0.2111;9139;-759;47754;2082;0.0436;1835;247
2016-09-19 12:00:00;41,27;41,24;0,03;39696;9390;0.2366;10248;-858;47754;2240;0.0469;1789;451
2016-09-19 13:00:00;39,31;39,96;-0,65;39696;8969;0.226;10188;-1219;47754;2050;0.0429;1707;343
2016-09-19 14:00:00;37,68;40,26;-2,58;39696;8262;0.2081;9250;-988;47754;1880;0.0394;1618;262
2016-09-19 15:00:00;37,93;39,0;-1,07;39696;6431;0.162;7621;-1190;47754;1843;0.0386;1593;250
2016-09-19 16:00:00;37,78;38,01;-0,23;39696;4456;0.1122;5453;-997;47754;1772;0.0371;1631;141
2016-09-19 17:00:00;39,22;39,56;-0,34;39696;2458;0.0619;3011;-553;47754;1936;0.0406;1741;195
2016-09-19 18:00:00;39,9;38,91;0,99;39696;750;0.0189;908;-158;47754;1926;0.0403;1968;-42
2016-09-19 19:00:00;41,99;39,87;2,12;39696;45;0.0012;56;-11;47754;2168;0.0454;2284;-116
2016-09-19 20:00:00;40,1;37,76;2,34;39696;0;0;0;0;47754;2566;0.0537;2596;-30
2016-09-19 21:00:00;30,0;29,04;0,96;39696;0;0;0;0;47754;2691;0.0564;2720;-29
2016-09-19 22:00:00;28,01;25,67;2,34;39696;0;0;0;0;47754;2494;0.0522;2730;-236
2016-09-19 23:00:00;26,02;23,94;2,08;39696;0;0;0;0;47754;2085;0.0436;2588;-503
2016-09-20 00:00:00;24,79;24,04;0,75;39698;0;0;0;0;47786;1859;0.0389;1816;43
2016-09-20 01:00:00;24,83;23,16;1,67;39698;0;0;0;0;47786;1631;0.0342;1529;102
2016-09-20 02:00:00;23,51;22,32;1,19;39698;0;0;0;0;47786;1417;0.0297;1309;108
2016-09-20 03:00:00;23,06;20,79;2,27;39698;0;0;0;0;47786;1186;0.0248;1180;6
2016-09-20 04:00:00;23,44;21,25;2,19;39698;0;0;0;0;47786;1000;0.0209;1102;-102
2016-09-20 05:00:00;25,24;23,54;1,7;39698;0;0;0;0;47786;790;0.0166;1052;-262
2016-09-20 06:00:00;32,73;29,66;3,07;39698;6;0.0002;8;-2;47786;685;0.0144;974;-289
2016-09-20 07:00:00;42,96;41,17;1,79;39698;421;0.0106;526;-105;47786;666;0.014;878;-212
2016-09-20 08:00:00;43,88;41,71;2,17;39698;1766;0.0445;2643;-877;47786;587;0.0122;743;-156
2016-09-20 09:00:00;42,77;42,85;-0,08;39698;4292;0.1081;5509;-1217;47786;493;0.0103;561;-68
2016-09-20 10:00:00;42,18;42,19;-0,01;39698;7456;0.1878;8464;-1008;47786;457;0.0096;420;37
2016-09-20 11:00:00;41,17;40,1;1,07;39698;10514;0.2648;11074;-560;47786;540;0.0113;395;145
2016-09-20 12:00:00;38,21;35,24;2,97;39698;12060;0.3038;12769;-709;47786;647;0.0135;441;206
2016-09-20 13:00:00;35,6;31,18;4,42;39698;11913;0.3001;13008;-1095;47786;796;0.0167;503;293
2016-09-20 14:00:00;34,22;29,79;4,43;39698;10964;0.2762;12134;-1170;47786;814;0.017;554;260
2016-09-20 15:00:00;34,55;30,33;4,22;39698;8886;0.2238;10258;-1372;47786;840;0.0176;612;228
2016-09-20 16:00:00;36,08;31,76;4,32;39698;6469;0.163;7375;-906;47786;882;0.0184;680;202
2016-09-20 17:00:00;39,13;35,04;4,09;39698;3515;0.0886;4010;-495;47786;858;0.018;784;74
2016-09-20 18:00:00;42,07;37,15;4,92;39698;965;0.0243;1112;-147;47786;812;0.017;967;-155
2016-09-20 19:00:00;46,8;42,08;4,72;39698;41;0.001;63;-22;47786;942;0.0197;1241;-299
2016-09-20 20:00:00;41,95;37,23;4,72;39698;0;0;0;0;47786;1229;0.0257;1566;-337
2016-09-20 21:00:00;35,06;33,01;2,05;39698;0;0;0;0;47786;1530;0.032;1823;-293
2016-09-20 22:00:00;28,54;28,5;0,04;39698;0;0;0;0;47786;1695;0.0355;1985;-290
2016-09-20 23:00:00;26,03;26,31;-0,28;39698;0;0;0;0;47786;1780;0.0373;1996;-216
2016-09-21 00:00:00;25,43;26,34;-0,91;39702;0;0;0;0;47847;1729;0.0362;1887;-158
2016-09-21 01:00:00;24,94;25,54;-0,6;39702;0;0;0;0;47847;1737;0.0363;1755;-18
2016-09-21 02:00:00;24,11;25,37;-1,26;39702;0;0;0;0;47847;1655;0.0346;1621;34
2016-09-21 03:00:00;24,13;24,92;-0,79;39702;0;0;0;0;47847;1622;0.0339;1530;92
2016-09-21 04:00:00;24,09;25,33;-1,24;39702;0;0;0;0;47847;1618;0.0338;1483;135
2016-09-21 05:00:00;25,71;26,74;-1,03;39702;0;0;0;0;47847;1575;0.0329;1475;100
2016-09-21 06:00:00;36,97;36,22;0,75;39702;6;0.0002;9;-3;47847;1470;0.0307;1452;18
2016-09-21 07:00:00;48,19;45,44;2,75;39702;587;0.0148;636;-49;47847;1428;0.0298;1376;52
2016-09-21 08:00:00;49,71;48,13;1,58;39702;3627;0.0913;3553;74;47847;1282;0.0268;1200;82
2016-09-21 09:00:00;44,5;40,85;3,65;39702;8508;0.2143;7944;564;47847;852;0.0178;920;-68
2016-09-21 10:00:00;39,98;34,52;5,46;39702;13545;0.3412;12468;1077;47847;706;0.0148;712;-6
2016-09-21 11:00:00;36,03;28,0;8,03;39702;17281;0.4353;16081;1200;47847;890;0.0186;655;235
2016-09-21 12:00:00;32,15;26,54;5,61;39702;18725;0.4716;18133;592;47847;1006;0.021;675;331
2016-09-21 13:00:00;31,92;27,23;4,69;39702;18522;0.4666;18088;434;47847;968;0.0202;692;276
2016-09-21 14:00:00;30,7;26,05;4,65;39702;17123;0.4313;16456;667;47847;962;0.0201;715;247
2016-09-21 15:00:00;32,81;25,69;7,12;39702;14362;0.3618;13619;743;47847;1006;0.021;764;242
2016-09-21 16:00:00;35,36;28,04;7,32;39702;10644;0.2681;9760;884;47847;1144;0.0239;867;277
2016-09-21 17:00:00;42,7;37,69;5,01;39702;5815;0.1465;5286;529;47847;1009;0.0211;1032;-23
2016-09-21 18:00:00;45,0;43,94;1,06;39702;1603;0.0404;1451;152;47847;994;0.0208;1260;-266
2016-09-21 19:00:00;48,75;46,96;1,79;39702;52;0.0013;74;-22;47847;1516;0.0317;1604;-88
2016-09-21 20:00:00;43,87;43,77;0,1;39702;0;0;0;0;47847;2230;0.0466;2020;210
2016-09-21 21:00:00;37,96;36,32;1,64;39702;0;0;0;0;47847;2842;0.0594;2361;481
2016-09-21 22:00:00;28,49;26,77;1,72;39702;0;0;0;0;47847;2866;0.0599;2639;227
2016-09-21 23:00:00;27,09;25,86;1,23;39702;0;0;0;0;47847;2889;0.0604;2760;129
2016-09-22 00:00:00;25,86;25,61;0,25;39706;0;0;0;0;47882;2921;0.061;2329;592
2016-09-22 01:00:00;25,09;25,05;0,04;39706;0;0;0;0;47882;2868;0.0599;2229;639
2016-09-22 02:00:00;24,73;24,02;0,71;39706;0;0;0;0;47882;2686;0.0561;2058;628
2016-09-22 03:00:00;24,26;23,58;0,68;39706;0;0;0;0;47882;2448;0.0512;1877;571
2016-09-22 04:00:00;24,24;25,16;-0,92;39706;0;0;0;0;47882;2248;0.047;1737;511
2016-09-22 05:00:00;26,84;28,57;-1,73;39706;0;0;0;0;47882;2060;0.043;1626;434
2016-09-22 06:00:00;38,19;36,47;1,72;39706;3;0.0001;9;-6;47882;1815;0.0379;1537;278
2016-09-22 07:00:00;43,34;41,94;1,4;39706;756;0.019;760;-4;47882;1698;0.0354;1436;262
2016-09-22 08:00:00;42,2;47,0;-4,8;39706;4839;0.1219;4525;314;47882;1643;0.0343;1272;371
2016-09-22 09:00:00;35,77;33,1;2,67;39706;10814;0.2724;10214;600;47882;1040;0.0217;953;87
2016-09-22 10:00:00;28,79;27,09;1,7;39706;16468;0.4148;15594;874;47882;474;0.0099;613;-139
2016-09-22 11:00:00;27,75;27,01;0,74;39706;20134;0.5071;19413;721;47882;526;0.011;408;118
2016-09-22 12:00:00;27,11;27,45;-0,34;39706;21604;0.5442;21139;465;47882;671;0.014;380;291
2016-09-22 13:00:00;27,06;27,16;-0,1;39706;20986;0.5285;20837;149;47882;778;0.0162;369;409
2016-09-22 14:00:00;27,29;27,66;-0,37;39706;18605;0.4686;18741;-136;47882;717;0.015;345;372
2016-09-22 15:00:00;28,61;28,1;0,51;39706;15189;0.3825;15225;-36;47882;616;0.0129;316;300
2016-09-22 16:00:00;31,87;35,97;-4,1;39706;10761;0.271;10651;110;47882;538;0.0113;293;245
2016-09-22 17:00:00;39,93;45,08;-5,15;39706;5496;0.1384;5533;-37;47882;566;0.0118;291;275
2016-09-22 18:00:00;43,06;46,05;-2,99;39706;1297;0.0326;1408;-111;47882;620;0.013;352;268
2016-09-22 19:00:00;49,06;51,82;-2,76;39706;32;0.0008;65;-33;47882;802;0.0168;508;294
2016-09-22 20:00:00;45,82;48,01;-2,19;39706;0;0;0;0;47882;928;0.0194;743;185
2016-09-22 21:00:00;38,95;40,31;-1,36;39706;0;0;0;0;47882;1124;0.0235;1021;103
2016-09-22 22:00:00;29,97;30,11;-0,14;39706;0;0;0;0;47882;1410;0.0294;1319;91
2016-09-22 23:00:00;26,47;26,76;-0,29;39706;0;0;0;0;47882;1792;0.0374;1611;181
2016-09-23 00:00:00;25,84;30,08;-4,24;39711;0;0;0;0;47933;1984;0.0414;2227;-243
2016-09-23 01:00:00;25,03;27,86;-2,83;39711;0;0;0;0;47933;2138;0.0446;2384;-246
2016-09-23 02:00:00;24,68;26,83;-2,15;39711;0;0;0;0;47933;2037;0.0425;2427;-390
2016-09-23 03:00:00;24,78;25,97;-1,19;39711;0;0;0;0;47933;2073;0.0432;2441;-368
2016-09-23 04:00:00;25,14;25,5;-0,36;39711;0;0;0;0;47933;2142;0.0447;2470;-328
2016-09-23 05:00:00;26,47;28,85;-2,38;39711;0;0;0;0;47933;2195;0.0458;2543;-348
2016-09-23 06:00:00;36,06;37,43;-1,37;39711;2;0.0001;5;-3;47933;2234;0.0466;2682;-448
2016-09-23 07:00:00;43,04;44,49;-1,45;39711;546;0.0137;662;-116;47933;2188;0.0456;2779;-591
2016-09-23 08:00:00;43,01;45,97;-2,96;39711;3613;0.091;3837;-224;47933;2238;0.0467;2698;-460
2016-09-23 09:00:00;38,94;39,95;-1,01;39711;8556;0.2155;8116;440;47933;1791;0.0374;2338;-547
2016-09-23 10:00:00;33,83;34,67;-0,84;39711;13625;0.3431;12315;1310;47933;1322;0.0276;1929;-607
2016-09-23 11:00:00;28,77;28,55;0,22;39711;17308;0.4358;15505;1803;47933;1833;0.0382;1958;-125
2016-09-23 12:00:00;27,69;27,18;0,51;39711;18878;0.4754;17089;1789;47933;2948;0.0615;2494;454
2016-09-23 13:00:00;27,54;26,21;1,33;39711;18163;0.4574;16783;1380;47933;3865;0.0806;3101;764
2016-09-23 14:00:00;26,6;26,91;-0,31;39711;15648;0.394;15004;644;47933;4393;0.0917;3588;805
2016-09-23 15:00:00;27,66;29,22;-1,56;39711;12286;0.3094;12182;104;47933;5278;0.1101;4003;1275
2016-09-23 16:00:00;27,68;30,04;-2,36;39711;8735;0.22;8659;76;47933;5202;0.1085;4306;896
2016-09-23 17:00:00;31,06;32,23;-1,17;39711;4856;0.1223;4648;208;47933;4965;0.1036;4301;664
2016-09-23 18:00:00;35,91;37,03;-1,12;39711;1283;0.0323;1180;103;47933;3989;0.0832;3954;35
2016-09-23 19:00:00;41,83;42,8;-0,97;39711;34;0.0008;50;-16;47933;3260;0.068;3667;-407
2016-09-23 20:00:00;39,98;42,11;-2,13;39711;0;0;0;0;47933;3485;0.0727;3401;84
2016-09-23 21:00:00;30,36;32,47;-2,11;39711;0;0;0;0;47933;3381;0.0706;3375;6
2016-09-23 22:00:00;27,7;30,16;-2,46;39711;0;0;0;0;47933;3383;0.0706;3384;-1
2016-09-23 23:00:00;26,79;28,92;-2,13;39711;0;0;0;0;47933;3284;0.0685;3301;-17
2016-09-24 00:00:00;26,27;28,1;-1,83;39711;0;0;0;0;47956;3422;0.0714;4046;-624
2016-09-24 01:00:00;24,68;25,64;-0,96;39711;0;0;0;0;47956;3349;0.0698;3880;-531
2016-09-24 02:00:00;24,39;25,2;-0,81;39711;0;0;0;0;47956;3325;0.0693;3780;-455
2016-09-24 03:00:00;25,15;24,15;1,0;39711;0;0;0;0;47956;3406;0.071;3718;-312
2016-09-24 04:00:00;24,65;24,99;-0,34;39711;0;0;0;0;47956;3497;0.0729;3651;-154
2016-09-24 05:00:00;24,59;27,24;-2,65;39711;0;0;0;0;47956;3763;0.0785;3520;243
2016-09-24 06:00:00;27,31;28,88;-1,57;39711;2;0.0001;6;-4;47956;3650;0.0761;3327;323
2016-09-24 07:00:00;31,15;30,83;0,32;39711;603;0.0152;794;-191;47956;3466;0.0723;3114;352
2016-09-24 08:00:00;34,63;32,3;2,33;39711;4198;0.1057;4756;-558;47956;3330;0.0694;2862;468
2016-09-24 09:00:00;34,04;33,65;0,39;39711;9879;0.2488;10223;-344;47956;2751;0.0574;2547;204
2016-09-24 10:00:00;29,0;29,36;-0,36;39711;15449;0.389;15288;161;47956;2398;0.05;2205;193
2016-09-24 11:00:00;25,43;25,33;0,1;39711;19720;0.4966;18912;808;47956;2526;0.0527;2050;476
2016-09-24 12:00:00;24,32;23,36;0,96;39711;21423;0.5394;20852;571;47956;2707;0.0564;2245;462
2016-09-24 13:00:00;24,26;22,71;1,55;39711;21092;0.5312;20895;197;47956;3066;0.0639;2483;583
2016-09-24 14:00:00;24,4;23,56;0,84;39711;19298;0.4859;19208;90;47956;3071;0.064;2572;499
2016-09-24 15:00:00;24,93;23,8;1,13;39711;16234;0.4088;15960;274;47956;2935;0.0612;2353;582
2016-09-24 16:00:00;28,01;25,97;2,04;39711;11708;0.2948;11331;377;47956;2295;0.0478;2079;216
2016-09-24 17:00:00;34,58;32,88;1,7;39711;6096;0.1535;5919;177;47956;1564;0.0326;2071;-507
2016-09-24 18:00:00;38,08;37,66;0,42;39711;1513;0.0381;1425;88;47956;1406;0.0293;2640;-1234
2016-09-24 19:00:00;42,63;40,62;2,01;39711;33;0.0008;50;-17;47956;1972;0.0411;3669;-1697
2016-09-24 20:00:00;40,99;41,52;-0,53;39711;0;0;0;0;47956;3209;0.0669;4734;-1525
2016-09-24 21:00:00;34,53;37,33;-2,8;39711;0;0;0;0;47956;4754;0.0991;6228;-1474
2016-09-24 22:00:00;31,15;31,84;-0,69;39711;0;0;0;0;47956;6324;0.1318;7707;-1383
2016-09-24 23:00:00;25,46;27,57;-2,11;39711;0;0;0;0;47956;7797;0.1626;8591;-794
2016-09-25 00:00:00;24,46;23,21;1,25;39711;0;0;0;0;47979;9042;0.1884;8715;327
2016-09-25 01:00:00;22,06;20,6;1,46;39711;0;0;0;0;47979;9514;0.1983;9130;384
2016-09-25 02:00:00;20,55;11,03;9,52;39711;0;0;0;0;47979;9743;0.2031;9268;475
2016-09-25 03:00:00;17,84;7,12;10,72;39711;0;0;0;0;47979;9876;0.2058;9143;733
2016-09-25 04:00:00;17,7;8,36;9,34;39711;0;0;0;0;47979;9691;0.202;9034;657
2016-09-25 05:00:00;19,68;8,84;10,84;39711;0;0;0;0;47979;9457;0.1971;9006;451
2016-09-25 06:00:00;20,09;10,45;9,64;39711;2;0;6;-4;47979;9062;0.1888;9185;-123
2016-09-25 07:00:00;21,47;17,0;4,47;39711;608;0.0153;741;-133;47979;9228;0.1924;9291;-63
2016-09-25 08:00:00;22,45;20,26;2,19;39711;4500;0.1134;4823;-323;47979;8676;0.1808;8843;-167
2016-09-25 09:00:00;22,95;21,26;1,69;39711;10535;0.2653;10880;-345;47979;6828;0.1423;7585;-757
2016-09-25 10:00:00;21,09;19,83;1,26;39711;16230;0.4087;16631;-401;47979;5054;0.1054;6238;-1184
2016-09-25 11:00:00;21,09;19,4;1,69;39711;19995;0.5035;20562;-567;47979;4907;0.1023;5764;-857
2016-09-25 12:00:00;15,97;15,28;0,69;39711;22120;0.557;22524;-404;47979;5821;0.1213;6010;-189
2016-09-25 13:00:00;10,93;11,75;-0,82;39711;22302;0.5616;22567;-265;47979;6819;0.1421;6286;533
2016-09-25 14:00:00;11,49;10,53;0,96;39711;20633;0.5196;20804;-171;47979;7021;0.1463;6294;727
2016-09-25 15:00:00;12,89;9,11;3,78;39711;17189;0.4328;17312;-123;47979;6369;0.1328;5954;415
2016-09-25 16:00:00;19,76;16,48;3,28;39711;12066;0.3038;12145;-79;47979;5772;0.1203;5556;216
2016-09-25 17:00:00;26,55;25,19;1,36;39711;6034;0.152;6124;-90;47979;4962;0.1034;5388;-426
2016-09-25 18:00:00;35,09;31,89;3,2;39711;1302;0.0328;1383;-81;47979;4908;0.1023;5866;-958
2016-09-25 19:00:00;40,95;40,14;0,81;39711;26;0.0006;44;-18;47979;6617;0.1379;6814;-197
2016-09-25 20:00:00;40,94;40,22;0,72;39711;0;0;1;-1;47979;7895;0.1646;7482;413
2016-09-25 21:00:00;33,53;32,41;1,12;39711;0;0;0;0;47979;8496;0.1771;7761;735
2016-09-25 22:00:00;29,57;30,0;-0,43;39711;0;0;0;0;47979;8216;0.1713;7704;512
2016-09-25 23:00:00;24,52;25,93;-1,41;39711;0;0;0;0;47979;7596;0.1583;7340;256
2016-09-26 00:00:00;24,27;26,36;-2,09;39716;0;0;0;0;48001;6880;0.1433;7285;-405
2016-09-26 01:00:00;24,2;25,86;-1,66;39716;0;0;0;0;48001;6386;0.133;6435;-49
2016-09-26 02:00:00;23,42;23,22;0,2;39716;0;0;0;0;48001;5373;0.1119;5808;-435
2016-09-26 03:00:00;23,28;22,52;0,76;39716;0;0;0;0;48001;4730;0.0985;5435;-705
2016-09-26 04:00:00;23,49;24,8;-1,31;39716;0;0;0;0;48001;4799;0.1;5214;-415
2016-09-26 05:00:00;25,46;25,71;-0,25;39716;0;0;0;0;48001;4502;0.0938;5072;-570
2016-09-26 06:00:00;39,24;37,83;1,41;39716;2;0;6;-4;48001;3884;0.0809;4767;-883
2016-09-26 07:00:00;46,53;45,49;1,04;39716;446;0.0112;581;-135;48001;3256;0.0678;4268;-1012
2016-09-26 08:00:00;49,0;52,99;-3,99;39716;3230;0.0813;3586;-356;48001;2556;0.0532;3492;-936
2016-09-26 09:00:00;46,84;49,74;-2,9;39716;7542;0.1899;7761;-219;48001;1522;0.0317;2505;-983
2016-09-26 10:00:00;39,97;41,75;-1,78;39716;11984;0.3018;11684;300;48001;836;0.0174;1663;-827
2016-09-26 11:00:00;37,39;38,87;-1,48;39716;15120;0.3807;14519;601;48001;504;0.0105;1212;-708
2016-09-26 12:00:00;34,94;33,59;1,35;39716;16600;0.418;15984;616;48001;466;0.0097;1080;-614
2016-09-26 13:00:00;33,95;33,31;0,64;39716;16324;0.411;15827;497;48001;574;0.012;1004;-430
2016-09-26 14:00:00;32,44;34,21;-1,77;39716;14895;0.375;14273;622;48001;612;0.0127;934;-322
2016-09-26 15:00:00;35,0;37,96;-2,96;39716;12154;0.306;11651;503;48001;538;0.0112;907;-369
2016-09-26 16:00:00;39,87;51,01;-11,14;39716;8286;0.2086;8085;201;48001;559;0.0116;939;-380
2016-09-26 17:00:00;44,65;51,31;-6,66;39716;4063;0.1023;4098;-35;48001;700;0.0146;1032;-332
2016-09-26 18:00:00;49,55;55,13;-5,58;39716;836;0.0211;904;-68;48001;938;0.0196;1231;-293
2016-09-26 19:00:00;54,12;60,45;-6,33;39716;17;0.0004;25;-8;48001;1601;0.0334;1537;64
2016-09-26 20:00:00;51,23;55,46;-4,23;39716;0;0;0;0;48001;2114;0.044;1816;298
2016-09-26 21:00:00;37,93;42,76;-4,83;39716;0;0;0;0;48001;2299;0.0479;1952;347
2016-09-26 22:00:00;30,52;33,63;-3,11;39716;0;0;0;0;48001;2268;0.0472;1989;279
2016-09-26 23:00:00;28,4;28,96;-0,56;39716;0;0;0;0;48001;1879;0.0392;1942;-63
2016-09-27 00:00:00;31,33;33,58;-2,25;39721;0;0;0;0;48037;2719;0.0566;1848;871
2016-09-27 01:00:00;30,74;31,39;-0,65;39721;0;0;0;0;48037;2746;0.0571;1617;1129
2016-09-27 02:00:00;29,75;30,16;-0,41;39721;0;0;0;0;48037;2605;0.0542;1449;1156
2016-09-27 03:00:00;28,73;29,41;-0,68;39721;0;0;0;0;48037;2431;0.0506;1386;1045
2016-09-27 04:00:00;27,84;30,23;-2,39;39721;0;0;0;0;48037;2547;0.053;1343;1204
2016-09-27 05:00:00;29,56;33,84;-4,28;39721;0;0;0;0;48037;2734;0.0569;1311;1423
2016-09-27 06:00:00;41,53;38,89;2,64;39721;1;0;5;-4;48037;2652;0.0552;1334;1318
2016-09-27 07:00:00;49,0;51,37;-2,37;39721;398;0.01;455;-57;48037;2787;0.058;1364;1423
2016-09-27 08:00:00;50,0;56,88;-6,88;39721;3028;0.0762;3117;-89;48037;3107;0.0647;1310;1797
2016-09-27 09:00:00;44,98;50,84;-5,86;39721;7069;0.178;7142;-73;48037;2900;0.0604;1232;1668
2016-09-27 10:00:00;40,22;42,14;-1,92;39721;11188;0.2817;11353;-165;48037;2860;0.0595;1182;1678
2016-09-27 11:00:00;33,93;36,71;-2,78;39721;15058;0.3791;14835;223;48037;3256;0.0678;1270;1986
2016-09-27 12:00:00;29,17;31,45;-2,28;39721;18287;0.4604;17052;1235;48037;4006;0.0834;1558;2448
2016-09-27 13:00:00;28,28;28,3;-0,02;39721;18950;0.4771;17482;1468;48037;4616;0.0961;2000;2616
2016-09-27 14:00:00;27,91;26,58;1,33;39721;17789;0.4478;16329;1460;48037;5360;0.1116;2533;2827
2016-09-27 15:00:00;28,29;27,03;1,26;39721;14878;0.3746;13739;1139;48037;6322;0.1316;3049;3273
2016-09-27 16:00:00;29,33;25,39;3,94;39721;10427;0.2625;9654;773;48037;6678;0.139;3470;3208
2016-09-27 17:00:00;38,91;31,69;7,22;39721;5181;0.1304;4878;303;48037;6186;0.1288;3816;2370
2016-09-27 18:00:00;45,2;39,99;5,21;39721;1074;0.027;1031;43;48037;5847;0.1217;4330;1517
2016-09-27 19:00:00;48,97;46,14;2,83;39721;19;0.0005;25;-6;48037;6866;0.143;5150;1716
2016-09-27 20:00:00;41,91;37,52;4,39;39721;0;0;0;0;48037;8084;0.1683;6077;2007
2016-09-27 21:00:00;29,94;28,56;1,38;39721;0;0;0;0;48037;9456;0.1968;7621;1835
2016-09-27 22:00:00;27,82;27,16;0,66;39721;0;0;0;0;48037;10895;0.2268;9343;1552
2016-09-27 23:00:00;24,36;24,32;0,04;39721;0;0;0;0;48037;12132;0.2526;10862;1270
2016-09-28 00:00:00;24,01;23,56;0,45;39730;0;0;0;0;48093;12094;0.2514;10995;1099
2016-09-28 01:00:00;21,03;21,69;-0,66;39730;0;0;0;0;48093;13050;0.2714;12258;792
2016-09-28 02:00:00;16,19;17,55;-1,36;39730;0;0;0;0;48093;13778;0.2865;13315;463
2016-09-28 03:00:00;14,66;18,8;-4,14;39730;0;0;0;0;48093;14505;0.3016;14115;390
2016-09-28 04:00:00;14,91;17,32;-2,41;39730;0;0;0;0;48093;15394;0.3201;14936;458
2016-09-28 05:00:00;19,89;25,7;-5,81;39730;0;0;0;0;48093;16420;0.3414;15785;635
2016-09-28 06:00:00;28,52;31,32;-2,8;39730;2;0;4;-2;48093;17348;0.3607;16819;529
2016-09-28 07:00:00;37,94;44,41;-6,47;39730;358;0.009;466;-108;48093;18530;0.3853;17853;677
2016-09-28 08:00:00;38,1;44,22;-6,12;39730;2736;0.0689;3184;-448;48093;19374;0.4029;18490;884
2016-09-28 09:00:00;32,22;33,89;-1,67;39730;6468;0.1628;7165;-697;48093;19126;0.3977;18724;402
2016-09-28 10:00:00;26,0;27,8;-1,8;39730;10429;0.2625;11009;-580;48093;19762;0.411;19262;500
2016-09-28 11:00:00;23,06;25,84;-2,78;39730;14042;0.3534;13898;144;48093;22076;0.459;20443;1633
2016-09-28 12:00:00;19,79;16,4;3,39;39730;15757;0.3966;15544;213;48093;23832;0.4956;21598;2234
2016-09-28 13:00:00;12,94;11,58;1,36;39730;15624;0.3932;15667;-43;48093;24708;0.5138;22425;2283
2016-09-28 14:00:00;12,95;10,53;2,42;39730;13704;0.3449;14431;-727;48093;24758;0.5148;23033;1725
2016-09-28 15:00:00;16,84;14,46;2,38;39730;11000;0.2769;11951;-951;48093;24458;0.5086;23188;1270
2016-09-28 16:00:00;22,67;23,19;-0,52;39730;7352;0.185;8310;-958;48093;23184;0.482;22161;1023
2016-09-28 17:00:00;26,45;31,05;-4,6;39730;3609;0.0908;4211;-602;48093;20942;0.4354;20659;283
2016-09-28 18:00:00;33,53;41,25;-7,72;39730;709;0.0179;913;-204;48093;18730;0.3894;19075;-345
2016-09-28 19:00:00;39,59;51,33;-11,74;39730;15;0.0004;25;-10;48093;18117;0.3767;18117;0
2016-09-28 20:00:00;34,36;42,0;-7,64;39730;0;0;0;0;48093;18445;0.3835;17721;724
2016-09-28 21:00:00;28,14;30,47;-2,33;39730;0;0;0;0;48093;18393;0.3824;17823;570
2016-09-28 22:00:00;24,41;24,02;0,39;39730;0;0;0;0;48093;18202;0.3785;17943;259
2016-09-28 23:00:00;22,02;18,87;3,15;39730;0;0;0;0;48093;18096;0.3763;18094;2
2016-09-29 00:00:00;19,93;16,42;3,51;39736;0;0;0;0;48158;17478;0.363;16683;795
2016-09-29 01:00:00;16,1;17,53;-1,43;39736;0;0;0;0;48158;17447;0.3622;16559;888
2016-09-29 02:00:00;18,63;23,72;-5,09;39736;0;0;0;0;48158;17374;0.3608;16596;778
2016-09-29 03:00:00;14,57;22,58;-8,01;39736;0;0;0;0;48158;17558;0.3646;16819;739
2016-09-29 04:00:00;14,15;20,23;-6,08;39736;0;0;0;0;48158;18015;0.3741;17320;695
2016-09-29 05:00:00;21,08;29,02;-7,94;39736;0;0;0;0;48158;18699;0.3883;18119;580
2016-09-29 06:00:00;28,93;31,83;-2,9;39736;1;0;3;-2;48158;19800;0.4112;19023;777
2016-09-29 07:00:00;37,97;42,29;-4,32;39736;373;0.0094;466;-93;48158;20177;0.419;19816;361
2016-09-29 08:00:00;37,84;41,65;-3,81;39736;3299;0.083;3434;-135;48158;19934;0.414;20452;-518
2016-09-29 09:00:00;28,42;34,84;-6,42;39736;8396;0.2113;7904;492;48158;19908;0.4134;20852;-944
2016-09-29 10:00:00;23,59;23,62;-0,03;39736;13439;0.3382;12293;1146;48158;20919;0.4344;21399;-480
2016-09-29 11:00:00;21,71;14,48;7,23;39736;17133;0.4312;15578;1555;48158;22508;0.4674;22301;207
2016-09-29 12:00:00;15,84;11,21;4,63;39736;19230;0.4839;17411;1819;48158;24071;0.4998;23365;706
2016-09-29 13:00:00;12,65;3,64;9,01;39736;19092;0.4805;17520;1572;48158;24768;0.5143;24314;454
2016-09-29 14:00:00;11,43;-2,9;14,33;39736;17062;0.4294;16038;1024;48158;25760;0.5349;24947;813
2016-09-29 15:00:00;12,66;0,8;11,86;39736;13960;0.3513;13169;791;48158;26685;0.5541;25414;1271
2016-09-29 16:00:00;14,78;3,88;10,9;39736;9715;0.2445;8999;716;48158;26535;0.551;25247;1288
2016-09-29 17:00:00;24,61;19,69;4,92;39736;4660;0.1172;4334;326;48158;25525;0.53;24623;902
2016-09-29 18:00:00;29,1;31,72;-2,62;39736;822;0.0207;842;-20;48158;24122;0.5009;23659;463
2016-09-29 19:00:00;37,91;38,88;-0,97;39736;7;0.0002;17;-10;48158;23248;0.4828;22652;596
2016-09-29 20:00:00;32,05;30,94;1,11;39736;0;0;0;0;48158;22538;0.468;21953;585
2016-09-29 21:00:00;25,03;24,64;0,39;39736;0;0;0;0;48158;21989;0.4566;21549;440
2016-09-29 22:00:00;22,69;19,95;2,74;39736;0;0;0;0;48158;20620;0.4282;20930;-310
2016-09-29 23:00:00;16,85;13,68;3,17;39736;0;0;0;0;48158;19270;0.4002;20088;-818
2016-09-30 00:00:00;23,79;27,24;-3,45;39749;0;0;0;0;48231;17942;0.372;17376;566
2016-09-30 01:00:00;23,32;25,58;-2,26;39749;0;0;0;0;48231;16552;0.3432;16238;314
2016-09-30 02:00:00;23,81;28,31;-4,5;39749;0;0;0;0;48231;15035;0.3117;15203;-168
2016-09-30 03:00:00;23,09;26,93;-3,84;39749;0;0;0;0;48231;13101;0.2716;14358;-1257
2016-09-30 04:00:00;24,02;25,69;-1,67;39749;0;0;0;0;48231;11763;0.2439;13686;-1923
2016-09-30 05:00:00;25,73;28,01;-2,28;39749;0;0;0;0;48231;10536;0.2184;13056;-2520
2016-09-30 06:00:00;39,68;48,79;-9,11;39749;1;0;4;-3;48231;10196;0.2114;12406;-2210
2016-09-30 07:00:00;49,66;71,66;-22,0;39749;294;0.0074;386;-92;48231;9956;0.2064;11782;-1826
2016-09-30 08:00:00;49,97;66,95;-16,98;39749;2462;0.062;2749;-287;48231;9466;0.1963;11197;-1731
2016-09-30 09:00:00;43,91;57,0;-13,09;39749;5955;0.1498;6304;-349;48231;8894;0.1844;10546;-1652
2016-09-30 10:00:00;39,96;53,59;-13,63;39749;9240;0.2325;9676;-436;48231;8512;0.1765;10099;-1587
2016-09-30 11:00:00;39,6;52,02;-12,42;39749;11988;0.3016;12093;-105;48231;9262;0.192;10155;-893
2016-09-30 12:00:00;37,9;48,36;-10,46;39749;13325;0.3353;13316;9;48231;11169;0.2316;10593;576
2016-09-30 13:00:00;29,65;34,2;-4,55;39749;13119;0.33;13175;-56;48231;12082;0.2505;11005;1077
2016-09-30 14:00:00;29,37;34,46;-5,09;39749;11571;0.2911;11891;-320;48231;11926;0.2473;11092;834
2016-09-30 15:00:00;31,96;38,72;-6,76;39749;9310;0.2342;9691;-381;48231;11300;0.2343;10918;382
2016-09-30 16:00:00;31,19;41,68;-10,49;39749;6582;0.1656;6615;-33;48231;10164;0.2107;10506;-342
2016-09-30 17:00:00;31,48;39,7;-8,22;39749;3248;0.0817;3170;78;48231;9301;0.1928;9481;-180
2016-09-30 18:00:00;37,99;41,0;-3,01;39749;632;0.0159;612;20;48231;7618;0.1579;8257;-639
2016-09-30 19:00:00;42,91;48,07;-5,16;39749;7;0.0002;9;-2;48231;7063;0.1464;7349;-286
2016-09-30 20:00:00;38,97;41,6;-2,63;39749;0;0;0;0;48231;7100;0.1472;6741;359
2016-09-30 21:00:00;31,9;36,44;-4,54;39749;0;0;0;0;48231;7148;0.1482;6515;633
2016-09-30 22:00:00;30,93;34,73;-3,8;39749;0;0;0;0;48231;6713;0.1392;6301;412
2016-09-30 23:00:00;28,43;32,72;-4,29;39749;0;0;0;0;48231;5734;0.1189;6077;-343
2016-01-10 00:00:00;29,18;31,12;-1,94;39749;0;0;0;0;48234;5184;0.1075;6768;-1584
2016-01-10 01:00:00;31,06;33,98;-2,92;39749;0;0;0;0;48234;4450;0.0922;6215;-1765
2016-01-10 02:00:00;26,0;28,53;-2,53;39749;0;0;0;0;48234;3590;0.0744;5609;-2019
2016-01-10 03:00:00;29,02;34,61;-5,59;39749;0;0;0;0;48234;2957;0.0613;5111;-2154
2016-01-10 04:00:00;25,94;27,9;-1,96;39749;0;0;0;0;48234;3129;0.0649;4731;-1602
2016-01-10 05:00:00;29,13;30,55;-1,42;39749;0;0;0;0;48234;3222;0.0668;4514;-1292
2016-01-10 06:00:00;32,55;35,79;-3,24;39749;1;0;2;-1;48234;3513;0.0728;4448;-935
2016-01-10 07:00:00;31,3;30,11;1,19;39749;196;0.0049;252;-56;48234;3906;0.081;4350;-444
2016-01-10 08:00:00;38,38;28,97;9,41;39749;1933;0.0486;1855;78;48234;4295;0.089;4182;113
2016-01-10 09:00:00;38,96;32,75;6,21;39749;4677;0.1177;4296;381;48234;4116;0.0854;3822;294
2016-01-10 10:00:00;39,94;33,33;6,61;39749;7117;0.179;6706;411;48234;3430;0.0711;3414;16
2016-01-10 11:00:00;39,21;34,41;4,8;39749;8846;0.2226;8577;269;48234;3336;0.0692;3373;-37
2016-01-10 12:00:00;34,07;35,42;-1,35;39749;10147;0.2553;9629;518;48234;3444;0.0714;3752;-308
2016-01-10 13:00:00;30,53;32,58;-2,05;39749;10170;0.2558;9571;599;48234;3654;0.0758;4208;-554
2016-01-10 14:00:00;29,63;30,73;-1,1;39749;9209;0.2317;8518;691;48234;3553;0.0737;4457;-904
2016-01-10 15:00:00;29,18;31,3;-2,12;39749;6770;0.1703;6778;-8;48234;3482;0.0722;4539;-1057
2016-01-10 16:00:00;29,44;35,82;-6,38;39749;4092;0.103;4493;-401;48234;3573;0.0741;4582;-1009
2016-01-10 17:00:00;34,63;39,12;-4,49;39749;1762;0.0443;2132;-370;48234;3871;0.0803;4736;-865
2016-01-10 18:00:00;39,93;47,19;-7,26;39749;334;0.0085;403;-69;48234;4452;0.0923;5109;-657
2016-01-10 19:00:00;45,03;53,62;-8,59;39749;4;0.0001;5;-1;48234;5518;0.1144;5607;-89
2016-01-10 20:00:00;40,06;44,5;-4,44;39749;0;0;0;0;48234;6658;0.138;5757;901
2016-01-10 21:00:00;30,74;29,81;0,93;39749;0;0;0;0;48234;7108;0.1474;6097;1011
2016-01-10 22:00:00;28,84;28,94;-0,1;39749;0;0;0;0;48234;7866;0.1631;6507;1359
2016-01-10 23:00:00;32,47;31,56;0,91;39749;0;0;0;0;48234;7722;0.1601;6851;871
2016-02-10 00:00:00;32,68;30,57;2,11;39749;0;0;0;0;48234;7366;0.1527;8375;-1009
2016-02-10 01:00:00;27,04;27,83;-0,79;39749;0;0;0;0;48234;7336;0.1521;8725;-1389
2016-02-10 02:00:00;26,28;26,98;-0,7;39749;0;0;0;0;48234;7532;0.1562;9005;-1473
2016-02-10 03:00:00;25,13;25,99;-0,86;39749;0;0;0;0;48234;7812;0.162;9149;-1337
2016-02-10 04:00:00;24,9;23,62;1,28;39749;0;0;0;0;48234;7813;0.162;9230;-1417
2016-02-10 05:00:00;25,03;24,26;0,77;39749;0;0;0;0;48234;7732;0.1603;9364;-1632
2016-02-10 06:00:00;25,43;24,87;0,56;39749;1;0;3;-2;48234;7840;0.1626;9593;-1753
2016-02-10 07:00:00;26,09;26,81;-0,72;39749;183;0.0046;281;-98;48234;8283;0.1718;9827;-1544
2016-02-10 08:00:00;29,7;29,81;-0,11;39749;2027;0.051;2336;-309;48234;8083;0.1676;10034;-1951
2016-02-10 09:00:00;30,99;31,14;-0,15;39749;5087;0.128;5579;-492;48234;7372;0.1529;10278;-2906
2016-02-10 10:00:00;29,88;32,34;-2,46;39749;7893;0.1986;8449;-556;48234;7442;0.1543;10705;-3263
2016-02-10 11:00:00;32,38;36,81;-4,43;39749;9650;0.2428;10376;-726;48234;8525;0.1768;11153;-2628
2016-02-10 12:00:00;29,11;34,47;-5,36;39749;9864;0.2482;11239;-1375;48234;9541;0.1978;11385;-1844
2016-02-10 13:00:00;26,64;31,59;-4,95;39749;9655;0.2429;11108;-1453;48234;9182;0.1904;11574;-2392
2016-02-10 14:00:00;25,01;29,13;-4,12;39749;9077;0.2284;10074;-997;48234;8946;0.1854;11664;-2718
2016-02-10 15:00:00;24,65;28,49;-3,84;39749;7535;0.1896;8218;-683;48234;8477;0.1758;11402;-2925
2016-02-10 16:00:00;25,06;28,51;-3,45;39749;5315;0.1337;5594;-279;48234;7794;0.1616;10908;-3114
2016-02-10 17:00:00;31,65;32,73;-1,08;39749;2743;0.069;2640;103;48234;6830;0.1416;10280;-3450
2016-02-10 18:00:00;41,22;42,32;-1,1;39749;490;0.0124;457;33;48234;6038;0.1252;9939;-3901
2016-02-10 19:00:00;49,35;49,52;-0,17;39749;6;0.0001;5;1;48234;6536;0.1355;10158;-3622
2016-02-10 20:00:00;42,4;44,69;-2,29;39749;0;0;0;0;48234;6825;0.1415;11337;-4512
2016-02-10 21:00:00;34,78;37,11;-2,33;39749;0;0;0;0;48234;6818;0.1414;12089;-5271
2016-02-10 22:00:00;29,94;32,83;-2,89;39749;0;0;0;0;48234;6817;0.1414;12408;-5591
2016-02-10 23:00:00;25,19;28,07;-2,88;39749;0;0;0;0;48234;7188;0.149;12593;-5405
2016-03-10 00:00:00;30,81;25,99;4,82;39749;0;0;0;0;48242;7059;0.1463;6485;574
2016-03-10 01:00:00;26,11;23,88;2,23;39749;0;0;0;0;48242;6949;0.144;6474;475
2016-03-10 02:00:00;25,09;24,75;0,34;39749;0;0;0;0;48242;6952;0.1441;6375;577
2016-03-10 03:00:00;24,54;24,62;-0,08;39749;0;0;0;0;48242;6818;0.1413;6251;567
2016-03-10 04:00:00;24,59;25,73;-1,14;39749;0;0;0;0;48242;6781;0.1406;6047;734
2016-03-10 05:00:00;25,78;25,82;-0,04;39749;0;0;0;0;48242;6486;0.1344;5795;691
2016-03-10 06:00:00;36,12;26,2;9,92;39749;0;0;1;-1;48242;6085;0.1261;5627;458
2016-03-10 07:00:00;40,96;26,41;14,55;39749;164;0.0041;219;-55;48242;6060;0.1256;5587;473
2016-03-10 08:00:00;38,19;29,8;8,39;39749;1633;0.0411;1921;-288;48242;6225;0.129;5534;691
2016-03-10 09:00:00;39,76;31,51;8,25;39749;4373;0.11;4782;-409;48242;6326;0.1311;5426;900
2016-03-10 10:00:00;32,6;31,3;1,3;39749;7122;0.1792;7541;-419;48242;6604;0.1369;5339;1265
2016-03-10 11:00:00;33,17;29,42;3,75;39749;9044;0.2275;9643;-599;48242;6995;0.145;5455;1540
2016-03-10 12:00:00;26,19;23,5;2,69;39749;9837;0.2475;10817;-980;48242;7320;0.1517;5873;1447
2016-03-10 13:00:00;25,33;23,06;2,27;39749;10118;0.2546;10764;-646;48242;7613;0.1578;6441;1172
2016-03-10 14:00:00;24,59;24,61;-0,02;39749;9389;0.2362;9747;-358;48242;8445;0.1751;6919;1526
2016-03-10 15:00:00;29,39;27,66;1,73;39749;7479;0.1882;7951;-472;48242;8572;0.1777;7374;1198
2016-03-10 16:00:00;31,04;30,7;0,34;39749;4900;0.1233;5434;-534;48242;8272;0.1714;7750;522
2016-03-10 17:00:00;33,37;34,65;-1,28;39749;2280;0.0574;2598;-318;48242;8179;0.1695;8011;168
2016-03-10 18:00:00;37,1;38,17;-1,07;39749;359;0.009;448;-89;48242;8314;0.1723;8169;145
2016-03-10 19:00:00;37,74;38,07;-0,33;39749;4;0.0001;6;-2;48242;9324;0.1933;8480;844
2016-03-10 20:00:00;32,63;31,89;0,74;39749;0;0;0;0;48242;9806;0.2033;9038;768
2016-03-10 21:00:00;28,42;28,88;-0,46;39749;0;0;0;0;48242;10202;0.2115;9326;876
2016-03-10 22:00:00;25,74;25,95;-0,21;39749;0;0;0;0;48242;10376;0.2151;9386;990
2016-03-10 23:00:00;24,6;24,76;-0,16;39749;0;0;0;0;48242;10516;0.218;9281;1235
2016-04-10 00:00:00;25,96;27,2;-1,24;39752;0;0;0;0;48242;10450;0.2166;9924;526
2016-04-10 01:00:00;25,28;26,03;-0,75;39752;0;0;0;0;48242;10819;0.2242;10306;513
2016-04-10 02:00:00;24,05;26,0;-1,95;39752;0;0;0;0;48242;11261;0.2334;10822;439
2016-04-10 03:00:00;22,03;22,23;-0,2;39752;0;0;0;0;48242;11964;0.248;11316;648
2016-04-10 04:00:00;23,25;19,54;3,71;39752;0;0;0;0;48242;12526;0.2596;11775;751
2016-04-10 05:00:00;25,54;21,58;3,96;39752;0;0;0;0;48242;13342;0.2766;12041;1301
2016-04-10 06:00:00;30,04;29,36;0,68;39752;0;0;0;0;48242;14166;0.2936;12170;1996
2016-04-10 07:00:00;37,1;38,4;-1,3;39752;142;0.0036;221;-79;48242;14618;0.303;12245;2373
2016-04-10 08:00:00;40,38;40,18;0,2;39752;1696;0.0426;2112;-416;48242;14740;0.3056;12193;2547
2016-04-10 09:00:00;36,78;35,02;1,76;39752;4541;0.1142;5282;-741;48242;14752;0.3058;12407;2345
2016-04-10 10:00:00;32,37;32,12;0,25;39752;7480;0.1882;8309;-829;48242;15603;0.3234;13127;2476
2016-04-10 11:00:00;28,71;32,18;-3,47;39752;9696;0.2439;10561;-865;48242;16046;0.3326;13444;2602
2016-04-10 12:00:00;31,29;33,87;-2,58;39752;11108;0.2794;11796;-688;48242;16072;0.3332;13159;2913
2016-04-10 13:00:00;32,08;36,35;-4,27;39752;11525;0.2899;12046;-521;48242;15804;0.3276;12787;3017
2016-04-10 14:00:00;31,99;38,25;-6,26;39752;11240;0.2828;11324;-84;48242;15794;0.3274;12759;3035
2016-04-10 15:00:00;31,87;35,25;-3,38;39752;9532;0.2398;9474;58;48242;15620;0.3238;13112;2508
2016-04-10 16:00:00;30,49;32,49;-2,0;39752;6692;0.1684;6446;246;48242;15650;0.3244;13507;2143
2016-04-10 17:00:00;35,7;34,54;1,16;39752;3170;0.0798;2980;190;48242;15200;0.315;13663;1537
2016-04-10 18:00:00;37,88;35,72;2,16;39752;442;0.0111;460;-18;48242;14724;0.3052;13857;867
2016-04-10 19:00:00;39,09;40,06;-0,97;39752;4;0.0001;4;0;48242;15941;0.3305;14532;1409
2016-04-10 20:00:00;30,21;29,14;1,07;39752;0;0;0;0;48242;17074;0.3539;15372;1702
2016-04-10 21:00:00;26,08;27,15;-1,07;39752;0;0;0;0;48242;17750;0.3679;15737;2013
2016-04-10 22:00:00;24,78;24,22;0,56;39752;0;0;0;0;48242;17496;0.3627;15613;1883
2016-04-10 23:00:00;24,93;22,73;2,2;39752;0;0;0;0;48242;16629;0.3447;15035;1594
2016-05-10 00:00:00;25,06;18,58;6,48;39754;0;0;0;0;48253;15584;0.323;14547;1037
2016-05-10 01:00:00;23,67;15,49;8,18;39754;0;0;0;0;48253;14892;0.3086;13668;1224
2016-05-10 02:00:00;22,45;13,59;8,86;39754;0;0;0;0;48253;14731;0.3053;12911;1820
2016-05-10 03:00:00;22,23;12,43;9,8;39754;0;0;0;0;48253;14781;0.3063;12399;2382
2016-05-10 04:00:00;22,71;9,64;13,07;39754;0;0;0;0;48253;14479;0.3;12170;2309
2016-05-10 05:00:00;24,3;14,97;9,33;39754;0;0;0;0;48253;14180;0.2939;12114;2066
2016-05-10 06:00:00;31,17;28,62;2,55;39754;0;0;1;-1;48253;14092;0.292;12203;1889
2016-05-10 07:00:00;42,45;35,36;7,09;39754;241;0.0061;344;-103;48253;14037;0.2909;12356;1681
2016-05-10 08:00:00;41,97;37,81;4,16;39754;3394;0.0854;3524;-130;48253;13333;0.2763;12700;633
2016-05-10 09:00:00;30,14;28,7;1,44;39754;8552;0.2151;8751;-199;48253;12406;0.2571;13288;-882
2016-05-10 10:00:00;27,58;28,96;-1,38;39754;13460;0.3386;12993;467;48253;13902;0.2881;14264;-362
2016-05-10 11:00:00;27,51;27,54;-0,03;39754;15966;0.4016;15366;600;48253;15442;0.32;15239;203
2016-05-10 12:00:00;26,33;26,34;-0,01;39754;16054;0.4038;16082;-28;48253;15771;0.3268;15690;81
2016-05-10 13:00:00;26,98;27,34;-0,36;39754;15025;0.378;15284;-259;48253;15110;0.3132;15791;-681
2016-05-10 14:00:00;28,17;29,24;-1,07;39754;13871;0.3489;13247;624;48253;14650;0.3036;15879;-1229
2016-05-10 15:00:00;28,18;30,27;-2,09;39754;11037;0.2776;10358;679;48253;15516;0.3216;15973;-457
2016-05-10 16:00:00;29,99;29,43;0,56;39754;7349;0.1849;6902;447;48253;16128;0.3342;15969;159
2016-05-10 17:00:00;35,0;33,39;1,61;39754;3325;0.0836;3138;187;48253;16609;0.3442;15831;778
2016-05-10 18:00:00;42,2;39,38;2,82;39754;483;0.0122;485;-2;48253;15848;0.3284;15712;136
2016-05-10 19:00:00;41,08;41,25;-0,17;39754;3;0.0001;2;1;48253;16366;0.3392;15910;456
2016-05-10 20:00:00;33,37;36,09;-2,72;39754;0;0;0;0;48253;17614;0.3651;15959;1655
2016-05-10 21:00:00;27,67;29,78;-2,11;39754;0;0;0;0;48253;18272;0.3787;16196;2076
2016-05-10 22:00:00;26,98;27,16;-0,18;39754;0;0;0;0;48253;18057;0.3742;16262;1795
2016-05-10 23:00:00;25,02;26,11;-1,09;39754;0;0;0;0;48253;17797;0.3688;16054;1743
2016-06-10 00:00:00;13,65;20,13;-6,48;39755;0;0;0;0;48253;17854;0.37;17531;323
2016-06-10 01:00:00;17,1;21,85;-4,75;39755;0;0;0;0;48253;18103;0.3752;17485;618
2016-06-10 02:00:00;16,05;20,09;-4,04;39755;0;0;0;0;48253;17910;0.3712;17490;420
2016-06-10 03:00:00;12,3;19,52;-7,22;39755;0;0;0;0;48253;17618;0.3651;17369;249
2016-06-10 04:00:00;19,55;23,51;-3,96;39755;0;0;0;0;48253;17401;0.3606;17119;282
2016-06-10 05:00:00;24,06;27,32;-3,26;39755;0;0;0;0;48253;17615;0.3651;16992;623
2016-06-10 06:00:00;27,63;30,01;-2,38;39755;0;0;0;0;48253;17605;0.3648;16839;766
2016-06-10 07:00:00;33,19;30,97;2,22;39755;39;0.001;59;-20;48253;16879;0.3498;16655;224
2016-06-10 08:00:00;32,57;38,42;-5,85;39755;655;0.0165;632;23;48253;16009;0.3318;16535;-526
2016-06-10 09:00:00;36,19;41,32;-5,13;39755;1984;0.0499;1796;188;48253;14890;0.3086;16434;-1544
2016-06-10 10:00:00;36,45;46,48;-10,03;39755;3372;0.0849;2924;448;48253;14611;0.3028;16349;-1738
2016-06-10 11:00:00;36,77;45,63;-8,86;39755;4058;0.1021;3676;382;48253;14185;0.294;16335;-2150
2016-06-10 12:00:00;36,97;43,65;-6,68;39755;4451;0.112;3990;461;48253;13663;0.2832;16267;-2604
2016-06-10 13:00:00;36,44;42,5;-6,06;39755;4448;0.1119;3959;489;48253;13460;0.2789;16138;-2678
2016-06-10 14:00:00;34,18;39,03;-4,85;39755;3878;0.0975;3576;302;48253;13293;0.2755;16021;-2728
2016-06-10 15:00:00;34,06;37,65;-3,59;39755;3146;0.0791;2860;286;48253;13427;0.2782;15719;-2292
2016-06-10 16:00:00;33,42;36,05;-2,63;39755;2030;0.051;1845;185;48253;13510;0.28;15209;-1699
2016-06-10 17:00:00;42,42;48,02;-5,6;39755;824;0.0208;812;12;48253;13737;0.2847;14737;-1000
2016-06-10 18:00:00;42,47;49,87;-7,4;39755;108;0.0027;131;-23;48253;13696;0.2838;14354;-658
2016-06-10 19:00:00;49,69;61,7;-12,01;39755;0;0;0;0;48253;13610;0.2821;13998;-388
2016-06-10 20:00:00;40,02;44,38;-4,36;39755;0;0;0;0;48253;13158;0.2727;13380;-222
2016-06-10 21:00:00;34,23;37,29;-3,06;39755;0;0;0;0;48253;12060;0.2499;12565;-505
2016-06-10 22:00:00;30,68;33,37;-2,69;39755;0;0;0;0;48253;10845;0.2248;11736;-891
2016-06-10 23:00:00;28,43;32,67;-4,24;39755;0;0;0;0;48253;9925;0.2056;11024;-1099
2016-07-10 00:00:00;28,87;33,45;-4,58;39758;0;0;0;0;48261;8926;0.1849;11458;-2532
2016-07-10 01:00:00;26,9;32,58;-5,68;39758;0;0;0;0;48261;8520;0.1765;10934;-2414
2016-07-10 02:00:00;26,98;32,29;-5,31;39758;0;0;0;0;48261;8395;0.174;10327;-1932
2016-07-10 03:00:00;27,59;31,23;-3,64;39758;0;0;0;0;48261;7787;0.1614;9701;-1914
2016-07-10 04:00:00;27,96;31,44;-3,48;39758;0;0;0;0;48261;7416;0.1537;9193;-1777
2016-07-10 05:00:00;29,93;34,36;-4,43;39758;0;0;0;0;48261;7086;0.1468;8817;-1731
2016-07-10 06:00:00;42,28;50,35;-8,07;39758;0;0;0;0;48261;6675;0.1383;8565;-1890
2016-07-10 07:00:00;42,0;48,45;-6,45;39758;54;0.0014;92;-38;48261;6620;0.1372;8367;-1747
2016-07-10 08:00:00;45,58;64,51;-18,93;39758;764;0.0192;919;-155;48261;6686;0.1386;8174;-1488
2016-07-10 09:00:00;45,05;57,75;-12,7;39758;2474;0.0622;2467;7;48261;6362;0.1318;8038;-1676
2016-07-10 10:00:00;46,53;57,07;-10,54;39758;4531;0.114;4285;246;48261;6106;0.1265;7953;-1847
2016-07-10 11:00:00;52,32;60,02;-7,7;39758;6096;0.1533;5994;102;48261;5880;0.1218;7679;-1799
2016-07-10 12:00:00;53,07;59,18;-6,11;39758;6996;0.176;7239;-243;48261;5502;0.114;7148;-1646
2016-07-10 13:00:00;47,11;57,46;-10,35;39758;7198;0.181;7557;-359;48261;5184;0.1074;6762;-1578
2016-07-10 14:00:00;44,06;58,16;-14,1;39758;6412;0.1613;7076;-664;48261;5190;0.1076;6667;-1477
2016-07-10 15:00:00;42,47;52,08;-9,61;39758;4973;0.1251;5866;-893;48261;5234;0.1084;6553;-1319
2016-07-10 16:00:00;41,98;52,05;-10,07;39758;3067;0.0771;3894;-827;48261;5115;0.106;6516;-1401
2016-07-10 17:00:00;38,49;50,53;-12,04;39758;1255;0.0316;1702;-447;48261;4922;0.102;6538;-1616
2016-07-10 18:00:00;41,94;57,57;-15,63;39758;150;0.0038;232;-82;48261;5200;0.1077;6756;-1556
2016-07-10 19:00:00;42,46;58,62;-16,16;39758;0;0;1;-1;48261;5803;0.1203;7083;-1280
2016-07-10 20:00:00;33,1;41,96;-8,86;39758;0;0;0;0;48261;6078;0.1259;7150;-1072
2016-07-10 21:00:00;30,53;34,96;-4,43;39758;0;0;0;0;48261;6631;0.1374;7112;-481
2016-07-10 22:00:00;31,12;37,29;-6,17;39758;0;0;0;0;48261;6365;0.1319;7039;-674
2016-07-10 23:00:00;32,97;39,61;-6,64;39758;0;0;0;0;48261;5852;0.1213;6856;-1004
2016-08-10 00:00:00;31,04;30,18;0,86;39758;0;0;0;0;48261;5539;0.1148;5690;-151
2016-08-10 01:00:00;28,78;27,51;1,27;39758;0;0;0;0;48261;5605;0.1162;5445;160
2016-08-10 02:00:00;29,97;28,13;1,84;39758;0;0;0;0;48261;5526;0.1145;5367;159
2016-08-10 03:00:00;29,7;26,36;3,34;39758;0;0;0;0;48261;5646;0.117;5458;188
2016-08-10 04:00:00;29,99;26,09;3,9;39758;0;0;0;0;48261;5675;0.1176;5599;76
2016-08-10 05:00:00;29,56;26,87;2,69;39758;0;0;0;0;48261;6278;0.1301;5767;511
2016-08-10 06:00:00;31,59;27,87;3,72;39758;0;0;0;0;48261;6216;0.1288;5900;316
2016-08-10 07:00:00;33,39;32,85;0,54;39758;69;0.0018;121;-52;48261;5989;0.1241;5942;47
2016-08-10 08:00:00;40,04;34,91;5,13;39758;1281;0.0322;1421;-140;48261;5736;0.1188;5838;-102
2016-08-10 09:00:00;43,41;37,32;6,09;39758;3804;0.0957;3932;-128;48261;5602;0.1161;5578;24
2016-08-10 10:00:00;44,94;40,42;4,52;39758;6359;0.1599;6404;-45;48261;5758;0.1193;5380;378
2016-08-10 11:00:00;42,08;37,11;4,97;39758;8144;0.2049;8373;-229;48261;6150;0.1274;5346;804
2016-08-10 12:00:00;33,58;31,72;1,86;39758;8857;0.2228;9477;-620;48261;6278;0.1301;5246;1032
2016-08-10 13:00:00;32,48;33,07;-0,59;39758;8154;0.2051;9522;-1368;48261;6050;0.1254;5145;905
2016-08-10 14:00:00;33,03;35,34;-2,31;39758;7424;0.1868;8726;-1302;48261;5837;0.1209;5348;489
2016-08-10 15:00:00;32,44;34,65;-2,21;39758;6196;0.1558;7111;-915;48261;5545;0.1149;5588;-43
2016-08-10 16:00:00;37,02;40,19;-3,17;39758;4164;0.1047;4716;-552;48261;5422;0.1123;5795;-373
2016-08-10 17:00:00;42,69;41,92;0,77;39758;1797;0.0452;2065;-268;48261;4973;0.103;5797;-824
2016-08-10 18:00:00;46,0;45,9;0,1;39758;206;0.0052;273;-67;48261;5094;0.1056;5729;-635
2016-08-10 19:00:00;52,75;55,53;-2,78;39758;0;0;1;-1;48261;5709;0.1183;5863;-154
2016-08-10 20:00:00;42,92;42,84;0,08;39758;0;0;0;0;48261;6196;0.1284;5901;295
2016-08-10 21:00:00;35,0;33,95;1,05;39758;0;0;0;0;48261;6146;0.1274;5835;311
2016-08-10 22:00:00;32,44;34,12;-1,68;39758;0;0;0;0;48261;5782;0.1198;5710;72
2016-08-10 23:00:00;31,12;31,64;-0,52;39758;0;0;0;0;48261;5424;0.1124;5534;-110
2016-09-10 00:00:00;28,71;29,85;-1,14;39758;0;0;0;0;48261;4927;0.1021;5480;-553
2016-09-10 01:00:00;28,45;28,32;0,13;39758;0;0;0;0;48261;4705;0.0975;5301;-596
2016-09-10 02:00:00;29,25;29,48;-0,23;39758;0;0;0;0;48261;4480;0.0928;5165;-685
2016-09-10 03:00:00;28,79;28,34;0,45;39758;0;0;0;0;48261;4400;0.0912;5069;-669
2016-09-10 04:00:00;28,72;28,22;0,5;39758;0;0;0;0;48261;4392;0.091;5029;-637
2016-09-10 05:00:00;28,09;27,46;0,63;39758;0;0;0;0;48261;4517;0.0936;4979;-462
2016-09-10 06:00:00;28,55;29,91;-1,36;39758;0;0;0;0;48261;4758;0.0986;4933;-175
2016-09-10 07:00:00;29,11;31,3;-2,19;39758;66;0.0017;119;-53;48261;4708;0.0976;4880;-172
2016-09-10 08:00:00;31,87;32,51;-0,64;39758;1376;0.0346;1582;-206;48261;4535;0.094;4749;-214
2016-09-10 09:00:00;33,68;34,67;-0,99;39758;4042;0.1017;4507;-465;48261;3855;0.0799;4474;-619
2016-09-10 10:00:00;33,34;36,42;-3,08;39758;7122;0.1792;7386;-264;48261;3569;0.0739;4226;-657
2016-09-10 11:00:00;34,13;35,46;-1,33;39758;9492;0.2387;9628;-136;48261;3183;0.066;4025;-842
2016-09-10 12:00:00;32,06;34,94;-2,88;39758;10651;0.2679;10887;-236;48261;2800;0.058;3840;-1040
2016-09-10 13:00:00;28,81;31,95;-3,14;39758;10602;0.2666;10912;-310;48261;2626;0.0544;3645;-1019
2016-09-10 14:00:00;28,23;32,73;-4,5;39758;9718;0.2444;9831;-113;48261;2437;0.0505;3495;-1058
2016-09-10 15:00:00;28,21;33,2;-4,99;39758;7774;0.1956;7822;-48;48261;2322;0.0481;3325;-1003
2016-09-10 16:00:00;28,8;31,89;-3,09;39758;5123;0.1288;5061;62;48261;1944;0.0402;3124;-1180
2016-09-10 17:00:00;32,95;32,57;0,38;39758;2196;0.0552;2114;82;48261;1426;0.0295;2939;-1513
2016-09-10 18:00:00;41,29;39,49;1,8;39758;216;0.0054;243;-27;48261;1320;0.0274;2820;-1500
2016-09-10 19:00:00;50,52;50,1;0,42;39758;0;0;0;0;48261;1280;0.0265;2738;-1458
2016-09-10 20:00:00;45,29;45,66;-0,37;39758;0;0;0;0;48261;1167;0.0242;2500;-1333
2016-09-10 21:00:00;43,45;44,1;-0,65;39758;0;0;0;0;48261;1146;0.0238;2318;-1172
2016-09-10 22:00:00;42,24;42,23;0,01;39758;0;0;0;0;48261;955;0.0198;2196;-1241
2016-09-10 23:00:00;34,39;36,51;-2,12;39758;0;0;0;0;48261;932;0.0193;2081;-1149
2016-10-10 00:00:00;29,58;28,8;0,78;39764;0;0;0;0;48273;850;0.0176;866;-16
2016-10-10 01:00:00;31,87;32,75;-0,88;39764;0;0;0;0;48273;645;0.0134;796;-151
2016-10-10 02:00:00;33,49;34,51;-1,02;39764;0;0;0;0;48273;502;0.0104;769;-267
2016-10-10 03:00:00;30,66;31,18;-0,52;39764;0;0;0;0;48273;563;0.0117;802;-239
2016-10-10 04:00:00;30,19;30,31;-0,12;39764;0;0;0;0;48273;657;0.0136;877;-220
2016-10-10 05:00:00;31,28;28,85;2,43;39764;0;0;0;0;48273;616;0.0128;952;-336
2016-10-10 06:00:00;48,85;38,28;10,57;39764;0;0;0;0;48273;572;0.0119;1033;-461
2016-10-10 07:00:00;69,24;52,74;16,5;39764;81;0.002;130;-49;48273;610;0.0126;1102;-492
2016-10-10 08:00:00;75,0;64,97;10,03;39764;1362;0.0342;1903;-541;48273;767;0.0159;1113;-346
2016-10-10 09:00:00;70,16;58,39;11,77;39764;3939;0.099;5462;-1523;48273;907;0.0188;1036;-129
2016-10-10 10:00:00;60,13;63,7;-3,57;39764;6785;0.1706;9067;-2282;48273;814;0.0168;977;-163
2016-10-10 11:00:00;55,66;65,13;-9,47;39764;9254;0.2327;11783;-2529;48273;663;0.0137;941;-278
2016-10-10 12:00:00;51,99;63,45;-11,46;39764;10989;0.2764;13162;-2173;48273;584;0.0121;975;-391
2016-10-10 13:00:00;53,21;58,61;-5,4;39764;10882;0.2737;12763;-1881;48273;670;0.0139;1032;-362
2016-10-10 14:00:00;52,65;58,67;-6,02;39764;9159;0.2304;10997;-1838;48273;798;0.0165;1202;-404
2016-10-10 15:00:00;51,91;57,69;-5,78;39764;6518;0.1639;8396;-1878;48273;982;0.0204;1440;-458
2016-10-10 16:00:00;55,0;61,83;-6,83;39764;3924;0.0987;5333;-1409;48273;1211;0.0251;1764;-553
2016-10-10 17:00:00;57,24;64,67;-7,43;39764;1483;0.0373;2179;-696;48273;1596;0.0331;2222;-626
2016-10-10 18:00:00;69,94;71,1;-1,16;39764;128;0.0032;231;-103;48273;2006;0.0415;2831;-825
2016-10-10 19:00:00;81,93;73,44;8,49;39764;0;0;0;0;48273;2174;0.045;3412;-1238
2016-10-10 20:00:00;57,1;54,39;2,71;39764;0;0;0;0;48273;2563;0.0531;3658;-1095
2016-10-10 21:00:00;43,41;41,66;1,75;39764;0;0;0;0;48273;2718;0.0563;4015;-1297
2016-10-10 22:00:00;33,48;33,84;-0,36;39764;0;0;0;0;48273;2968;0.0615;4452;-1484
2016-10-10 23:00:00;30,53;32,37;-1,84;39764;0;0;0;0;48273;3326;0.0689;4817;-1491
2016-11-10 00:00:00;32,34;31,81;0,53;39767;0;0;0;0;48273;3525;0.073;4930;-1405
2016-11-10 01:00:00;30,23;32,47;-2,24;39767;0;0;0;0;48273;3838;0.0795;5334;-1496
2016-11-10 02:00:00;29,08;30,53;-1,45;39767;0;0;0;0;48273;4278;0.0886;5789;-1511
2016-11-10 03:00:00;29,16;32,11;-2,95;39767;0;0;0;0;48273;4614;0.0956;6278;-1664
2016-11-10 04:00:00;30,18;32,2;-2,02;39767;0;0;0;0;48273;4669;0.0967;6724;-2055
2016-11-10 05:00:00;31,91;34,29;-2,38;39767;0;0;0;0;48273;5127;0.1062;7053;-1926
2016-11-10 06:00:00;36,91;40,92;-4,01;39767;0;0;0;0;48273;5718;0.1185;7189;-1471
2016-11-10 07:00:00;45,93;46,73;-0,8;39767;44;0.0011;85;-41;48273;6164;0.1277;7283;-1119
2016-11-10 08:00:00;49,39;47,56;1,83;39767;968;0.0244;1322;-354;48273;6318;0.1309;7331;-1013
2016-11-10 09:00:00;49,35;52,28;-2,93;39767;3120;0.0784;3922;-802;48273;6111;0.1266;7301;-1190
2016-11-10 10:00:00;47,58;46,75;0,83;39767;5818;0.1463;6397;-579;48273;6119;0.1268;7246;-1127
2016-11-10 11:00:00;45,08;43,59;1,49;39767;7924;0.1993;8191;-267;48273;6184;0.1281;7293;-1109
2016-11-10 12:00:00;40,08;38,47;1,61;39767;8701;0.2188;8941;-240;48273;6324;0.131;7457;-1133
2016-11-10 13:00:00;39,91;35,61;4,3;39767;7905;0.1988;8494;-589;48273;6687;0.1385;7730;-1043
2016-11-10 14:00:00;37,88;34,26;3,62;39767;6390;0.1607;7150;-760;48273;7295;0.1511;8220;-925
2016-11-10 15:00:00;39,25;36,49;2,76;39767;4412;0.111;5313;-901;48273;7753;0.1606;8470;-717
2016-11-10 16:00:00;39,96;39,14;0,82;39767;2572;0.0647;3318;-746;48273;7885;0.1634;8814;-929
2016-11-10 17:00:00;42,67;39,61;3,06;39767;914;0.023;1327;-413;48273;8201;0.1699;9123;-922
2016-11-10 18:00:00;44,97;42,43;2,54;39767;73;0.0018;149;-76;48273;8824;0.1828;9307;-483
2016-11-10 19:00:00;44,54;39,41;5,13;39767;0;0;0;0;48273;9711;0.2012;9471;240
2016-11-10 20:00:00;35,45;34,4;1,05;39767;0;0;0;0;48273;10359;0.2146;9603;756
2016-11-10 21:00:00;34,23;31,59;2,64;39767;0;0;0;0;48273;10583;0.2192;9553;1030
2016-11-10 22:00:00;33,03;31,13;1,9;39767;0;0;0;0;48273;10280;0.213;9419;861
2016-11-10 23:00:00;30,41;29,42;0,99;39767;0;0;0;0;48273;9939;0.2059;9239;700
2016-12-10 00:00:00;28,17;28,27;-0,1;39772;0;0;0;0;48282;9650;0.1999;9052;598
2016-12-10 01:00:00;27,93;29,83;-1,9;39772;0;0;0;0;48282;9368;0.194;8790;578
2016-12-10 02:00:00;28,09;27,5;0,59;39772;0;0;0;0;48282;9013;0.1867;8520;493
2016-12-10 03:00:00;28,01;27,48;0,53;39772;0;0;0;0;48282;8742;0.1811;8402;340
2016-12-10 04:00:00;28,16;26,81;1,35;39772;0;0;0;0;48282;8614;0.1784;8432;182
2016-12-10 05:00:00;29,99;27,54;2,45;39772;0;0;0;0;48282;8569;0.1775;8502;67
2016-12-10 06:00:00;32,93;33,69;-0,76;39772;0;0;0;0;48282;8632;0.1788;8519;113
2016-12-10 07:00:00;45,07;43,31;1,76;39772;34;0.0008;59;-25;48282;8380;0.1736;8578;-198
2016-12-10 08:00:00;46,99;42,19;4,8;39772;848;0.0213;929;-81;48282;7928;0.1642;8727;-799
2016-12-10 09:00:00;45,95;42,57;3,38;39772;2758;0.0694;2863;-105;48282;7634;0.1581;8912;-1278
2016-12-10 10:00:00;41,59;43,07;-1,48;39772;5098;0.1282;4891;207;48282;7626;0.1579;9090;-1464
2016-12-10 11:00:00;44,94;44,11;0,83;39772;6822;0.1715;6488;334;48282;7346;0.1521;9041;-1695
2016-12-10 12:00:00;40,54;41,94;-1,4;39772;7670;0.1929;7260;410;48282;7401;0.1533;8791;-1390
2016-12-10 13:00:00;36,77;41,89;-5,12;39772;7422;0.1866;7289;133;48282;7368;0.1526;8678;-1310
2016-12-10 14:00:00;34,93;36,47;-1,54;39772;6762;0.17;6679;83;48282;7586;0.1571;8722;-1136
2016-12-10 15:00:00;33,87;34,16;-0,29;39772;5335;0.1341;5443;-108;48282;7804;0.1616;8627;-823
2016-12-10 16:00:00;37,44;34,97;2,47;39772;3512;0.0883;3502;10;48282;8146;0.1687;8551;-405
2016-12-10 17:00:00;44,02;42,42;1,6;39772;1492;0.0375;1396;96;48282;8342;0.1728;8546;-204
2016-12-10 18:00:00;45,68;36,1;9,58;39772;115;0.0029;146;-31;48282;8462;0.1753;8714;-252
2016-12-10 19:00:00;47,82;37,97;9,85;39772;0;0;0;0;48282;8885;0.184;9019;-134
2016-12-10 20:00:00;38,26;37,44;0,82;39772;0;0;0;0;48282;8951;0.1854;9332;-381
2016-12-10 21:00:00;33,57;31,6;1,97;39772;0;0;0;0;48282;8668;0.1795;9436;-768
2016-12-10 22:00:00;33,99;29,75;4,24;39772;0;0;0;0;48282;8379;0.1736;9502;-1123
2016-12-10 23:00:00;30,1;29,49;0,61;39772;0;0;0;0;48282;8153;0.1688;9498;-1345
2016-10-13 00:00:00;28,21;28,65;-0,44;39774;0;0;0;0;48296;8461;0.1752;9154;-693
2016-10-13 01:00:00;28,15;28,0;0,15;39774;0;0;0;0;48296;8368;0.1733;9095;-727
2016-10-13 02:00:00;28,08;29,17;-1,09;39774;0;0;0;0;48296;8786;0.1819;9127;-341
2016-10-13 03:00:00;28,14;28,56;-0,42;39774;0;0;0;0;48296;9140;0.1893;9225;-85
2016-10-13 04:00:00;28,12;28,72;-0,6;39774;0;0;0;0;48296;9612;0.199;9531;81
2016-10-13 05:00:00;28,23;28,4;-0,17;39774;0;0;0;0;48296;9839;0.2037;9976;-137
2016-10-13 06:00:00;36,66;44,06;-7,4;39774;0;0;0;0;48296;10240;0.212;10530;-290
2016-10-13 07:00:00;47,91;51,62;-3,71;39774;39;0.001;88;-49;48296;10447;0.2163;11099;-652
2016-10-13 08:00:00;49,64;51,24;-1,6;39774;1150;0.0289;1540;-390;48296;10821;0.224;11772;-951
2016-10-13 09:00:00;44,98;49,67;-4,69;39774;3398;0.0854;4637;-1239;48296;11198;0.2318;12618;-1420
2016-10-13 10:00:00;40,02;48,2;-8,18;39774;6152;0.1547;7795;-1643;48296;11848;0.2454;13641;-1793
2016-10-13 11:00:00;37,64;46,35;-8,71;39774;7790;0.1958;10155;-2365;48296;13189;0.2731;14668;-1479
2016-10-13 12:00:00;31,39;36,16;-4,77;39774;8769;0.2205;11206;-2437;48296;13967;0.2892;15526;-1559
2016-10-13 13:00:00;31,06;36,99;-5,93;39774;8848;0.2225;10993;-2145;48296;14277;0.2956;16201;-1924
2016-10-13 14:00:00;30,12;34,93;-4,81;39774;7111;0.1788;9610;-2499;48296;14603;0.3024;16781;-2178
2016-10-13 15:00:00;32,06;34,7;-2,64;39774;5114;0.1286;7306;-2192;48296;14959;0.3097;17337;-2378
2016-10-13 16:00:00;31,63;34,88;-3,25;39774;3287;0.0827;4454;-1167;48296;15042;0.3114;17840;-2798
2016-10-13 17:00:00;38,13;36,7;1,43;39774;1502;0.0378;1634;-132;48296;15684;0.3248;18296;-2612
2016-10-13 18:00:00;42,76;41,78;0,98;39774;91;0.0023;131;-40;48296;16423;0.34;18832;-2409
2016-10-13 19:00:00;39,96;38,65;1,31;39774;0;0;0;0;48296;16986;0.3517;19414;-2428
2016-10-13 20:00:00;30,58;34,49;-3,91;39774;0;0;0;0;48296;16997;0.352;19845;-2848
2016-10-13 21:00:00;28,7;32,05;-3,35;39774;0;0;0;0;48296;17346;0.3591;20288;-2942
2016-10-13 22:00:00;28,2;30,57;-2,37;39774;0;0;0;0;48296;17296;0.3581;20250;-2954
2016-10-13 23:00:00;27,42;30,52;-3,1;39774;0;0;0;0;48296;17784;0.3682;20065;-2281
2016-10-14 00:00:00;20,8;18,45;2,35;39779;0;0;0;0;48299;17850;0.3696;18460;-610
2016-10-14 01:00:00;20,02;20,56;-0,54;39779;0;0;0;0;48299;17308;0.3584;18177;-869
2016-10-14 02:00:00;14,98;17,87;-2,89;39779;0;0;0;0;48299;16667;0.3451;17971;-1304
2016-10-14 03:00:00;20,07;19,4;0,67;39779;0;0;0;0;48299;16366;0.3388;17670;-1304
2016-10-14 04:00:00;21,72;25,49;-3,77;39779;0;0;0;0;48299;16010;0.3315;17657;-1647
2016-10-14 05:00:00;25,2;28,84;-3,64;39779;0;0;0;0;48299;16049;0.3323;17818;-1769
2016-10-14 06:00:00;30,29;34,16;-3,87;39779;0;0;0;0;48299;16743;0.3466;17975;-1232
2016-10-14 07:00:00;40,53;38,57;1,96;39779;60;0.0015;89;-29;48299;17449;0.3612;17951;-502
2016-10-14 08:00:00;40,08;38,12;1,96;39779;1585;0.0398;1894;-309;48299;17759;0.3677;17623;136
2016-10-14 09:00:00;40,1;32,39;7,71;39779;4779;0.1202;5572;-793;48299;16859;0.3491;17076;-217
2016-10-14 10:00:00;34,13;32,42;1,71;39779;7906;0.1987;9429;-1523;48299;16222;0.3359;16556;-334
2016-10-14 11:00:00;29,55;32,19;-2,64;39779;10277;0.2583;12413;-2136;48299;16095;0.3332;16210;-115
2016-10-14 12:00:00;28,17;33,33;-5,16;39779;12052;0.303;13872;-1820;48299;16380;0.3391;16050;330
2016-10-14 13:00:00;28,1;32,18;-4,08;39779;11724;0.2948;13597;-1873;48299;17002;0.352;15977;1025
2016-10-14 14:00:00;28,2;31,42;-3,22;39779;9347;0.235;11910;-2563;48299;17143;0.355;16001;1142
2016-10-14 15:00:00;30,01;35,1;-5,09;39779;6756;0.1698;9005;-2249;48299;18210;0.377;16115;2095
2016-10-14 16:00:00;29,0;30,61;-1,61;39779;3962;0.0996;5391;-1429;48299;18564;0.3843;16142;2422
2016-10-14 17:00:00;37,07;34,55;2,52;39779;1251;0.0315;1894;-643;48299;18716;0.3875;16412;2304
2016-10-14 18:00:00;38,27;36,93;1,34;39779;84;0.0021;128;-44;48299;19456;0.4028;17152;2304
2016-10-14 19:00:00;38,52;35,11;3,41;39779;0;0;0;0;48299;20290;0.4201;17794;2496
2016-10-14 20:00:00;32,32;27,81;4,51;39779;0;0;0;0;48299;20261;0.4195;17822;2439
2016-10-14 21:00:00;29,57;25,48;4,09;39779;0;0;0;0;48299;19574;0.4052;17330;2244
2016-10-14 22:00:00;28,2;26,12;2,08;39779;0;0;0;0;48299;18234;0.3776;16526;1708
2016-10-14 23:00:00;28,01;25,72;2,29;39779;0;0;0;0;48299;17074;0.3535;15781;1293
2016-10-15 00:00:00;15,53;22,5;-6,97;39779;0;0;0;0;48299;16012;0.3315;17178;-1166
2016-10-15 01:00:00;13,1;26,34;-13,24;39779;0;0;0;0;48299;16083;0.333;16812;-729
2016-10-15 02:00:00;13,66;23,72;-10,06;39779;0;0;0;0;48299;16616;0.344;16453;163
2016-10-15 03:00:00;13,62;19,39;-5,77;39779;0;0;0;0;48299;16414;0.3399;15989;425
2016-10-15 04:00:00;17,99;20,5;-2,51;39779;0;0;0;0;48299;15748;0.3261;15690;58
2016-10-15 05:00:00;15,5;23,33;-7,83;39779;0;0;0;0;48299;15345;0.3177;15319;26
2016-10-15 06:00:00;15,79;21,73;-5,94;39779;0;0;0;0;48299;14980;0.3102;14773;207
2016-10-15 07:00:00;27,62;31,06;-3,44;39779;28;0.0007;47;-19;48299;14427;0.2987;14180;247
2016-10-15 08:00:00;30,59;30,34;0,25;39779;970;0.0244;981;-11;48299;13442;0.2783;13442;0
2016-10-15 09:00:00;31,62;33,51;-1,89;39779;3346;0.0841;2967;379;48299;12691;0.2628;12477;214
2016-10-15 10:00:00;31,89;34,35;-2,46;39779;5882;0.1479;4867;1015;48299;11490;0.2379;11420;70
2016-10-15 11:00:00;33,34;33,04;0,3;39779;7786;0.1958;6345;1441;48299;10848;0.2246;10284;564
2016-10-15 12:00:00;31,39;30,31;1,08;39779;8917;0.2242;7199;1718;48299;9781;0.2025;9052;729
2016-10-15 13:00:00;31,36;28,11;3,25;39779;9145;0.2299;7219;1926;48299;8308;0.172;7858;450
2016-10-15 14:00:00;32,24;28,45;3,79;39779;8365;0.2103;6568;1797;48299;7090;0.1468;6778;312
2016-10-15 15:00:00;36,05;30,16;5,89;39779;6249;0.1571;5286;963;48299;6228;0.129;5834;394
2016-10-15 16:00:00;38,03;33,88;4,15;39779;3545;0.0891;3371;174;48299;5413;0.1121;4971;442
2016-10-15 17:00:00;42,86;39,44;3,42;39779;1340;0.0337;1247;93;48299;4590;0.0951;4357;233
2016-10-15 18:00:00;49,92;47,04;2,88;39779;106;0.0026;90;16;48299;4050;0.0838;4214;-164
2016-10-15 19:00:00;57,05;55,56;1,49;39779;0;0;0;0;48299;4028;0.0834;4171;-143
2016-10-15 20:00:00;48,93;50,05;-1,12;39779;0;0;0;0;48299;4006;0.083;4071;-65
2016-10-15 21:00:00;44,38;43,39;0,99;39779;0;0;0;0;48299;3665;0.0759;3961;-296
2016-10-15 22:00:00;40,02;38,28;1,74;39779;0;0;0;0;48299;3206;0.0664;3685;-479
2016-10-15 23:00:00;32,96;34,93;-1,97;39779;0;0;0;0;48299;2921;0.0605;3344;-423
2016-10-16 00:00:00;33,08;33,27;-0,19;39780;0;0;0;0;48299;2527;0.0523;3307;-780
2016-10-16 01:00:00;31,1;30,28;0,82;39780;0;0;0;0;48299;2286;0.0473;2916;-630
2016-10-16 02:00:00;31,6;29,79;1,81;39780;0;0;0;0;48299;2101;0.0435;2644;-543
2016-10-16 03:00:00;30,59;31,37;-0,78;39780;0;0;0;0;48299;2002;0.0414;2462;-460
2016-10-16 04:00:00;30,66;30,48;0,18;39780;0;0;0;0;48299;2101;0.0435;2322;-221
2016-10-16 05:00:00;30,61;30,55;0,06;39780;0;0;0;0;48299;2248;0.0466;2251;-3
2016-10-16 06:00:00;30,91;31,58;-0,67;39780;0;0;0;0;48299;2390;0.0495;2291;99
2016-10-16 07:00:00;31,51;31,48;0,03;39780;32;0.0008;46;-14;48299;2629;0.0544;2362;267
2016-10-16 08:00:00;36,63;36,23;0,4;39780;1415;0.0356;1282;133;48299;2880;0.0596;2410;470
2016-10-16 09:00:00;38,48;38,51;-0,03;39780;4929;0.1239;4599;330;48299;3103;0.0642;2400;703
2016-10-16 10:00:00;37,39;34,3;3,09;39780;9447;0.2375;8553;894;48299;2478;0.0513;2297;181
2016-10-16 11:00:00;34,57;31,24;3,33;39780;13144;0.3304;12141;1003;48299;2134;0.0442;2109;25
2016-10-16 12:00:00;33,1;30,26;2,84;39780;15506;0.3898;14314;1192;48299;2411;0.0499;1958;453
2016-10-16 13:00:00;31,54;27,44;4,1;39780;15888;0.3994;14657;1231;48299;2916;0.0604;2001;915
2016-10-16 14:00:00;30,08;27,44;2,64;39780;14714;0.3699;13337;1377;48299;3296;0.0682;2180;1116
2016-10-16 15:00:00;30,44;27,55;2,89;39780;11976;0.301;10467;1509;48299;3640;0.0754;2349;1291
2016-10-16 16:00:00;31,05;28,5;2,55;39780;7504;0.1886;6458;1046;48299;4347;0.09;2593;1754
2016-10-16 17:00:00;36,06;31,8;4,26;39780;2572;0.0647;2305;267;48299;5329;0.1103;3314;2015
2016-10-16 18:00:00;45,85;41,48;4,37;39780;106;0.0027;157;-51;48299;7204;0.1492;4899;2305
2016-10-16 19:00:00;48,93;46,56;2,37;39780;0;0;0;0;48299;9208;0.1906;6549;2659
2016-10-16 20:00:00;34,15;33,9;0,25;39780;0;0;0;0;48299;10366;0.2146;7687;2679
2016-10-16 21:00:00;31,06;31,12;-0,06;39780;0;0;0;0;48299;10950;0.2267;8256;2694
2016-10-16 22:00:00;30,57;32,09;-1,52;39780;0;0;0;0;48299;10829;0.2242;8539;2290
2016-10-16 23:00:00;28,84;30,57;-1,73;39780;0;0;0;0;48299;10610;0.2197;8562;2048
2016-10-17 00:00:00;30,6;35,13;-4,53;39793;0;0;0;0;48303;10206;0.2113;10556;-350
2016-10-17 01:00:00;29,56;29,85;-0,29;39793;0;0;0;0;48303;9978;0.2066;10274;-296
2016-10-17 02:00:00;29,17;30,59;-1,42;39793;0;0;0;0;48303;9863;0.2042;9946;-83
2016-10-17 03:00:00;28,44;30,94;-2,5;39793;0;0;0;0;48303;9758;0.202;9559;199
2016-10-17 04:00:00;28,53;30,07;-1,54;39793;0;0;0;0;48303;9528;0.1973;9276;252
2016-10-17 05:00:00;30,46;31,65;-1,19;39793;0;0;0;0;48303;9360;0.1938;9082;278
2016-10-17 06:00:00;41,75;45,27;-3,52;39793;0;0;0;0;48303;9143;0.1893;8907;236
2016-10-17 07:00:00;45,11;49,62;-4,51;39793;32;0.0008;34;-2;48303;8802;0.1822;8638;164
2016-10-17 08:00:00;48,34;56,09;-7,75;39793;978;0.0246;801;177;48303;8684;0.1798;8097;587
2016-10-17 09:00:00;46,42;52,04;-5,62;39793;3074;0.0773;3105;-31;48303;8072;0.1671;7207;865
2016-10-17 10:00:00;46,48;47,41;-0,93;39793;5294;0.133;5784;-490;48303;6698;0.1387;6254;444
2016-10-17 11:00:00;46,02;45,0;1,02;39793;7380;0.1854;7679;-299;48303;5370;0.1112;5383;-13
2016-10-17 12:00:00;41,9;46,46;-4,56;39793;8384;0.2107;8528;-144;48303;4420;0.0915;4671;-251
2016-10-17 13:00:00;45,21;48,0;-2,79;39793;7638;0.1919;8023;-385;48303;4018;0.0832;4098;-80
2016-10-17 14:00:00;48,97;51,14;-2,17;39793;6274;0.1577;6606;-332;48303;3753;0.0777;3744;9
2016-10-17 15:00:00;52,42;56,06;-3,64;39793;4488;0.1128;4709;-221;48303;3647;0.0755;3499;148
2016-10-17 16:00:00;53,97;61,71;-7,74;39793;2420;0.0608;2714;-294;48303;3336;0.069;3342;-6
2016-10-17 17:00:00;50,05;66,06;-16,01;39793;768;0.0193;849;-81;48303;3234;0.067;3424;-190
2016-10-17 18:00:00;55,56;73,27;-17,71;39793;49;0.0012;56;-7;48303;3338;0.0691;3769;-431
2016-10-17 19:00:00;56,08;81,65;-25,57;39793;0;0;0;0;48303;3546;0.0734;4056;-510
2016-10-17 20:00:00;46,44;60,46;-14,02;39793;0;0;0;0;48303;3617;0.0749;4164;-547
2016-10-17 21:00:00;35,74;44,45;-8,71;39793;0;0;0;0;48303;3410;0.0706;4072;-662
2016-10-17 22:00:00;36,87;44,8;-7,93;39793;0;0;0;0;48303;3116;0.0645;3943;-827
2016-10-17 23:00:00;32,57;36,28;-3,71;39793;0;0;0;0;48303;2720;0.0563;3883;-1163
2016-10-18 00:00:00;31,5;33,06;-1,56;39795;0;0;0;0;48307;2556;0.0529;3510;-954
2016-10-18 01:00:00;30,82;32,73;-1,91;39795;0;0;0;0;48307;2601;0.0538;3401;-800
2016-10-18 02:00:00;30,46;31,31;-0,85;39795;0;0;0;0;48307;2614;0.0541;3294;-680
2016-10-18 03:00:00;30,5;30,48;0,02;39795;0;0;0;0;48307;2839;0.0588;3253;-414
2016-10-18 04:00:00;31,11;30,59;0,52;39795;0;0;0;0;48307;2944;0.061;3263;-319
2016-10-18 05:00:00;32,96;32,05;0,91;39795;0;0;0;0;48307;3192;0.066;3391;-199
2016-10-18 06:00:00;41,79;35,85;5,94;39795;0;0;0;0;48307;3436;0.0711;3693;-257
2016-10-18 07:00:00;51,33;54,87;-3,54;39795;8;0.0002;19;-11;48307;3813;0.079;4033;-220
2016-10-18 08:00:00;54,95;57,89;-2,94;39795;455;0.0114;629;-174;48307;4059;0.084;4284;-225
2016-10-18 09:00:00;51,93;57,31;-5,38;39795;1932;0.0486;2439;-507;48307;3890;0.0805;4422;-532
2016-10-18 10:00:00;50,35;59,4;-9,05;39795;3653;0.0918;4619;-966;48307;4031;0.0834;4517;-486
2016-10-18 11:00:00;50,81;68,22;-17,41;39795;5571;0.14;6480;-909;48307;4664;0.0966;4688;-24
2016-10-18 12:00:00;46,49;63,1;-16,61;39795;7070;0.1776;7508;-438;48307;5402;0.1118;5212;190
2016-10-18 13:00:00;41,16;53,13;-11,97;39795;7557;0.1899;7552;5;48307;6677;0.1382;5835;842
2016-10-18 14:00:00;35,38;43,7;-8,32;39795;7043;0.177;6768;275;48307;7657;0.1585;6247;1410
2016-10-18 15:00:00;35,76;40,33;-4,57;39795;5320;0.1337;5217;103;48307;8041;0.1665;6463;1578
2016-10-18 16:00:00;36,8;39,81;-3,01;39795;2972;0.0747;3112;-140;48307;8669;0.1795;6678;1991
2016-10-18 17:00:00;44,9;45,83;-0,93;39795;813;0.0204;1002;-189;48307;9067;0.1877;6953;2114
2016-10-18 18:00:00;48,91;50,72;-1,81;39795;34;0.0009;69;-35;48307;9938;0.2057;7395;2543
2016-10-18 19:00:00;47,47;50,77;-3,3;39795;0;0;0;0;48307;10833;0.2242;7988;2845
2016-10-18 20:00:00;37,63;36,19;1,44;39795;0;0;0;0;48307;11854;0.2454;8444;3410
2016-10-18 21:00:00;34,44;32,31;2,13;39795;0;0;0;0;48307;12105;0.2506;8495;3610
2016-10-18 22:00:00;32,7;29,74;2,96;39795;0;0;0;0;48307;10907;0.2258;8440;2467
2016-10-18 23:00:00;30,49;26,5;3,99;39795;0;0;0;0;48307;9794;0.2027;8290;1504
2016-10-19 00:00:00;30,27;31,57;-1,3;39797;0;0;0;0;48321;9152;0.1894;9004;148
2016-10-19 01:00:00;28,99;28,3;0,69;39797;0;0;0;0;48321;8746;0.181;8571;175
2016-10-19 02:00:00;28,95;26,65;2,3;39797;0;0;0;0;48321;8499;0.1759;8138;361
2016-10-19 03:00:00;29,08;26,76;2,32;39797;0;0;0;0;48321;8076;0.1672;7692;384
2016-10-19 04:00:00;30,32;26,38;3,94;39797;0;0;0;0;48321;7574;0.1568;7320;254
2016-10-19 05:00:00;30,85;28,37;2,48;39797;0;0;0;0;48321;7181;0.1486;6993;188
2016-10-19 06:00:00;36,66;33,83;2,83;39797;0;0;0;0;48321;7197;0.1489;6732;465
2016-10-19 07:00:00;47,5;41,3;6,2;39797;7;0.0002;20;-13;48321;7381;0.1527;6590;791
2016-10-19 08:00:00;48,68;40,04;8,64;39797;510;0.0128;779;-269;48321;7086;0.1466;6569;517
2016-10-19 09:00:00;48,47;40,9;7,57;39797;2074;0.0521;2817;-743;48321;7129;0.1475;6679;450
2016-10-19 10:00:00;49,29;40,06;9,23;39797;3811;0.0958;4895;-1084;48321;7476;0.1547;6839;637
2016-10-19 11:00:00;49,29;39,86;9,43;39797;5387;0.1353;6473;-1086;48321;7906;0.1636;6976;930
2016-10-19 12:00:00;47,99;38,7;9,29;39797;6031;0.1516;7327;-1296;48321;7646;0.1582;7151;495
2016-10-19 13:00:00;45,92;37,72;8,2;39797;6319;0.1588;7207;-888;48321;8950;0.1852;7407;1543
2016-10-19 14:00:00;42,01;35,05;6,96;39797;5941;0.1493;6373;-432;48321;8909;0.1844;7572;1337
2016-10-19 15:00:00;41,27;33,04;8,23;39797;4661;0.1171;4911;-250;48321;8766;0.1814;7397;1369
2016-10-19 16:00:00;42,12;33,22;8,9;39797;2652;0.0667;2925;-273;48321;8555;0.1771;7146;1409
2016-10-19 17:00:00;48,32;39,66;8,66;39797;739;0.0186;896;-157;48321;8771;0.1815;6928;1843
2016-10-19 18:00:00;48,95;41,66;7,29;39797;38;0.001;49;-11;48321;9506;0.1967;6805;2701
2016-10-19 19:00:00;49,0;43,53;5,47;39797;0;0;0;0;48321;10212;0.2114;6773;3439
2016-10-19 20:00:00;44,49;34,63;9,86;39797;0;0;0;0;48321;10690;0.2212;6662;4028
2016-10-19 21:00:00;35,2;32,34;2,86;39797;0;0;0;0;48321;10204;0.2112;6439;3765
2016-10-19 22:00:00;34,99;31,32;3,67;39797;0;0;0;0;48321;9835;0.2035;6180;3655
2016-10-19 23:00:00;31,26;28,83;2,43;39797;0;0;0;0;48321;9319;0.1928;5955;3364
2016-10-20 00:00:00;30,36;29,53;0,83;39801;0;0;0;0;48323;8958;0.1854;7958;1000
2016-10-20 01:00:00;29,99;27,19;2,8;39801;0;0;0;0;48323;9021;0.1867;7560;1461
2016-10-20 02:00:00;29,97;27,6;2,37;39801;0;0;0;0;48323;8939;0.185;7361;1578
2016-10-20 03:00:00;30,03;31,46;-1,43;39801;0;0;0;0;48323;9140;0.1891;7227;1913
2016-10-20 04:00:00;30,02;28,64;1,38;39801;0;0;0;0;48323;9016;0.1866;7011;2005
2016-10-20 05:00:00;30,83;30,69;0,14;39801;0;0;0;0;48323;8753;0.1812;6846;1907
2016-10-20 06:00:00;35,35;35,93;-0,58;39801;0;0;0;0;48323;8036;0.1663;6646;1390
2016-10-20 07:00:00;41,84;44,6;-2,76;39801;8;0.0002;18;-10;48323;7527;0.1558;6447;1080
2016-10-20 08:00:00;46,95;45,35;1,6;39801;522;0.0132;699;-177;48323;7133;0.1476;6236;897
2016-10-20 09:00:00;47,98;45,99;1,99;39801;2169;0.0545;2530;-361;48323;6553;0.1356;5875;678
2016-10-20 10:00:00;47,06;45,61;1,45;39801;3890;0.0978;4470;-580;48323;5734;0.1186;5477;257
2016-10-20 11:00:00;47,16;45,73;1,43;39801;5566;0.1399;6063;-497;48323;5360;0.111;5253;107
2016-10-20 12:00:00;44,93;45,34;-0,41;39801;6415;0.1612;6998;-583;48323;5111;0.1058;5207;-96
2016-10-20 13:00:00;44,71;44,26;0,45;39801;6245;0.1569;6981;-736;48323;5118;0.1059;5077;41
2016-10-20 14:00:00;42,6;43,37;-0,77;39801;5657;0.1422;6207;-550;48323;5289;0.1094;4859;430
2016-10-20 15:00:00;43,6;43,23;0,37;39801;4454;0.1119;4737;-283;48323;5250;0.1086;4467;783
2016-10-20 16:00:00;44,98;41,09;3,89;39801;2680;0.0673;2751;-71;48323;5157;0.1068;4112;1045
2016-10-20 17:00:00;48,91;44,41;4,5;39801;772;0.0194;797;-25;48323;5308;0.1098;3945;1363
2016-10-20 18:00:00;48,96;48,59;0,37;39801;32;0.0008;39;-7;48323;5771;0.1194;4021;1750
2016-10-20 19:00:00;56,01;50,93;5,08;39801;0;0;0;0;48323;5628;0.1165;4234;1394
2016-10-20 20:00:00;46,45;41,97;4,48;39801;0;0;0;0;48323;5571;0.1153;4462;1109
2016-10-20 21:00:00;36,11;36,22;-0,11;39801;0;0;0;0;48323;5016;0.1038;4522;494
2016-10-20 22:00:00;34,67;37,86;-3,19;39801;0;0;0;0;48323;4490;0.0929;4439;51
2016-10-20 23:00:00;32,87;34,25;-1,38;39801;0;0;0;0;48323;3868;0.08;4360;-492
2016-10-21 00:00:00;32,65;32,56;0,09;39804;0;0;0;0;48337;3609;0.0747;3344;265
2016-10-21 01:00:00;31,94;30,46;1,48;39804;0;0;0;0;48337;3386;0.07;3341;45
2016-10-21 02:00:00;31,39;30,96;0,43;39804;0;0;0;0;48337;3044;0.063;3432;-388
2016-10-21 03:00:00;31,17;30,43;0,74;39804;0;0;0;0;48337;2958;0.0612;3625;-667
2016-10-21 04:00:00;32,55;32,27;0,28;39804;0;0;0;0;48337;3154;0.0652;3809;-655
2016-10-21 05:00:00;32,84;33,98;-1,14;39804;0;0;0;0;48337;3208;0.0663;4082;-874
2016-10-21 06:00:00;35,9;36,5;-0,6;39804;0;0;0;0;48337;3397;0.0703;4490;-1093
2016-10-21 07:00:00;46,87;47,79;-0,92;39804;5;0.0002;14;-9;48337;3947;0.0816;4875;-928
2016-10-21 08:00:00;48,98;50,4;-1,42;39804;368;0.0093;520;-152;48337;4181;0.0865;5286;-1105
2016-10-21 09:00:00;48,45;53,2;-4,75;39804;1579;0.0397;2031;-452;48337;4601;0.0952;5618;-1017
2016-10-21 10:00:00;48,42;51,14;-2,72;39804;3109;0.0781;3663;-554;48337;4951;0.1024;5929;-978
2016-10-21 11:00:00;47,82;47,87;-0,05;39804;4198;0.1055;4921;-723;48337;5299;0.1096;6195;-896
2016-10-21 12:00:00;46,49;47,49;-1,0;39804;4858;0.1221;5583;-725;48337;5890;0.1218;6454;-564
2016-10-21 13:00:00;41,84;43,9;-2,06;39804;4864;0.1222;5624;-760;48337;6179;0.1278;6780;-601
2016-10-21 14:00:00;38,31;39,05;-0,74;39804;4372;0.1098;5050;-678;48337;6262;0.1295;7136;-874
2016-10-21 15:00:00;37,41;38,74;-1,33;39804;3239;0.0814;3837;-598;48337;6134;0.1269;6995;-861
2016-10-21 16:00:00;37,96;38,67;-0,71;39804;1852;0.0465;2187;-335;48337;5904;0.1222;6743;-839
2016-10-21 17:00:00;42,06;41,12;0,94;39804;512;0.0129;625;-113;48337;6190;0.1281;6547;-357
2016-10-21 18:00:00;46,44;44,71;1,73;39804;23;0.0006;31;-8;48337;6363;0.1316;6453;-90
2016-10-21 19:00:00;45,95;43,89;2,06;39804;0;0;0;0;48337;6484;0.1341;6460;24
2016-10-21 20:00:00;39,49;38,65;0,84;39804;0;0;0;0;48337;6399;0.1324;6592;-193
2016-10-21 21:00:00;36,09;35,33;0,76;39804;0;0;0;0;48337;6303;0.1304;6564;-261
2016-10-21 22:00:00;34,98;33,5;1,48;39804;0;0;0;0;48337;5941;0.1229;6430;-489
2016-10-21 23:00:00;33,9;32,3;1,6;39804;0;0;0;0;48337;5524;0.1143;6226;-702
2016-10-22 00:00:00;38,45;34,23;4,22;39804;0;0;0;0;48345;5314;0.1099;5100;214
2016-10-22 01:00:00;34,55;33,11;1,44;39804;0;0;0;0;48345;5407;0.1118;5043;364
2016-10-22 02:00:00;33,96;33,44;0,52;39804;0;0;0;0;48345;5444;0.1126;5087;357
2016-10-22 03:00:00;34,11;33,91;0,2;39804;0;0;0;0;48345;5410;0.1119;5130;280
2016-10-22 04:00:00;35,18;34,2;0,98;39804;0;0;0;0;48345;5285;0.1093;5179;106
2016-10-22 05:00:00;35,61;31,6;4,01;39804;0;0;0;0;48345;5250;0.1086;5151;99
2016-10-22 06:00:00;34,55;33,09;1,46;39804;0;0;0;0;48345;5116;0.1058;5030;86
2016-10-22 07:00:00;36,89;36,39;0,5;39804;6;0.0002;17;-11;48345;5105;0.1056;4898;207
2016-10-22 08:00:00;35,21;40,09;-4,88;39804;549;0.0138;723;-174;48345;4956;0.1025;4759;197
2016-10-22 09:00:00;38,07;40,05;-1,98;39804;2356;0.0592;2749;-393;48345;4871;0.1007;4481;390
2016-10-22 10:00:00;37,87;44,53;-6,66;39804;4693;0.1179;5033;-340;48345;4332;0.0896;4201;131
2016-10-22 11:00:00;37,28;42,22;-4,94;39804;6508;0.1635;6806;-298;48345;3672;0.076;4057;-385
2016-10-22 12:00:00;39,96;45,03;-5,07;39804;6838;0.1718;7667;-829;48345;3284;0.0679;3864;-580
2016-10-22 13:00:00;35,02;40,02;-5,0;39804;6559;0.1648;7482;-923;48345;3012;0.0623;3693;-681
2016-10-22 14:00:00;34,31;37,77;-3,46;39804;6111;0.1535;6519;-408;48345;2844;0.0588;3564;-720
2016-10-22 15:00:00;34,17;35,56;-1,39;39804;4866;0.1222;4974;-108;48345;2338;0.0483;3251;-913
2016-10-22 16:00:00;35,19;35,48;-0,29;39804;2935;0.0737;2950;-15;48345;2075;0.0429;2874;-799
2016-10-22 17:00:00;46,76;43,34;3,42;39804;874;0.0219;861;13;48345;1924;0.0398;2593;-669
2016-10-22 18:00:00;49,96;45,59;4,37;39804;29;0.0007;36;-7;48345;1682;0.0348;2422;-740
2016-10-22 19:00:00;49,99;48,65;1,34;39804;0;0;0;0;48345;1767;0.0366;2283;-516
2016-10-22 20:00:00;44,11;45,05;-0,94;39804;0;0;0;0;48345;1596;0.033;1966;-370
2016-10-22 21:00:00;35,88;39,29;-3,41;39804;0;0;0;0;48345;1280;0.0265;1764;-484
2016-10-22 22:00:00;34,53;40,61;-6,08;39804;0;0;0;0;48345;1128;0.0234;1629;-501
2016-10-22 23:00:00;34,51;37,31;-2,8;39804;0;0;0;0;48345;935;0.0193;1532;-597
2016-10-23 00:00:00;33,09;34,85;-1,76;39804;0;0;0;0;48349;736;0.0152;1081;-345
2016-10-23 01:00:00;32,69;32,05;0,64;39804;0;0;0;0;48349;666;0.0138;1088;-422
2016-10-23 02:00:00;32,41;29,9;2,51;39804;0;0;0;0;48349;608;0.0126;1105;-497
2016-10-23 03:00:00;31,85;31,49;0,36;39804;0;0;0;0;48349;682;0.0141;1100;-418
2016-10-23 04:00:00;32,03;32,12;-0,09;39804;0;0;0;0;48349;766;0.0158;1160;-394
2016-10-23 05:00:00;31,9;31,79;0,11;39804;0;0;0;0;48349;758;0.0157;1280;-522
2016-10-23 06:00:00;32,52;31,03;1,49;39804;0;0;0;0;48349;857;0.0177;1438;-581
2016-10-23 07:00:00;33,04;32,04;1,0;39804;6;0.0002;20;-14;48349;1188;0.0246;1586;-398
2016-10-23 08:00:00;33,75;33,18;0,57;39804;580;0.0146;970;-390;48349;1730;0.0358;1642;88
2016-10-23 09:00:00;35,22;36,15;-0,93;39804;2682;0.0674;3935;-1253;48349;1993;0.0412;1604;389
2016-10-23 10:00:00;34,84;36,23;-1,39;39804;5704;0.1433;7823;-2119;48349;1962;0.0406;1532;430
2016-10-23 11:00:00;33,91;41,6;-7,69;39804;8493;0.2134;10928;-2435;48349;1763;0.0364;1536;227
2016-10-23 12:00:00;32,63;41,55;-8,92;39804;10310;0.259;12554;-2244;48349;1808;0.0374;1595;213
2016-10-23 13:00:00;32,86;38,42;-5,56;39804;11042;0.2774;12312;-1270;48349;1820;0.0377;1696;124
2016-10-23 14:00:00;31,95;34,65;-2,7;39804;10109;0.254;10481;-372;48349;1798;0.0372;1737;61
2016-10-23 15:00:00;32,66;34,59;-1,93;39804;7174;0.1803;7625;-451;48349;1863;0.0386;1714;149
2016-10-23 16:00:00;34,44;36,88;-2,44;39804;3522;0.0885;4213;-691;48349;2296;0.0475;1783;513
2016-10-23 17:00:00;37,24;37,55;-0,31;39804;850;0.0214;1071;-221;48349;3092;0.0639;2176;916
2016-10-23 18:00:00;42,01;41,79;0,22;39804;20;0.0005;29;-9;48349;4555;0.0942;3108;1447
2016-10-23 19:00:00;47,02;42,82;4,2;39804;0;0;0;0;48349;5994;0.124;4098;1896
2016-10-23 20:00:00;39,77;37,79;1,98;39804;0;0;0;0;48349;6927;0.1432;4560;2367
2016-10-23 21:00:00;36,86;34,87;1,99;39804;0;0;0;0;48349;7150;0.1479;4850;2300
2016-10-23 22:00:00;34,75;32,21;2,54;39804;0;0;0;0;48349;6864;0.142;5032;1832
2016-10-23 23:00:00;33,6;31,1;2,5;39804;0;0;0;0;48349;6006;0.1242;4940;1066
2016-10-24 00:00:00;31,44;28,24;3,2;39806;0;0;0;0;48360;5387;0.1114;4692;695
2016-10-24 01:00:00;31,08;30,19;0,89;39806;0;0;0;0;48360;4962;0.1026;4279;683
2016-10-24 02:00:00;31,53;30,25;1,28;39806;0;0;0;0;48360;4786;0.099;3927;859
2016-10-24 03:00:00;30,9;30,43;0,47;39806;0;0;0;0;48360;4528;0.0936;3710;818
2016-10-24 04:00:00;31,24;29,88;1,36;39806;0;0;0;0;48360;4506;0.0932;3609;897
2016-10-24 05:00:00;31,68;31,37;0,31;39806;0;0;0;0;48360;4956;0.1025;3657;1299
2016-10-24 06:00:00;43,5;40,16;3,34;39806;0;0;0;0;48360;4593;0.0949;3844;749
2016-10-24 07:00:00;49,92;50,34;-0,42;39806;3;0.0001;7;-4;48360;4450;0.092;3983;467
2016-10-24 08:00:00;49,92;54,47;-4,55;39806;426;0.0107;475;-49;48360;4954;0.1024;3978;976
2016-10-24 09:00:00;49,9;53,38;-3,48;39806;2077;0.0522;2055;22;48360;4658;0.0963;3737;921
2016-10-24 10:00:00;49,98;52,0;-2,02;39806;4529;0.1138;4249;280;48360;4544;0.094;3438;1106
2016-10-24 11:00:00;49,97;50,95;-0,98;39806;6120;0.1538;6236;-116;48360;4325;0.0894;3218;1107
2016-10-24 12:00:00;49,07;50,66;-1,59;39806;6082;0.1528;7404;-1322;48360;4354;0.09;3135;1219
2016-10-24 13:00:00;46,07;50,53;-4,46;39806;5717;0.1436;7285;-1568;48360;4311;0.0891;3288;1023
2016-10-24 14:00:00;44,73;52,18;-7,45;39806;4736;0.119;6195;-1459;48360;4418;0.0914;3860;558
2016-10-24 15:00:00;46,09;57,28;-11,19;39806;3068;0.0771;4469;-1401;48360;4579;0.0947;4400;179
2016-10-24 16:00:00;46,47;55,65;-9,18;39806;1605;0.0403;2389;-784;48360;4549;0.0941;5028;-479
2016-10-24 17:00:00;48,21;58,52;-10,31;39806;566;0.0142;602;-36;48360;4918;0.1017;5769;-851
2016-10-24 18:00:00;48,49;58,99;-10,5;39806;13;0.0003;29;-16;48360;5590;0.1156;6458;-868
2016-10-24 19:00:00;48,35;59,17;-10,82;39806;0;0;0;0;48360;5898;0.122;7110;-1212
2016-10-24 20:00:00;42,32;53,04;-10,72;39806;0;0;0;0;48360;5632;0.1164;7584;-1952
2016-10-24 21:00:00;36,35;41,31;-4,96;39806;0;0;0;0;48360;5257;0.1087;7456;-2199
2016-10-24 22:00:00;35,82;40,53;-4,71;39806;0;0;0;0;48360;4715;0.0975;7141;-2426
2016-10-24 23:00:00;33,07;37,45;-4,38;39806;0;0;0;0;48360;3982;0.0823;6753;-2771
2016-10-25 00:00:00;35,38;39,15;-3,77;39809;0;0;0;0;48371;3797;0.0785;4294;-497
2016-10-25 01:00:00;34,58;38,53;-3,95;39809;0;0;0;0;48371;3247;0.0671;3850;-603
2016-10-25 02:00:00;34,64;38,17;-3,53;39809;0;0;0;0;48371;3008;0.0622;3561;-553
2016-10-25 03:00:00;35,02;37,69;-2,67;39809;0;0;0;0;48371;3537;0.0731;3366;171
2016-10-25 04:00:00;34,97;35,17;-0,2;39809;0;0;0;0;48371;3984;0.0824;3250;734
2016-10-25 05:00:00;37,01;34,0;3,01;39809;0;0;0;0;48371;4043;0.0836;3123;920
2016-10-25 06:00:00;43,3;42,71;0,59;39809;0;0;0;0;48371;3713;0.0768;2955;758
2016-10-25 07:00:00;68,1;66,65;1,45;39809;0;0;3;-3;48371;3511;0.0726;2744;767
2016-10-25 08:00:00;68,02;70,15;-2,13;39809;142;0.0036;277;-135;48371;3106;0.0642;2437;669
2016-10-25 09:00:00;67,28;71,08;-3,8;39809;910;0.0229;1258;-348;48371;2334;0.0483;2035;299
2016-10-25 10:00:00;73,07;76,55;-3,48;39809;2295;0.0577;2554;-259;48371;1600;0.0331;1641;-41
2016-10-25 11:00:00;74,23;74,23;0,0;39809;3890;0.0977;3737;153;48371;1128;0.0233;1336;-208
2016-10-25 12:00:00;67,61;65,5;2,11;39809;4664;0.1172;4567;97;48371;906;0.0187;1174;-268
2016-10-25 13:00:00;66,01;61,71;4,3;39809;4410;0.1108;4683;-273;48371;814;0.0168;1081;-267
2016-10-25 14:00:00;57,97;58,91;-0,94;39809;3864;0.0971;4140;-276;48371;747;0.0154;1033;-286
2016-10-25 15:00:00;56,38;59,18;-2,8;39809;2681;0.0673;3063;-382;48371;719;0.0149;1033;-314
2016-10-25 16:00:00;56,0;59,07;-3,07;39809;1358;0.0341;1635;-277;48371;760;0.0157;1042;-282
2016-10-25 17:00:00;67,71;66,22;1,49;39809;314;0.0079;408;-94;48371;818;0.0169;1078;-260
2016-10-25 18:00:00;67,18;67,32;-0,14;39809;9;0.0002;16;-7;48371;988;0.0204;1144;-156
2016-10-25 19:00:00;60,39;65,55;-5,16;39809;0;0;0;0;48371;1190;0.0246;1225;-35
2016-10-25 20:00:00;51,98;56,23;-4,25;39809;0;0;0;0;48371;1312;0.0272;1230;82
2016-10-25 21:00:00;39,76;42,15;-2,39;39809;0;0;0;0;48371;1264;0.0262;1187;77
2016-10-25 22:00:00;37,38;41,2;-3,82;39809;0;0;0;0;48371;1063;0.022;1085;-22
2016-10-25 23:00:00;34,7;35,71;-1,01;39809;0;0;0;0;48371;893;0.0184;995;-102
2016-10-26 00:00:00;35,81;37,13;-1,32;39816;0;0;0;0;48385;639;0.0132;680;-41
2016-10-26 01:00:00;34,6;34,45;0,15;39816;0;0;0;0;48385;478;0.0099;614;-136
2016-10-26 02:00:00;34,71;32,17;2,54;39816;0;0;0;0;48385;376;0.0078;597;-221
2016-10-26 03:00:00;35,03;31,67;3,36;39816;0;0;0;0;48385;374;0.0077;606;-232
2016-10-26 04:00:00;35,03;33,39;1,64;39816;0;0;0;0;48385;435;0.009;629;-194
2016-10-26 05:00:00;36,17;35,46;0,71;39816;0;0;0;0;48385;594;0.0123;654;-60
2016-10-26 06:00:00;41,2;46,73;-5,53;39816;0;0;0;0;48385;784;0.0162;725;59
2016-10-26 07:00:00;52,3;52,33;-0,03;39816;2;0.0001;8;-6;48385;851;0.0176;871;-20
2016-10-26 08:00:00;55,66;53,1;2,56;39816;251;0.0063;353;-102;48385;956;0.0198;1094;-138
2016-10-26 09:00:00;58,21;57,0;1,21;39816;1537;0.0386;1810;-273;48385;1404;0.029;1324;80
2016-10-26 10:00:00;58,01;56,27;1,74;39816;3371;0.0846;3877;-506;48385;1441;0.0298;1540;-99
2016-10-26 11:00:00;55,68;54,38;1,3;39816;5005;0.1257;5845;-840;48385;1442;0.0298;1773;-331
2016-10-26 12:00:00;52,15;52,48;-0,33;39816;6292;0.1581;6996;-704;48385;1522;0.0314;2052;-530
2016-10-26 13:00:00;49,88;50,92;-1,04;39816;6518;0.1637;7030;-512;48385;1797;0.0371;2385;-588
2016-10-26 14:00:00;45,67;45,99;-0,32;39816;5806;0.1458;6152;-346;48385;2326;0.0481;2725;-399
2016-10-26 15:00:00;46,81;45,6;1,21;39816;4288;0.1077;4535;-247;48385;2881;0.0596;3052;-171
2016-10-26 16:00:00;47,92;44,68;3,24;39816;2353;0.0591;2433;-80;48385;3132;0.0647;3365;-233
2016-10-26 17:00:00;50,27;47,69;2,58;39816;543;0.0136;560;-17;48385;3684;0.0761;3781;-97
2016-10-26 18:00:00;53,84;51,34;2,5;39816;15;0.0004;16;-1;48385;4525;0.0935;4378;147
2016-10-26 19:00:00;52,49;50,13;2,36;39816;0;0;0;0;48385;5523;0.1141;5112;411
2016-10-26 20:00:00;41,28;39,95;1,33;39816;0;0;0;0;48385;6204;0.1282;6022;182
2016-10-26 21:00:00;39,99;38,08;1,91;39816;0;0;0;0;48385;6860;0.1418;6955;-95
2016-10-26 22:00:00;37,37;37,7;-0,33;39816;0;0;0;0;48385;7427;0.1535;7828;-401
2016-10-26 23:00:00;34,1;34,68;-0,58;39816;0;0;0;0;48385;7882;0.1629;8514;-632
2016-10-27 00:00:00;32,84;30,68;2,16;39838;0;0;0;0;48405;8002;0.1653;7970;32
2016-10-27 01:00:00;32,26;31,03;1,23;39838;0;0;0;0;48405;7873;0.1627;8182;-309
2016-10-27 02:00:00;31,87;31,6;0,27;39838;0;0;0;0;48405;7727;0.1597;8323;-596
2016-10-27 03:00:00;31,25;31,57;-0,32;39838;0;0;0;0;48405;7708;0.1592;8285;-577
2016-10-27 04:00:00;32,34;31,13;1,21;39838;0;0;0;0;48405;8053;0.1664;8172;-119
2016-10-27 05:00:00;33,58;30,56;3,02;39838;0;0;0;0;48405;7964;0.1645;7937;27
2016-10-27 06:00:00;38,12;36,07;2,05;39838;0;0;0;0;48405;7626;0.1576;7673;-47
2016-10-27 07:00:00;47,94;43,58;4,36;39838;0;0;8;-8;48405;7350;0.1518;7492;-142
2016-10-27 08:00:00;48,99;46,13;2,86;39838;320;0.0081;447;-127;48405;6904;0.1426;7350;-446
2016-10-27 09:00:00;47,42;48,63;-1,21;39838;1965;0.0493;2224;-259;48405;6532;0.1349;7216;-684
2016-10-27 10:00:00;47,94;47,58;0,36;39838;4316;0.1083;4594;-278;48405;6269;0.1295;7109;-840
2016-10-27 11:00:00;45,69;43,08;2,61;39838;6479;0.1626;6472;7;48405;6311;0.1304;7226;-915
2016-10-27 12:00:00;44,11;38,96;5,15;39838;7788;0.1955;7494;294;48405;6884;0.1422;7709;-825
2016-10-27 13:00:00;41,77;38,01;3,76;39838;8429;0.2116;7370;1059;48405;7228;0.1493;8459;-1231
2016-10-27 14:00:00;38,68;35,71;2,97;39838;7760;0.1948;6328;1432;48405;7416;0.1532;9167;-1751
2016-10-27 15:00:00;39,51;35,0;4,51;39838;5611;0.1408;4602;1009;48405;8246;0.1704;9201;-955
2016-10-27 16:00:00;40,91;36,76;4,15;39838;3002;0.0754;2476;526;48405;8648;0.1786;9228;-580
2016-10-27 17:00:00;44,69;39,21;5,48;39838;712;0.0179;590;122;48405;9316;0.1925;9669;-353
2016-10-27 18:00:00;48,73;40,85;7,88;39838;10;0.0002;14;-4;48405;10184;0.2104;10585;-401
2016-10-27 19:00:00;42,0;40,17;1,83;39838;0;0;0;0;48405;11256;0.2326;11655;-399
2016-10-27 20:00:00;38,02;38,64;-0,62;39838;0;0;0;0;48405;12118;0.2503;12696;-578
2016-10-27 21:00:00;36,76;37,29;-0,53;39838;0;0;0;0;48405;12944;0.2674;13470;-526
2016-10-27 22:00:00;33,82;40,39;-6,57;39838;0;0;0;0;48405;13857;0.2863;14145;-288
2016-10-27 23:00:00;31,05;31,4;-0,35;39838;0;0;0;0;48405;14332;0.2961;14782;-450
2016-10-28 00:00:00;29,06;30,6;-1,54;39840;0;0;0;0;48429;14762;0.3048;15256;-494
2016-10-28 01:00:00;26,87;29,68;-2,81;39840;0;0;0;0;48429;15508;0.3202;15742;-234
2016-10-28 02:00:00;23,43;28,83;-5,4;39840;0;0;0;0;48429;15773;0.3257;16172;-399
2016-10-28 03:00:00;23,65;26,65;-3,0;39840;0;0;0;0;48429;16274;0.336;16490;-216
2016-10-28 04:00:00;23,92;22,83;1,09;39840;0;0;0;0;48429;17059;0.3522;16805;254
2016-10-28 05:00:00;29,1;29,98;-0,88;39840;0;0;0;0;48429;17415;0.3596;17036;379
2016-10-28 06:00:00;31,08;31,02;0,06;39840;0;0;0;0;48429;18103;0.3738;17220;883
2016-10-28 07:00:00;37,04;43,9;-6,86;39840;1;0;12;-11;48429;18466;0.3813;17339;1127
2016-10-28 08:00:00;39,3;38,29;1,01;39840;491;0.0124;659;-168;48429;18605;0.3842;17226;1379
2016-10-28 09:00:00;37,72;39,57;-1,85;39840;2168;0.0544;2980;-812;48429;18418;0.3803;16832;1586
2016-10-28 10:00:00;37,76;39,16;-1,4;39840;4142;0.104;5524;-1382;48429;18142;0.3746;16437;1705
2016-10-28 11:00:00;38,89;40,62;-1,73;39840;5664;0.1422;7376;-1712;48429;17759;0.3667;16184;1575
2016-10-28 12:00:00;37,17;41,43;-4,26;39840;6618;0.1661;8168;-1550;48429;18053;0.3728;16106;1947
2016-10-28 13:00:00;36,82;37,84;-1,02;39840;6799;0.1707;7788;-989;48429;18003;0.3717;16068;1935
2016-10-28 14:00:00;36,31;37,41;-1,1;39840;6131;0.1539;6474;-343;48429;17415;0.3596;15879;1536
2016-10-28 15:00:00;37,23;35,16;2,07;39840;4770;0.1197;4548;222;48429;16128;0.333;15306;822
2016-10-28 16:00:00;37,99;35,73;2,26;39840;2665;0.0669;2399;266;48429;15140;0.3126;14443;697
2016-10-28 17:00:00;43,74;39,88;3,86;39840;581;0.0146;552;29;48429;13997;0.289;13569;428
2016-10-28 18:00:00;50,5;45,91;4,59;39840;12;0.0003;8;4;48429;13668;0.2822;12878;790
2016-10-28 19:00:00;47,62;48,31;-0,69;39840;0;0;0;0;48429;13472;0.2782;12286;1186
2016-10-28 20:00:00;41,97;39,53;2,44;39840;0;0;0;0;48429;13340;0.2754;11690;1650
2016-10-28 21:00:00;42,82;38,68;4,14;39840;0;0;0;0;48429;13255;0.2737;11049;2206
2016-10-28 22:00:00;39,93;36,97;2,96;39840;0;0;0;0;48429;12624;0.2607;10358;2266
2016-10-28 23:00:00;33,1;34,47;-1,37;39840;0;0;0;0;48429;11812;0.244;9867;1945
2016-10-29 00:00:00;31,05;31,59;-0,54;39845;0;0;0;0;48432;11678;0.2411;10644;1034
2016-10-29 01:00:00;29,85;31,86;-2,01;39845;0;0;0;0;48432;11175;0.2308;10402;773
2016-10-29 02:00:00;29,04;30,58;-1,54;39845;0;0;0;0;48432;10782;0.2226;10302;480
2016-10-29 03:00:00;28,65;29,66;-1,01;39845;0;0;0;0;48432;11046;0.2281;10210;836
2016-10-29 04:00:00;28,77;28,01;0,76;39845;0;0;0;0;48432;11395;0.2352;10168;1227
2016-10-29 05:00:00;28,84;28,41;0,43;39845;0;0;0;0;48432;11549;0.2385;10134;1415
2016-10-29 06:00:00;30,77;31,68;-0,91;39845;0;0;0;0;48432;11833;0.2443;10099;1734
2016-10-29 07:00:00;32,5;33,77;-1,27;39845;0;0;6;-6;48432;12196;0.2518;10100;2096
2016-10-29 08:00:00;35,06;35,04;0,02;39845;305;0.0077;360;-55;48432;11583;0.2391;10008;1575
2016-10-29 09:00:00;41,76;37,17;4,59;39845;1872;0.047;1999;-127;48432;11468;0.2368;9820;1648
2016-10-29 10:00:00;41,54;36,92;4,62;39845;4137;0.1038;4147;-10;48432;11081;0.2288;9624;1457
2016-10-29 11:00:00;36,19;36,68;-0,49;39845;6808;0.1709;6166;642;48432;11594;0.2394;9886;1708
2016-10-29 12:00:00;33,79;34,4;-0,61;39845;8808;0.2211;7451;1357;48432;12662;0.2614;10790;1872
2016-10-29 13:00:00;31,54;28,84;2,7;39845;9249;0.2321;7692;1557;48432;14666;0.3028;11742;2924
2016-10-29 14:00:00;30,03;19,87;10,16;39845;8171;0.2051;6936;1235;48432;15080;0.3114;12251;2829
2016-10-29 15:00:00;31,41;23,11;8,3;39845;6400;0.1606;5234;1166;48432;14301;0.2952;11832;2469
2016-10-29 16:00:00;32,7;30,28;2,42;39845;3512;0.0882;2765;747;48432;12999;0.2684;11056;1943
2016-10-29 17:00:00;37,93;38,19;-0,26;39845;715;0.0179;575;140;48432;11551;0.2385;10407;1144
2016-10-29 18:00:00;45,92;44,32;1,6;39845;12;0.0003;10;2;48432;10847;0.224;10069;778
2016-10-29 19:00:00;44,27;43,93;0,34;39845;0;0;0;0;48432;10351;0.2138;9873;478
2016-10-29 20:00:00;39,44;40,76;-1,32;39845;0;0;0;0;48432;10065;0.2078;9736;329
2016-10-29 21:00:00;35,24;37,92;-2,68;39845;0;0;0;0;48432;10113;0.2088;9704;409
2016-10-29 22:00:00;35,12;34,53;0,59;39845;0;0;0;0;48432;9814;0.2026;9601;213
2016-10-29 23:00:00;33,81;33,0;0,81;39845;0;0;0;0;48432;9342;0.1929;9413;-71
2016-10-30 00:00:00;32,57;32,32;0,25;39845;0;0;0;0;48440;8860;0.1829;8386;474
2016-10-30 01:00:00;32,15;31,3;0,85;39845;0;0;0;0;48440;8520;0.1759;8097;423
2016-10-30 02:00:00;31,55;30,28;1,27;39845;0;0;0;0;48440;8007;0.1653;7346;661
2016-10-30 03:00:00;31,4;31,56;-0,16;39845;0;0;0;0;48440;7870;0.1625;6996;874
2016-10-30 04:00:00;31,45;30,29;1,16;39845;0;0;0;0;48440;7506;0.1549;6629;877
2016-10-30 05:00:00;32,03;30,83;1,2;39845;0;0;0;0;48440;7139;0.1474;6262;877
2016-10-30 06:00:00;32,55;30,53;2,02;39845;2;0.0001;5;-3;48440;6892;0.1423;5864;1028
2016-10-30 07:00:00;33,35;30,86;2,49;39845;462;0.0116;521;-59;48440;6019;0.1242;5314;705
2016-10-30 08:00:00;35,02;29,65;5,37;39845;2916;0.0732;2898;18;48440;5021;0.1036;4630;391
2016-10-30 09:00:00;36,49;31,4;5,09;39845;6260;0.1571;5855;405;48440;3964;0.0818;3971;-7
2016-10-30 10:00:00;36,99;31,42;5,57;39845;9206;0.231;8274;932;48440;3453;0.0713;3493;-40
2016-10-30 11:00:00;38,33;31,8;6,53;39845;11174;0.2804;9670;1504;48440;3254;0.0672;3158;96
2016-10-30 12:00:00;37,2;33,27;3,93;39845;11798;0.2961;9666;2132;48440;2871;0.0593;2910;-39
2016-10-30 13:00:00;33,9;32,18;1,72;39845;10756;0.27;8366;2390;48440;2619;0.054;2679;-60
2016-10-30 14:00:00;32,48;32,36;0,12;39845;8019;0.2012;6063;1956;48440;2387;0.0493;2309;78
2016-10-30 15:00:00;33,09;33,07;0,02;39845;4059;0.1019;3133;926;48440;1977;0.0408;1969;8
2016-10-30 16:00:00;34,64;34,28;0,36;39845;738;0.0185;649;89;48440;1765;0.0364;1797;-32
2016-10-30 17:00:00;49,2;45,9;3,3;39845;13;0.0003;7;6;48440;2058;0.0425;1831;227
2016-10-30 18:00:00;52,48;44,99;7,49;39845;0;0;0;0;48440;2302;0.0475;1931;371
2016-10-30 19:00:00;48,28;42,28;6,0;39845;0;0;0;0;48440;2394;0.0494;1944;450
2016-10-30 20:00:00;40,3;35,23;5,07;39845;0;0;0;0;48440;2320;0.0479;1879;441
2016-10-30 21:00:00;39,0;34,75;4,25;39845;0;0;0;0;48440;2064;0.0426;1733;331
2016-10-30 22:00:00;39,0;34,63;4,37;39845;0;0;0;0;48440;1873;0.0387;1575;298
2016-10-30 23:00:00;37,64;33,56;4,08;39845;0;0;0;0;48440;1454;0.03;1441;13
2016-10-31 00:00:00;35,36;31,78;3,58;39850;0;0;0;0;48446;1737;0.0358;1331;406
2016-10-31 01:00:00;34,94;30,87;4,07;39850;0;0;0;0;48446;1768;0.0365;1205;563
2016-10-31 02:00:00;34,66;32,01;2,65;39850;0;0;0;0;48446;1874;0.0387;1113;761
2016-10-31 03:00:00;33,92;31,13;2,79;39850;0;0;0;0;48446;1928;0.0398;1045;883
2016-10-31 04:00:00;34,39;30,91;3,48;39850;0;0;0;0;48446;2020;0.0417;1015;1005
2016-10-31 05:00:00;40,03;32,77;7,26;39850;0;0;0;0;48446;2020;0.0417;1028;992
2016-10-31 06:00:00;45,29;33,3;11,99;39850;3;0.0001;5;-2;48446;2056;0.0424;1045;1011
2016-10-31 07:00:00;51,68;41,67;10,01;39850;453;0.0113;613;-160;48446;2258;0.0466;1040;1218
2016-10-31 08:00:00;50,47;48,26;2,21;39850;2725;0.0684;3075;-350;48446;2338;0.0482;1020;1318
2016-10-31 09:00:00;47,38;39,5;7,88;39850;5533;0.1388;6272;-739;48446;1936;0.04;985;951
2016-10-31 10:00:00;45,1;36,42;8,68;39850;8210;0.206;9000;-790;48446;1522;0.0314;922;600
2016-10-31 11:00:00;44,0;35,98;8,02;39850;10195;0.2558;10680;-485;48446;1321;0.0273;893;428
2016-10-31 12:00:00;39,0;33,67;5,33;39850;11257;0.2825;11014;243;48446;1361;0.0281;954;407
2016-10-31 13:00:00;38,08;32,82;5,26;39850;10606;0.2662;9927;679;48446;1509;0.0312;1070;439
2016-10-31 14:00:00;38,64;34,21;4,43;39850;8014;0.2011;7464;550;48446;1613;0.0333;1208;405
2016-10-31 15:00:00;46,04;38,17;7,87;39850;4256;0.1068;3969;287;48446;1681;0.0347;1390;291
2016-10-31 16:00:00;49,73;44,34;5,39;39850;804;0.0202;848;-44;48446;1654;0.0341;1615;39
2016-10-31 17:00:00;59,2;53,79;5,41;39850;8;0.0002;8;0;48446;1952;0.0403;1968;-16
2016-10-31 18:00:00;55,98;51,82;4,16;39850;0;0;0;0;48446;2340;0.0483;2346;-6
2016-10-31 19:00:00;48,96;47,77;1,19;39850;0;0;0;0;48446;2752;0.0568;2546;206
2016-10-31 20:00:00;44,13;40,27;3,86;39850;0;0;0;0;48446;3145;0.0649;2960;185
2016-10-31 21:00:00;40,26;36,18;4,08;39850;0;0;0;0;48446;3640;0.0751;3393;247
2016-10-31 22:00:00;38,62;38,42;0,2;39850;0;0;0;0;48446;4271;0.0882;3926;345
2016-10-31 23:00:00;37,68;36,52;1,16;39850;0;0;0;0;48446;4816;0.0994;4561;255
2016-01-11 00:00:00;33,31;31,11;2,2;39851;0;0;0;0;48457;5516;0.1138;5106;410
2016-01-11 01:00:00;33,68;32,15;1,53;39851;0;0;0;0;48457;5909;0.122;5596;313
2016-01-11 02:00:00;33,31;32,1;1,21;39851;0;0;0;0;48457;6431;0.1327;6148;283
2016-01-11 03:00:00;32,52;33,0;-0,48;39851;0;0;0;0;48457;6615;0.1365;6743;-128
2016-01-11 04:00:00;32,99;32,83;0,16;39851;0;0;0;0;48457;6678;0.1378;7223;-545
2016-01-11 05:00:00;33,31;34,21;-0,9;39851;0;0;0;0;48457;7034;0.1452;7526;-492
2016-01-11 06:00:00;36,98;39,3;-2,32;39851;2;0.0001;4;-2;48457;7856;0.1621;7788;68
2016-01-11 07:00:00;41,93;41,45;0,48;39851;471;0.0118;583;-112;48457;7934;0.1637;7962;-28
2016-01-11 08:00:00;41,09;40,35;0,74;39851;2689;0.0675;3421;-732;48457;7865;0.1623;7990;-125
2016-01-11 09:00:00;33,77;34,39;-0,62;39851;5720;0.1436;7031;-1311;48457;7592;0.1567;8002;-410
2016-01-11 10:00:00;31,27;37,35;-6,08;39851;8520;0.2138;9957;-1437;48457;7807;0.1611;8101;-294
2016-01-11 11:00:00;30,9;33,94;-3,04;39851;9659;0.2424;11493;-1834;48457;8220;0.1696;8448;-228
2016-01-11 12:00:00;30,75;32,9;-2,15;39851;9532;0.2392;11324;-1792;48457;9363;0.1932;8938;425
2016-01-11 13:00:00;30,03;32,38;-2,35;39851;8260;0.2073;9655;-1395;48457;9761;0.2014;9499;262
2016-01-11 14:00:00;31,58;33,15;-1,57;39851;5900;0.148;6834;-934;48457;10104;0.2085;10100;4
2016-01-11 15:00:00;33,28;32,41;0,87;39851;2826;0.0709;3456;-630;48457;10512;0.2169;10647;-135
2016-01-11 16:00:00;39,34;39,91;-0,57;39851;472;0.0119;694;-222;48457;11376;0.2348;11274;102
2016-01-11 17:00:00;47,51;50,19;-2,68;39851;5;0.0001;6;-1;48457;12178;0.2513;11962;216
2016-01-11 18:00:00;49,99;48,99;1,0;39851;0;0;0;0;48457;12919;0.2666;12720;199
2016-01-11 19:00:00;45,97;41,23;4,74;39851;0;0;0;0;48457;13902;0.2869;13774;128
2016-01-11 20:00:00;35,94;31,62;4,32;39851;0;0;0;0;48457;15115;0.312;14257;858
2016-01-11 21:00:00;29,59;28,24;1,35;39851;0;0;0;0;48457;15776;0.3256;14642;1134
2016-01-11 22:00:00;28,86;28,59;0,27;39851;0;0;0;0;48457;15708;0.3242;15085;623
2016-01-11 23:00:00;16,02;16,62;-0,6;39851;0;0;0;0;48457;16319;0.3368;15583;736
2016-02-11 00:00:00;27,11;24,01;3,1;39853;0;0;0;0;48467;16810;0.3469;15656;1154
2016-02-11 01:00:00;15,12;14,29;0,83;39853;0;0;0;0;48467;17488;0.3608;16337;1151
2016-02-11 02:00:00;13,2;9,84;3,36;39853;0;0;0;0;48467;18098;0.3734;16992;1106
2016-02-11 03:00:00;12,26;9,5;2,76;39853;0;0;0;0;48467;18442;0.3805;17575;867
2016-02-11 04:00:00;13,16;9,74;3,42;39853;0;0;0;0;48467;19007;0.3922;18146;861
2016-02-11 05:00:00;21,01;15,09;5,92;39853;0;0;0;0;48467;19337;0.399;19055;282
2016-02-11 06:00:00;33,85;30,08;3,77;39853;1;0;1;0;48467;20183;0.4164;19838;345
2016-02-11 07:00:00;39,04;41,05;-2,01;39853;285;0.0072;338;-53;48467;20175;0.4163;20390;-215
2016-02-11 08:00:00;36,54;46,15;-9,61;39853;1916;0.048;2214;-298;48467;20366;0.4202;20828;-462
2016-02-11 09:00:00;36,72;41,03;-4,31;39853;4236;0.1063;4615;-379;48467;20588;0.4248;21251;-663
2016-02-11 10:00:00;33,19;38,62;-5,43;39853;6010;0.1508;6552;-542;48467;21196;0.4373;21547;-351
2016-02-11 11:00:00;34,07;37,93;-3,86;39853;6688;0.1678;7639;-951;48467;21760;0.449;21557;203
2016-02-11 12:00:00;32,93;36,94;-4,01;39853;6807;0.1708;7821;-1014;48467;21722;0.4482;21488;234
2016-02-11 13:00:00;33,18;38,23;-5,05;39853;6036;0.1514;7131;-1095;48467;22292;0.46;21091;1201
2016-02-11 14:00:00;33,06;37,84;-4,78;39853;4745;0.119;5391;-646;48467;21353;0.4406;20141;1212
2016-02-11 15:00:00;33,99;37,39;-3,4;39853;2644;0.0664;2793;-149;48467;19587;0.4041;18625;962
2016-02-11 16:00:00;39,16;41,2;-2,04;39853;469;0.0118;516;-47;48467;17716;0.3655;17165;551
2016-02-11 17:00:00;52,91;54,46;-1,55;39853;1;0;4;-3;48467;16969;0.3501;15805;1164
2016-02-11 18:00:00;52,46;53,4;-0,94;39853;0;0;0;0;48467;16890;0.3485;14506;2384
2016-02-11 19:00:00;51,46;44,84;6,62;39853;0;0;0;0;48467;15866;0.3273;13321;2545
2016-02-11 20:00:00;39,98;38,8;1,18;39853;0;0;0;0;48467;14493;0.2991;12116;2377
2016-02-11 21:00:00;37,52;37,49;0,03;39853;0;0;0;0;48467;12620;0.2604;10861;1759
2016-02-11 22:00:00;35,18;34,98;0,2;39853;0;0;0;0;48467;11233;0.2318;9779;1454
2016-02-11 23:00:00;35,67;33,76;1,91;39853;0;0;0;0;48467;9909;0.2045;8982;927
2016-03-11 00:00:00;35,05;33,9;1,15;39855;0;0;0;0;48485;8824;0.182;7559;1265
2016-03-11 01:00:00;35,07;33,45;1,62;39855;0;0;0;0;48485;7957;0.1641;7035;922
2016-03-11 02:00:00;34,74;33,41;1,33;39855;0;0;0;0;48485;7426;0.1532;6538;888
2016-03-11 03:00:00;35,87;33,3;2,57;39855;0;0;0;0;48485;7069;0.1458;6010;1059
2016-03-11 04:00:00;36,74;33,48;3,26;39855;0;0;0;0;48485;6502;0.1341;5461;1041
2016-03-11 05:00:00;38,95;33,96;4,99;39855;0;0;0;0;48485;5675;0.117;4910;765
2016-03-11 06:00:00;47,23;48,42;-1,19;39855;1;0;1;0;48485;4922;0.1015;4323;599
2016-03-11 07:00:00;53,41;54,72;-1,31;39855;352;0.0088;420;-68;48485;4373;0.0902;3630;743
2016-03-11 08:00:00;56,06;56,97;-0,91;39855;2560;0.0642;2951;-391;48485;3615;0.0746;2943;672
2016-03-11 09:00:00;50,11;50,37;-0,26;39855;5958;0.1495;6346;-388;48485;2760;0.0569;2373;387
2016-03-11 10:00:00;46,86;47,78;-0,92;39855;8803;0.2209;9024;-221;48485;2255;0.0465;2039;216
2016-03-11 11:00:00;47,63;46,15;1,48;39855;10240;0.2569;10497;-257;48485;2315;0.0478;2062;253
2016-03-11 12:00:00;48,0;44,22;3,78;39855;9891;0.2482;10494;-603;48485;2453;0.0506;2204;249
2016-03-11 13:00:00;48,95;47,54;1,41;39855;8080;0.2027;9114;-1034;48485;2368;0.0488;2312;56
2016-03-11 14:00:00;48,96;49,28;-0,32;39855;5602;0.1406;6596;-994;48485;2662;0.0549;2482;180
2016-03-11 15:00:00;59,6;53,01;6,59;39855;2698;0.0677;3306;-608;48485;2708;0.0558;2680;28
2016-03-11 16:00:00;56,35;54,01;2,34;39855;441;0.0111;559;-118;48485;3023;0.0624;2950;73
2016-03-11 17:00:00;59,99;61,62;-1,63;39855;4;0.0001;4;0;48485;3490;0.072;3451;39
2016-03-11 18:00:00;56,03;57,91;-1,88;39855;0;0;0;0;48485;4856;0.1001;4123;733
2016-03-11 19:00:00;48,88;53,35;-4,47;39855;0;0;0;0;48485;6053;0.1248;4933;1120
2016-03-11 20:00:00;42,41;39,34;3,07;39855;0;0;0;0;48485;6640;0.1369;6026;614
2016-03-11 21:00:00;37,27;37,65;-0,38;39855;0;0;0;0;48485;7242;0.1494;7232;10
2016-03-11 22:00:00;36,24;39,24;-3,0;39855;0;0;0;0;48485;8104;0.1672;8414;-310
2016-03-11 23:00:00;33,98;36,21;-2,23;39855;0;0;0;0;48485;9171;0.1891;9377;-206
2016-04-11 00:00:00;32,4;34,75;-2,35;39856;0;0;0;0;48499;9850;0.2031;9655;195
2016-04-11 01:00:00;32,42;32,94;-0,52;39856;0;0;0;0;48499;10279;0.212;10275;4
2016-04-11 02:00:00;30,96;33,04;-2,08;39856;0;0;0;0;48499;11374;0.2345;10753;621
2016-04-11 03:00:00;30,8;32,15;-1,35;39856;0;0;0;0;48499;11690;0.2411;11229;461
2016-04-11 04:00:00;31,98;34,88;-2,9;39856;0;0;0;0;48499;11694;0.2411;11594;100
2016-04-11 05:00:00;34,13;38,26;-4,13;39856;0;0;0;0;48499;11801;0.2434;11823;-22
2016-04-11 06:00:00;36,98;44,91;-7,93;39856;0;0;0;0;48499;12215;0.2518;12041;174
2016-04-11 07:00:00;46,78;50,64;-3,86;39856;292;0.0074;378;-86;48499;12429;0.2563;12036;393
2016-04-11 08:00:00;48,69;53,81;-5,12;39856;2154;0.054;2465;-311;48499;12096;0.2494;11858;238
2016-04-11 09:00:00;47,94;50,36;-2,42;39856;4606;0.1156;5238;-632;48499;11768;0.2426;11619;149
2016-04-11 10:00:00;40,86;49,3;-8,44;39856;6818;0.171;7464;-646;48499;11192;0.2308;11351;-159
2016-04-11 11:00:00;42,83;50,07;-7,24;39856;8387;0.2104;8658;-271;48499;10804;0.2228;11107;-303
2016-04-11 12:00:00;38,05;46,68;-8,63;39856;8731;0.219;8546;185;48499;10494;0.2164;10851;-357
2016-04-11 13:00:00;40,49;46,79;-6,3;39856;7437;0.1866;7252;185;48499;10282;0.212;10442;-160
2016-04-11 14:00:00;43,15;46,78;-3,63;39856;5156;0.1294;5100;56;48499;9234;0.1904;9827;-593
2016-04-11 15:00:00;49,91;53,66;-3,75;39856;2279;0.0572;2432;-153;48499;8785;0.1811;9287;-502
2016-04-11 16:00:00;48,73;57,33;-8,6;39856;288;0.0072;400;-112;48499;9181;0.1893;9236;-55
2016-04-11 17:00:00;52,19;60,04;-7,85;39856;3;0.0001;1;2;48499;9709;0.2002;9779;-70
2016-04-11 18:00:00;49,6;59,36;-9,76;39856;0;0;0;0;48499;10817;0.223;10364;453
2016-04-11 19:00:00;40,15;49,02;-8,87;39856;0;0;0;0;48499;11262;0.2322;10455;807
2016-04-11 20:00:00;39,23;45,52;-6,29;39856;0;0;0;0;48499;11054;0.2279;10003;1051
2016-04-11 21:00:00;38,31;41,05;-2,74;39856;0;0;0;0;48499;10681;0.2202;9427;1254
2016-04-11 22:00:00;37,02;39,86;-2,84;39856;0;0;0;0;48499;10018;0.2066;8850;1168
2016-04-11 23:00:00;34,9;38,01;-3,11;39856;0;0;0;0;48499;9442;0.1947;8228;1214
2016-05-11 00:00:00;37,05;37,27;-0,22;39857;0;0;0;0;48499;8442;0.174;7493;949
2016-05-11 01:00:00;37,07;33,26;3,81;39857;0;0;0;0;48499;8128;0.1676;7126;1002
2016-05-11 02:00:00;36,77;34,0;2,77;39857;0;0;0;0;48499;8404;0.1732;6898;1506
2016-05-11 03:00:00;35,97;33,31;2,66;39857;0;0;0;0;48499;8412;0.1735;6775;1637
2016-05-11 04:00:00;35,54;34,04;1,5;39857;0;0;0;0;48499;8236;0.1698;6765;1471
2016-05-11 05:00:00;35,93;34,7;1,23;39857;0;0;0;0;48499;8239;0.1699;6865;1374
2016-05-11 06:00:00;36,5;34,43;2,07;39857;1;0;1;0;48499;8356;0.1723;7060;1296
2016-05-11 07:00:00;37,02;37,11;-0,09;39857;124;0.0031;161;-37;48499;8206;0.1692;7152;1054
2016-05-11 08:00:00;38,96;41,31;-2,35;39857;805;0.0202;936;-131;48499;8082;0.1667;7035;1047
2016-05-11 09:00:00;39,89;45,27;-5,38;39857;1812;0.0454;1980;-168;48499;7332;0.1512;6836;496
2016-05-11 10:00:00;41,16;44,93;-3,77;39857;3080;0.0773;2729;351;48499;6620;0.1365;6541;79
2016-05-11 11:00:00;44,79;47,46;-2,67;39857;3480;0.0873;3127;353;48499;6207;0.128;6344;-137
2016-05-11 12:00:00;46,54;47,03;-0,49;39857;3194;0.0802;3148;46;48499;5812;0.1198;6330;-518
2016-05-11 13:00:00;40,8;42,54;-1,74;39857;2690;0.0675;2760;-70;48499;5671;0.1169;6400;-729
2016-05-11 14:00:00;39,35;40,67;-1,32;39857;2075;0.0521;2009;66;48499;5580;0.115;6551;-971
2016-05-11 15:00:00;38,88;40,69;-1,81;39857;1122;0.0282;976;146;48499;5348;0.1103;6828;-1480
2016-05-11 16:00:00;42,65;42,88;-0,23;39857;174;0.0044;166;8;48499;5730;0.1182;7297;-1567
2016-05-11 17:00:00;48,1;54,18;-6,08;39857;3;0.0001;0;3;48499;6125;0.1263;7962;-1837
2016-05-11 18:00:00;44,78;53,98;-9,2;39857;0;0;0;0;48499;7127;0.147;8781;-1654
2016-05-11 19:00:00;40,91;47,38;-6,47;39857;0;0;0;0;48499;7768;0.1601;9651;-1883
2016-05-11 20:00:00;37,07;38,73;-1,66;39857;0;0;0;0;48499;8740;0.1802;10408;-1668
2016-05-11 21:00:00;34,32;36,75;-2,43;39857;0;0;0;0;48499;9061;0.1868;11126;-2065
2016-05-11 22:00:00;32,71;38,18;-5,47;39857;0;0;0;0;48499;9344;0.1927;11701;-2357
2016-05-11 23:00:00;29,94;33,08;-3,14;39857;0;0;0;0;48499;9784;0.2018;12008;-2224
2016-06-11 00:00:00;32,23;27,66;4,57;39857;0;0;0;0;48499;9893;0.204;8578;1315
2016-06-11 01:00:00;27,78;22,19;5,59;39857;0;0;0;0;48499;9642;0.1988;8531;1111
2016-06-11 02:00:00;27,95;16,58;11,37;39857;0;0;0;0;48499;9397;0.1937;8375;1022
2016-06-11 03:00:00;25,03;15,81;9,22;39857;0;0;0;0;48499;9276;0.1912;8255;1021
2016-06-11 04:00:00;30,1;18,34;11,76;39857;0;0;0;0;48499;8842;0.1823;8096;746
2016-06-11 05:00:00;29,82;19,31;10,51;39857;0;0;0;0;48499;8549;0.1763;7963;586
2016-06-11 06:00:00;30,89;24,47;6,42;39857;0;0;0;0;48499;8552;0.1763;7914;638
2016-06-11 07:00:00;30,88;24,67;6,21;39857;107;0.0027;132;-25;48499;8115;0.1673;7906;209
2016-06-11 08:00:00;33,81;29,05;4,76;39857;966;0.0243;1137;-171;48499;7663;0.158;7936;-273
2016-06-11 09:00:00;37,02;30,34;6,68;39857;2306;0.0578;2657;-351;48499;6991;0.1442;7914;-923
2016-06-11 10:00:00;37,93;33,87;4,06;39857;3599;0.0903;3982;-383;48499;6638;0.1369;7775;-1137
2016-06-11 11:00:00;41,58;37,31;4,27;39857;4417;0.1108;4788;-371;48499;6539;0.1348;7456;-917
2016-06-11 12:00:00;38,94;35,33;3,61;39857;4328;0.1086;4911;-583;48499;6533;0.1347;6973;-440
2016-06-11 13:00:00;37,07;37,18;-0,11;39857;3670;0.0921;4391;-721;48499;6383;0.1316;6430;-47
2016-06-11 14:00:00;37,09;34,32;2,77;39857;2493;0.0626;3199;-706;48499;6086;0.1255;5960;126
2016-06-11 15:00:00;37,0;35,43;1,57;39857;1092;0.0274;1507;-415;48499;6506;0.1342;5608;898
2016-06-11 16:00:00;39,5;34,22;5,28;39857;148;0.0037;241;-93;48499;7329;0.1512;5699;1630
2016-06-11 17:00:00;48,51;41,53;6,98;39857;2;0.0001;1;1;48499;8272;0.1706;6326;1946
2016-06-11 18:00:00;47,96;38,85;9,11;39857;0;0;0;0;48499;9223;0.1902;7010;2213
2016-06-11 19:00:00;43,27;33,57;9,7;39857;0;0;0;0;48499;9774;0.2015;7386;2388
2016-06-11 20:00:00;37,05;31,26;5,79;39857;0;0;0;0;48499;10084;0.2079;7661;2423
2016-06-11 21:00:00;36,0;30,15;5,85;39857;0;0;0;0;48499;10265;0.2117;7923;2342
2016-06-11 22:00:00;33,33;30,25;3,08;39857;0;0;0;0;48499;10336;0.2131;8143;2193
2016-06-11 23:00:00;30,23;16,46;13,77;39857;0;0;0;0;48499;10405;0.2146;8334;2071
2016-07-11 00:00:00;10,72;13,18;-2,46;39858;0;0;0;0;48509;10277;0.2119;10109;168
2016-07-11 01:00:00;13,61;12,32;1,29;39858;0;0;0;0;48509;10319;0.2127;10187;132
2016-07-11 02:00:00;13,69;13,07;0,62;39858;0;0;0;0;48509;10047;0.2071;10125;-78
2016-07-11 03:00:00;12,6;12,75;-0,15;39858;0;0;0;0;48509;9635;0.1986;9989;-354
2016-07-11 04:00:00;11,94;12,84;-0,9;39858;0;0;0;0;48509;9621;0.1983;9858;-237
2016-07-11 05:00:00;15,82;14,63;1,19;39858;0;0;0;0;48509;8959;0.1847;9749;-790
2016-07-11 06:00:00;33,02;26,19;6,83;39858;0;0;0;0;48509;9122;0.188;9654;-532
2016-07-11 07:00:00;40,81;41,16;-0,35;39858;118;0.003;167;-49;48509;9084;0.1872;9560;-476
2016-07-11 08:00:00;38,01;45,67;-7,66;39858;994;0.025;1422;-428;48509;8805;0.1815;9389;-584
2016-07-11 09:00:00;38,07;46,98;-8,91;39858;2231;0.056;3403;-1172;48509;8197;0.169;9138;-941
2016-07-11 10:00:00;39,93;49,29;-9,36;39858;3299;0.0828;4919;-1620;48509;7845;0.1617;8744;-899
2016-07-11 11:00:00;39,98;52,89;-12,91;39858;4062;0.1019;5626;-1564;48509;7160;0.1476;8175;-1015
2016-07-11 12:00:00;41,76;50,36;-8,6;39858;4086;0.1025;5529;-1443;48509;6516;0.1343;7462;-946
2016-07-11 13:00:00;42,67;49,79;-7,12;39858;3742;0.0939;4720;-978;48509;5843;0.1204;6694;-851
2016-07-11 14:00:00;46,9;52,03;-5,13;39858;2750;0.069;3349;-599;48509;5134;0.1058;5885;-751
2016-07-11 15:00:00;53,03;54,12;-1,09;39858;1415;0.0355;1609;-194;48509;4937;0.1018;5225;-288
2016-07-11 16:00:00;58,45;56,7;1,75;39858;176;0.0044;252;-76;48509;4845;0.0999;4812;33
2016-07-11 17:00:00;69,83;70,61;-0,78;39858;2;0;0;2;48509;4878;0.1006;4699;179
2016-07-11 18:00:00;65,94;57,96;7,98;39858;0;0;0;0;48509;5186;0.1069;4661;525
2016-07-11 19:00:00;59,93;49,03;10,9;39858;0;0;0;0;48509;4930;0.1016;4551;379
2016-07-11 20:00:00;49,99;40,74;9,25;39858;0;0;0;0;48509;5066;0.1044;4219;847
2016-07-11 21:00:00;37,85;37,58;0,27;39858;0;0;0;0;48509;4606;0.095;3828;778
2016-07-11 22:00:00;39,7;39,42;0,28;39858;0;0;0;0;48509;4360;0.0899;3447;913
2016-07-11 23:00:00;38,05;35,48;2,57;39858;0;0;0;0;48509;4158;0.0857;3104;1054
2016-08-11 00:00:00;37,47;34,86;2,61;39860;0;0;0;0;48519;3897;0.0803;3444;453
2016-08-11 01:00:00;36,65;33,69;2,96;39860;0;0;0;0;48519;3688;0.076;3194;494
2016-08-11 02:00:00;36,09;33,76;2,33;39860;0;0;0;0;48519;3651;0.0753;3041;610
2016-08-11 03:00:00;36,17;35,22;0,95;39860;0;0;0;0;48519;3776;0.0778;2963;813
2016-08-11 04:00:00;37,13;35,78;1,35;39860;0;0;0;0;48519;3984;0.0821;2966;1018
2016-08-11 05:00:00;37,17;36,14;1,03;39860;0;0;0;0;48519;4291;0.0884;2998;1293
2016-08-11 06:00:00;46,77;43,74;3,03;39860;0;0;0;0;48519;4318;0.089;3052;1266
2016-08-11 07:00:00;61,65;59,61;2,04;39860;131;0.0033;219;-88;48519;4318;0.089;3060;1258
2016-08-11 08:00:00;64,64;61,26;3,38;39860;1054;0.0264;1653;-599;48519;4224;0.087;2947;1277
2016-08-11 09:00:00;63,89;59,2;4,69;39860;2745;0.0689;3892;-1147;48519;4022;0.0829;2792;1230
2016-08-11 10:00:00;58,97;59,73;-0,76;39860;4256;0.1068;5861;-1605;48519;4038;0.0832;2702;1336
2016-08-11 11:00:00;58,99;60,52;-1,53;39860;4628;0.1161;6805;-2177;48519;4398;0.0907;2711;1687
2016-08-11 12:00:00;58,47;62,16;-3,69;39860;4603;0.1155;6677;-2074;48519;4631;0.0954;2743;1888
2016-08-11 13:00:00;58,94;61,54;-2,6;39860;4409;0.1106;5605;-1196;48519;4833;0.0996;2717;2116
2016-08-11 14:00:00;62,13;62,34;-0,21;39860;3460;0.0868;3898;-438;48519;4940;0.1018;2633;2307
2016-08-11 15:00:00;67,91;65,05;2,86;39860;1580;0.0396;1838;-258;48519;4880;0.1006;2564;2316
2016-08-11 16:00:00;84,92;79,42;5,5;39860;173;0.0043;265;-92;48519;5094;0.105;2643;2451
2016-08-11 17:00:00;104,96;100,8;4,16;39860;2;0;0;2;48519;5411;0.1115;2969;2442
2016-08-11 18:00:00;70,03;64,48;5,55;39860;0;0;0;0;48519;5472;0.1128;3470;2002
2016-08-11 19:00:00;56,43;51,24;5,19;39860;0;0;0;0;48519;5572;0.1148;3976;1596
2016-08-11 20:00:00;44,15;49,39;-5,24;39860;0;0;0;0;48519;5767;0.1189;4221;1546
2016-08-11 21:00:00;42,45;43,43;-0,98;39860;0;0;0;0;48519;5610;0.1156;4371;1239
2016-08-11 22:00:00;40,0;39,84;0,16;39860;0;0;0;0;48519;5700;0.1175;4498;1202
2016-08-11 23:00:00;35,98;35,17;0,81;39860;0;0;0;0;48519;5716;0.1178;4596;1120
2016-09-11 00:00:00;35,6;35,81;-0,21;39864;0;0;0;0;48533;5752;0.1185;4575;1177
2016-09-11 01:00:00;33,38;26,54;6,84;39864;0;0;0;0;48533;5467;0.1126;4646;821
2016-09-11 02:00:00;31,46;29,36;2,1;39864;0;0;0;0;48533;4966;0.1023;4613;353
2016-09-11 03:00:00;31,48;31,02;0,46;39864;0;0;0;0;48533;4592;0.0946;4583;9
2016-09-11 04:00:00;34,23;33,23;1,0;39864;0;0;0;0;48533;4512;0.093;4588;-76
2016-09-11 05:00:00;35,77;34,31;1,46;39864;0;0;0;0;48533;4428;0.0912;4621;-193
2016-09-11 06:00:00;39,77;41,48;-1,71;39864;0;0;0;0;48533;4487;0.0924;4702;-215
2016-09-11 07:00:00;55,2;58,17;-2,97;39864;140;0.0035;231;-91;48533;4744;0.0977;4781;-37
2016-09-11 08:00:00;55,2;56,7;-1,5;39864;1567;0.0393;2230;-663;48533;4705;0.0969;4789;-84
2016-09-11 09:00:00;54,96;54,35;0,61;39864;3821;0.0959;5449;-1628;48533;4241;0.0874;4722;-481
2016-09-11 10:00:00;49,72;51,8;-2,08;39864;6191;0.1553;7834;-1643;48533;3648;0.0752;4669;-1021
2016-09-11 11:00:00;56,92;54,66;2,26;39864;7700;0.1931;8683;-983;48533;3236;0.0667;4695;-1459
2016-09-11 12:00:00;55,82;49,4;6,42;39864;7654;0.192;8110;-456;48533;2909;0.06;4709;-1800
2016-09-11 13:00:00;55,58;48,84;6,74;39864;5951;0.1493;6404;-453;48533;2716;0.056;4627;-1911
2016-09-11 14:00:00;54,28;52,12;2,16;39864;3500;0.0878;4135;-635;48533;2890;0.0596;4736;-1846
2016-09-11 15:00:00;55,08;55,18;-0,1;39864;1262;0.0317;1716;-454;48533;3384;0.0697;5090;-1706
2016-09-11 16:00:00;62,21;57,58;4,63;39864;83;0.0021;175;-92;48533;4398;0.0906;5728;-1330
2016-09-11 17:00:00;78,44;65,96;12,48;39864;0;0;0;0;48533;5656;0.1165;6620;-964
2016-09-11 18:00:00;60,93;56,15;4,78;39864;0;0;0;0;48533;7164;0.1476;7445;-281
2016-09-11 19:00:00;58,5;51,65;6,85;39864;0;0;0;0;48533;7882;0.1624;7773;109
2016-09-11 20:00:00;48,22;42,09;6,13;39864;0;0;0;0;48533;8282;0.1707;7819;463
2016-09-11 21:00:00;40,85;35,05;5,8;39864;0;0;0;0;48533;8548;0.1762;7709;839
2016-09-11 22:00:00;39,5;34,84;4,66;39864;0;0;0;0;48533;8529;0.1758;7474;1055
2016-09-11 23:00:00;36,1;31,0;5,1;39864;0;0;0;0;48533;8554;0.1762;7248;1306
2016-10-11 00:00:00;33,53;31,25;2,28;39867;0;0;0;0;48546;8076;0.1664;6715;1361
2016-10-11 01:00:00;32,95;30,46;2,49;39867;0;0;0;0;48546;8219;0.1693;6505;1714
2016-10-11 02:00:00;31,69;30,07;1,62;39867;0;0;0;0;48546;7972;0.1642;6103;1869
2016-10-11 03:00:00;33,2;29,27;3,93;39867;0;0;0;0;48546;7240;0.1492;5737;1503
2016-10-11 04:00:00;33,53;30,68;2,85;39867;0;0;0;0;48546;6757;0.1392;5450;1307
2016-10-11 05:00:00;35,0;32,57;2,43;39867;0;0;0;0;48546;6469;0.1332;5204;1265
2016-10-11 06:00:00;41,48;36,38;5,1;39867;0;0;0;0;48546;6324;0.1303;4925;1399
2016-10-11 07:00:00;50,37;47,9;2,47;39867;71;0.0018;85;-14;48546;6119;0.126;4586;1533
2016-10-11 08:00:00;58,91;55,19;3,72;39867;736;0.0184;742;-6;48546;5494;0.1132;4230;1264
2016-10-11 09:00:00;59,98;55,82;4,16;39867;1822;0.0457;1819;3;48546;5077;0.1046;3906;1171
2016-10-11 10:00:00;58,52;55,42;3,1;39867;2709;0.0679;2768;-59;48546;4568;0.0941;3627;941
2016-10-11 11:00:00;59,93;55,24;4,69;39867;3519;0.0883;3360;159;48546;4098;0.0844;3438;660
2016-10-11 12:00:00;61,1;55,53;5,57;39867;3727;0.0935;3415;312;48546;3994;0.0823;3268;726
2016-10-11 13:00:00;65,01;57,62;7,39;39867;3237;0.0812;2953;284;48546;3645;0.0751;3056;589
2016-10-11 14:00:00;63,24;57,1;6,14;39867;2358;0.0592;2065;293;48546;3260;0.0672;2806;454
2016-10-11 15:00:00;65,08;59,31;5,77;39867;997;0.025;902;95;48546;3258;0.0671;2630;628
2016-10-11 16:00:00;63,08;55,67;7,41;39867;106;0.0027;122;-16;48546;3710;0.0764;2669;1041
2016-10-11 17:00:00;98,15;84,83;13,32;39867;0;0;0;0;48546;4662;0.0961;2956;1706
2016-10-11 18:00:00;67,87;54,03;13,84;39867;0;0;0;0;48546;5378;0.1108;3316;2062
2016-10-11 19:00:00;60,24;51,12;9,12;39867;0;0;0;0;48546;5739;0.1182;3652;2087
2016-10-11 20:00:00;50,39;46,54;3,85;39867;0;0;0;0;48546;5985;0.1232;3792;2193
2016-10-11 21:00:00;41,96;37,66;4,3;39867;0;0;0;0;48546;5960;0.1228;3838;2122
2016-10-11 22:00:00;39,72;36,5;3,22;39867;0;0;0;0;48546;5790;0.1192;3828;1962
2016-10-11 23:00:00;37,76;35,05;2,71;39867;0;0;0;0;48546;5708;0.1176;3773;1935
2016-11-11 00:00:00;37,07;39,71;-2,64;39868;0;0;0;0;48559;5826;0.12;4804;1022
2016-11-11 01:00:00;36,22;38,22;-2,0;39868;0;0;0;0;48559;5785;0.1191;4833;952
2016-11-11 02:00:00;34,9;36,4;-1,5;39868;0;0;0;0;48559;5811;0.1197;4855;956
2016-11-11 03:00:00;34,46;37,3;-2,84;39868;0;0;0;0;48559;5932;0.1222;4916;1016
2016-11-11 04:00:00;36,46;36,75;-0,29;39868;0;0;0;0;48559;5859;0.1207;5038;821
2016-11-11 05:00:00;35,45;36,62;-1,17;39868;0;0;0;0;48559;6382;0.1314;5185;1197
2016-11-11 06:00:00;37,6;38,26;-0,66;39868;0;0;0;0;48559;7113;0.1465;5282;1831
2016-11-11 07:00:00;48,46;44,57;3,89;39868;55;0.0014;82;-27;48559;7253;0.1494;5214;2039
2016-11-11 08:00:00;54,97;44,53;10,44;39868;584;0.0146;881;-297;48559;7155;0.1473;4896;2259
2016-11-11 09:00:00;54,92;46,62;8,3;39868;1685;0.0423;2335;-650;48559;6691;0.1378;4449;2242
2016-11-11 10:00:00;55,9;50,23;5,67;39868;3000;0.0753;3726;-726;48559;5672;0.1168;3958;1714
2016-11-11 11:00:00;55,93;53,03;2,9;39868;3868;0.097;4646;-778;48559;4976;0.1025;3509;1467
2016-11-11 12:00:00;54,93;56,05;-1,12;39868;4143;0.1039;4825;-682;48559;4448;0.0916;3148;1300
2016-11-11 13:00:00;54,42;54,6;-0,18;39868;3886;0.0975;4211;-325;48559;3905;0.0804;2909;996
2016-11-11 14:00:00;51,7;48,1;3,6;39868;2735;0.0686;2921;-186;48559;3644;0.075;2786;858
2016-11-11 15:00:00;51,71;50,56;1,15;39868;1060;0.0266;1258;-198;48559;3608;0.0743;2726;882
2016-11-11 16:00:00;57,91;56,63;1,28;39868;100;0.0026;157;-57;48559;3430;0.0706;2703;727
2016-11-11 17:00:00;64,92;66,42;-1,5;39868;0;0;0;0;48559;3487;0.0718;2710;777
2016-11-11 18:00:00;56,94;57,91;-0,97;39868;0;0;0;0;48559;3593;0.074;2675;918
2016-11-11 19:00:00;56,25;58,04;-1,79;39868;0;0;0;0;48559;3344;0.0689;2531;813
2016-11-11 20:00:00;45,79;50,3;-4,51;39868;0;0;0;0;48559;3071;0.0632;2242;829
2016-11-11 21:00:00;42,09;44,89;-2,8;39868;0;0;0;0;48559;2876;0.0592;1923;953
2016-11-11 22:00:00;43,48;44,55;-1,07;39868;0;0;0;0;48559;2572;0.053;1627;945
2016-11-11 23:00:00;41,27;43,27;-2,0;39868;0;0;0;0;48559;2280;0.0469;1435;845
2016-12-11 00:00:00;40,21;43,49;-3,28;39868;0;0;0;0;48563;2038;0.0419;1543;495
2016-12-11 01:00:00;38,31;41,95;-3,64;39868;0;0;0;0;48563;1942;0.04;1394;548
2016-12-11 02:00:00;36,78;39,1;-2,32;39868;0;0;0;0;48563;2032;0.0418;1359;673
2016-12-11 03:00:00;36,09;37,09;-1,0;39868;0;0;0;0;48563;2352;0.0484;1390;962
2016-12-11 04:00:00;36,05;35,31;0,74;39868;0;0;0;0;48563;2549;0.0525;1528;1021
2016-12-11 05:00:00;36,09;36,32;-0,23;39868;0;0;0;0;48563;2679;0.0552;1802;877
2016-12-11 06:00:00;36,33;36,47;-0,14;39868;0;0;0;0;48563;2977;0.0613;2169;808
2016-12-11 07:00:00;38,38;42,52;-4,14;39868;68;0.0017;116;-48;48563;3349;0.069;2562;787
2016-12-11 08:00:00;42,21;47,53;-5,32;39868;932;0.0234;1635;-703;48563;3940;0.0811;2946;994
2016-12-11 09:00:00;45,77;47,82;-2,05;39868;3038;0.0762;4346;-1308;48563;4135;0.0851;3281;854
2016-12-11 10:00:00;46,52;50,47;-3,95;39868;5170;0.1297;6584;-1414;48563;4302;0.0886;3468;834
2016-12-11 11:00:00;43,34;49,25;-5,91;39868;6544;0.1641;7898;-1354;48563;4388;0.0903;3518;870
2016-12-11 12:00:00;39,94;47,5;-7,56;39868;6636;0.1664;8002;-1366;48563;4379;0.0902;3506;873
2016-12-11 13:00:00;40,86;45,89;-5,03;39868;5828;0.1462;6972;-1144;48563;4294;0.0884;3508;786
2016-12-11 14:00:00;36,09;40,32;-4,23;39868;3897;0.0977;4889;-992;48563;4255;0.0876;3645;610
2016-12-11 15:00:00;38,06;43,5;-5,44;39868;1510;0.0379;2114;-604;48563;4568;0.0941;3924;644
2016-12-11 16:00:00;45,9;51,09;-5,19;39868;133;0.0033;231;-98;48563;5424;0.1117;4489;935
2016-12-11 17:00:00;51,17;54,54;-3,37;39868;0;0;0;0;48563;6414;0.1321;5355;1059
2016-12-11 18:00:00;48,32;49,04;-0,72;39868;0;0;0;0;48563;7458;0.1536;6230;1228
2016-12-11 19:00:00;39,15;40,03;-0,88;39868;0;0;0;0;48563;7692;0.1584;6963;729
2016-12-11 20:00:00;36,1;39,51;-3,41;39868;0;0;0;0;48563;7700;0.1586;7191;509
2016-12-11 21:00:00;34,77;38,32;-3,55;39868;0;0;0;0;48563;7883;0.1623;7183;700
2016-12-11 22:00:00;34,99;38,14;-3,15;39868;0;0;0;0;48563;7904;0.1628;6996;908
2016-12-11 23:00:00;34,34;35,97;-1,63;39868;0;0;0;0;48563;7790;0.1604;6679;1111
2016-11-13 00:00:00;32,99;35,68;-2,69;39868;0;0;0;0;48563;7936;0.1634;6757;1179
2016-11-13 01:00:00;34,15;37,07;-2,92;39868;0;0;0;0;48563;7949;0.1637;6431;1518
2016-11-13 02:00:00;32,95;34,45;-1,5;39868;0;0;0;0;48563;7909;0.1628;6249;1660
2016-11-13 03:00:00;31,76;33,71;-1,95;39868;0;0;0;0;48563;7953;0.1638;6173;1780
2016-11-13 04:00:00;31,46;32,62;-1,16;39868;0;0;0;0;48563;7998;0.1647;6165;1833
2016-11-13 05:00:00;31,43;31,3;0,13;39868;0;0;0;0;48563;8120;0.1672;6208;1912
2016-11-13 06:00:00;31,63;31,42;0,21;39868;0;0;0;0;48563;7932;0.1633;6163;1769
2016-11-13 07:00:00;31,46;31,15;0,31;39868;124;0.0032;119;5;48563;7500;0.1544;6011;1489
2016-11-13 08:00:00;35,07;33,13;1,94;39868;1512;0.0379;1472;40;48563;7280;0.1499;5754;1526
2016-11-13 09:00:00;36,02;33,17;2,85;39868;4087;0.1025;4286;-199;48563;6773;0.1395;5387;1386
2016-11-13 10:00:00;35,57;34,82;0,75;39868;6984;0.1752;7082;-98;48563;5833;0.1201;4870;963
2016-11-13 11:00:00;36,37;33,07;3,3;39868;8639;0.2167;8632;7;48563;5270;0.1085;4278;992
2016-11-13 12:00:00;36,1;32,81;3,29;39868;8316;0.2086;8812;-496;48563;4919;0.1013;3729;1190
2016-11-13 13:00:00;36,05;30,54;5,51;39868;7936;0.199;7681;255;48563;4220;0.0869;3305;915
2016-11-13 14:00:00;36,28;29,68;6,6;39868;4922;0.1235;5350;-428;48563;3605;0.0742;3207;398
2016-11-13 15:00:00;39,37;35,09;4,28;39868;1897;0.0476;2286;-389;48563;3596;0.074;3399;197
2016-11-13 16:00:00;44,74;47,18;-2,44;39868;125;0.0031;227;-102;48563;4530;0.0932;4017;513
2016-11-13 17:00:00;48,82;45,47;3,35;39868;0;0;0;0;48563;5695;0.1173;4911;784
2016-11-13 18:00:00;48,29;43,62;4,67;39868;0;0;0;0;48563;6588;0.1356;5711;877
2016-11-13 19:00:00;46,07;41,25;4,82;39868;0;0;0;0;48563;7323;0.1508;6176;1147
2016-11-13 20:00:00;40,9;36,29;4,61;39868;0;0;0;0;48563;7708;0.1587;6199;1509
2016-11-13 21:00:00;38,06;30,7;7,36;39868;0;0;0;0;48563;7883;0.1623;6049;1834
2016-11-13 22:00:00;37,44;32,35;5,09;39868;0;0;0;0;48563;8280;0.1705;5809;2471
2016-11-13 23:00:00;35,91;27,85;8,06;39868;0;0;0;0;48563;8232;0.1695;5547;2685
2016-11-14 00:00:00;32,56;27,97;4,59;39872;0;0;0;0;48582;7756;0.1597;5896;1860
2016-11-14 01:00:00;31,61;27,86;3,75;39872;0;0;0;0;48582;7714;0.1588;5852;1862
2016-11-14 02:00:00;31,79;28,41;3,38;39872;0;0;0;0;48582;8103;0.1668;5794;2309
2016-11-14 03:00:00;31,68;28,3;3,38;39872;0;0;0;0;48582;8525;0.1755;5774;2751
2016-11-14 04:00:00;31,68;25,46;6,22;39872;0;0;0;0;48582;8898;0.1832;5854;3044
2016-11-14 05:00:00;32,69;27,93;4,76;39872;0;0;0;0;48582;9570;0.197;6090;3480
2016-11-14 06:00:00;43,92;36,68;7,24;39872;0;0;0;0;48582;10040;0.2066;6383;3657
2016-11-14 07:00:00;54,92;42,41;12,51;39872;224;0.0057;231;-7;48582;10517;0.2165;6690;3827
2016-11-14 08:00:00;51,19;49,94;1,25;39872;3176;0.0796;3276;-100;48582;10952;0.2254;7015;3937
2016-11-14 09:00:00;38,49;39,28;-0,79;39872;7578;0.19;8161;-583;48582;10308;0.2122;7137;3171
2016-11-14 10:00:00;37,07;38,58;-1,51;39872;11382;0.2854;11853;-471;48582;9120;0.1878;6882;2238
2016-11-14 11:00:00;36,94;39,29;-2,35;39872;13082;0.3281;13591;-509;48582;8587;0.1768;6509;2078
2016-11-14 12:00:00;39,51;43,64;-4,13;39872;12644;0.3171;13398;-754;48582;8654;0.1781;6338;2316
2016-11-14 13:00:00;37,84;45,02;-7,18;39872;10405;0.261;11331;-926;48582;8706;0.1792;6530;2176
2016-11-14 14:00:00;42,03;47,77;-5,74;39872;6811;0.1708;7707;-896;48582;8398;0.1728;7134;1264
2016-11-14 15:00:00;51,19;48,74;2,45;39872;2488;0.0624;3262;-774;48582;8683;0.1787;8137;546
2016-11-14 16:00:00;49,95;51,64;-1,69;39872;172;0.0043;307;-135;48582;9826;0.2022;9421;405
2016-11-14 17:00:00;56,09;56,57;-0,48;39872;0;0;0;0;48582;11547;0.2377;10733;814
2016-11-14 18:00:00;46,98;47,03;-0,05;39872;0;0;0;0;48582;13257;0.2729;11906;1351
2016-11-14 19:00:00;38,58;44,2;-5,62;39872;0;0;0;0;48582;14588;0.3002;12872;1716
2016-11-14 20:00:00;40,07;35,9;4,17;39872;0;0;0;0;48582;16042;0.3302;13543;2499
2016-11-14 21:00:00;35,36;33,82;1,54;39872;0;0;0;0;48582;16852;0.3469;14119;2733
2016-11-14 22:00:00;32,67;31,25;1,42;39872;0;0;0;0;48582;16848;0.3468;14584;2264
2016-11-14 23:00:00;31,72;30,52;1,2;39872;0;0;0;0;48582;16486;0.3393;14881;1605
2016-11-15 00:00:00;30,08;31,1;-1,02;39877;0;0;0;0;48591;16009;0.3295;15271;738
2016-11-15 01:00:00;30,18;31,33;-1,15;39877;0;0;0;0;48591;15617;0.3214;15153;464
2016-11-15 02:00:00;27,68;32,03;-4,35;39877;0;0;0;0;48591;15356;0.316;14900;456
2016-11-15 03:00:00;26,58;32,35;-5,77;39877;0;0;0;0;48591;15080;0.3104;14664;416
2016-11-15 04:00:00;30,07;32,67;-2,6;39877;0;0;0;0;48591;15017;0.309;14470;547
2016-11-15 05:00:00;31,67;34,32;-2,65;39877;0;0;0;0;48591;15611;0.3213;14489;1122
2016-11-15 06:00:00;36,6;36,44;0,16;39877;0;0;0;0;48591;16652;0.3427;14662;1990
2016-11-15 07:00:00;44,65;45,28;-0,63;39877;36;0.0009;53;-17;48591;17274;0.3555;14988;2286
2016-11-15 08:00:00;43,94;47,42;-3,48;39877;526;0.0132;492;34;48591;17676;0.3638;15395;2281
2016-11-15 09:00:00;43,96;47,23;-3,27;39877;1567;0.0393;1156;411;48591;17214;0.3543;15809;1405
2016-11-15 10:00:00;43,96;49,08;-5,12;39877;2708;0.068;1611;1097;48591;17706;0.3644;16134;1572
2016-11-15 11:00:00;44,65;45,12;-0,47;39877;3286;0.0824;1782;1504;48591;18282;0.3763;16316;1966
2016-11-15 12:00:00;43,08;43,52;-0,44;39877;3059;0.0767;1604;1455;48591;18204;0.3746;16400;1804
2016-11-15 13:00:00;43,58;43,19;0,39;39877;2394;0.0601;1182;1212;48591;17535;0.3609;16239;1296
2016-11-15 14:00:00;43,97;46,32;-2,35;39877;1366;0.0342;702;664;48591;17137;0.3527;15832;1305
2016-11-15 15:00:00;44,01;50,09;-6,08;39877;434;0.0109;286;148;48591;16872;0.3472;15335;1537
2016-11-15 16:00:00;44,97;51,49;-6,52;39877;36;0.0009;39;-3;48591;16502;0.3396;14876;1626
2016-11-15 17:00:00;51,98;54,04;-2,06;39877;0;0;0;0;48591;16260;0.3346;14456;1804
2016-11-15 18:00:00;48,02;49,4;-1,38;39877;0;0;0;0;48591;16235;0.3341;14112;2123
2016-11-15 19:00:00;52,91;48,28;4,63;39877;0;0;0;0;48591;15878;0.3268;13815;2063
2016-11-15 20:00:00;44,74;40,63;4,11;39877;0;0;0;0;48591;15257;0.314;13364;1893
2016-11-15 21:00:00;38,22;36,89;1,33;39877;0;0;0;0;48591;14628;0.301;12784;1844
2016-11-15 22:00:00;38,42;37,72;0,7;39877;0;0;0;0;48591;13604;0.28;12118;1486
2016-11-15 23:00:00;35,4;35,76;-0,36;39877;0;0;0;0;48591;12648;0.2603;11423;1225
2016-11-16 00:00:00;35,55;34,44;1,11;39898;0;0;0;0;48605;11264;0.2317;10646;618
2016-11-16 01:00:00;34,14;34,28;-0,14;39898;0;0;0;0;48605;10234;0.2106;9834;400
2016-11-16 02:00:00;33,4;35,31;-1,91;39898;0;0;0;0;48605;9568;0.1968;9236;332
2016-11-16 03:00:00;33,45;35,04;-1,59;39898;0;0;0;0;48605;9321;0.1918;8897;424
2016-11-16 04:00:00;33,05;34,49;-1,44;39898;0;0;0;0;48605;9146;0.1881;8822;324
2016-11-16 05:00:00;38,59;35,77;2,82;39898;0;0;0;0;48605;9272;0.1907;9152;120
2016-11-16 06:00:00;46,99;37,64;9,35;39898;0;0;0;0;48605;9783;0.2013;9727;56
2016-11-16 07:00:00;51,92;44,3;7,62;39898;18;0.0005;23;-5;48605;10574;0.2176;10562;12
2016-11-16 08:00:00;55,96;46,1;9,86;39898;329;0.0082;288;41;48605;11562;0.2379;11779;-217
2016-11-16 09:00:00;57,81;44,1;13,71;39898;1040;0.026;760;280;48605;12510;0.2574;13278;-768
2016-11-16 10:00:00;56,36;43,16;13,2;39898;1737;0.0435;1173;564;48605;13486;0.2775;14950;-1464
2016-11-16 11:00:00;53,96;43,12;10,84;39898;2044;0.0512;1405;639;48605;15369;0.3162;16641;-1272
2016-11-16 12:00:00;46,9;43,26;3,64;39898;2086;0.0523;1454;632;48605;17370;0.3574;18283;-913
2016-11-16 13:00:00;45,36;41,06;4,3;39898;1874;0.047;1291;583;48605;18516;0.3809;19602;-1086
2016-11-16 14:00:00;40,94;39,89;1,05;39898;1376;0.0345;925;451;48605;19311;0.3973;20674;-1363
2016-11-16 15:00:00;40,11;40,52;-0,41;39898;559;0.014;384;175;48605;19820;0.4078;21623;-1803
2016-11-16 16:00:00;40,83;43,27;-2,44;39898;63;0.0016;46;17;48605;20653;0.4249;22058;-1405
2016-11-16 17:00:00;48,91;46,87;2,04;39898;0;0;0;0;48605;21238;0.437;21960;-722
2016-11-16 18:00:00;46,95;42,3;4,65;39898;0;0;0;0;48605;22212;0.457;21688;524
2016-11-16 19:00:00;46,95;35,25;11,7;39898;0;0;0;0;48605;22792;0.4689;21366;1426
2016-11-16 20:00:00;40,58;29,83;10,75;39898;0;0;0;0;48605;22884;0.4708;20697;2187
2016-11-16 21:00:00;36,12;24,35;11,77;39898;0;0;0;0;48605;22192;0.4566;19889;2303
2016-11-16 22:00:00;36,13;23,54;12,59;39898;0;0;0;0;48605;21311;0.4384;18996;2315
2016-11-16 23:00:00;31,73;16,48;15,25;39898;0;0;0;0;48605;20631;0.4245;18002;2629
2016-11-17 00:00:00;27,1;18,17;8,93;39908;0;0;0;0;48623;19923;0.4098;18794;1129
2016-11-17 01:00:00;26,44;13,57;12,87;39908;0;0;0;0;48623;18836;0.3874;18340;496
2016-11-17 02:00:00;22,38;11,39;10,99;39908;0;0;0;0;48623;18110;0.3725;17853;257
2016-11-17 03:00:00;24,99;15,52;9,47;39908;0;0;0;0;48623;17783;0.3657;17479;304
2016-11-17 04:00:00;28,16;24,25;3,91;39908;0;0;0;0;48623;17783;0.3657;17134;649
2016-11-17 05:00:00;30,85;26,33;4,52;39908;0;0;0;0;48623;17091;0.3515;16842;249
2016-11-17 06:00:00;38,54;33,6;4,94;39908;0;0;0;0;48623;17540;0.3607;16580;960
2016-11-17 07:00:00;47,94;40,38;7,56;39908;27;0.0007;32;-5;48623;17288;0.3556;16501;787
2016-11-17 08:00:00;48,93;41,97;6,96;39908;437;0.011;544;-107;48623;17146;0.3526;16748;398
2016-11-17 09:00:00;43,14;41,35;1,79;39908;1564;0.0392;1713;-149;48623;17509;0.3601;17213;296
2016-11-17 10:00:00;42,93;39,04;3,89;39908;2938;0.0736;2859;79;48623;18767;0.386;17953;814
2016-11-17 11:00:00;43,91;38,07;5,84;39908;4048;0.1014;3566;482;48623;19738;0.4059;18908;830
2016-11-17 12:00:00;43,65;35,51;8,14;39908;4952;0.1241;3654;1298;48623;20432;0.4202;19778;654
2016-11-17 13:00:00;41,66;31,96;9,7;39908;4421;0.1108;3223;1198;48623;21040;0.4327;20550;490
2016-11-17 14:00:00;37,13;32,72;4,41;39908;3098;0.0776;2229;869;48623;21554;0.4433;21544;10
2016-11-17 15:00:00;37,36;31,41;5,95;39908;1238;0.031;870;368;48623;21574;0.4437;22362;-788
2016-11-17 16:00:00;37,91;31,66;6,25;39908;121;0.003;91;30;48623;22465;0.462;22992;-527
2016-11-17 17:00:00;37,99;34,47;3,52;39908;0;0;0;0;48623;24672;0.5074;23855;817
2016-11-17 18:00:00;37,47;30,19;7,28;39908;0;0;0;0;48623;25850;0.5316;25055;795
2016-11-17 19:00:00;35,62;22,97;12,65;39908;0;0;0;0;48623;27016;0.5556;26441;575
2016-11-17 20:00:00;32,08;22,6;9,48;39908;0;0;0;0;48623;28657;0.5894;27849;808
2016-11-17 21:00:00;26,92;17,91;9,01;39908;0;0;0;0;48623;30103;0.6191;29210;893
2016-11-17 22:00:00;13,72;6,93;6,79;39908;0;0;0;0;48623;30112;0.6193;30197;-85
2016-11-17 23:00:00;8,26;0,97;7,29;39908;0;0;0;0;48623;30284;0.6228;30549;-265
2016-11-18 00:00:00;0,1;-3,19;3,29;39916;0;0;0;0;48629;29616;0.609;30913;-1297
2016-11-18 01:00:00;-12,1;-6,42;-5,68;39916;0;0;0;0;48629;28730;0.5908;30060;-1330
2016-11-18 02:00:00;-10,0;-0,74;-9,26;39916;0;0;0;0;48629;27546;0.5665;28722;-1176
2016-11-18 03:00:00;-0,01;6,2;-6,21;39916;0;0;0;0;48629;27001;0.5552;27554;-553
2016-11-18 04:00:00;8,86;13,25;-4,39;39916;0;0;0;0;48629;26371;0.5423;26524;-153
2016-11-18 05:00:00;13,22;22,06;-8,84;39916;0;0;0;0;48629;27096;0.5572;25718;1378
2016-11-18 06:00:00;29,83;37,16;-7,33;39916;0;0;0;0;48629;27489;0.5652;25213;2276
2016-11-18 07:00:00;37,88;38,73;-0,85;39916;78;0.002;55;23;48629;26828;0.5516;25368;1460
2016-11-18 08:00:00;34,74;38,09;-3,35;39916;1036;0.026;915;121;48629;28224;0.5804;26236;1988
2016-11-18 09:00:00;34,65;40,89;-6,24;39916;2672;0.067;2580;92;48629;27730;0.5702;26848;882
2016-11-18 10:00:00;33,86;40,94;-7,08;39916;4580;0.1147;4129;451;48629;28078;0.5774;27149;929
2016-11-18 11:00:00;33,13;42,48;-9,35;39916;5105;0.1279;5107;-2;48629;27630;0.5682;27387;243
2016-11-18 12:00:00;31,04;41,47;-10,43;39916;4573;0.1145;5146;-573;48629;27041;0.5561;27704;-663
2016-11-18 13:00:00;31,06;42,69;-11,63;39916;4058;0.1017;4298;-240;48629;26710;0.5493;27262;-552
2016-11-18 14:00:00;31,79;41,26;-9,47;39916;2888;0.0724;2897;-9;48629;25596;0.5263;25905;-309
2016-11-18 15:00:00;35,99;39,69;-3,7;39916;1160;0.029;1161;-1;48629;24055;0.4947;24352;-297
2016-11-18 16:00:00;39,96;43,46;-3,5;39916;114;0.0029;102;12;48629;23878;0.491;23311;567
2016-11-18 17:00:00;39,98;46,68;-6,7;39916;0;0;0;0;48629;24954;0.5132;23034;1920
2016-11-18 18:00:00;39,02;44,82;-5,8;39916;0;0;0;0;48629;25716;0.5288;23157;2559
2016-11-18 19:00:00;34,06;36,86;-2,8;39916;0;0;0;0;48629;25957;0.5337;23456;2501
2016-11-18 20:00:00;34,02;32,86;1,16;39916;0;0;0;0;48629;25901;0.5326;23746;2155
2016-11-18 21:00:00;27,66;27,6;0,06;39916;0;0;0;0;48629;26066;0.536;23776;2290
2016-11-18 22:00:00;17,88;22,09;-4,21;39916;0;0;0;0;48629;25025;0.5146;23574;1451
2016-11-18 23:00:00;13,57;22,14;-8,57;39916;0;0;0;0;48629;23935;0.4922;23273;662
2016-11-19 00:00:00;13,79;22,71;-8,92;39916;0;0;0;0;48629;22910;0.4711;24020;-1110
2016-11-19 01:00:00;12,69;23,82;-11,13;39916;0;0;0;0;48629;21401;0.4401;22901;-1500
2016-11-19 02:00:00;12,85;23,49;-10,64;39916;0;0;0;0;48629;19229;0.3954;21393;-2164
2016-11-19 03:00:00;15,18;29,22;-14,04;39916;0;0;0;0;48629;17954;0.3692;20143;-2189
2016-11-19 04:00:00;20,56;29,07;-8,51;39916;0;0;0;0;48629;17567;0.3612;19289;-1722
2016-11-19 05:00:00;18,58;29,51;-10,93;39916;0;0;0;0;48629;17627;0.3625;18875;-1248
2016-11-19 06:00:00;20,2;30,39;-10,19;39916;0;0;0;0;48629;17986;0.3699;18690;-704
2016-11-19 07:00:00;33,36;39,28;-5,92;39916;11;0.0003;27;-16;48629;17666;0.3633;18444;-778
2016-11-19 08:00:00;37,01;41,54;-4,53;39916;427;0.0107;683;-256;48629;17219;0.3541;18012;-793
2016-11-19 09:00:00;41,08;43,12;-2,04;39916;1263;0.0316;2179;-916;48629;16429;0.3378;17446;-1017
2016-11-19 10:00:00;41,0;43,16;-2,16;39916;2038;0.051;3506;-1468;48629;15503;0.3188;16864;-1361
2016-11-19 11:00:00;40,1;45,6;-5,5;39916;2605;0.0652;4288;-1683;48629;15208;0.3127;16466;-1258
2016-11-19 12:00:00;39,24;46,38;-7,14;39916;3025;0.0758;4297;-1272;48629;15780;0.3245;16193;-413
2016-11-19 13:00:00;36,97;40,27;-3,3;39916;3128;0.0784;3572;-444;48629;15635;0.3215;15660;-25
2016-11-19 14:00:00;36,96;38,88;-1,92;39916;2328;0.0583;2372;-44;48629;15210;0.3128;14736;474
2016-11-19 15:00:00;39,96;38,56;1,4;39916;1041;0.0261;916;125;48629;14449;0.2971;13863;586
2016-11-19 16:00:00;46,9;37,01;9,89;39916;97;0.0024;86;11;48629;14536;0.2989;13492;1044
2016-11-19 17:00:00;46,95;45,3;1,65;39916;0;0;0;0;48629;15041;0.3093;13877;1164
2016-11-19 18:00:00;42,96;44,68;-1,72;39916;0;0;0;0;48629;16130;0.3317;14622;1508
2016-11-19 19:00:00;39,97;39,26;0,71;39916;0;0;0;0;48629;16894;0.3474;15287;1607
2016-11-19 20:00:00;33,8;32,5;1,3;39916;0;0;0;0;48629;17380;0.3574;15799;1581
2016-11-19 21:00:00;33,08;31,59;1,49;39916;0;0;0;0;48629;17641;0.3628;16044;1597
2016-11-19 22:00:00;32,14;32,05;0,09;39916;0;0;0;0;48629;17180;0.3533;16149;1031
2016-11-19 23:00:00;22,09;24,23;-2,14;39916;0;0;0;0;48629;17354;0.3569;16177;1177
2016-11-20 00:00:00;13,66;23,21;-9,55;39916;0;0;0;0;48629;17558;0.3611;15847;1711
2016-11-20 01:00:00;13,62;13,29;0,33;39916;0;0;0;0;48629;17646;0.3629;16022;1624
2016-11-20 02:00:00;14,66;8,59;6,07;39916;0;0;0;0;48629;18333;0.377;16464;1869
2016-11-20 03:00:00;13,61;6,32;7,29;39916;0;0;0;0;48629;19491;0.4008;17125;2366
2016-11-20 04:00:00;13,64;5,26;8,38;39916;0;0;0;0;48629;21106;0.434;18206;2900
2016-11-20 05:00:00;5,68;-9,23;14,91;39916;0;0;0;0;48629;22902;0.471;19705;3197
2016-11-20 06:00:00;1,0;-23,41;24,41;39916;0;0;0;0;48629;25514;0.5247;21357;4157
2016-11-20 07:00:00;-0,01;-39,55;39,54;39916;65;0.0016;63;2;48629;27787;0.5714;23175;4612
2016-11-20 08:00:00;8,04;-44,27;52,31;39916;1580;0.0396;1614;-34;48629;29432;0.6052;24899;4533
2016-11-20 09:00:00;5,68;-56,7;62,38;39916;4319;0.1082;4683;-364;48629;30218;0.6214;26485;3733
2016-11-20 10:00:00;-0,44;-57,76;57,32;39916;7416;0.1858;7142;274;48629;30543;0.6281;27793;2750
2016-11-20 11:00:00;-0,04;-56,67;56,63;39916;9166;0.2296;8323;843;48629;31450;0.6467;28813;2637
2016-11-20 12:00:00;-9,94;-60,36;50,42;39916;9063;0.2271;8272;791;48629;31953;0.6571;29779;2174
2016-11-20 13:00:00;-22,17;-63,06;40,89;39916;7853;0.1967;6922;931;48629;31958;0.6572;30744;1214
2016-11-20 14:00:00;-30,41;-52,47;22,06;39916;5282;0.1323;4566;716;48629;32379;0.6658;31603;776
2016-11-20 15:00:00;-15,68;-22,86;7,18;39916;1998;0.05;1734;264;48629;32558;0.6695;32353;205
2016-11-20 16:00:00;-29,04;-5,54;-23,5;39916;134;0.0034;139;-5;48629;32844;0.6754;32690;154
2016-11-20 17:00:00;9,9;16,76;-6,86;39916;0;0;0;0;48629;32379;0.6659;32613;-234
2016-11-20 18:00:00;8,06;15,97;-7,91;39916;0;0;0;0;48629;31613;0.6501;32317;-704
2016-11-20 19:00:00;8,99;16,35;-7,36;39916;0;0;0;0;48629;30277;0.6226;31746;-1469
2016-11-20 20:00:00;-1,58;13,83;-15,41;39916;0;0;0;0;48629;28403;0.584;30926;-2523
2016-11-20 21:00:00;-3,35;21,3;-24,65;39916;0;0;0;0;48629;26047;0.5356;29649;-3602
2016-11-20 22:00:00;3,45;25,82;-22,37;39916;0;0;0;0;48629;24210;0.4978;28101;-3891
2016-11-20 23:00:00;-14,91;23,24;-38,15;39916;0;0;0;0;48629;23186;0.4768;26366;-3180
2016-11-21 00:00:00;13,56;16,73;-3,17;39917;0;0;0;0;48638;21607;0.4442;21661;-54
2016-11-21 01:00:00;8,81;12,28;-3,47;39917;0;0;0;0;48638;20467;0.4208;19800;667
2016-11-21 02:00:00;9,79;10,46;-0,67;39917;0;0;0;0;48638;18975;0.3901;17986;989
2016-11-21 03:00:00;11,01;11,9;-0,89;39917;0;0;0;0;48638;17161;0.3528;16496;665
2016-11-21 04:00:00;10,88;10,38;0,5;39917;0;0;0;0;48638;15782;0.3245;15546;236
2016-11-21 05:00:00;20,0;20,15;-0,15;39917;0;0;0;0;48638;14800;0.3043;15224;-424
2016-11-21 06:00:00;38,71;31,63;7,08;39917;0;0;0;0;48638;15246;0.3135;15406;-160
2016-11-21 07:00:00;49,86;43,24;6,62;39917;70;0.0017;67;3;48638;16042;0.3298;15823;219
2016-11-21 08:00:00;49,4;44,26;5,14;39917;1367;0.0342;1472;-105;48638;16310;0.3354;16203;107
2016-11-21 09:00:00;46,25;41,13;5,12;39917;3802;0.0953;4041;-239;48638;16431;0.3378;16356;75
2016-11-21 10:00:00;41,15;45,22;-4,07;39917;5857;0.1467;6129;-272;48638;15502;0.3187;15971;-469
2016-11-21 11:00:00;41,61;47,7;-6,09;39917;6900;0.1729;7183;-283;48638;14252;0.293;15013;-761
2016-11-21 12:00:00;41,75;46,39;-4,64;39917;6295;0.1577;6915;-620;48638;12936;0.266;14129;-1193
2016-11-21 13:00:00;45,74;47,52;-1,78;39917;4723;0.1183;5532;-809;48638;11616;0.2388;13653;-2037
2016-11-21 14:00:00;46,91;50,41;-3,5;39917;2674;0.067;3430;-756;48638;11631;0.2391;13835;-2204
2016-11-21 15:00:00;48,0;50,4;-2,4;39917;857;0.0215;1195;-338;48638;13429;0.2761;14554;-1125
2016-11-21 16:00:00;44,72;48,65;-3,93;39917;63;0.0016;75;-12;48638;16078;0.3306;15558;520
2016-11-21 17:00:00;45,56;46,6;-1,04;39917;0;0;0;0;48638;18830;0.3871;16583;2247
2016-11-21 18:00:00;38,71;43,38;-4,67;39917;0;0;0;0;48638;19815;0.4074;17462;2353
2016-11-21 19:00:00;36,3;41,8;-5,5;39917;0;0;0;0;48638;19641;0.4038;18091;1550
2016-11-21 20:00:00;35,75;39,08;-3,33;39917;0;0;0;0;48638;18613;0.3827;18366;247
2016-11-21 21:00:00;32,84;36,19;-3,35;39917;0;0;0;0;48638;17646;0.3628;18371;-725
2016-11-21 22:00:00;32,46;38,32;-5,86;39917;0;0;0;0;48638;16930;0.3481;18291;-1361
2016-11-21 23:00:00;22,07;30,94;-8,87;39917;0;0;0;0;48638;16944;0.3484;18190;-1246
2016-11-22 00:00:00;24,1;28,46;-4,36;39923;0;0;0;0;48657;17392;0.3574;17637;-245
2016-11-22 01:00:00;27,11;27,98;-0,87;39923;0;0;0;0;48657;17048;0.3504;16876;172
2016-11-22 02:00:00;21,49;23,01;-1,52;39923;0;0;0;0;48657;15885;0.3264;16036;-151
2016-11-22 03:00:00;21,0;18,05;2,95;39923;0;0;0;0;48657;15363;0.3157;15264;99
2016-11-22 04:00:00;19,99;19,18;0,81;39923;0;0;0;0;48657;15536;0.3193;14585;951
2016-11-22 05:00:00;29,38;29,04;0,34;39923;0;0;0;0;48657;14886;0.306;14036;850
2016-11-22 06:00:00;33,89;29,13;4,76;39923;0;0;0;0;48657;14449;0.297;13527;922
2016-11-22 07:00:00;40,89;37,62;3,27;39923;47;0.0012;61;-14;48657;14131;0.2904;12911;1220
2016-11-22 08:00:00;39,43;40,41;-0,98;39923;971;0.0244;1557;-586;48657;13647;0.2805;12089;1558
2016-11-22 09:00:00;37,16;39,45;-2,29;39923;2618;0.0656;4504;-1886;48657;12752;0.2621;11175;1577
2016-11-22 10:00:00;35,85;39,77;-3,92;39923;4318;0.1082;6940;-2622;48657;11546;0.2373;9933;1613
2016-11-22 11:00:00;36,35;40,65;-4,3;39923;5194;0.1301;8295;-3101;48657;10037;0.2063;8436;1601
2016-11-22 12:00:00;37,0;41,31;-4,31;39923;4995;0.1251;8258;-3263;48657;8446;0.1736;7112;1334
2016-11-22 13:00:00;38,46;41,66;-3,2;39923;4258;0.1066;6807;-2549;48657;6869;0.1412;6159;710
2016-11-22 14:00:00;46,02;47,74;-1,72;39923;2926;0.0733;4343;-1417;48657;5772;0.1186;5661;111
2016-11-22 15:00:00;51,94;49,99;1,95;39923;1114;0.0279;1555;-441;48657;5487;0.1128;5502;-15
2016-11-22 16:00:00;51,51;48,41;3,1;39923;88;0.0022;102;-14;48657;6452;0.1326;5623;829
2016-11-22 17:00:00;64,2;55,33;8,87;39923;0;0;0;0;48657;7213;0.1482;5899;1314
2016-11-22 18:00:00;54,67;50,4;4,27;39923;0;0;0;0;48657;7682;0.1579;6123;1559
2016-11-22 19:00:00;51,99;45,49;6,5;39923;0;0;0;0;48657;7844;0.1612;6132;1712
2016-11-22 20:00:00;46,98;38,76;8,22;39923;0;0;0;0;48657;7793;0.1602;5901;1892
2016-11-22 21:00:00;38,77;36,81;1,96;39923;0;0;0;0;48657;7000;0.1439;5543;1457
2016-11-22 22:00:00;37,17;34,91;2,26;39923;0;0;0;0;48657;6150;0.1264;5142;1008
2016-11-22 23:00:00;34,8;32,05;2,75;39923;0;0;0;0;48657;5754;0.1182;4732;1022
2016-11-23 00:00:00;34,61;34,16;0,45;39935;0;0;0;0;48663;5257;0.108;5036;221
2016-11-23 01:00:00;33,65;31,42;2,23;39935;0;0;0;0;48663;4359;0.0896;4628;-269
2016-11-23 02:00:00;33,46;32,47;0,99;39935;0;0;0;0;48663;3496;0.0718;4223;-727
2016-11-23 03:00:00;32,08;32,54;-0,46;39935;0;0;0;0;48663;2779;0.0571;3911;-1132
2016-11-23 04:00:00;33,54;33,3;0,24;39935;0;0;0;0;48663;2450;0.0503;3698;-1248
2016-11-23 05:00:00;35,38;35,35;0,03;39935;0;0;0;0;48663;2428;0.0499;3602;-1174
2016-11-23 06:00:00;46,34;46,62;-0,28;39935;0;0;0;0;48663;2541;0.0522;3530;-989
2016-11-23 07:00:00;48,81;49,14;-0,33;39935;34;0.0008;43;-9;48663;2677;0.055;3425;-748
2016-11-23 08:00:00;51,1;52,09;-0,99;39935;1290;0.0323;1178;112;48663;3204;0.0658;3240;-36
2016-11-23 09:00:00;53,94;51,03;2,91;39935;3871;0.0969;3882;-11;48663;3067;0.063;2995;72
2016-11-23 10:00:00;51,0;47,08;3,92;39935;5960;0.1492;6356;-396;48663;2756;0.0566;2605;151
2016-11-23 11:00:00;51,95;48,2;3,75;39935;6947;0.174;7749;-802;48663;2330;0.0479;2132;198
2016-11-23 12:00:00;49,99;48,02;1,97;39935;7242;0.1813;7853;-611;48663;1702;0.035;1731;-29
2016-11-23 13:00:00;51,92;49,41;2,51;39935;6314;0.1581;6687;-373;48663;1448;0.0298;1531;-83
2016-11-23 14:00:00;54,98;50,25;4,73;39935;3890;0.0974;4361;-471;48663;1362;0.028;1641;-279
2016-11-23 15:00:00;58,48;52,01;6,47;39935;1251;0.0313;1546;-295;48663;1662;0.0342;1984;-322
2016-11-23 16:00:00;55,01;54,77;0,24;39935;97;0.0024;100;-3;48663;2456;0.0505;2487;-31
2016-11-23 17:00:00;62,0;58,71;3,29;39935;0;0;0;0;48663;3297;0.0678;3071;226
2016-11-23 18:00:00;52,92;52,16;0,76;39935;0;0;0;0;48663;4108;0.0844;3653;455
2016-11-23 19:00:00;50,0;48,96;1,04;39935;0;0;0;0;48663;4826;0.0992;4214;612
2016-11-23 20:00:00;39,13;39,54;-0,41;39935;0;0;0;0;48663;5564;0.1143;4718;846
2016-11-23 21:00:00;37,21;37,29;-0,08;39935;0;0;0;0;48663;6225;0.1279;5200;1025
2016-11-23 22:00:00;37,79;37,25;0,54;39935;0;0;0;0;48663;6608;0.1358;5782;826
2016-11-23 23:00:00;33,99;32,46;1,53;39935;0;0;0;0;48663;7414;0.1523;6565;849
2016-11-24 00:00:00;32,66;32,87;-0,21;39938;0;0;0;0;48688;8813;0.181;7309;1504
2016-11-24 01:00:00;31,61;30,06;1,55;39938;0;0;0;0;48688;10185;0.2092;8088;2097
2016-11-24 02:00:00;30,8;28,96;1,84;39938;0;0;0;0;48688;10981;0.2255;8581;2400
2016-11-24 03:00:00;29,58;27,11;2,47;39938;0;0;0;0;48688;11144;0.2289;8877;2267
2016-11-24 04:00:00;29,76;27,58;2,18;39938;0;0;0;0;48688;11100;0.228;9082;2018
2016-11-24 05:00:00;32,44;29,69;2,75;39938;0;0;0;0;48688;10832;0.2224;9225;1607
2016-11-24 06:00:00;36,5;34,94;1,56;39938;0;0;0;0;48688;10669;0.2192;9322;1347
2016-11-24 07:00:00;43,12;42,8;0,32;39938;15;0.0004;26;-11;48688;10888;0.2236;9325;1563
2016-11-24 08:00:00;45,97;44,63;1,34;39938;639;0.016;846;-207;48688;11105;0.2281;9168;1937
2016-11-24 09:00:00;44,96;43,04;1,92;39938;2368;0.0593;2947;-579;48688;10392;0.2134;8873;1519
2016-11-24 10:00:00;43,69;44,27;-0,58;39938;4304;0.1078;4969;-665;48688;8222;0.1689;8344;-122
2016-11-24 11:00:00;44,25;46,69;-2,44;39938;5674;0.1421;6260;-586;48688;7600;0.1561;7686;-86
2016-11-24 12:00:00;42,87;45,22;-2,35;39938;6084;0.1524;6541;-457;48688;6952;0.1428;7247;-295
2016-11-24 13:00:00;42,91;46,78;-3,87;39938;5357;0.1342;5737;-380;48688;6550;0.1345;7131;-581
2016-11-24 14:00:00;42,77;45,6;-2,83;39938;3492;0.0874;3903;-411;48688;6690;0.1374;7352;-662
2016-11-24 15:00:00;44,59;46,33;-1,74;39938;1136;0.0284;1461;-325;48688;7603;0.1562;7816;-213
2016-11-24 16:00:00;49,36;50,64;-1,28;39938;67;0.0017;98;-31;48688;9260;0.1902;8450;810
2016-11-24 17:00:00;50,97;51,61;-0,64;39938;0;0;0;0;48688;9456;0.1942;9110;346
2016-11-24 18:00:00;45,23;44,93;0,3;39938;0;0;0;0;48688;11208;0.2302;9609;1599
2016-11-24 19:00:00;44,1;42,01;2,09;39938;0;0;0;0;48688;11769;0.2417;9802;1967
2016-11-24 20:00:00;38,07;36,68;1,39;39938;0;0;0;0;48688;11671;0.2397;9699;1972
2016-11-24 21:00:00;37,71;37,28;0,43;39938;0;0;0;0;48688;11462;0.2354;9405;2057
2016-11-24 22:00:00;35,88;34,01;1,87;39938;0;0;0;0;48688;10658;0.2189;9052;1606
2016-11-24 23:00:00;33,62;33,5;0,12;39938;0;0;0;0;48688;10200;0.2095;8735;1465
2016-11-25 00:00:00;35,23;31,54;3,69;39947;0;0;0;0;48703;9721;0.1996;8418;1303
2016-11-25 01:00:00;32,99;30,54;2,45;39947;0;0;0;0;48703;9464;0.1943;8216;1248
2016-11-25 02:00:00;32,02;30,23;1,79;39947;0;0;0;0;48703;9293;0.1908;8099;1194
2016-11-25 03:00:00;31,05;29,21;1,84;39947;0;0;0;0;48703;9249;0.1899;8022;1227
2016-11-25 04:00:00;31,18;29,24;1,94;39947;0;0;0;0;48703;9124;0.1874;7895;1229
2016-11-25 05:00:00;34,85;33,55;1,3;39947;0;0;0;0;48703;9008;0.1849;7782;1226
2016-11-25 06:00:00;37,98;34,09;3,89;39947;0;0;0;0;48703;8978;0.1844;7597;1381
2016-11-25 07:00:00;47,1;43,45;3,65;39947;9;0.0002;16;-7;48703;8573;0.176;7247;1326
2016-11-25 08:00:00;48,49;45,56;2,93;39947;446;0.0112;630;-184;48703;8025;0.1648;6780;1245
2016-11-25 09:00:00;47,97;43,7;4,27;39947;2058;0.0515;2381;-323;48703;7158;0.147;6334;824
2016-11-25 10:00:00;47,42;45,1;2,32;39947;4143;0.1038;4140;3;48703;6359;0.1306;5876;483
2016-11-25 11:00:00;48,25;46,19;2,06;39947;5775;0.1446;5254;521;48703;5577;0.1145;5457;120
2016-11-25 12:00:00;47,95;44,86;3,09;39947;6145;0.1538;5422;723;48703;5003;0.1027;5125;-122
2016-11-25 13:00:00;47,95;44,69;3,26;39947;5226;0.1309;4658;568;48703;4508;0.0925;5033;-525
2016-11-25 14:00:00;47,92;46,39;1,53;39947;3197;0.08;3025;172;48703;4176;0.0857;5186;-1010
2016-11-25 15:00:00;48,81;47,96;0,85;39947;964;0.0241;1047;-83;48703;3959;0.0813;5429;-1470
2016-11-25 16:00:00;49,96;49,63;0,33;39947;58;0.0015;58;0;48703;3977;0.0817;5642;-1665
2016-11-25 17:00:00;54,75;53,64;1,11;39947;0;0;0;0;48703;3892;0.0799;5681;-1789
2016-11-25 18:00:00;48,29;47,28;1,01;39947;0;0;0;0;48703;3499;0.0718;5580;-2081
2016-11-25 19:00:00;48,94;46,31;2,63;39947;0;0;0;0;48703;3086;0.0634;5272;-2186
2016-11-25 20:00:00;43,52;43,7;-0,18;39947;0;0;0;0;48703;2783;0.0571;4813;-2030
2016-11-25 21:00:00;38,92;38,33;0,59;39947;0;0;0;0;48703;2606;0.0535;4353;-1747
2016-11-25 22:00:00;38,67;39,72;-1,05;39947;0;0;0;0;48703;2467;0.0506;3940;-1473
2016-11-25 23:00:00;35,24;37,05;-1,81;39947;0;0;0;0;48703;2387;0.049;3549;-1162
2016-11-26 00:00:00;32,5;36,88;-4,38;39948;0;0;0;0;48703;2302;0.0473;3283;-981
2016-11-26 01:00:00;31,93;33,19;-1,26;39948;0;0;0;0;48703;2339;0.048;3083;-744
2016-11-26 02:00:00;31,82;32,21;-0,39;39948;0;0;0;0;48703;2186;0.0449;2968;-782
2016-11-26 03:00:00;31,84;30,79;1,05;39948;0;0;0;0;48703;2215;0.0455;2916;-701
2016-11-26 04:00:00;32,07;29,44;2,63;39948;0;0;0;0;48703;2392;0.0491;2961;-569
2016-11-26 05:00:00;32,35;31,75;0,6;39948;0;0;0;0;48703;2668;0.0548;3098;-430
2016-11-26 06:00:00;33,36;33,92;-0,56;39948;0;0;0;0;48703;2799;0.0575;3259;-460
2016-11-26 07:00:00;42,22;40,99;1,23;39948;4;0.0002;9;-5;48703;2948;0.0605;3408;-460
2016-11-26 08:00:00;44,1;45,99;-1,89;39948;250;0.0062;365;-115;48703;3003;0.0617;3572;-569
2016-11-26 09:00:00;46,76;49,09;-2,33;39948;1079;0.027;1464;-385;48703;3102;0.0637;3781;-679
2016-11-26 10:00:00;48,92;50,73;-1,81;39948;2009;0.0503;2625;-616;48703;3330;0.0684;4069;-739
2016-11-26 11:00:00;48,56;52,12;-3,56;39948;2523;0.0632;3362;-839;48703;3894;0.08;4455;-561
2016-11-26 12:00:00;47,91;51,23;-3,32;39948;2673;0.0669;3423;-750;48703;4588;0.0942;4929;-341
2016-11-26 13:00:00;43,97;47,94;-3,97;39948;2172;0.0544;2874;-702;48703;5234;0.1075;5531;-297
2016-11-26 14:00:00;38,24;42,19;-3,95;39948;1245;0.0312;1797;-552;48703;5971;0.1226;6292;-321
2016-11-26 15:00:00;40,44;43,83;-3,39;39948;400;0.01;583;-183;48703;6373;0.1309;7183;-810
2016-11-26 16:00:00;45,3;48,07;-2,77;39948;25;0.0007;28;-3;48703;7198;0.1478;8235;-1037
2016-11-26 17:00:00;47,96;52,09;-4,13;39948;0;0;0;0;48703;8356;0.1716;9439;-1083
2016-11-26 18:00:00;43,95;50,51;-6,56;39948;0;0;0;0;48703;9518;0.1954;10710;-1192
2016-11-26 19:00:00;37,5;47,25;-9,75;39948;0;0;0;0;48703;10558;0.2168;11815;-1257
2016-11-26 20:00:00;32,91;37,62;-4,71;39948;0;0;0;0;48703;11240;0.2308;12749;-1509
2016-11-26 21:00:00;32,75;33,99;-1,24;39948;0;0;0;0;48703;11872;0.2438;13510;-1638
2016-11-26 22:00:00;31,72;34,3;-2,58;39948;0;0;0;0;48703;12876;0.2644;14110;-1234
2016-11-26 23:00:00;28,25;33,29;-5,04;39948;0;0;0;0;48703;13508;0.2774;14538;-1030
2016-11-27 00:00:00;22,92;32,03;-9,11;39948;0;0;0;0;48703;13915;0.2857;15162;-1247
2016-11-27 01:00:00;21,14;28,15;-7,01;39948;0;0;0;0;48703;14112;0.2898;15134;-1022
2016-11-27 02:00:00;20,25;25,24;-4,99;39948;0;0;0;0;48703;14025;0.2879;14896;-871
2016-11-27 03:00:00;20,28;25,93;-5,65;39948;0;0;0;0;48703;13735;0.282;14603;-868
2016-11-27 04:00:00;20,95;26,1;-5,15;39948;0;0;0;0;48703;13352;0.2742;14199;-847
2016-11-27 05:00:00;27,0;28,35;-1,35;39948;0;0;0;0;48703;12792;0.2627;13557;-765
2016-11-27 06:00:00;28,02;29,62;-1,6;39948;0;0;0;0;48703;12470;0.2561;12778;-308
2016-11-27 07:00:00;28,93;30,81;-1,88;39948;8;0.0002;8;0;48703;11888;0.2441;11903;-15
2016-11-27 08:00:00;31,35;31,39;-0,04;39948;476;0.0119;404;72;48703;11255;0.2311;10964;291
2016-11-27 09:00:00;33,19;34,8;-1,61;39948;2282;0.0571;1768;514;48703;9803;0.2013;9974;-171
2016-11-27 10:00:00;34,24;36,23;-1,99;39948;4550;0.1139;3342;1208;48703;8460;0.1737;8935;-475
2016-11-27 11:00:00;38,13;40,18;-2,05;39948;5752;0.144;4543;1209;48703;7728;0.1586;8089;-361
2016-11-27 12:00:00;35,69;38,77;-3,08;39948;5988;0.1498;4888;1100;48703;8084;0.166;7648;436
2016-11-27 13:00:00;33,44;35,15;-1,71;39948;5322;0.1332;4346;976;48703;8088;0.166;7581;507
2016-11-27 14:00:00;33,53;35,04;-1,51;39948;3189;0.0798;2819;370;48703;8310;0.1706;7796;514
2016-11-27 15:00:00;34,2;36,16;-1,96;39948;920;0.023;897;23;48703;8281;0.17;8237;44
2016-11-27 16:00:00;37,48;38,67;-1,19;39948;46;0.0012;45;1;48703;9444;0.194;9003;441
2016-11-27 17:00:00;41,07;45,84;-4,77;39948;0;0;0;0;48703;11145;0.2288;9952;1193
2016-11-27 18:00:00;41,05;45,05;-4,0;39948;0;0;0;0;48703;12198;0.2504;10784;1414
2016-11-27 19:00:00;36,08;38,87;-2,79;39948;0;0;0;0;48703;13672;0.2807;11293;2379
2016-11-27 20:00:00;34,69;36,38;-1,69;39948;0;0;0;0;48703;14445;0.2966;11420;3025
2016-11-27 21:00:00;32,69;33,85;-1,16;39948;0;0;0;0;48703;14134;0.2902;11463;2671
2016-11-27 22:00:00;32,16;36,27;-4,11;39948;0;0;0;0;48703;14000;0.2874;11464;2536
2016-11-27 23:00:00;28,43;30,62;-2,19;39948;0;0;0;0;48703;14410;0.2958;11400;3010
2016-11-28 00:00:00;27,06;25,57;1,49;39955;0;0;0;0;48726;14947;0.3068;12668;2279
2016-11-28 01:00:00;28,24;24,85;3,39;39955;0;0;0;0;48726;15316;0.3143;12671;2645
2016-11-28 02:00:00;24,31;17,07;7,24;39955;0;0;0;0;48726;15118;0.3103;12500;2618
2016-11-28 03:00:00;24,03;12,98;11,05;39955;0;0;0;0;48726;14817;0.304;12194;2623
2016-11-28 04:00:00;26,81;15,87;10,94;39955;0;0;0;0;48726;14539;0.2984;11752;2787
2016-11-28 05:00:00;31,96;26,46;5,5;39955;0;0;0;0;48726;13757;0.2823;11162;2595
2016-11-28 06:00:00;37,94;29,44;8,5;39955;0;0;0;0;48726;13296;0.2729;10487;2809
2016-11-28 07:00:00;47,88;40,2;7,68;39955;12;0.0003;27;-15;48726;12810;0.2629;9706;3104
2016-11-28 08:00:00;46,99;41,28;5,71;39955;1371;0.0343;1748;-377;48726;11852;0.2432;8816;3036
2016-11-28 09:00:00;44,42;39,37;5,05;39955;5762;0.1442;6211;-449;48726;9958;0.2044;7803;2155
2016-11-28 10:00:00;37,92;37,0;0,92;39955;10309;0.258;9977;332;48726;7900;0.1621;6587;1313
2016-11-28 11:00:00;43,53;38,71;4,82;39955;12686;0.3175;12060;626;48726;6791;0.1394;5516;1275
2016-11-28 12:00:00;37,38;35,31;2,07;39955;12798;0.3203;12215;583;48726;6279;0.1289;4818;1461
2016-11-28 13:00:00;44,81;39,16;5,65;39955;10686;0.2675;10491;195;48726;5500;0.1129;4455;1045
2016-11-28 14:00:00;45,77;42,38;3,39;39955;6774;0.1695;6987;-213;48726;4688;0.0962;4305;383
2016-11-28 15:00:00;51,38;49,99;1,39;39955;2211;0.0554;2458;-247;48726;4272;0.0877;4335;-63
2016-11-28 16:00:00;57,21;57,78;-0,57;39955;102;0.0026;116;-14;48726;4502;0.0924;4586;-84
2016-11-28 17:00:00;65,11;68,31;-3,2;39955;0;0;0;0;48726;5339;0.1096;4996;343
2016-11-28 18:00:00;51,42;53,09;-1,67;39955;0;0;0;0;48726;5818;0.1194;5306;512
2016-11-28 19:00:00;48,5;49,72;-1,22;39955;0;0;0;0;48726;5628;0.1155;5319;309
2016-11-28 20:00:00;45,97;45,67;0,3;39955;0;0;0;0;48726;5354;0.1099;5090;264
2016-11-28 21:00:00;39,29;44,28;-4,99;39955;0;0;0;0;48726;4952;0.1016;4873;79
2016-11-28 22:00:00;36,14;38,86;-2,72;39955;0;0;0;0;48726;4601;0.0944;4834;-233
2016-11-28 23:00:00;34,59;35,12;-0,53;39955;0;0;0;0;48726;4560;0.0936;5040;-480
2016-11-29 00:00:00;36,92;38,7;-1,78;39970;0;0;0;0;48752;4730;0.097;4972;-242
2016-11-29 01:00:00;35,78;36,99;-1,21;39970;0;0;0;0;48752;5122;0.1051;5387;-265
2016-11-29 02:00:00;34,81;35,19;-0,38;39970;0;0;0;0;48752;5736;0.1176;5857;-121
2016-11-29 03:00:00;34,43;34,08;0,35;39970;0;0;0;0;48752;6302;0.1292;6375;-73
2016-11-29 04:00:00;34,89;32,86;2,03;39970;0;0;0;0;48752;6898;0.1415;6852;46
2016-11-29 05:00:00;36,75;39,4;-2,65;39970;0;0;0;0;48752;7499;0.1538;7275;224
2016-11-29 06:00:00;44,68;47,4;-2,72;39970;0;0;0;0;48752;8079;0.1657;7692;387
2016-11-29 07:00:00;54,95;62,05;-7,1;39970;9;0.0002;30;-21;48752;8621;0.1768;8060;561
2016-11-29 08:00:00;52,65;57,18;-4,53;39970;1766;0.0441;1813;-47;48752;9022;0.1851;8299;723
2016-11-29 09:00:00;48,5;55,49;-6,99;39970;6250;0.1564;6516;-266;48752;8790;0.1803;8277;513
2016-11-29 10:00:00;43,69;47,91;-4,22;39970;10892;0.2725;10498;394;48752;7892;0.1619;7899;-7
2016-11-29 11:00:00;42,2;46,81;-4,61;39970;13975;0.3496;12600;1375;48752;6933;0.1422;7624;-691
2016-11-29 12:00:00;40,42;44,01;-3,59;39970;14321;0.3583;12715;1606;48752;6652;0.1364;7531;-879
2016-11-29 13:00:00;41,75;44,05;-2,3;39970;12273;0.3071;10969;1304;48752;6378;0.1308;7647;-1269
2016-11-29 14:00:00;43,12;46,56;-3,44;39970;7996;0.2;7348;648;48752;6404;0.1314;8238;-1834
2016-11-29 15:00:00;50,94;52,11;-1,17;39970;2756;0.069;2519;237;48752;7120;0.146;9122;-2002
2016-11-29 16:00:00;55,58;62,34;-6,76;39970;140;0.0035;107;33;48752;8705;0.1786;10259;-1554
2016-11-29 17:00:00;55,66;72,64;-16,98;39970;0;0;0;0;48752;10518;0.2157;11357;-839
2016-11-29 18:00:00;52,61;66,93;-14,32;39970;0;0;0;0;48752;12009;0.2464;12197;-188
2016-11-29 19:00:00;47,94;53,01;-5,07;39970;0;0;0;0;48752;12932;0.2653;12912;20
2016-11-29 20:00:00;39,97;48,18;-8,21;39970;0;0;0;0;48752;13689;0.2808;13448;241
2016-11-29 21:00:00;35,9;43,97;-8,07;39970;0;0;0;0;48752;14375;0.2949;13975;400
2016-11-29 22:00:00;32,9;37,06;-4,16;39970;0;0;0;0;48752;14708;0.3017;14604;104
2016-11-29 23:00:00;30,38;32,75;-2,37;39970;0;0;0;0;48752;15397;0.3158;15289;108
2016-11-30 00:00:00;27,75;33,31;-5,56;39977;0;0;0;0;48794;16154;0.3311;16216;-62
2016-11-30 01:00:00;27,36;34,9;-7,54;39977;0;0;0;0;48794;16719;0.3426;16983;-264
2016-11-30 02:00:00;27,02;34,39;-7,37;39977;0;0;0;0;48794;17282;0.3542;17698;-416
2016-11-30 03:00:00;25,3;32,25;-6,95;39977;0;0;0;0;48794;17766;0.3641;18326;-560
2016-11-30 04:00:00;28,04;33,41;-5,37;39977;0;0;0;0;48794;17944;0.3678;18900;-956
2016-11-30 05:00:00;29,93;37,35;-7,42;39977;0;0;0;0;48794;18265;0.3744;19388;-1123
2016-11-30 06:00:00;34,13;44,58;-10,45;39977;0;0;0;0;48794;18936;0.3881;19764;-828
2016-11-30 07:00:00;47,92;55,28;-7,36;39977;5;0.0001;23;-18;48794;19340;0.3964;20014;-674
2016-11-30 08:00:00;47,91;50,99;-3,08;39977;962;0.0241;1107;-145;48794;19385;0.3973;20099;-714
2016-11-30 09:00:00;44,47;47,78;-3,31;39977;3905;0.0976;4025;-120;48794;19690;0.4035;20046;-356
2016-11-30 10:00:00;37,49;41,41;-3,92;39977;7072;0.1769;6531;541;48794;19132;0.3921;19997;-865
2016-11-30 11:00:00;37,91;39,74;-1,83;39977;8918;0.223;7842;1076;48794;18667;0.3826;19958;-1291
2016-11-30 12:00:00;37,42;37,91;-0,49;39977;8890;0.2224;7744;1146;48794;18710;0.3834;19996;-1286
2016-11-30 13:00:00;35,98;37,36;-1,38;39977;7267;0.1818;6418;849;48794;19582;0.4013;20173;-591
2016-11-30 14:00:00;39,33;37,63;1,7;39977;4430;0.1108;4072;358;48794;19806;0.4059;20502;-696
2016-11-30 15:00:00;38,74;38,43;0,31;39977;1548;0.0387;1413;135;48794;20144;0.4128;20857;-713
2016-11-30 16:00:00;44,75;45,2;-0,45;39977;84;0.0021;70;14;48794;21025;0.4309;21238;-213
2016-11-30 17:00:00;46,93;49,61;-2,68;39977;0;0;0;0;48794;22428;0.4597;21732;696
2016-11-30 18:00:00;39,95;44,58;-4,63;39977;0;0;0;0;48794;23602;0.4837;22200;1402
2016-11-30 19:00:00;39,47;40,02;-0,55;39977;0;0;0;0;48794;23989;0.4916;22643;1346
2016-11-30 20:00:00;35,08;34,41;0,67;39977;0;0;0;0;48794;23949;0.4908;23048;901
2016-11-30 21:00:00;32,58;34,55;-1,97;39977;0;0;0;0;48794;23895;0.4897;23438;457
2016-11-30 22:00:00;31,86;33,07;-1,21;39977;0;0;0;0;48794;23732;0.4864;23790;-58
2016-11-30 23:00:00;27,0;31,01;-4,01;39977;0;0;0;0;48794;24150;0.495;24155;-5
2016-01-12 00:00:00;26,79;28,12;-1,33;40007;0;0;0;0;48818;24214;0.496;24934;-720
2016-01-12 01:00:00;14,95;24,93;-9,98;40007;0;0;0;0;48818;24189;0.4955;25363;-1174
2016-01-12 02:00:00;11,95;23,79;-11,84;40007;0;0;0;0;48818;24420;0.5002;25631;-1211
2016-01-12 03:00:00;10,27;26,39;-16,12;40007;0;0;0;0;48818;24897;0.51;25974;-1077
2016-01-12 04:00:00;11,29;26,78;-15,49;40007;0;0;0;0;48818;25294;0.5181;26373;-1079
2016-01-12 05:00:00;21,93;32,27;-10,34;40007;0;0;0;0;48818;25814;0.5288;26755;-941
2016-01-12 06:00:00;32,06;42,8;-10,74;40007;0;0;0;0;48818;26863;0.5503;27083;-220
2016-01-12 07:00:00;35,39;47,02;-11,63;40007;8;0.0002;8;0;48818;27251;0.5582;27313;-62
2016-01-12 08:00:00;34,36;44,55;-10,19;40007;308;0.0077;385;-77;48818;27189;0.557;27580;-391
2016-01-12 09:00:00;37,01;40,45;-3,44;40007;1153;0.0288;1553;-400;48818;26713;0.5472;27870;-1157
2016-01-12 10:00:00;38,79;43,58;-4,79;40007;2213;0.0553;2770;-557;48818;26814;0.5493;28147;-1333
2016-01-12 11:00:00;36,36;44,29;-7,93;40007;3042;0.076;3618;-576;48818;27390;0.5611;28431;-1041
2016-01-12 12:00:00;33,99;44,11;-10,12;40007;3412;0.0853;3845;-433;48818;27753;0.5685;28663;-910
2016-01-12 13:00:00;32,29;40,05;-7,76;40007;3260;0.0815;3377;-117;48818;27974;0.573;28922;-948
2016-01-12 14:00:00;31,37;40,8;-9,43;40007;2306;0.0576;2228;78;48818;28171;0.577;29708;-1537
2016-01-12 15:00:00;31,38;43,55;-12,17;40007;863;0.0216;789;74;48818;28692;0.5877;30057;-1365
2016-01-12 16:00:00;32,38;45,95;-13,57;40007;48;0.0012;45;3;48818;29549;0.6053;30334;-785
2016-01-12 17:00:00;35,73;44,24;-8,51;40007;0;0;0;0;48818;29961;0.6138;30624;-663
2016-01-12 18:00:00;32,94;41,89;-8,95;40007;0;0;0;0;48818;30802;0.631;30910;-108
2016-01-12 19:00:00;33,86;40,22;-6,36;40007;0;0;0;0;48818;31082;0.6367;31075;7
2016-01-12 20:00:00;31,32;35,63;-4,31;40007;0;0;0;0;48818;31207;0.6392;31351;-144
2016-01-12 21:00:00;28,01;31,93;-3,92;40007;0;0;0;0;48818;31158;0.6382;31442;-284
2016-01-12 22:00:00;19,66;29,93;-10,27;40007;0;0;0;0;48818;30359;0.6219;31439;-1080
2016-01-12 23:00:00;8,94;22,08;-13,14;40007;0;0;0;0;48818;30223;0.6191;31317;-1094
2016-02-12 00:00:00;7,23;15,49;-8,26;40013;0;0;0;0;48839;29434;0.6027;30440;-1006
2016-02-12 01:00:00;7,2;17,06;-9,86;40013;0;0;0;0;48839;28953;0.5928;30127;-1174
2016-02-12 02:00:00;6,07;13,11;-7,04;40013;0;0;0;0;48839;28243;0.5783;29372;-1129
2016-02-12 03:00:00;8,79;14,18;-5,39;40013;0;0;0;0;48839;27271;0.5584;28274;-1003
2016-02-12 04:00:00;19,83;19,82;0,01;40013;0;0;0;0;48839;25854;0.5294;26404;-550
2016-02-12 05:00:00;26,88;27,78;-0,9;40013;0;0;0;0;48839;24431;0.5002;23814;617
2016-02-12 06:00:00;31,87;35,28;-3,41;40013;0;0;0;0;48839;22107;0.4526;20949;1158
2016-02-12 07:00:00;46,06;48,13;-2,07;40013;2;0.0001;7;-5;48839;18957;0.3882;17925;1032
2016-02-12 08:00:00;46,94;48,37;-1,43;40013;550;0.0137;686;-136;48839;15804;0.3236;15163;641
2016-02-12 09:00:00;44,71;49,39;-4,68;40013;2673;0.0668;2887;-214;48839;12662;0.2593;12782;-120
2016-02-12 10:00:00;43,5;49,13;-5,63;40013;5243;0.131;5017;226;48839;10220;0.2093;10703;-483
2016-02-12 11:00:00;46,9;50,78;-3,88;40013;6894;0.1723;6253;641;48839;8675;0.1776;9020;-345
2016-02-12 12:00:00;46,93;50,27;-3,34;40013;7466;0.1866;6345;1121;48839;7784;0.1594;7643;141
2016-02-12 13:00:00;47,97;48,42;-0,45;40013;6233;0.1558;5325;908;48839;6921;0.1417;6813;108
2016-02-12 14:00:00;49,54;50,95;-1,41;40013;3792;0.0948;3326;466;48839;5840;0.1196;6497;-657
2016-02-12 15:00:00;51,11;57,79;-6,68;40013;1055;0.0264;965;90;48839;5312;0.1088;6626;-1314
2016-02-12 16:00:00;49,99;61,66;-11,67;40013;34;0.0008;35;-1;48839;5693;0.1166;7062;-1369
2016-02-12 17:00:00;56,85;66,02;-9,17;40013;0;0;0;0;48839;6586;0.1348;7608;-1022
2016-02-12 18:00:00;58,1;61,56;-3,46;40013;0;0;0;0;48839;7043;0.1442;7798;-755
2016-02-12 19:00:00;50,03;52,1;-2,07;40013;0;0;0;0;48839;7180;0.147;7613;-433
2016-02-12 20:00:00;52,07;44,26;7,81;40013;0;0;0;0;48839;6864;0.1406;7160;-296
2016-02-12 21:00:00;47,91;41,42;6,49;40013;0;0;0;0;48839;6374;0.1305;6555;-181
2016-02-12 22:00:00;44,02;36,84;7,18;40013;0;0;0;0;48839;6089;0.1247;5910;179
2016-02-12 23:00:00;36,03;34,16;1,87;40013;0;0;0;0;48839;5587;0.1144;5401;186
2016-03-12 00:00:00;32,9;33,11;-0,21;40013;0;0;0;0;48841;4784;0.098;5147;-363
2016-03-12 01:00:00;33,11;35,08;-1,97;40013;0;0;0;0;48841;4124;0.0844;4597;-473
2016-03-12 02:00:00;33,71;35,21;-1,5;40013;0;0;0;0;48841;3710;0.0759;4035;-325
2016-03-12 03:00:00;33,49;35,29;-1,8;40013;0;0;0;0;48841;3497;0.0716;3530;-33
2016-03-12 04:00:00;33,63;35,63;-2,0;40013;0;0;0;0;48841;3396;0.0695;3081;315
2016-03-12 05:00:00;33,21;35,76;-2,55;40013;0;0;0;0;48841;3226;0.066;2676;550
2016-03-12 06:00:00;36,69;36,21;0,48;40013;0;0;0;0;48841;3020;0.0618;2338;682
2016-03-12 07:00:00;36,0;34,82;1,18;40013;3;0;11;-8;48841;2784;0.057;2043;741
2016-03-12 08:00:00;39,0;39,58;-0,58;40013;826;0.0206;807;19;48841;2582;0.0529;1799;783
2016-03-12 09:00:00;45,96;40,11;5,85;40013;4169;0.1042;4056;113;48841;2238;0.0458;1587;651
2016-03-12 10:00:00;40,13;37,32;2,81;40013;8346;0.2086;7739;607;48841;1776;0.0364;1384;392
2016-03-12 11:00:00;38,22;33,98;4,24;40013;11260;0.2814;9879;1381;48841;1250;0.0256;1239;11
2016-03-12 12:00:00;37,32;32,46;4,86;40013;12044;0.301;10259;1785;48841;1058;0.0216;1180;-122
2016-03-12 13:00:00;36,18;31,93;4,25;40013;10462;0.2614;8879;1583;48841;1147;0.0235;1230;-83
2016-03-12 14:00:00;39,69;34,48;5,21;40013;6690;0.1672;5799;891;48841;1359;0.0278;1474;-115
2016-03-12 15:00:00;47,94;43,61;4,33;40013;2149;0.0537;1940;209;48841;1746;0.0358;1860;-114
2016-03-12 16:00:00;52,0;48,79;3,21;40013;72;0.0018;81;-9;48841;2443;0.05;2352;91
2016-03-12 17:00:00;64,6;58,85;5,75;40013;0;0;3;-3;48841;3210;0.0657;2853;357
2016-03-12 18:00:00;58,94;50,49;8,45;40013;0;0;0;0;48841;3834;0.0785;3252;582
2016-03-12 19:00:00;48,9;44,37;4,53;40013;0;0;0;0;48841;4237;0.0867;3467;770
2016-03-12 20:00:00;44,97;37,99;6,98;40013;0;0;0;0;48841;4127;0.0845;3519;608
2016-03-12 21:00:00;40,73;37,76;2,97;40013;0;0;0;0;48841;4076;0.0835;3510;566
2016-03-12 22:00:00;41,9;38,73;3,17;40013;0;0;0;0;48841;4076;0.0835;3493;583
2016-03-12 23:00:00;34,42;33,77;0,65;40013;0;0;0;0;48841;4322;0.0885;3523;799
2016-04-12 00:00:00;35,6;37,06;-1,46;40013;0;0;0;0;48841;4252;0.0871;3616;636
2016-04-12 01:00:00;33,9;34,92;-1,02;40013;0;0;0;0;48841;4162;0.0852;3547;615
2016-04-12 02:00:00;34,22;34,48;-0,26;40013;0;0;0;0;48841;4055;0.083;3571;484
2016-04-12 03:00:00;34,28;34,45;-0,17;40013;0;0;0;0;48841;3974;0.0814;3569;405
2016-04-12 04:00:00;33,75;33,38;0,37;40013;0;0;0;0;48841;3962;0.0812;3456;506
2016-04-12 05:00:00;33,75;34,61;-0,86;40013;0;0;0;0;48841;3870;0.0792;3333;537
2016-04-12 06:00:00;33,85;33,41;0,44;40013;0;0;0;0;48841;3675;0.0752;3227;448
2016-04-12 07:00:00;33,1;34,16;-1,06;40013;2;0;13;-11;48841;3394;0.0695;3143;251
2016-04-12 08:00:00;35,08;37,43;-2,35;40013;790;0.0198;1031;-241;48841;3324;0.068;3064;260
2016-04-12 09:00:00;36,28;37,55;-1,27;40013;3826;0.0956;4390;-564;48841;3186;0.0652;2949;237
2016-04-12 10:00:00;35,88;38,14;-2,26;40013;7163;0.179;7900;-737;48841;2868;0.0587;2711;157
2016-04-12 11:00:00;36,33;38,82;-2,49;40013;9759;0.2439;10068;-309;48841;2518;0.0516;2351;167
2016-04-12 12:00:00;34,42;35,45;-1,03;40013;10277;0.2568;10445;-168;48841;2201;0.0451;2099;102
2016-04-12 13:00:00;34,02;34,98;-0,96;40013;8807;0.2201;8968;-161;48841;2164;0.0443;2041;123
2016-04-12 14:00:00;34,2;36,94;-2,74;40013;5548;0.1386;5825;-277;48841;2310;0.0473;2292;18
2016-04-12 15:00:00;35,68;40,72;-5,04;40013;1799;0.045;1964;-165;48841;2682;0.0549;2766;-84
2016-04-12 16:00:00;44,0;49,13;-5,13;40013;68;0.0017;77;-9;48841;3577;0.0732;3378;199
2016-04-12 17:00:00;47,98;50,43;-2,45;40013;0;0;0;0;48841;4751;0.0973;3811;940
2016-04-12 18:00:00;48,96;49,8;-0,84;40013;0;0;0;0;48841;5369;0.1099;4099;1270
2016-04-12 19:00:00;49,9;47,73;2,17;40013;0;0;0;0;48841;5550;0.1136;4245;1305
2016-04-12 20:00:00;46,95;45,87;1,08;40013;0;0;0;0;48841;5630;0.1152;4254;1376
2016-04-12 21:00:00;43,91;42,03;1,88;40013;0;0;0;0;48841;5584;0.1143;4205;1379
2016-04-12 22:00:00;46,34;43,57;2,77;40013;0;0;0;0;48841;5358;0.1097;4074;1284
2016-04-12 23:00:00;35,75;38,67;-2,92;40013;0;0;0;0;48841;5278;0.1081;3896;1382
2016-05-12 00:00:00;35,77;37,93;-2,16;40018;0;0;0;0;48867;5079;0.104;4173;906
2016-05-12 01:00:00;35,03;37,48;-2,45;40018;0;0;0;0;48867;4637;0.0949;3925;712
2016-05-12 02:00:00;33,56;37,46;-3,9;40018;0;0;0;0;48867;4326;0.0885;3702;624
2016-05-12 03:00:00;33,27;37,7;-4,43;40018;0;0;0;0;48867;4117;0.0842;3488;629
2016-05-12 04:00:00;34,93;38,27;-3,34;40018;0;0;0;0;48867;3788;0.0775;3318;470
2016-05-12 05:00:00;37,44;41,15;-3,71;40018;0;0;0;0;48867;3635;0.0744;3212;423
2016-05-12 06:00:00;50,38;51,17;-0,79;40018;0;0;0;0;48867;3505;0.0717;3119;386
2016-05-12 07:00:00;62,55;64,06;-1,51;40018;2;0;12;-10;48867;3250;0.0665;3054;196
2016-05-12 08:00:00;64,79;71,72;-6,93;40018;558;0.0139;812;-254;48867;3141;0.0642;2991;150
2016-05-12 09:00:00;56,45;69,43;-12,98;40018;3066;0.0766;3953;-887;48867;2948;0.0603;2886;62
2016-05-12 10:00:00;47,93;59,61;-11,68;40018;6174;0.1543;7692;-1518;48867;2606;0.0533;2635;-29
2016-05-12 11:00:00;46,98;63,85;-16,87;40018;8370;0.2092;10234;-1864;48867;2132;0.0436;2332;-200
2016-05-12 12:00:00;39,65;55,07;-15,42;40018;8805;0.22;10737;-1932;48867;1698;0.0347;2115;-417
2016-05-12 13:00:00;54,45;68,93;-14,48;40018;7307;0.1826;9458;-2151;48867;1570;0.0321;1978;-408
2016-05-12 14:00:00;62,36;71,82;-9,46;40018;4472;0.1117;6223;-1751;48867;1746;0.0357;2054;-308
2016-05-12 15:00:00;62,36;71,93;-9,57;40018;1296;0.0324;2067;-771;48867;2160;0.0442;2389;-229
2016-05-12 16:00:00;63,45;75,13;-11,68;40018;42;0.001;75;-33;48867;2717;0.0556;2845;-128
2016-05-12 17:00:00;78,39;87,75;-9,36;40018;0;0;0;0;48867;3458;0.0708;3337;121
2016-05-12 18:00:00;58,42;82,78;-24,36;40018;0;0;0;0;48867;3886;0.0795;3788;98
2016-05-12 19:00:00;56,96;77,78;-20,82;40018;0;0;0;0;48867;4216;0.0863;4209;7
2016-05-12 20:00:00;48,9;60,32;-11,42;40018;0;0;0;0;48867;4466;0.0914;4516;-50
2016-05-12 21:00:00;40,99;48,08;-7,09;40018;0;0;0;0;48867;4654;0.0952;4711;-57
2016-05-12 22:00:00;33,94;42,44;-8,5;40018;0;0;0;0;48867;4852;0.0993;4847;5
2016-05-12 23:00:00;33,51;38,54;-5,03;40018;0;0;0;0;48867;5058;0.1035;4986;72
2016-06-12 00:00:00;38,02;38,44;-0,42;40019;0;0;0;0;48870;5223;0.1068;6237;-1014
2016-06-12 01:00:00;41,58;41,7;-0,12;40019;0;0;0;0;48870;5292;0.1083;6203;-911
2016-06-12 02:00:00;36,53;34,98;1,55;40019;0;0;0;0;48870;5093;0.1042;5989;-896
2016-06-12 03:00:00;38,15;35,73;2,42;40019;0;0;0;0;48870;4833;0.0989;5584;-751
2016-06-12 04:00:00;42,93;40,16;2,77;40019;0;0;0;0;48870;4538;0.0929;5066;-528
2016-06-12 05:00:00;46,66;41,54;5,12;40019;0;0;0;0;48870;4205;0.086;4519;-314
2016-06-12 06:00:00;49,5;47,11;2,39;40019;0;0;0;0;48870;3979;0.0814;4017;-38
2016-06-12 07:00:00;74,73;62,51;12,22;40019;1;0;6;-5;48870;3774;0.0772;3544;230
2016-06-12 08:00:00;80,09;73,1;6,99;40019;364;0.0091;498;-134;48870;3434;0.0702;3107;327
2016-06-12 09:00:00;76,0;70,02;5,98;40019;2219;0.0554;2401;-182;48870;3033;0.062;2665;368
2016-06-12 10:00:00;66,39;67,21;-0,82;40019;4606;0.1151;4751;-145;48870;2694;0.0551;2223;471
2016-06-12 11:00:00;58,99;68,61;-9,62;40019;6526;0.163;6359;167;48870;2022;0.0414;1827;195
2016-06-12 12:00:00;56,77;63,48;-6,71;40019;6852;0.1712;6887;-35;48870;1762;0.036;1542;220
2016-06-12 13:00:00;58,12;64,4;-6,28;40019;5695;0.1423;5918;-223;48870;1592;0.0326;1370;222
2016-06-12 14:00:00;63,61;66,06;-2,45;40019;3492;0.0873;3903;-411;48870;1333;0.0273;1322;11
2016-06-12 15:00:00;66,31;67,5;-1,19;40019;1062;0.0266;1345;-283;48870;1488;0.0305;1351;137
2016-06-12 16:00:00;72,97;77,99;-5,02;40019;34;0.0008;58;-24;48870;1537;0.0314;1437;100
2016-06-12 17:00:00;89,25;87,5;1,75;40019;0;0;0;0;48870;1807;0.037;1532;275
2016-06-12 18:00:00;82,71;77,84;4,87;40019;0;0;0;0;48870;2037;0.0417;1705;332
2016-06-12 19:00:00;75,39;69,04;6,35;40019;0;0;0;0;48870;2491;0.0509;2129;362
2016-06-12 20:00:00;62,76;55,23;7,53;40019;0;0;0;0;48870;3077;0.063;2764;313
2016-06-12 21:00:00;46,98;43,29;3,69;40019;0;0;0;0;48870;4199;0.0859;3450;749
2016-06-12 22:00:00;39,47;35,51;3,96;40019;0;0;0;0;48870;5181;0.106;4038;1143
2016-06-12 23:00:00;36,08;32,25;3,83;40019;0;0;0;0;48870;5705;0.1168;4580;1125
2016-07-12 00:00:00;33,09;30,94;2,15;40023;0;0;0;0;48897;6039;0.1235;5784;255
2016-07-12 01:00:00;32,77;30,96;1,81;40023;0;0;0;0;48897;6258;0.128;6663;-405
2016-07-12 02:00:00;31,91;31,74;0,17;40023;0;0;0;0;48897;6331;0.1295;7140;-809
2016-07-12 03:00:00;31,41;33,0;-1,59;40023;0;0;0;0;48897;6893;0.141;7295;-402
2016-07-12 04:00:00;31,07;33,79;-2,72;40023;0;0;0;0;48897;7672;0.1569;7622;50
2016-07-12 05:00:00;32,43;34,83;-2,4;40023;0;0;0;0;48897;8244;0.1686;8119;125
2016-07-12 06:00:00;38,0;42,79;-4,79;40023;0;0;0;0;48897;8849;0.181;8622;227
2016-07-12 07:00:00;45,28;45,75;-0,47;40023;1;0;5;-4;48897;9971;0.2039;9250;721
2016-07-12 08:00:00;47,96;46,71;1,25;40023;286;0.0071;381;-95;48897;10925;0.2234;9983;942
2016-07-12 09:00:00;46,95;47,1;-0,15;40023;1694;0.0423;1877;-183;48897;11838;0.2421;10694;1144
2016-07-12 10:00:00;46,98;45,33;1,65;40023;3458;0.0864;3641;-183;48897;12276;0.2511;11053;1223
2016-07-12 11:00:00;44,89;42,53;2,36;40023;4792;0.1197;4934;-142;48897;12041;0.2462;11226;815
2016-07-12 12:00:00;40,0;42,66;-2,66;40023;5308;0.1326;5235;73;48897;11868;0.2427;11497;371
2016-07-12 13:00:00;39,13;41,97;-2,84;40023;4218;0.1054;4464;-246;48897;12060;0.2466;12136;-76
2016-07-12 14:00:00;39,11;42,36;-3,25;40023;2401;0.06;2864;-463;48897;12983;0.2656;13191;-208
2016-07-12 15:00:00;41,12;44,29;-3,17;40023;671;0.0168;932;-261;48897;13881;0.2839;14553;-672
2016-07-12 16:00:00;44,47;47,82;-3,35;40023;27;0.0007;48;-21;48897;15520;0.3174;16024;-504
2016-07-12 17:00:00;45,28;45,57;-0,29;40023;0;0;0;0;48897;16850;0.3446;17402;-552
2016-07-12 18:00:00;38,39;40,6;-2,21;40023;0;0;0;0;48897;18296;0.3742;18592;-296
2016-07-12 19:00:00;36,03;39,32;-3,29;40023;0;0;0;0;48897;19536;0.3996;19618;-82
2016-07-12 20:00:00;34,14;36,38;-2,24;40023;0;0;0;0;48897;20413;0.4175;20502;-89
2016-07-12 21:00:00;32,03;34,14;-2,11;40023;0;0;0;0;48897;20840;0.4262;21282;-442
2016-07-12 22:00:00;30,85;34,2;-3,35;40023;0;0;0;0;48897;20659;0.4225;21973;-1314
2016-07-12 23:00:00;27,03;33,43;-6,4;40023;0;0;0;0;48897;21144;0.4324;22521;-1377
2016-08-12 00:00:00;22,46;30,59;-8,13;40034;0;0;0;0;48915;21326;0.436;23729;-2403
2016-08-12 01:00:00;13,7;28,8;-15,1;40034;0;0;0;0;48915;21046;0.4302;24029;-2983
2016-08-12 02:00:00;11,57;28,97;-17,4;40034;0;0;0;0;48915;21065;0.4306;24074;-3009
2016-08-12 03:00:00;11,79;30,02;-18,23;40034;0;0;0;0;48915;21190;0.4332;24147;-2957
2016-08-12 04:00:00;13,33;28,42;-15,09;40034;0;0;0;0;48915;21183;0.433;24128;-2945
2016-08-12 05:00:00;17,94;30,02;-12,08;40034;0;0;0;0;48915;21222;0.4338;24039;-2817
2016-08-12 06:00:00;29,36;32,87;-3,51;40034;0;0;0;0;48915;21782;0.4453;23914;-2132
2016-08-12 07:00:00;33,56;40,52;-6,96;40034;1;0;5;-4;48915;22545;0.4609;23696;-1151
2016-08-12 08:00:00;36,01;45,72;-9,71;40034;498;0.0124;482;16;48915;22796;0.466;23398;-602
2016-08-12 09:00:00;36,34;42,42;-6,08;40034;3081;0.077;2793;288;48915;21767;0.445;23027;-1260
2016-08-12 10:00:00;32,88;32,99;-0,11;40034;6206;0.155;5840;366;48915;20562;0.4204;22441;-1879
2016-08-12 11:00:00;31,97;32,92;-0,95;40034;8291;0.2071;7613;678;48915;19327;0.3951;21673;-2346
2016-08-12 12:00:00;30,83;31,39;-0,56;40034;8438;0.2108;7784;654;48915;18428;0.3767;20960;-2532
2016-08-12 13:00:00;32,46;32,59;-0,13;40034;7038;0.1758;6471;567;48915;17852;0.365;20548;-2696
2016-08-12 14:00:00;36,33;37,25;-0,92;40034;4278;0.1069;4087;191;48915;17120;0.35;20592;-3472
2016-08-12 15:00:00;42,33;43,14;-0,81;40034;1316;0.0329;1360;-44;48915;17457;0.3569;20841;-3384
2016-08-12 16:00:00;43,97;46,88;-2,91;40034;50;0.0012;63;-13;48915;18374;0.3756;21225;-2851
2016-08-12 17:00:00;46,99;46,46;0,53;40034;0;0;0;0;48915;19344;0.3955;21703;-2359
2016-08-12 18:00:00;43,41;42,5;0,91;40034;0;0;0;0;48915;20155;0.412;22145;-1990
2016-08-12 19:00:00;39,96;38,62;1,34;40034;0;0;0;0;48915;20690;0.423;22320;-1630
2016-08-12 20:00:00;35,0;37,72;-2,72;40034;0;0;0;0;48915;21607;0.4417;22106;-499
2016-08-12 21:00:00;30,7;32,6;-1,9;40034;0;0;0;0;48915;22002;0.4498;21821;181
2016-08-12 22:00:00;29,9;29,73;0,17;40034;0;0;0;0;48915;21105;0.4315;21412;-307
2016-08-12 23:00:00;27,27;26,62;0,65;40034;0;0;0;0;48915;20128;0.4115;20871;-743
2016-09-12 00:00:00;27,59;25,65;1,94;40043;0;0;0;0;48961;20134;0.4112;19880;254
2016-09-12 01:00:00;25,56;20,72;4,84;40043;0;0;0;0;48961;19979;0.4081;19794;185
2016-09-12 02:00:00;25,12;20,97;4,15;40043;0;0;0;0;48961;19020;0.3885;19575;-555
2016-09-12 03:00:00;25,52;18,78;6,74;40043;0;0;0;0;48961;17944;0.3665;19257;-1313
2016-09-12 04:00:00;27,46;26,39;1,07;40043;0;0;0;0;48961;17719;0.3619;18859;-1140
2016-09-12 05:00:00;27,55;28,54;-0,99;40043;0;0;0;0;48961;18444;0.3767;18448;-4
2016-09-12 06:00:00;31,57;31,1;0,47;40043;0;0;0;0;48961;18755;0.383;18085;670
2016-09-12 07:00:00;44,47;43,78;0,69;40043;1;0;3;-2;48961;18832;0.3846;17705;1127
2016-09-12 08:00:00;46,99;43,35;3,64;40043;437;0.0109;357;80;48961;18964;0.3874;17386;1578
2016-09-12 09:00:00;43,68;43,38;0,3;40043;1980;0.0495;1559;421;48961;18276;0.3733;17207;1069
2016-09-12 10:00:00;45,93;40,4;5,53;40043;3527;0.0881;2979;548;48961;17846;0.3645;17109;737
2016-09-12 11:00:00;42,51;38,56;3,95;40043;4395;0.1098;4319;76;48961;17812;0.3638;16999;813
2016-09-12 12:00:00;39,02;40,4;-1,38;40043;4363;0.109;4775;-412;48961;17431;0.356;16808;623
2016-09-12 13:00:00;37,5;41,28;-3,78;40043;3334;0.0833;4093;-759;48961;16513;0.3372;16441;72
2016-09-12 14:00:00;37,44;43,01;-5,57;40043;1989;0.0497;2660;-671;48961;15640;0.3194;15973;-333
2016-09-12 15:00:00;40,82;43,06;-2,24;40043;563;0.0141;916;-353;48961;14945;0.3052;15405;-460
2016-09-12 16:00:00;41,91;44,56;-2,65;40043;22;0.0005;46;-24;48961;15289;0.3123;15068;221
2016-09-12 17:00:00;41,96;46,36;-4,4;40043;0;0;0;0;48961;16196;0.3308;15135;1061
2016-09-12 18:00:00;39,15;42,52;-3,37;40043;0;0;0;0;48961;16984;0.3469;15321;1663
2016-09-12 19:00:00;40,86;38,74;2,12;40043;0;0;0;0;48961;17102;0.3493;15639;1463
2016-09-12 20:00:00;35,0;34,12;0,88;40043;0;0;0;0;48961;17272;0.3528;16022;1250
2016-09-12 21:00:00;32,46;33,43;-0,97;40043;0;0;0;0;48961;18092;0.3695;16465;1627
2016-09-12 22:00:00;31,24;33,56;-2,32;40043;0;0;0;0;48961;18414;0.3761;17014;1400
2016-09-12 23:00:00;29,0;29,76;-0,76;40043;0;0;0;0;48961;19223;0.3926;17641;1582
2016-10-12 00:00:00;25,98;29,81;-3,83;40043;0;0;0;0;48968;20040;0.4092;19872;168
2016-10-12 01:00:00;24,02;29,99;-5,97;40043;0;0;0;0;48968;20903;0.4268;20588;315
2016-10-12 02:00:00;23,95;26,8;-2,85;40043;0;0;0;0;48968;21192;0.4328;21064;128
2016-10-12 03:00:00;20,3;25,19;-4,89;40043;0;0;0;0;48968;21438;0.4378;21579;-141
2016-10-12 04:00:00;20,55;28,54;-7,99;40043;0;0;0;0;48968;21747;0.4441;21933;-186
2016-10-12 05:00:00;23,25;30,02;-6,77;40043;0;0;0;0;48968;21558;0.4402;22053;-495
2016-10-12 06:00:00;23,08;28,06;-4,98;40043;0;0;0;0;48968;21620;0.4415;22003;-383
2016-10-12 07:00:00;24,13;30,48;-6,35;40043;1;0;7;-6;48968;21141;0.4317;21718;-577
2016-10-12 08:00:00;28,49;31,13;-2,64;40043;624;0.0156;648;-24;48968;20562;0.4199;21251;-689
2016-10-12 09:00:00;31,08;36,01;-4,93;40043;3156;0.0788;3178;-22;48968;20059;0.4096;20745;-686
2016-10-12 10:00:00;31,86;35,78;-3,92;40043;6045;0.1509;5776;269;48968;19514;0.3985;20104;-590
2016-10-12 11:00:00;33,77;33,61;0,16;40043;8106;0.2024;7301;805;48968;18484;0.3775;19263;-779
2016-10-12 12:00:00;33,0;29,85;3,15;40043;8781;0.2193;7447;1334;48968;17386;0.355;18360;-974
2016-10-12 13:00:00;32,35;29,65;2,7;40043;7387;0.1845;6221;1166;48968;16354;0.3339;17443;-1089
2016-10-12 14:00:00;35,02;32,68;2,34;40043;4595;0.1148;3956;639;48968;14744;0.3011;16621;-1877
2016-10-12 15:00:00;41,92;42,49;-0,57;40043;1489;0.0372;1367;122;48968;13426;0.2742;15802;-2376
2016-10-12 16:00:00;43,67;47,0;-3,33;40043;53;0.0013;65;-12;48968;12825;0.2619;15090;-2265
2016-10-12 17:00:00;50,03;60,58;-10,55;40043;0;0;0;0;48968;12312;0.2514;14533;-2221
2016-10-12 18:00:00;45,12;51,6;-6,48;40043;0;0;0;0;48968;12111;0.2474;14021;-1910
2016-10-12 19:00:00;40,17;48,37;-8,2;40043;0;0;0;0;48968;11752;0.24;13585;-1833
2016-10-12 20:00:00;39,94;43,54;-3,6;40043;0;0;0;0;48968;11401;0.2328;13370;-1969
2016-10-12 21:00:00;34,72;38,26;-3,54;40043;0;0;0;0;48968;10688;0.2183;13326;-2638
2016-10-12 22:00:00;34,94;40,09;-5,15;40043;0;0;0;0;48968;10369;0.2118;13467;-3098
2016-10-12 23:00:00;31,4;36,83;-5,43;40043;0;0;0;0;48968;10230;0.2089;13783;-3553
2016-11-12 00:00:00;30,58;32,63;-2,05;40047;0;0;0;0;48968;10392;0.2122;11606;-1214
2016-11-12 01:00:00;28,44;29,62;-1,18;40047;0;0;0;0;48968;10660;0.2177;11944;-1284
2016-11-12 02:00:00;28,95;32,97;-4,02;40047;0;0;0;0;48968;12149;0.2481;12802;-653
2016-11-12 03:00:00;28,08;28,4;-0,32;40047;0;0;0;0;48968;14676;0.2997;13895;781
2016-11-12 04:00:00;27,56;25,59;1,97;40047;0;0;0;0;48968;17996;0.3675;14977;3019
2016-11-12 05:00:00;27,94;15,4;12,54;40047;0;0;0;0;48968;20913;0.427;15882;5031
2016-11-12 06:00:00;26,16;4,31;21,85;40047;0;0;0;0;48968;23662;0.4832;16914;6748
2016-11-12 07:00:00;26,51;2,51;24,0;40047;1;0;3;-2;48968;24900;0.5085;17692;7208
2016-11-12 08:00:00;26,84;7,54;19,3;40047;205;0.0051;188;17;48968;25806;0.527;18155;7651
2016-11-12 09:00:00;29,51;9,89;19,62;40047;845;0.0211;878;-33;48968;26681;0.5449;19081;7600
2016-11-12 10:00:00;29,75;12,17;17,58;40047;1469;0.0367;1653;-184;48968;27283;0.5571;20261;7022
2016-11-12 11:00:00;30,42;16,76;13,66;40047;2068;0.0516;2213;-145;48968;27314;0.5578;21161;6153
2016-11-12 12:00:00;29,03;18,82;10,21;40047;2485;0.062;2362;123;48968;27287;0.5572;21813;5474
2016-11-12 13:00:00;25,1;18,59;6,51;40047;2237;0.0558;2032;205;48968;26584;0.5429;22017;4567
2016-11-12 14:00:00;24,01;16,19;7,82;40047;1495;0.0373;1261;234;48968;25388;0.5185;21727;3661
2016-11-12 15:00:00;24,7;21,28;3,42;40047;542;0.0136;377;165;48968;24779;0.506;21292;3487
2016-11-12 16:00:00;34,57;30,63;3,94;40047;28;0.0007;19;9;48968;24477;0.4998;20885;3592
2016-11-12 17:00:00;32,83;28,06;4,77;40047;0;0;0;0;48968;23936;0.4888;20693;3243
2016-11-12 18:00:00;34,07;29,19;4,88;40047;0;0;0;0;48968;23867;0.4874;20637;3230
2016-11-12 19:00:00;32,9;28,12;4,78;40047;0;0;0;0;48968;23792;0.4859;20579;3213
2016-11-12 20:00:00;32,01;26,64;5,37;40047;0;0;0;0;48968;23724;0.4845;20463;3261
2016-11-12 21:00:00;29,09;20,46;8,63;40047;0;0;0;0;48968;22854;0.4667;20299;2555
2016-11-12 22:00:00;30,44;27,51;2,93;40047;0;0;0;0;48968;21878;0.4468;20053;1825
2016-11-12 23:00:00;25,92;21,36;4,56;40047;0;0;0;0;48968;20910;0.427;19688;1222
2016-12-12 00:00:00;23,98;26,33;-2,35;40048;0;0;0;0;48986;20173;0.4118;21401;-1228
2016-12-12 01:00:00;28,82;28,2;0,62;40048;0;0;0;0;48986;18875;0.3853;20264;-1389
2016-12-12 02:00:00;28,24;27,48;0,76;40048;0;0;0;0;48986;17331;0.3538;18624;-1293
2016-12-12 03:00:00;27,49;26,7;0,79;40048;0;0;0;0;48986;16124;0.3291;17214;-1090
2016-12-12 04:00:00;26,6;27,7;-1,1;40048;0;0;0;0;48986;14915;0.3045;15640;-725
2016-12-12 05:00:00;28,78;30,42;-1,64;40048;0;0;0;0;48986;13111;0.2676;13690;-579
2016-12-12 06:00:00;43,7;47,39;-3,69;40048;0;0;0;0;48986;11260;0.2299;11706;-446
2016-12-12 07:00:00;57,36;59,63;-2,27;40048;1;0;3;-2;48986;9633;0.1967;9803;-170
2016-12-12 08:00:00;47,93;50,29;-2,36;40048;95;0.0024;184;-89;48986;8042;0.1642;8064;-22
2016-12-12 09:00:00;50,09;51,94;-1,85;40048;702;0.0175;1039;-337;48986;6424;0.1311;6541;-117
2016-12-12 10:00:00;52,32;52,81;-0,49;40048;1776;0.0444;2169;-393;48986;4901;0.1;5240;-339
2016-12-12 11:00:00;59,54;57,48;2,06;40048;2846;0.0711;3016;-170;48986;3914;0.0799;4144;-230
2016-12-12 12:00:00;53,91;55,45;-1,54;40048;3573;0.0892;3256;317;48986;3048;0.0622;3282;-234
2016-12-12 13:00:00;63,67;59,65;4,02;40048;3310;0.0826;2840;470;48986;2084;0.0425;2659;-575
2016-12-12 14:00:00;63,81;64,94;-1,13;40048;2134;0.0533;1805;329;48986;1584;0.0323;2270;-686
2016-12-12 15:00:00;56,29;66,03;-9,74;40048;596;0.0149;572;24;48986;1365;0.0279;2011;-646
2016-12-12 16:00:00;70,25;76,57;-6,32;40048;25;0.0006;31;-6;48986;1510;0.0308;1999;-489
2016-12-12 17:00:00;80,62;96,44;-15,82;40048;0;0;0;0;48986;2025;0.0414;2358;-333
2016-12-12 18:00:00;65,2;80,73;-15,53;40048;0;0;0;0;48986;2570;0.0525;2944;-374
2016-12-12 19:00:00;57,18;65,6;-8,42;40048;0;0;0;0;48986;2968;0.0606;3536;-568
2016-12-12 20:00:00;46,96;54,39;-7,43;40048;0;0;0;0;48986;3488;0.0712;4014;-526
2016-12-12 21:00:00;37,73;42,61;-4,88;40048;0;0;0;0;48986;3888;0.0794;4520;-632
2016-12-12 22:00:00;35,07;41,91;-6,84;40048;0;0;0;0;48986;4124;0.0842;4862;-738
2016-12-12 23:00:00;33,33;40,48;-7,15;40048;0;0;0;0;48986;4422;0.0903;4962;-540
2016-12-13 00:00:00;35,88;40,44;-4,56;40057;0;0;0;0;49034;4872;0.0994;5040;-168
2016-12-13 01:00:00;33,04;39,26;-6,22;40057;0;0;0;0;49034;4949;0.1009;5190;-241
2016-12-13 02:00:00;33,04;39,27;-6,23;40057;0;0;0;0;49034;4711;0.0961;5379;-668
2016-12-13 03:00:00;33,02;39,94;-6,92;40057;0;0;0;0;49034;4753;0.0969;5528;-775
2016-12-13 04:00:00;34,97;40,24;-5,27;40057;0;0;0;0;49034;4694;0.0957;5636;-942
2016-12-13 05:00:00;32,84;39,38;-6,54;40057;0;0;0;0;49034;4731;0.0965;5706;-975
2016-12-13 06:00:00;47,41;53,95;-6,54;40057;0;0;0;0;49034;4845;0.0988;5806;-961
2016-12-13 07:00:00;49,9;56,67;-6,77;40057;0;0;5;-5;49034;5254;0.1071;5949;-695
2016-12-13 08:00:00;54,39;74,22;-19,83;40057;279;0.007;263;16;49034;5079;0.1036;6104;-1025
2016-12-13 09:00:00;58,12;72,5;-14,38;40057;1753;0.0438;1368;385;49034;4933;0.1006;6180;-1247
2016-12-13 10:00:00;62,76;71,42;-8,66;40057;3650;0.0911;2798;852;49034;4526;0.0923;6051;-1525
2016-12-13 11:00:00;60,09;67,67;-7,58;40057;4872;0.1216;3782;1090;49034;3922;0.08;5808;-1886
2016-12-13 12:00:00;58,0;65,86;-7,86;40057;4933;0.1232;3968;965;49034;3495;0.0713;5629;-2134
2016-12-13 13:00:00;59,39;68,99;-9,6;40057;3800;0.0948;3334;466;49034;3202;0.0653;5435;-2233
2016-12-13 14:00:00;59,6;71,28;-11,68;40057;2030;0.0506;2069;-39;49034;3148;0.0642;5326;-2178
2016-12-13 15:00:00;61,6;73,35;-11,75;40057;533;0.0133;655;-122;49034;3245;0.0662;5325;-2080
2016-12-13 16:00:00;63,02;78,39;-15,37;40057;22;0.0006;32;-10;49034;3600;0.0734;5518;-1918
2016-12-13 17:00:00;70,42;86,51;-16,09;40057;0;0;0;0;49034;4034;0.0822;5836;-1802
2016-12-13 18:00:00;60,09;80,96;-20,87;40057;0;0;0;0;49034;4424;0.0902;6123;-1699
2016-12-13 19:00:00;57,76;68,94;-11,18;40057;0;0;0;0;49034;4659;0.095;6296;-1637
2016-12-13 20:00:00;45,66;53,56;-7,9;40057;0;0;0;0;49034;4574;0.0933;6280;-1706
2016-12-13 21:00:00;40,19;42,56;-2,37;40057;0;0;0;0;49034;4668;0.0952;6170;-1502
2016-12-13 22:00:00;37,02;41,32;-4,3;40057;0;0;0;0;49034;4662;0.0951;6011;-1349
2016-12-13 23:00:00;32,53;34,47;-1,94;40057;0;0;0;0;49034;4785;0.0976;5744;-959
2016-12-14 00:00:00;33,09;28,98;4,11;40068;0;0;0;0;49060;4790;0.0976;4845;-55
2016-12-14 01:00:00;33,28;29,31;3,97;40068;0;0;0;0;49060;4459;0.0909;4617;-158
2016-12-14 02:00:00;33,0;29,7;3,3;40068;0;0;0;0;49060;4248;0.0866;4310;-62
2016-12-14 03:00:00;32,64;28,12;4,52;40068;0;0;0;0;49060;3911;0.0797;3941;-30
2016-12-14 04:00:00;32,66;27,39;5,27;40068;0;0;0;0;49060;3535;0.0721;3462;73
2016-12-14 05:00:00;36,9;31,38;5,52;40068;0;0;0;0;49060;3150;0.0642;2976;174
2016-12-14 06:00:00;49,91;43,1;6,81;40068;0;0;0;0;49060;2823;0.0576;2612;211
2016-12-14 07:00:00;75,06;65,33;9,73;40068;0;0;3;-3;49060;2634;0.0537;2355;279
2016-12-14 08:00:00;82,26;78,73;3,53;40068;149;0.0037;203;-54;49060;2414;0.0492;2176;238
2016-12-14 09:00:00;78,58;76,54;2,04;40068;1008;0.0251;1121;-113;49060;1979;0.0403;2016;-37
2016-12-14 10:00:00;77,17;70,56;6,61;40068;2254;0.0562;2324;-70;49060;1609;0.0328;1786;-177
2016-12-14 11:00:00;75,94;71,28;4,66;40068;3214;0.0802;3282;-68;49060;1467;0.0299;1497;-30
2016-12-14 12:00:00;70,55;65,78;4,77;40068;3590;0.0896;3662;-72;49060;1293;0.0264;1289;4
2016-12-14 13:00:00;69,91;63,21;6,7;40068;3284;0.082;3278;6;49060;1179;0.024;1198;-19
2016-12-14 14:00:00;69,69;62,73;6,96;40068;2226;0.0556;2181;45;49060;1306;0.0266;1240;66
2016-12-14 15:00:00;72,52;66,27;6,25;40068;688;0.0172;771;-83;49060;1524;0.031;1394;130
2016-12-14 16:00:00;75,15;75,12;0,03;40068;38;0.001;45;-7;49060;1930;0.0393;1676;254
2016-12-14 17:00:00;91,81;97,04;-5,23;40068;0;0;0;0;49060;2403;0.049;2063;340
2016-12-14 18:00:00;79,9;78,03;1,87;40068;0;0;0;0;49060;2593;0.0528;2476;117
2016-12-14 19:00:00;78,62;68,63;9,99;40068;0;0;0;0;49060;2614;0.0533;2792;-178
2016-12-14 20:00:00;67,54;55,71;11,83;40068;0;0;0;0;49060;2626;0.0535;3007;-381
2016-12-14 21:00:00;47,94;43,02;4,92;40068;0;0;0;0;49060;2747;0.056;3253;-506
2016-12-14 22:00:00;41,71;41,89;-0,18;40068;0;0;0;0;49060;2891;0.0589;3516;-625
2016-12-14 23:00:00;35,57;38,32;-2,75;40068;0;0;0;0;49060;3095;0.0631;3753;-658
2016-12-15 00:00:00;35,05;34,49;0,56;40105;0;0;0;0;49110;3358;0.0684;3903;-545
2016-12-15 01:00:00;33,31;33,76;-0,45;40105;0;0;0;0;49110;3579;0.0728;4075;-496
2016-12-15 02:00:00;34,2;34,66;-0,46;40105;0;0;0;0;49110;3617;0.0736;4196;-579
2016-12-15 03:00:00;33,51;34,75;-1,24;40105;0;0;0;0;49110;3856;0.0785;4274;-418
2016-12-15 04:00:00;34,53;36,44;-1,91;40105;0;0;0;0;49110;4197;0.0854;4469;-272
2016-12-15 05:00:00;35,61;34,96;0,65;40105;0;0;0;0;49110;4445;0.0905;4842;-397
2016-12-15 06:00:00;49,55;47,77;1,78;40105;0;0;0;0;49110;4716;0.096;5363;-647
2016-12-15 07:00:00;67,91;70,53;-2,62;40105;0;0;4;-4;49110;5370;0.1094;5993;-623
2016-12-15 08:00:00;67,07;86,62;-19,55;40105;174;0.0043;297;-123;49110;6269;0.1276;6676;-407
2016-12-15 09:00:00;62,27;72,63;-10,36;40105;1143;0.0285;1708;-565;49110;6922;0.141;7313;-391
2016-12-15 10:00:00;59,13;69,78;-10,65;40105;2461;0.0614;3662;-1201;49110;7533;0.1534;7632;-99
2016-12-15 11:00:00;57,69;63,4;-5,71;40105;3420;0.0853;5058;-1638;49110;7870;0.1602;7618;252
2016-12-15 12:00:00;53,72;66,83;-13,11;40105;3472;0.0866;5363;-1891;49110;7979;0.1624;7604;375
2016-12-15 13:00:00;54,95;67,27;-12,32;40105;2878;0.0718;4583;-1705;49110;7828;0.1594;7759;69
2016-12-15 14:00:00;55,0;69,0;-14,0;40105;1731;0.0432;2909;-1178;49110;8104;0.165;8147;-43
2016-12-15 15:00:00;60,24;68,98;-8,74;40105;475;0.0118;947;-472;49110;8929;0.1818;8722;207
2016-12-15 16:00:00;62,05;66,81;-4,76;40105;19;0.0005;43;-24;49110;10116;0.206;9510;606
2016-12-15 17:00:00;70,03;71,16;-1,13;40105;0;0;0;0;49110;10869;0.2213;10409;460
2016-12-15 18:00:00;58,95;59,45;-0,5;40105;0;0;0;0;49110;11546;0.2351;11143;403
2016-12-15 19:00:00;54,65;49,19;5,46;40105;0;0;0;0;49110;11816;0.2406;11520;296
2016-12-15 20:00:00;45,37;41,35;4,02;40105;0;0;0;0;49110;11706;0.2384;11525;181
2016-12-15 21:00:00;40,0;38,45;1,55;40105;0;0;0;0;49110;11189;0.2278;11330;-141
2016-12-15 22:00:00;37,53;37,21;0,32;40105;0;0;0;0;49110;10727;0.2184;10947;-220
2016-12-15 23:00:00;33,98;34,77;-0,79;40105;0;0;0;0;49110;10748;0.2188;10448;300
2016-12-16 00:00:00;34,25;34,66;-0,41;40112;0;0;0;0;49143;10515;0.2139;9884;631
2016-12-16 01:00:00;33,29;32,37;0,92;40112;0;0;0;0;49143;10002;0.2035;9565;437
2016-12-16 02:00:00;32,0;32,03;-0,03;40112;0;0;0;0;49143;9834;0.2001;9321;513
2016-12-16 03:00:00;31,92;31,14;0,78;40112;0;0;0;0;49143;9876;0.201;8973;903
2016-12-16 04:00:00;33,15;33,16;-0,01;40112;0;0;0;0;49143;9734;0.1981;8547;1187
2016-12-16 05:00:00;35,51;33,13;2,38;40112;0;0;0;0;49143;9202;0.1873;8151;1051
2016-12-16 06:00:00;46,76;46,49;0,27;40112;0;0;0;0;49143;8689;0.1768;7841;848
2016-12-16 07:00:00;58,99;57,16;1,83;40112;0;0;4;-4;49143;8398;0.1709;7581;817
2016-12-16 08:00:00;62,65;58,73;3,92;40112;284;0.0071;579;-295;49143;7916;0.1611;7229;687
2016-12-16 09:00:00;59,99;58,11;1,88;40112;1922;0.0479;3411;-1489;49143;6930;0.141;6664;266
2016-12-16 10:00:00;59,04;63,17;-4,13;40112;4153;0.1036;6740;-2587;49143;5650;0.115;5591;59
2016-12-16 11:00:00;59,56;65,91;-6,35;40112;5714;0.1425;8946;-3232;49143;4356;0.0886;4175;181
2016-12-16 12:00:00;56,96;61,72;-4,76;40112;6365;0.1587;9500;-3135;49143;3318;0.0675;3055;263
2016-12-16 13:00:00;57,98;61,39;-3,41;40112;5652;0.1409;8186;-2534;49143;2654;0.054;2499;155
2016-12-16 14:00:00;64,88;61,26;3,62;40112;3654;0.0911;5248;-1594;49143;2272;0.0462;2648;-376
2016-12-16 15:00:00;65,1;59,47;5,63;40112;1043;0.026;1700;-657;49143;2234;0.0455;3099;-865
2016-12-16 16:00:00;69,46;63,44;6,02;40112;40;0.001;62;-22;49143;2886;0.0587;3656;-770
2016-12-16 17:00:00;80,99;67,81;13,18;40112;0;0;0;0;49143;3618;0.0736;4053;-435
2016-12-16 18:00:00;68,0;59,33;8,67;40112;0;0;0;0;49143;3898;0.0793;4250;-352
2016-12-16 19:00:00;71,71;57,99;13,72;40112;0;0;0;0;49143;3766;0.0766;4134;-368
2016-12-16 20:00:00;63,6;53,87;9,73;40112;0;0;0;0;49143;3545;0.0722;3741;-196
2016-12-16 21:00:00;48,09;40,56;7,53;40112;0;0;0;0;49143;3058;0.0622;3335;-277
2016-12-16 22:00:00;42,49;39,93;2,56;40112;0;0;0;0;49143;2747;0.0559;2962;-215
2016-12-16 23:00:00;37,06;36,91;0,15;40112;0;0;0;0;49143;2417;0.0492;2688;-271
2016-12-17 00:00:00;42,1;39,07;3,03;40112;0;0;0;0;49150;2076;0.0422;1994;82
2016-12-17 01:00:00;39,44;37,0;2,44;40112;0;0;0;0;49150;1996;0.0406;1884;112
2016-12-17 02:00:00;38,36;34,7;3,66;40112;0;0;0;0;49150;2168;0.0441;1734;434
2016-12-17 03:00:00;38,28;35,81;2,47;40112;0;0;0;0;49150;2262;0.046;1543;719
2016-12-17 04:00:00;39,07;35,25;3,82;40112;0;0;0;0;49150;2204;0.0448;1361;843
2016-12-17 05:00:00;39,01;34,18;4,83;40112;0;0;0;0;49150;2112;0.043;1223;889
2016-12-17 06:00:00;36,0;32,66;3,34;40112;0;0;0;0;49150;2067;0.042;1183;884
2016-12-17 07:00:00;39,01;35,23;3,78;40112;0;0;4;-4;49150;2252;0.0458;1209;1043
2016-12-17 08:00:00;47,84;40,6;7,24;40112;126;0.0031;392;-266;49150;2377;0.0484;1270;1107
2016-12-17 09:00:00;54,97;44,86;10,11;40112;1238;0.0309;2256;-1018;49150;2438;0.0496;1367;1071
2016-12-17 10:00:00;54,91;51,62;3,29;40112;2852;0.0711;4388;-1536;49150;2448;0.0498;1424;1024
2016-12-17 11:00:00;54,35;52,03;2,32;40112;4039;0.1007;5630;-1591;49150;2237;0.0456;1403;834
2016-12-17 12:00:00;50,1;50,38;-0,28;40112;4229;0.1054;5748;-1519;49150;2127;0.0433;1402;725
2016-12-17 13:00:00;47,65;48,1;-0,45;40112;3307;0.0824;4755;-1448;49150;2273;0.0462;1448;825
2016-12-17 14:00:00;49,68;46,52;3,16;40112;1866;0.0465;2949;-1083;49150;2279;0.0464;1648;631
2016-12-17 15:00:00;50,68;46,56;4,12;40112;533;0.0133;945;-412;49150;2584;0.0526;2027;557
2016-12-17 16:00:00;54,8;51,6;3,2;40112;18;0.0004;45;-27;49150;3146;0.064;2493;653
2016-12-17 17:00:00;61,01;55,37;5,64;40112;0;0;0;0;49150;4104;0.0835;2909;1195
2016-12-17 18:00:00;63,53;54,16;9,37;40112;0;0;0;0;49150;5023;0.1022;3315;1708
2016-12-17 19:00:00;54,98;46,27;8,71;40112;0;0;0;0;49150;6130;0.1247;3665;2465
2016-12-17 20:00:00;46,22;37,65;8,57;40112;0;0;0;0;49150;7000;0.1424;4014;2986
2016-12-17 21:00:00;40,93;35,87;5,06;40112;0;0;0;0;49150;8074;0.1643;4386;3688
2016-12-17 22:00:00;40,98;36,94;4,04;40112;0;0;0;0;49150;9040;0.1839;4737;4303
2016-12-17 23:00:00;39,1;33,2;5,9;40112;0;0;0;0;49150;9616;0.1957;5103;4513
2016-12-18 00:00:00;35,78;39,03;-3,25;40113;0;0;0;0;49150;9840;0.2002;9379;461
2016-12-18 01:00:00;35,23;40,04;-4,81;40113;0;0;0;0;49150;9929;0.202;9890;39
2016-12-18 02:00:00;33,96;39,99;-6,03;40113;0;0;0;0;49150;10196;0.2075;10283;-87
2016-12-18 03:00:00;34,32;39,27;-4,95;40113;0;0;0;0;49150;10410;0.2118;10537;-127
2016-12-18 04:00:00;33,96;36,94;-2,98;40113;0;0;0;0;49150;10109;0.2057;10700;-591
2016-12-18 05:00:00;33,93;37,78;-3,85;40113;0;0;0;0;49150;9682;0.197;10747;-1065
2016-12-18 06:00:00;34,36;39,44;-5,08;40113;0;0;0;0;49150;9582;0.195;10708;-1126
2016-12-18 07:00:00;38,37;42,53;-4,16;40113;0;0;1;-1;49150;9092;0.185;10484;-1392
2016-12-18 08:00:00;36,88;44,49;-7,61;40113;84;0.0021;104;-20;49150;8673;0.1764;10040;-1367
2016-12-18 09:00:00;44,72;44,65;0,07;40113;578;0.0144;560;18;49150;7814;0.159;9636;-1822
2016-12-18 10:00:00;45,94;46,54;-0,6;40113;1329;0.0331;1270;59;49150;6851;0.1394;9233;-2382
2016-12-18 11:00:00;52,29;50,92;1,37;40113;1847;0.046;1821;26;49150;5938;0.1208;8696;-2758
2016-12-18 12:00:00;52,0;50,4;1,6;40113;1955;0.0488;1958;-3;49150;5131;0.1044;8070;-2939
2016-12-18 13:00:00;49,78;50,48;-0,7;40113;1530;0.0381;1649;-119;49150;4278;0.087;7415;-3137
2016-12-18 14:00:00;45,82;49,54;-3,72;40113;863;0.0215;1031;-168;49150;3462;0.0704;6719;-3257
2016-12-18 15:00:00;47,43;50,36;-2,93;40113;243;0.0061;342;-99;49150;2817;0.0573;6010;-3193
2016-12-18 16:00:00;49,98;55,24;-5,26;40113;10;0.0002;19;-9;49150;2274;0.0462;5318;-3044
2016-12-18 17:00:00;54,92;63,26;-8,34;40113;0;0;0;0;49150;1827;0.0372;4662;-2835
2016-12-18 18:00:00;53,98;64,42;-10,44;40113;0;0;0;0;49150;1509;0.0307;4047;-2538
2016-12-18 19:00:00;50,13;59,28;-9,15;40113;0;0;0;0;49150;1161;0.0236;3421;-2260
2016-12-18 20:00:00;49,92;55,41;-5,49;40113;0;0;0;0;49150;789;0.016;2839;-2050
2016-12-18 21:00:00;45,73;50,74;-5,01;40113;0;0;0;0;49150;581;0.0118;2387;-1806
2016-12-18 22:00:00;47,14;50,29;-3,15;40113;0;0;0;0;49150;442;0.009;2052;-1610
2016-12-18 23:00:00;42,06;43,36;-1,3;40113;0;0;0;0;49150;384;0.0078;1873;-1489
2016-12-19 00:00:00;39,9;36,7;3,2;40119;0;0;0;0;49169;412;0.0084;688;-276
2016-12-19 01:00:00;39,08;36,42;2,66;40119;0;0;0;0;49169;450;0.0092;740;-290
2016-12-19 02:00:00;39,02;34,76;4,26;40119;0;0;0;0;49169;612;0.0125;828;-216
2016-12-19 03:00:00;38,56;34,13;4,43;40119;0;0;0;0;49169;834;0.017;962;-128
2016-12-19 04:00:00;39,01;34,18;4,83;40119;0;0;0;0;49169;1128;0.023;1173;-45
2016-12-19 05:00:00;39,05;37,0;2,05;40119;0;0;0;0;49169;1344;0.0273;1454;-110
2016-12-19 06:00:00;54,11;49,05;5,06;40119;0;0;0;0;49169;1576;0.032;1802;-226
2016-12-19 07:00:00;66,7;60,04;6,66;40119;0;0;1;-1;49169;1893;0.0385;2174;-281
2016-12-19 08:00:00;65,38;62,31;3,07;40119;129;0.0032;206;-77;49169;2236;0.0454;2506;-270
2016-12-19 09:00:00;75,1;61,18;13,92;40119;923;0.023;1249;-326;49169;2569;0.0522;2800;-231
2016-12-19 10:00:00;74,99;57,86;17,13;40119;2250;0.0561;2712;-462;49169;3048;0.062;2919;129
2016-12-19 11:00:00;72,19;56,72;15,47;40119;3484;0.0868;3943;-459;49169;3268;0.0665;2870;398
2016-12-19 12:00:00;70,8;57,1;13,7;40119;4123;0.1028;4493;-370;49169;3352;0.0682;2897;455
2016-12-19 13:00:00;71,48;59,74;11,74;40119;3818;0.0952;4150;-332;49169;3593;0.0731;2989;604
2016-12-19 14:00:00;70,82;59,71;11,11;40119;2466;0.0615;2808;-342;49169;3756;0.0764;3185;571
2016-12-19 15:00:00;72,99;60,89;12,1;40119;780;0.0195;950;-170;49169;4097;0.0833;3491;606
2016-12-19 16:00:00;69,24;69,56;-0,32;40119;28;0.0007;47;-19;49169;4470;0.0909;3879;591
2016-12-19 17:00:00;79,46;72,42;7,04;40119;0;0;0;0;49169;4552;0.0926;4324;228
2016-12-19 18:00:00;66,0;62,04;3,96;40119;0;0;0;0;49169;4311;0.0876;4757;-446
2016-12-19 19:00:00;67,0;60,15;6,85;40119;0;0;0;0;49169;4332;0.0881;4971;-639
2016-12-19 20:00:00;50,94;48,82;2,12;40119;0;0;0;0;49169;4466;0.0908;4947;-481
2016-12-19 21:00:00;40,16;39,8;0,36;40119;0;0;0;0;49169;4411;0.0897;4851;-440
2016-12-19 22:00:00;40,05;40,01;0,04;40119;0;0;0;0;49169;4294;0.0873;4703;-409
2016-12-19 23:00:00;35,74;38,2;-2,46;40119;0;0;0;0;49169;4390;0.0893;4629;-239
2016-12-20 00:00:00;37,49;41,03;-3,54;40126;0;0;0;0;49208;4552;0.0925;3760;792
2016-12-20 01:00:00;37,06;35,75;1,31;40126;0;0;0;0;49208;4894;0.0994;3953;941
2016-12-20 02:00:00;37,06;34,84;2,22;40126;0;0;0;0;49208;5271;0.1071;4340;931
2016-12-20 03:00:00;34,96;31,71;3,25;40126;0;0;0;0;49208;5518;0.1122;4689;829
2016-12-20 04:00:00;37,0;34,14;2,86;40126;0;0;0;0;49208;5633;0.1144;4909;724
2016-12-20 05:00:00;38,14;36,32;1,82;40126;0;0;0;0;49208;5628;0.1144;5034;594
2016-12-20 06:00:00;43,27;41,67;1,6;40126;0;0;0;0;49208;5698;0.1158;5165;533
2016-12-20 07:00:00;55,94;50,4;5,54;40126;1;0;4;-3;49208;5923;0.1204;5313;610
2016-12-20 08:00:00;55,95;58,94;-2,99;40126;204;0.0051;426;-222;49208;6062;0.1232;5450;612
2016-12-20 09:00:00;58,13;62,56;-4,43;40126;1570;0.0391;2420;-850;49208;6146;0.1249;5528;618
2016-12-20 10:00:00;54,97;59,08;-4,11;40126;3726;0.0928;5169;-1443;49208;5770;0.1172;5426;344
2016-12-20 11:00:00;58,92;61,97;-3,05;40126;5462;0.1362;7282;-1820;49208;5334;0.1084;5206;128
2016-12-20 12:00:00;54,91;60,26;-5,35;40126;6111;0.1523;7907;-1796;49208;5033;0.1023;5103;-70
2016-12-20 13:00:00;58,53;64,85;-6,32;40126;5226;0.1302;6885;-1659;49208;5425;0.1102;5252;173
2016-12-20 14:00:00;58,17;64,37;-6,2;40126;3190;0.0795;4469;-1279;49208;5861;0.1191;5782;79
2016-12-20 15:00:00;54,97;61,81;-6,84;40126;935;0.0233;1530;-595;49208;6172;0.1254;6495;-323
2016-12-20 16:00:00;57,82;68,63;-10,81;40126;30;0.0008;71;-41;49208;6728;0.1367;7272;-544
2016-12-20 17:00:00;66,33;71,67;-5,34;40126;0;0;0;0;49208;7433;0.1511;7887;-454
2016-12-20 18:00:00;58,91;69,61;-10,7;40126;0;0;0;0;49208;7948;0.1615;8347;-399
2016-12-20 19:00:00;55,09;62,48;-7,39;40126;0;0;0;0;49208;8748;0.1778;8569;179
2016-12-20 20:00:00;43,53;48,19;-4,66;40126;0;0;0;0;49208;8831;0.1794;8610;221
2016-12-20 21:00:00;39,27;43,32;-4,05;40126;0;0;0;0;49208;9272;0.1884;8640;632
2016-12-20 22:00:00;39,04;40,8;-1,76;40126;0;0;0;0;49208;10019;0.2036;8626;1393
2016-12-20 23:00:00;36,34;37,45;-1,11;40126;0;0;0;0;49208;10878;0.2211;8470;2408
2016-12-21 00:00:00;31,88;33,36;-1,48;40130;0;0;0;0;49238;10947;0.2223;9334;1613
2016-12-21 01:00:00;31,35;33,16;-1,81;40130;0;0;0;0;49238;10648;0.2162;9187;1461
2016-12-21 02:00:00;31,74;35,95;-4,21;40130;0;0;0;0;49238;10240;0.208;8977;1263
2016-12-21 03:00:00;31,35;36,18;-4,83;40130;0;0;0;0;49238;9664;0.1962;8944;720
2016-12-21 04:00:00;31,34;37,01;-5,67;40130;0;0;0;0;49238;9426;0.1914;9202;224
2016-12-21 05:00:00;31,34;39,49;-8,15;40130;0;0;0;0;49238;10668;0.2166;9842;826
2016-12-21 06:00:00;36,09;40,31;-4,22;40130;0;0;0;0;49238;12029;0.2443;10671;1358
2016-12-21 07:00:00;46,97;49,91;-2,94;40130;1;0;4;-3;49238;13281;0.2697;11469;1812
2016-12-21 08:00:00;49,97;54,5;-4,53;40130;162;0.004;414;-252;49238;13464;0.2734;12128;1336
2016-12-21 09:00:00;46,27;50,52;-4,25;40130;1415;0.0353;2643;-1228;49238;13454;0.2733;12547;907
2016-12-21 10:00:00;46,9;56,1;-9,2;40130;3326;0.0829;5720;-2394;49238;13057;0.2652;12511;546
2016-12-21 11:00:00;43,96;58,83;-14,87;40130;4802;0.1196;7904;-3102;49238;12910;0.2622;12076;834
2016-12-21 12:00:00;39,53;60,17;-20,64;40130;5254;0.131;8429;-3175;49238;12582;0.2556;11803;779
2016-12-21 13:00:00;39,38;58,67;-19,29;40130;4505;0.1122;7144;-2639;49238;12470;0.2532;11976;494
2016-12-21 14:00:00;41,97;54,4;-12,43;40130;2741;0.0683;4501;-1760;49238;12204;0.2478;12738;-534
2016-12-21 15:00:00;47,95;60,39;-12,44;40130;742;0.0185;1459;-717;49238;12540;0.2547;13847;-1307
2016-12-21 16:00:00;47,95;62,44;-14,49;40130;26;0.0007;72;-46;49238;13777;0.2798;15059;-1282
2016-12-21 17:00:00;48,95;57,48;-8,53;40130;0;0;0;0;49238;14928;0.3032;16129;-1201
2016-12-21 18:00:00;47,0;54,49;-7,49;40130;0;0;0;0;49238;15220;0.3091;16945;-1725
2016-12-21 19:00:00;44,62;49,71;-5,09;40130;0;0;0;0;49238;15512;0.315;17329;-1817
2016-12-21 20:00:00;39,05;43,91;-4,86;40130;0;0;0;0;49238;15220;0.3091;17152;-1932
2016-12-21 21:00:00;37,22;39,85;-2,63;40130;0;0;0;0;49238;15130;0.3072;16749;-1619
2016-12-21 22:00:00;34,57;36,1;-1,53;40130;0;0;0;0;49238;14471;0.2939;16048;-1577
2016-12-21 23:00:00;33,94;36,5;-2,56;40130;0;0;0;0;49238;13770;0.2797;14955;-1185
2016-12-22 00:00:00;34,34;35,31;-0,97;40149;0;0;0;0;49306;12903;0.2617;13624;-721
2016-12-22 01:00:00;32,72;34,48;-1,76;40149;0;0;0;0;49306;12176;0.247;12829;-653
2016-12-22 02:00:00;33,34;33,84;-0,5;40149;0;0;0;0;49306;11658;0.2364;12161;-503
2016-12-22 03:00:00;34,42;32,8;1,62;40149;0;0;0;0;49306;11401;0.2312;11545;-144
2016-12-22 04:00:00;34,9;32,25;2,65;40149;0;0;0;0;49306;11679;0.2369;11070;609
2016-12-22 05:00:00;36,03;37,31;-1,28;40149;0;0;0;0;49306;11468;0.2326;10784;684
2016-12-22 06:00:00;41,88;38,05;3,83;40149;0;0;0;0;49306;10938;0.2218;10480;458
2016-12-22 07:00:00;51,84;50,15;1,69;40149;1;0;3;-2;49306;10283;0.2085;10249;34
2016-12-22 08:00:00;51,78;52,58;-0,8;40149;179;0.0045;282;-103;49306;10042;0.2036;10141;-99
2016-12-22 09:00:00;50,99;54,55;-3,56;40149;1283;0.032;1509;-226;49306;9727;0.1973;10087;-360
2016-12-22 10:00:00;55,62;54,49;1,13;40149;2835;0.0706;2986;-151;49306;9144;0.1854;9911;-767
2016-12-22 11:00:00;54,26;54,02;0,24;40149;4089;0.1018;4039;50;49306;9101;0.1846;9533;-432
2016-12-22 12:00:00;51,4;49,42;1,98;40149;4610;0.1148;4344;266;49306;9010;0.1827;9233;-223
2016-12-22 13:00:00;50,94;49,32;1,62;40149;3921;0.0976;3719;202;49306;8879;0.1801;9027;-148
2016-12-22 14:00:00;50,93;48,85;2,08;40149;2413;0.0601;2365;48;49306;8765;0.1778;9074;-309
2016-12-22 15:00:00;51,97;51,65;0,32;40149;751;0.0187;812;-61;49306;8616;0.1748;9354;-738
2016-12-22 16:00:00;56,7;54,66;2,04;40149;27;0.0007;52;-25;49306;8993;0.1824;9809;-816
2016-12-22 17:00:00;54,46;54,72;-0,26;40149;0;0;0;0;49306;9670;0.1961;10389;-719
2016-12-22 18:00:00;54,92;53,76;1,16;40149;0;0;0;0;49306;10352;0.21;10969;-617
2016-12-22 19:00:00;51,0;49,36;1,64;40149;0;0;0;0;49306;10768;0.2184;11519;-751
2016-12-22 20:00:00;39,94;39,92;0,02;40149;0;0;0;0;49306;11763;0.2386;12032;-269
2016-12-22 21:00:00;37,66;34,68;2,98;40149;0;0;0;0;49306;12826;0.2601;12529;297
2016-12-22 22:00:00;38,62;33,72;4,9;40149;0;0;0;0;49306;12943;0.2625;12890;53
2016-12-22 23:00:00;34,95;31,16;3,79;40149;0;0;0;0;49306;13382;0.2714;13159;223
2016-12-23 00:00:00;29,02;34,09;-5,07;40189;0;0;0;0;49357;13613;0.2758;14396;-783
2016-12-23 01:00:00;29,58;36,06;-6,48;40189;0;0;0;0;49357;13922;0.2821;14662;-740
2016-12-23 02:00:00;27,58;36,7;-9,12;40189;0;0;0;0;49357;14470;0.2932;14941;-471
2016-12-23 03:00:00;26,78;33,77;-6,99;40189;0;0;0;0;49357;15200;0.308;15175;25
2016-12-23 04:00:00;29,02;33,87;-4,85;40189;0;0;0;0;49357;15674;0.3176;15273;401
2016-12-23 05:00:00;30,0;34,81;-4,81;40189;0;0;0;0;49357;15547;0.315;15048;499
2016-12-23 06:00:00;36,3;37,59;-1,29;40189;0;0;0;0;49357;15234;0.3086;14562;672
2016-12-23 07:00:00;45,91;46,81;-0,9;40189;0;0;0;0;49357;14261;0.289;13827;434
2016-12-23 08:00:00;50,91;48,02;2,89;40189;115;0.0028;135;-20;49357;13251;0.2685;13015;236
2016-12-23 09:00:00;51,15;44,8;6,35;40189;990;0.0246;1054;-64;49357;12610;0.2555;12498;112
2016-12-23 10:00:00;50,98;46,71;4,27;40189;2117;0.0527;2415;-298;49357;12807;0.2595;12299;508
2016-12-23 11:00:00;48,89;45,03;3,86;40189;3181;0.0792;3420;-239;49357;12909;0.2616;12311;598
2016-12-23 12:00:00;45,91;40,37;5,54;40189;3838;0.0955;3726;112;49357;13235;0.2682;12385;850
2016-12-23 13:00:00;45,12;36,02;9,1;40189;3323;0.0827;3255;68;49357;13140;0.2662;12603;537
2016-12-23 14:00:00;44,95;34,84;10,11;40189;1978;0.0492;2098;-120;49357;12802;0.2594;13191;-389
2016-12-23 15:00:00;44,96;36,12;8,84;40189;546;0.0136;691;-145;49357;13338;0.2702;14175;-837
2016-12-23 16:00:00;46,96;37,74;9,22;40189;23;0.0006;38;-15;49357;14714;0.2981;15525;-811
2016-12-23 17:00:00;48,39;38,48;9,91;40189;0;0;0;0;49357;16592;0.3362;17351;-759
2016-12-23 18:00:00;40,84;40,44;0,4;40189;0;0;0;0;49357;18086;0.3664;19337;-1251
2016-12-23 19:00:00;38,15;40,12;-1,97;40189;0;0;0;0;49357;19490;0.3949;21143;-1653
2016-12-23 20:00:00;36,28;37,77;-1,49;40189;0;0;0;0;49357;20934;0.4241;22714;-1780
2016-12-23 21:00:00;33,0;35,87;-2,87;40189;0;0;0;0;49357;22486;0.4556;24312;-1826
2016-12-23 22:00:00;27,57;32,98;-5,41;40189;0;0;0;0;49357;23391;0.4739;25997;-2606
2016-12-23 23:00:00;7,82;18,97;-11,15;40189;0;0;0;0;49357;25115;0.5088;27731;-2616
2016-12-24 00:00:00;10,38;16,12;-5,74;40189;0;0;0;0;49357;26088;0.5286;28922;-2834
2016-12-24 01:00:00;3,71;14,16;-10,45;40189;0;0;0;0;49357;27095;0.549;29610;-2515
2016-12-24 02:00:00;-7,62;12,68;-20,3;40189;0;0;0;0;49357;27197;0.551;29709;-2512
2016-12-24 03:00:00;-2,57;12,32;-14,89;40189;0;0;0;0;49357;26802;0.543;29054;-2252
2016-12-24 04:00:00;8,47;17,2;-8,73;40189;0;0;0;0;49357;26380;0.5345;27847;-1467
2016-12-24 05:00:00;8,59;16,83;-8,24;40189;0;0;0;0;49357;25322;0.513;26764;-1442
2016-12-24 06:00:00;3,97;14,39;-10,42;40189;0;0;0;0;49357;25228;0.5112;25714;-486
2016-12-24 07:00:00;8,69;16,37;-7,68;40189;0;0;0;0;49357;25244;0.5114;24831;413
2016-12-24 08:00:00;15,99;20,36;-4,37;40189;82;0.002;117;-35;49357;24554;0.4974;24316;238
2016-12-24 09:00:00;20,36;26,31;-5,95;40189;664;0.0165;774;-110;49357;23896;0.4841;24275;-379
2016-12-24 10:00:00;21,0;30,85;-9,85;40189;1738;0.0433;1825;-87;49357;24423;0.4948;24580;-157
2016-12-24 11:00:00;20,02;33,05;-13,03;40189;2656;0.0661;2682;-26;49357;26403;0.5349;25259;1144
2016-12-24 12:00:00;18,04;20,27;-2,23;40189;2726;0.0678;3074;-348;49357;27500;0.5572;26137;1363
2016-12-24 13:00:00;15,3;13,94;1,36;40189;2661;0.0662;2811;-150;49357;28597;0.5794;27017;1580
2016-12-24 14:00:00;10,41;13,91;-3,5;40189;1726;0.0429;1880;-154;49357;28474;0.5769;27838;636
2016-12-24 15:00:00;10,51;13,94;-3,43;40189;565;0.014;633;-68;49357;29033;0.5882;28479;554
2016-12-24 16:00:00;13,79;23,52;-9,73;40189;25;0.0006;30;-5;49357;30118;0.6102;29217;901
2016-12-24 17:00:00;13,69;27,74;-14,05;40189;0;0;0;0;49357;30702;0.622;30061;641
2016-12-24 18:00:00;8,67;20,71;-12,04;40189;0;0;0;0;49357;31582;0.6399;30773;809
2016-12-24 19:00:00;2,16;14,58;-12,42;40189;0;0;0;0;49357;32264;0.6537;31336;928
2016-12-24 20:00:00;2,93;7,71;-4,78;40189;0;0;0;0;49357;32830;0.6652;31885;945
2016-12-24 21:00:00;0,11;-0,12;0,23;40189;0;0;0;0;49357;32529;0.659;32161;368
2016-12-24 22:00:00;8,31;0,86;7,45;40189;0;0;0;0;49357;31862;0.6456;32121;-259
2016-12-24 23:00:00;-12,05;-1,77;-10,28;40189;0;0;0;0;49357;31904;0.6464;31925;-21
2016-12-25 00:00:00;-18,07;-2,49;-15,58;40189;0;0;0;0;49357;31570;0.6396;31558;12
2016-12-25 01:00:00;-36,1;-7,5;-28,6;40189;0;0;0;0;49357;30847;0.625;31223;-376
2016-12-25 02:00:00;-38,78;-11,93;-26,85;40189;0;0;0;0;49357;29627;0.6003;30718;-1091
2016-12-25 03:00:00;-26,87;-8,81;-18,06;40189;0;0;0;0;49357;28783;0.5831;30263;-1480
2016-12-25 04:00:00;-15,06;1,74;-16,8;40189;0;0;0;0;49357;28570;0.5788;30026;-1456
2016-12-25 05:00:00;-12,1;3,71;-15,81;40189;0;0;0;0;49357;27767;0.5626;29903;-2136
2016-12-25 06:00:00;-30,07;5,24;-35,31;40189;0;0;0;0;49357;27758;0.5624;29912;-2154
2016-12-25 07:00:00;-4,02;11,46;-15,48;40189;0;0;0;0;49357;28512;0.5776;30035;-1523
2016-12-25 08:00:00;0,1;8,23;-8,13;40189;46;0.0011;63;-17;49357;29246;0.5925;30418;-1172
2016-12-25 09:00:00;10,6;14,2;-3,6;40189;309;0.0077;344;-35;49357;29832;0.6044;30736;-904
2016-12-25 10:00:00;13,49;16,32;-2,83;40189;770;0.0192;760;10;49357;30990;0.6279;31019;-29
2016-12-25 11:00:00;13,67;16,47;-2,8;40189;1208;0.0301;1145;63;49357;31708;0.6425;31266;442
2016-12-25 12:00:00;8,76;12,55;-3,79;40189;1438;0.0358;1290;148;49357;32501;0.6585;31424;1077
2016-12-25 13:00:00;0,13;-2,21;2,34;40189;1415;0.0352;1154;261;49357;32384;0.6561;31321;1063
2016-12-25 14:00:00;-0,1;-5,1;5,0;40189;1036;0.0258;763;273;49357;31931;0.6469;31042;889
2016-12-25 15:00:00;0,08;-2,04;2,12;40189;364;0.009;294;70;49357;31505;0.6383;30753;752
2016-12-25 16:00:00;8,67;2,07;6,6;40189;22;0.0005;30;-8;49357;31088;0.6298;30446;642
2016-12-25 17:00:00;13,63;5,84;7,79;40189;0;0;0;0;49357;30436;0.6166;30151;285
2016-12-25 18:00:00;10,7;3,43;7,27;40189;0;0;0;0;49357;29885;0.6055;29960;-75
2016-12-25 19:00:00;8,98;1,17;7,81;40189;0;0;0;0;49357;30108;0.61;29783;325
2016-12-25 20:00:00;10,67;-1,36;12,03;40189;0;0;0;0;49357;29968;0.6072;29496;472
2016-12-25 21:00:00;9,94;-3,64;13,58;40189;0;0;0;0;49357;29711;0.602;29373;338
2016-12-25 22:00:00;10,02;-1,76;11,78;40189;0;0;0;0;49357;29131;0.5902;29343;-212
2016-12-25 23:00:00;-2,95;-13,34;10,39;40189;0;0;0;0;49357;28970;0.587;29395;-425
2016-12-26 00:00:00;0,04;-22,99;23,03;40189;0;0;0;0;49357;28520;0.5778;28649;-129
2016-12-26 01:00:00;-9,92;-23,0;13,08;40189;0;0;0;0;49357;27718;0.5616;28581;-863
2016-12-26 02:00:00;-14,9;-33,45;18,55;40189;0;0;0;0;49357;27836;0.564;28661;-825
2016-12-26 03:00:00;-16,09;-33,42;17,33;40189;0;0;0;0;49357;27875;0.5648;28842;-967
2016-12-26 04:00:00;-15,05;-29,66;14,61;40189;0;0;0;0;49357;27535;0.5579;29077;-1542
2016-12-26 05:00:00;-51,49;-38,66;-12,83;40189;0;0;0;0;49357;26929;0.5456;29350;-2421
2016-12-26 06:00:00;-67,07;-39,8;-27,27;40189;0;0;0;0;49357;27396;0.555;29620;-2224
2016-12-26 07:00:00;-67,09;-38,44;-28,65;40189;0;0;0;0;49357;28042;0.5681;29947;-1905
2016-12-26 08:00:00;-54,2;-12,29;-41,91;40189;79;0.002;116;-37;49357;29038;0.5883;30312;-1274
2016-12-26 09:00:00;-3,08;0,2;-3,28;40189;800;0.0199;666;134;49357;29403;0.5957;30507;-1104
2016-12-26 10:00:00;0,11;2,37;-2,26;40189;2140;0.0532;1461;679;49357;30247;0.6128;30780;-533
2016-12-26 11:00:00;5,87;6,31;-0,44;40189;3352;0.0834;2022;1330;49357;31372;0.6356;31261;111
2016-12-26 12:00:00;1,05;1,21;-0,16;40189;3569;0.0888;2246;1323;49357;32187;0.6521;31741;446
2016-12-26 13:00:00;-6,71;-2,42;-4,29;40189;2998;0.0746;2068;930;49357;32538;0.6593;31798;740
2016-12-26 14:00:00;-13,31;-1,45;-11,86;40189;1826;0.0454;1458;368;49357;31271;0.6336;31052;219
2016-12-26 15:00:00;-6,74;2,28;-9,02;40189;661;0.0164;538;123;49357;30592;0.6198;30439;153
2016-12-26 16:00:00;-2,98;4,09;-7,07;40189;38;0.0009;30;8;49357;30776;0.6236;30128;648
2016-12-26 17:00:00;8,78;13,22;-4,44;40189;0;0;0;0;49357;30867;0.6254;30047;820
2016-12-26 18:00:00;9,68;13,51;-3,83;40189;0;0;0;0;49357;30931;0.6267;30244;687
2016-12-26 19:00:00;10,69;21,25;-10,56;40189;0;0;0;0;49357;31073;0.6296;30478;595
2016-12-26 20:00:00;8,32;13,25;-4,93;40189;0;0;0;0;49357;31327;0.6347;30971;356
2016-12-26 21:00:00;-0,91;7,2;-8,11;40189;0;0;0;0;49357;31336;0.6349;31432;-96
2016-12-26 22:00:00;4,39;7,38;-2,99;40189;0;0;0;0;49357;30586;0.6197;31798;-1212
2016-12-26 23:00:00;-13,34;-0,07;-13,27;40189;0;0;0;0;49357;30674;0.6215;32091;-1417
2016-12-27 00:00:00;-13,0;-2,09;-10,91;40194;0;0;0;0;49381;30611;0.6199;31804;-1193
2016-12-27 01:00:00;-24,92;-9,83;-15,09;40194;0;0;0;0;49381;30854;0.6248;31995;-1141
2016-12-27 02:00:00;-49,98;-25,4;-24,58;40194;0;0;0;0;49381;30788;0.6235;32554;-1766
2016-12-27 03:00:00;-53,62;-32,23;-21,39;40194;0;0;0;0;49381;30681;0.6213;32591;-1910
2016-12-27 04:00:00;-50,19;-39,51;-10,68;40194;0;0;0;0;49381;30741;0.6225;32501;-1760
2016-12-27 05:00:00;-23,36;-25,11;1,75;40194;0;0;0;0;49381;30184;0.6113;32244;-2060
2016-12-27 06:00:00;-12,15;-1,82;-10,33;40194;0;0;0;0;49381;30122;0.61;31962;-1840
2016-12-27 07:00:00;8,77;19,65;-10,88;40194;1;0;2;-1;49381;30286;0.6133;31573;-1287
2016-12-27 08:00:00;13,7;25,71;-12,01;40194;166;0.0041;206;-40;49381;30087;0.6093;31020;-933
2016-12-27 09:00:00;12,17;27,87;-15,7;40194;1418;0.0353;1385;33;49381;29764;0.6027;30508;-744
2016-12-27 10:00:00;10,63;28,45;-17,82;40194;3410;0.0848;3173;237;49381;29632;0.6001;30097;-465
2016-12-27 11:00:00;10,64;29,35;-18,71;40194;5022;0.125;4406;616;49381;29492;0.5973;29578;-86
2016-12-27 12:00:00;10,68;27,39;-16,71;40194;5410;0.1346;4659;751;49381;28862;0.5845;29032;-170
2016-12-27 13:00:00;13,75;29,01;-15,26;40194;4389;0.1092;3900;489;49381;28293;0.573;28423;-130
2016-12-27 14:00:00;13,76;32,49;-18,73;40194;2654;0.066;2492;162;49381;26973;0.5462;27656;-683
2016-12-27 15:00:00;21,04;38,12;-17,08;40194;915;0.0228;920;-5;49381;25522;0.5168;26688;-1166
2016-12-27 16:00:00;29,58;48,02;-18,44;40194;63;0.0016;76;-13;49381;24645;0.4991;25747;-1102
2016-12-27 17:00:00;29,76;49,68;-19,92;40194;0;0;0;0;49381;24266;0.4914;25002;-736
2016-12-27 18:00:00;29,69;54,89;-25,2;40194;0;0;0;0;49381;23514;0.4762;24394;-880
2016-12-27 19:00:00;29,45;51,05;-21,6;40194;0;0;0;0;49381;23032;0.4664;23813;-781
2016-12-27 20:00:00;31,91;50,49;-18,58;40194;0;0;0;0;49381;22002;0.4456;23252;-1250
2016-12-27 21:00:00;28,5;47,37;-18,87;40194;0;0;0;0;49381;20840;0.422;22710;-1870
2016-12-27 22:00:00;27,01;45,56;-18,55;40194;0;0;0;0;49381;20409;0.4133;22093;-1684
2016-12-27 23:00:00;13,71;35,48;-21,77;40194;0;0;0;0;49381;20225;0.4096;21300;-1075
2016-12-28 00:00:00;21,8;28,8;-7,0;40194;0;0;0;0;49434;19681;0.3981;18283;1398
2016-12-28 01:00:00;21,28;26,31;-5,03;40194;0;0;0;0;49434;19099;0.3864;17681;1418
2016-12-28 02:00:00;22,1;21,21;0,89;40194;0;0;0;0;49434;18198;0.3681;16956;1242
2016-12-28 03:00:00;20,28;20,19;0,09;40194;0;0;0;0;49434;17324;0.3504;16157;1167
2016-12-28 04:00:00;23,01;26,23;-3,22;40194;0;0;0;0;49434;16279;0.3293;15327;952
2016-12-28 05:00:00;28,09;30,86;-2,77;40194;0;0;0;0;49434;15285;0.3092;14382;903
2016-12-28 06:00:00;30,0;36,4;-6,4;40194;0;0;0;0;49434;14704;0.2974;13351;1353
2016-12-28 07:00:00;32,07;40,06;-7,99;40194;1;0;2;-1;49434;13526;0.2736;12264;1262
2016-12-28 08:00:00;40,06;43,18;-3,12;40194;109;0.0027;169;-60;49434;12351;0.2498;11310;1041
2016-12-28 09:00:00;45,57;43,78;1,79;40194;1075;0.0268;1061;14;49434;10871;0.2199;10637;234
2016-12-28 10:00:00;45,46;46,32;-0,86;40194;2694;0.067;2370;324;49434;9578;0.1938;10115;-537
2016-12-28 11:00:00;43,93;45,75;-1,82;40194;3870;0.0963;3363;507;49434;8012;0.1621;9572;-1560
2016-12-28 12:00:00;44,4;45,83;-1,43;40194;4283;0.1066;3618;665;49434;7227;0.1462;8963;-1736
2016-12-28 13:00:00;45,82;49,1;-3,28;40194;3798;0.0945;3156;642;49434;6587;0.1332;8239;-1652
2016-12-28 14:00:00;50,77;50,52;0,25;40194;2591;0.0645;2121;470;49434;6024;0.1219;7329;-1305
2016-12-28 15:00:00;51,6;52,85;-1,25;40194;960;0.0239;841;119;49434;5322;0.1076;6344;-1022
2016-12-28 16:00:00;55,2;57,79;-2,59;40194;69;0.0017;75;-6;49434;4595;0.093;5605;-1010
2016-12-28 17:00:00;62,8;64,47;-1,67;40194;0;0;0;0;49434;4205;0.085;5222;-1017
2016-12-28 18:00:00;63,7;62,74;0,96;40194;0;0;0;0;49434;3594;0.0727;4935;-1341
2016-12-28 19:00:00;59,82;58,79;1,03;40194;0;0;0;0;49434;3310;0.067;4606;-1296
2016-12-28 20:00:00;49,95;51,9;-1,95;40194;0;0;0;0;49434;3362;0.068;4204;-842
2016-12-28 21:00:00;50,0;51,1;-1,1;40194;0;0;0;0;49434;3378;0.0683;3903;-525
2016-12-28 22:00:00;45,64;48,36;-2,72;40194;0;0;0;0;49434;3387;0.0685;3746;-359
2016-12-28 23:00:00;37,92;40,99;-3,07;40194;0;0;0;0;49434;4053;0.082;3767;286
2016-12-29 00:00:00;42,28;39,38;2,9;40217;0;0;0;0;49486;4719;0.0954;4127;592
2016-12-29 01:00:00;39,3;36,5;2,8;40217;0;0;0;0;49486;5050;0.102;4372;678
2016-12-29 02:00:00;36,83;37,46;-0,63;40217;0;0;0;0;49486;5243;0.1059;4593;650
2016-12-29 03:00:00;34,11;36,38;-2,27;40217;0;0;0;0;49486;5244;0.106;4774;470
2016-12-29 04:00:00;34,99;35,68;-0,69;40217;0;0;0;0;49486;5023;0.1015;4893;130
2016-12-29 05:00:00;37,64;36,68;0,96;40217;0;0;0;0;49486;5150;0.1041;4976;174
2016-12-29 06:00:00;41,05;39,36;1,69;40217;0;0;0;0;49486;5926;0.1198;5139;787
2016-12-29 07:00:00;49,3;48,82;0,48;40217;1;0;3;-2;49486;6436;0.1301;5252;1184
2016-12-29 08:00:00;53,38;45,57;7,81;40217;238;0.0059;338;-100;49486;6814;0.1377;5352;1462
2016-12-29 09:00:00;54,01;45,91;8,1;40217;2460;0.0612;2422;38;49486;6899;0.1394;5487;1412
2016-12-29 10:00:00;51,14;41,8;9,34;40217;5778;0.1436;5352;426;49486;6488;0.1311;5517;971
2016-12-29 11:00:00;50,96;41,95;9,01;40217;8388;0.2086;7488;900;49486;6242;0.1261;5073;1169
2016-12-29 12:00:00;47,09;39,62;7,47;40217;9310;0.2315;8292;1018;49486;6048;0.1222;4999;1049
2016-12-29 13:00:00;46,62;37,94;8,68;40217;8471;0.2106;7508;963;49486;5932;0.1199;5141;791
2016-12-29 14:00:00;49,6;40,54;9,06;40217;5844;0.1453;5183;661;49486;5786;0.1169;5233;553
2016-12-29 15:00:00;51,63;47,36;4,27;40217;2286;0.0569;2045;241;49486;5776;0.1167;5409;367
2016-12-29 16:00:00;54,43;51,33;3,1;40217;134;0.0033;138;-4;49486;6642;0.1342;6174;468
2016-12-29 17:00:00;63,95;56,19;7,76;40217;0;0;0;0;49486;8148;0.1647;7230;918
2016-12-29 18:00:00;57,2;49,2;8,0;40217;0;0;0;0;49486;9106;0.184;8092;1014
2016-12-29 19:00:00;54,02;46,65;7,37;40217;0;0;0;0;49486;9396;0.1899;8559;837
2016-12-29 20:00:00;47,98;41,82;6,16;40217;0;0;0;0;49486;9516;0.1923;8441;1075
2016-12-29 21:00:00;42,93;42,01;0,92;40217;0;0;0;0;49486;9528;0.1926;8262;1266
2016-12-29 22:00:00;38,04;38,65;-0,61;40217;0;0;0;0;49486;9128;0.1844;8191;937
2016-12-29 23:00:00;36,03;36,99;-0,96;40217;0;0;0;0;49486;9211;0.1861;8203;1008
2016-12-30 00:00:00;36,01;39,47;-3,46;40260;0;0;0;0;49528;8966;0.181;7998;968
2016-12-30 01:00:00;35,96;38,45;-2,49;40260;0;0;0;0;49528;8986;0.1815;7922;1064
2016-12-30 02:00:00;32,06;35,31;-3,25;40260;0;0;0;0;49528;8860;0.1789;8130;730
2016-12-30 03:00:00;32,54;33,45;-0,91;40260;0;0;0;0;49528;8900;0.1797;8513;387
2016-12-30 04:00:00;33,09;34,27;-1,18;40260;0;0;0;0;49528;9237;0.1865;8863;374
2016-12-30 05:00:00;33,09;36,22;-3,13;40260;0;0;0;0;49528;9738;0.1966;9147;591
2016-12-30 06:00:00;33,94;35,8;-1,86;40260;0;0;0;0;49528;10388;0.2098;9417;971
2016-12-30 07:00:00;46,0;49,63;-3,63;40260;1;0;4;-3;49528;10854;0.2192;9769;1085
2016-12-30 08:00:00;49,96;48,79;1,17;40260;295;0.0074;367;-72;49528;11349;0.2292;10050;1299
2016-12-30 09:00:00;47,19;47,87;-0,68;40260;3076;0.0764;2938;138;49528;11554;0.2333;10147;1407
2016-12-30 10:00:00;43,0;42,85;0,15;40260;6853;0.1702;6839;14;49528;10594;0.2139;9371;1223
2016-12-30 11:00:00;37,27;42,33;-5,06;40260;9676;0.2404;9616;60;49528;9181;0.1854;8621;560
2016-12-30 12:00:00;36,3;40,71;-4,41;40260;10794;0.2681;10293;501;49528;7989;0.1613;8463;-474
2016-12-30 13:00:00;36,72;39,69;-2,97;40260;9520;0.2365;8962;558;49528;7389;0.1492;8382;-993
2016-12-30 14:00:00;47,19;48,34;-1,15;40260;6129;0.1522;6000;129;49528;7055;0.1424;8422;-1367
2016-12-30 15:00:00;52,78;53,46;-0,68;40260;2106;0.0523;2332;-226;49528;7615;0.1538;8681;-1066
2016-12-30 16:00:00;54,99;58,12;-3,13;40260;96;0.0024;154;-58;49528;9178;0.1853;9534;-356
2016-12-30 17:00:00;56,04;60,65;-4,61;40260;0;0;0;0;49528;10386;0.2097;10726;-340
2016-12-30 18:00:00;52,92;55,84;-2,92;40260;0;0;0;0;49528;10775;0.2176;11366;-591
2016-12-30 19:00:00;52,82;53,71;-0,89;40260;0;0;0;0;49528;11117;0.2244;11632;-515
2016-12-30 20:00:00;43,32;48,37;-5,05;40260;0;0;0;0;49528;11422;0.2306;11678;-256
2016-12-30 21:00:00;41,03;45,05;-4,02;40260;0;0;0;0;49528;11732;0.2369;11771;-39
2016-12-30 22:00:00;40,55;45,1;-4,55;40260;0;0;0;0;49528;11626;0.2348;11872;-246
2016-12-30 23:00:00;33,06;36,01;-2,95;40260;0;0;0;0;49528;11642;0.235;11933;-291
2016-12-31 00:00:00;36,1;43,56;-7,46;40293;0;0;0;0;49569;11690;0.2358;11308;382
2016-12-31 01:00:00;33,04;41,1;-8,06;40293;0;0;0;0;49569;11799;0.238;11375;424
2016-12-31 02:00:00;29,9;36,74;-6,84;40293;0;0;0;0;49569;11696;0.236;11700;-4
2016-12-31 03:00:00;27,63;40,51;-12,88;40293;0;0;0;0;49569;11706;0.2362;12072;-366
2016-12-31 04:00:00;27,52;38,82;-11,3;40293;0;0;0;0;49569;11588;0.2338;12368;-780
2016-12-31 05:00:00;27,28;38,12;-10,84;40293;0;0;0;0;49569;11699;0.236;12608;-909
2016-12-31 06:00:00;21,43;37,48;-16,05;40293;0;0;0;0;49569;12179;0.2457;12826;-647
2016-12-31 07:00:00;31,68;39,24;-7,56;40293;1;0;3;-2;49569;12408;0.2503;13001;-593
2016-12-31 08:00:00;35,02;44,56;-9,54;40293;214;0.0053;390;-176;49569;12941;0.2611;13141;-200
2016-12-31 09:00:00;41,88;49,01;-7,13;40293;2147;0.0533;2667;-520;49569;13026;0.2628;13161;-135
2016-12-31 10:00:00;39,94;49,93;-9,99;40293;4871;0.1209;5643;-772;49569;12803;0.2583;12736;67
2016-12-31 11:00:00;39,96;48,85;-8,89;40293;7038;0.1747;7809;-771;49569;12218;0.2465;12154;64
2016-12-31 12:00:00;38,86;46,47;-7,61;40293;7882;0.1956;8450;-568;49569;12017;0.2424;11998;19
2016-12-31 13:00:00;35,04;44,04;-9,0;40293;6680;0.1658;7459;-779;49569;11746;0.237;12043;-297
2016-12-31 14:00:00;37,5;49,61;-12,11;40293;4236;0.1052;5067;-831;49569;11522;0.2324;12407;-885
2016-12-31 15:00:00;43,81;54,41;-10,6;40293;1443;0.0358;2020;-577;49569;12394;0.25;13039;-645
2016-12-31 16:00:00;49,76;57,64;-7,88;40293;68;0.0017;147;-79;49569;13234;0.267;14004;-770
2016-12-31 17:00:00;53,98;64,86;-10,88;40293;0;0;0;0;49569;14072;0.2839;14847;-775
2016-12-31 18:00:00;49,76;61,36;-11,6;40293;0;0;0;0;49569;14836;0.2993;15440;-604
2016-12-31 19:00:00;40,84;58,24;-17,4;40293;0;0;0;0;49569;15196;0.3066;15908;-712
2016-12-31 20:00:00;35,05;51,2;-16,15;40293;0;0;0;0;49569;15303;0.3087;16207;-904
2016-12-31 21:00:00;33,02;48,41;-15,39;40293;0;0;0;0;49569;15354;0.3097;16450;-1096
2016-12-31 22:00:00;33,71;49,31;-15,6;40293;0;0;0;0;49569;14848;0.2995;16595;-1747
2016-12-31 23:00:00;27,95;50,48;-22,53;40293;0;0;0;0;49569;15056;0.3037;16588;-1532
2017-01-01 00:00:00;20,96;43,61;-22,65;40294;0;0;0;0;49569;15422;0.3111;16166;-744
2017-01-01 01:00:00;20,9;42,31;-21,41;40294;0;0;0;0;49569;15363;0.3099;15968;-605
2017-01-01 02:00:00;18,13;38,19;-20,06;40294;0;0;0;0;49569;15080;0.3042;15904;-824
2017-01-01 03:00:00;16,03;33,25;-17,22;40294;0;0;0;0;49569;14731;0.2972;15786;-1055
2017-01-01 04:00:00;16,43;32,79;-16,36;40294;0;0;0;0;49569;14865;0.2999;15720;-855
2017-01-01 05:00:00;13,75;36,08;-22,33;40294;0;0;0;0;49569;15254;0.3077;15810;-556
2017-01-01 06:00:00;11,1;25,97;-14,87;40294;0;0;0;0;49569;15904;0.3208;16042;-138
2017-01-01 07:00:00;15,47;23,28;-7,81;40294;1;0;2;-1;49569;15903;0.3208;16317;-414
2017-01-01 08:00:00;16,88;31,14;-14,26;40294;274;0.0068;427;-153;49569;15816;0.3191;16562;-746
2017-01-01 09:00:00;21,81;35,05;-13,24;40294;2083;0.0517;2602;-519;49569;15722;0.3172;16703;-981
2017-01-01 10:00:00;26,24;34,92;-8,68;40294;4679;0.1161;5269;-590;49569;14505;0.2926;16437;-1932
2017-01-01 11:00:00;26,42;35,06;-8,64;40294;6830;0.1695;7180;-350;49569;13300;0.2683;15567;-2267
2017-01-01 12:00:00;27,66;36,25;-8,59;40294;7926;0.1967;7807;119;49569;12236;0.2468;14640;-2404
2017-01-01 13:00:00;28,7;35,22;-6,52;40294;7084;0.1758;6934;150;49569;11020;0.2223;14070;-3050
2017-01-01 14:00:00;29,66;37,3;-7,64;40294;4635;0.115;4709;-74;49569;9829;0.1983;13818;-3989
2017-01-01 15:00:00;35,33;49,86;-14,53;40294;1661;0.0412;1878;-217;49569;8994;0.1815;13826;-4832
2017-01-01 16:00:00;44,12;55,32;-11,2;40294;118;0.003;148;-30;49569;9147;0.1845;13990;-4843
2017-01-01 17:00:00;51,59;59,55;-7,96;40294;0;0;3;-3;49569;9738;0.1964;14242;-4504
2017-01-01 18:00:00;53,95;64,04;-10,09;40294;0;0;0;0;49569;9876;0.1992;14512;-4636
2017-01-01 19:00:00;50,97;60,22;-9,25;40294;0;0;0;0;49569;10227;0.2063;14707;-4480
2017-01-01 20:00:00;44,93;53,62;-8,69;40294;0;0;0;0;49569;11094;0.2238;14741;-3647
2017-01-01 21:00:00;38,83;48,83;-10,0;40294;0;0;0;0;49569;11533;0.2326;14715;-3182
2017-01-01 22:00:00;42,17;52,03;-9,86;40294;0;0;0;0;49569;12339;0.2489;14622;-2283
2017-01-01 23:00:00;33,06;47,07;-14,01;40294;0;0;0;0;49569;12260;0.2473;14386;-2126
2017-02-01 00:00:00;30,54;38,61;-8,07;40301;0;0;0;0;49572;12389;0.2499;13567;-1178
2017-02-01 01:00:00;28,91;37,51;-8,6;40301;0;0;0;0;49572;12910;0.2604;13715;-805
2017-02-01 02:00:00;28,11;32,87;-4,76;40301;0;0;0;0;49572;12710;0.2564;13806;-1096
2017-02-01 03:00:00;27,89;32,13;-4,24;40301;0;0;0;0;49572;12694;0.2561;13852;-1158
2017-02-01 04:00:00;27,73;32,21;-4,48;40301;0;0;0;0;49572;11989;0.2418;13733;-1744
2017-02-01 05:00:00;31,18;37,51;-6,33;40301;0;0;0;0;49572;11863;0.2393;13440;-1577
2017-02-01 06:00:00;37,99;43,76;-5,77;40301;0;0;0;0;49572;12128;0.2446;13164;-1036
2017-02-01 07:00:00;50,98;54,76;-3,78;40301;0;0;1;-1;49572;11925;0.2406;12853;-928
2017-02-01 08:00:00;53,88;57,19;-3,31;40301;105;0.0026;229;-124;49572;11406;0.2301;12310;-904
2017-02-01 09:00:00;53,94;57,05;-3,11;40301;774;0.0192;1238;-464;49572;10518;0.2122;11805;-1287
2017-02-01 10:00:00;53,54;59,42;-5,88;40301;1627;0.0404;2623;-996;49572;10322;0.2082;11117;-795
2017-02-01 11:00:00;54,91;61,66;-6,75;40301;2401;0.0596;3608;-1207;49572;9825;0.1982;10479;-654
2017-02-01 12:00:00;54,08;65,99;-11,91;40301;2868;0.0712;3757;-889;49572;10077;0.2033;10273;-196
2017-02-01 13:00:00;55,67;67,5;-11,83;40301;2528;0.0628;3016;-488;49572;10096;0.2037;10243;-147
2017-02-01 14:00:00;55,98;64,97;-8,99;40301;1572;0.039;1809;-237;49572;10510;0.212;10306;204
2017-02-01 15:00:00;56,0;64,38;-8,38;40301;556;0.0138;633;-77;49572;10562;0.2131;10433;129
2017-02-01 16:00:00;57,77;67,33;-9,56;40301;48;0.0012;53;-5;49572;11042;0.2228;10654;388
2017-02-01 17:00:00;67,66;72,41;-4,75;40301;0;0;2;-2;49572;12126;0.2446;11081;1045
2017-02-01 18:00:00;55,1;67,28;-12,18;40301;0;0;0;0;49572;13440;0.2711;11464;1976
2017-02-01 19:00:00;53,92;57,44;-3,52;40301;0;0;0;0;49572;13900;0.2804;11619;2281
2017-02-01 20:00:00;49,07;48,35;0,72;40301;0;0;0;0;49572;13906;0.2805;11655;2251
2017-02-01 21:00:00;40,25;39,97;0,28;40301;0;0;0;0;49572;14249;0.2874;11789;2460
2017-02-01 22:00:00;45,92;42,86;3,06;40301;0;0;0;0;49572;14722;0.297;11921;2801
2017-02-01 23:00:00;38,88;38,58;0,3;40301;0;0;0;0;49572;15678;0.3163;11988;3690
2017-03-01 00:00:00;36,02;35,36;0,66;40303;0;0;0;0;49575;16501;0.3329;16171;330
2017-03-01 01:00:00;34,98;34,3;0,68;40303;0;0;0;0;49575;16640;0.3356;16666;-26
2017-03-01 02:00:00;33,64;32,09;1,55;40303;0;0;0;0;49575;17128;0.3455;17169;-41
2017-03-01 03:00:00;33,89;34,83;-0,94;40303;0;0;0;0;49575;18205;0.3672;17716;489
2017-03-01 04:00:00;33,5;34,05;-0,55;40303;0;0;0;0;49575;18855;0.3803;18244;611
2017-03-01 05:00:00;33,91;31,84;2,07;40303;0;0;0;0;49575;19734;0.398;18684;1050
2017-03-01 06:00:00;48,13;35,13;13,0;40303;0;0;0;0;49575;20756;0.4187;19027;1729
2017-03-01 07:00:00;54,61;41,88;12,73;40303;0;0;1;-1;49575;22145;0.4467;19390;2755
2017-03-01 08:00:00;57,93;42,0;15,93;40303;70;0.0017;164;-94;49575;22753;0.4589;20035;2718
2017-03-01 09:00:00;57,18;46,27;10,91;40303;538;0.0133;925;-387;49575;24081;0.4858;21024;3057
2017-03-01 10:00:00;52,27;43,88;8,39;40303;1166;0.0289;2120;-954;49575;25909;0.5226;22398;3511
2017-03-01 11:00:00;49,94;42,69;7,25;40303;1817;0.0451;3075;-1258;49575;27726;0.5592;23950;3776
2017-03-01 12:00:00;46,3;41,0;5,3;40303;2147;0.0533;3453;-1306;49575;29098;0.587;25474;3624
2017-03-01 13:00:00;41,51;38,36;3,15;40303;1908;0.0474;3118;-1210;49575;30230;0.6098;26885;3345
2017-03-01 14:00:00;37,08;35,23;1,85;40303;1220;0.0303;2150;-930;49575;30829;0.6219;28068;2761
2017-03-01 15:00:00;37,03;35,38;1,65;40303;439;0.0109;906;-467;49575;31969;0.6449;29127;2842
2017-03-01 16:00:00;39,08;35,72;3,36;40303;46;0.0012;98;-52;49575;33058;0.6669;30201;2857
2017-03-01 17:00:00;42,14;37,07;5,07;40303;0;0;3;-3;49575;33917;0.6842;31256;2661
2017-03-01 18:00:00;36,67;37,55;-0,88;40303;0;0;0;0;49575;34739;0.7007;32245;2494
2017-03-01 19:00:00;36,03;34,35;1,68;40303;0;0;0;0;49575;35220;0.7104;33038;2182
2017-03-01 20:00:00;33,55;31,4;2,15;40303;0;0;0;0;49575;35692;0.72;33731;1961
2017-03-01 21:00:00;24,56;23,91;0,65;40303;0;0;0;0;49575;35723;0.7206;34165;1558
2017-03-01 22:00:00;17,77;19,36;-1,59;40303;0;0;0;0;49575;34704;0.7001;34588;116
2017-03-01 23:00:00;9,49;7,04;2,45;40303;0;0;0;0;49575;34412;0.6942;34969;-557
2017-04-01 00:00:00;8,5;8,25;0,25;40305;0;0;0;0;49583;32650;0.6585;35375;-2725
2017-04-01 01:00:00;-0,05;8,31;-8,36;40305;0;0;0;0;49583;31757;0.6405;35389;-3632
2017-04-01 02:00:00;-6,27;20,7;-26,97;40305;0;0;0;0;49583;30978;0.6248;35155;-4177
2017-04-01 03:00:00;-5,09;14,36;-19,45;40305;0;0;0;0;49583;30633;0.6178;35048;-4415
2017-04-01 04:00:00;0,06;15,82;-15,76;40305;0;0;0;0;49583;30701;0.6192;35089;-4388
2017-04-01 05:00:00;10,55;21,23;-10,68;40305;0;0;0;0;49583;30838;0.622;35122;-4284
2017-04-01 06:00:00;10,98;36,19;-25,21;40305;0;0;0;0;49583;31701;0.6394;35195;-3494
2017-04-01 07:00:00;31,63;43,85;-12,22;40305;0;0;0;0;49583;32627;0.658;35327;-2700
2017-04-01 08:00:00;34,94;49,14;-14,2;40305;49;0.0012;80;-31;49583;33379;0.6732;35186;-1807
2017-04-01 09:00:00;33,27;43,48;-10,21;40305;675;0.0168;621;54;49583;32921;0.664;34829;-1908
2017-04-01 10:00:00;33,52;43,77;-10,25;40305;1747;0.0433;1535;212;49583;32260;0.6506;34378;-2118
2017-04-01 11:00:00;34,81;47,74;-12,93;40305;2619;0.065;2214;405;49583;32198;0.6494;33831;-1633
2017-04-01 12:00:00;35,08;49,07;-13,99;40305;2968;0.0736;2424;544;49583;32234;0.6501;33237;-1003
2017-04-01 13:00:00;35,88;45,67;-9,79;40305;2560;0.0635;2131;429;49583;31422;0.6338;32479;-1057
2017-04-01 14:00:00;36,03;44,93;-8,9;40305;1596;0.0396;1417;179;49583;30136;0.6078;31579;-1443
2017-04-01 15:00:00;36,17;49,85;-13,68;40305;556;0.0138;562;-6;49583;29088;0.5866;30525;-1437
2017-04-01 16:00:00;36,58;50,88;-14,3;40305;44;0.0011;52;-8;49583;27927;0.5632;29176;-1249
2017-04-01 17:00:00;46,95;54,38;-7,43;40305;0;0;0;0;49583;26062;0.5256;27729;-1667
2017-04-01 18:00:00;49,45;54,83;-5,38;40305;0;0;0;0;49583;25478;0.5138;26223;-745
2017-04-01 19:00:00;48,37;49,81;-1,44;40305;0;0;0;0;49583;25132;0.5068;24650;482
2017-04-01 20:00:00;38,02;39,0;-0,98;40305;0;0;0;0;49583;23856;0.4811;23206;650
2017-04-01 21:00:00;34,55;37,74;-3,19;40305;0;0;0;0;49583;23136;0.4666;21939;1197
2017-04-01 22:00:00;33,33;36,28;-2,95;40305;0;0;0;0;49583;21622;0.4361;20726;896
2017-04-01 23:00:00;32,05;34,21;-2,16;40305;0;0;0;0;49583;20924;0.422;19306;1618
2017-05-01 00:00:00;36,07;43,0;-6,93;40307;0;0;0;0;49589;19568;0.3946;18083;1485
2017-05-01 01:00:00;36,32;40,07;-3,75;40307;0;0;0;0;49589;18151;0.366;16731;1420
2017-05-01 02:00:00;30,99;32,91;-1,92;40307;0;0;0;0;49589;17270;0.3483;15424;1846
2017-05-01 03:00:00;30,97;32,38;-1,41;40307;0;0;0;0;49589;16276;0.3282;14323;1953
2017-05-01 04:00:00;35,64;35,98;-0,34;40307;0;0;0;0;49589;15572;0.314;13432;2140
2017-05-01 05:00:00;35,73;36,08;-0,35;40307;0;0;0;0;49589;14819;0.2988;12646;2173
2017-05-01 06:00:00;39,03;39,18;-0,15;40307;0;0;0;0;49589;13865;0.2796;11887;1978
2017-05-01 07:00:00;51,7;51,18;0,52;40307;0;0;1;-1;49589;13474;0.2717;11121;2353
2017-05-01 08:00:00;57,98;53,06;4,92;40307;116;0.0029;168;-52;49589;13034;0.2628;10276;2758
2017-05-01 09:00:00;54,11;50,79;3,32;40307;1267;0.0314;1322;-55;49589;12300;0.248;9522;2778
2017-05-01 10:00:00;53,13;50,32;2,81;40307;2991;0.0742;3081;-90;49589;11856;0.2391;9067;2789
2017-05-01 11:00:00;50,06;50,73;-0,67;40307;4276;0.1061;4410;-134;49589;11987;0.2417;8993;2994
2017-05-01 12:00:00;49,97;52,13;-2,16;40307;4453;0.1105;4956;-503;49589;12074;0.2435;9093;2981
2017-05-01 13:00:00;48,84;50,0;-1,16;40307;3876;0.0962;4595;-719;49589;11062;0.223;9011;2051
2017-05-01 14:00:00;50,99;52,56;-1,57;40307;2642;0.0656;3296;-654;49589;9947;0.2006;8561;1386
2017-05-01 15:00:00;57,48;59,75;-2,27;40307;1079;0.0268;1385;-306;49589;9464;0.1908;7928;1536
2017-05-01 16:00:00;69,7;66,97;2,73;40307;97;0.0024;123;-26;49589;8888;0.1792;7477;1411
2017-05-01 17:00:00;73,92;68,3;5,62;40307;0;0;2;-2;49589;8612;0.1736;7258;1354
2017-05-01 18:00:00;73,76;70,02;3,74;40307;0;0;0;0;49589;8174;0.1648;7138;1036
2017-05-01 19:00:00;65,15;61,64;3,51;40307;0;0;0;0;49589;7375;0.1488;6760;615
2017-05-01 20:00:00;64,24;58,55;5,69;40307;0;0;0;0;49589;6753;0.1362;6088;665
2017-05-01 21:00:00;43,09;43,12;-0,03;40307;0;0;0;0;49589;6172;0.1244;5380;792
2017-05-01 22:00:00;53,11;46,54;6,57;40307;0;0;0;0;49589;5452;0.11;4797;655
2017-05-01 23:00:00;37,08;35,61;1,47;40307;0;0;0;0;49589;4957;0.1;4343;614
2017-06-01 00:00:00;40,84;36,71;4,13;40307;0;0;0;0;49604;4224;0.0852;3777;447
2017-06-01 01:00:00;41,15;36,24;4,91;40307;0;0;0;0;49604;3849;0.0776;3436;413
2017-06-01 02:00:00;43,77;39,22;4,55;40307;0;0;0;0;49604;3637;0.0733;3151;486
2017-06-01 03:00:00;39,97;37,48;2,49;40307;0;0;0;0;49604;3555;0.0717;2891;664
2017-06-01 04:00:00;40,81;37,46;3,35;40307;0;0;0;0;49604;3613;0.0728;2771;842
2017-06-01 05:00:00;43,04;38,68;4,36;40307;0;0;0;0;49604;3420;0.069;2772;648
2017-06-01 06:00:00;45,37;39,99;5,38;40307;0;0;0;0;49604;3408;0.0687;2797;611
2017-06-01 07:00:00;49,49;48,67;0,82;40307;0;0;0;0;49604;3684;0.0743;2789;895
2017-06-01 08:00:00;59,92;51,35;8,57;40307;130;0.0032;292;-162;49604;3519;0.071;2754;765
2017-06-01 09:00:00;60,0;50,86;9,14;40307;1675;0.0416;2276;-601;49604;3097;0.0624;2753;344
2017-06-01 10:00:00;60,04;51,03;9,01;40307;4064;0.1008;4821;-757;49604;2724;0.0549;2741;-17
2017-06-01 11:00:00;57,7;50,77;6,93;40307;6262;0.1554;6436;-174;49604;2534;0.051;2712;-178
2017-06-01 12:00:00;52,86;50,36;2,5;40307;7288;0.1808;6895;393;49604;2818;0.0568;2760;58
2017-06-01 13:00:00;50,05;44,05;6,0;40307;6842;0.1698;6110;732;49604;3112;0.0627;2908;204
2017-06-01 14:00:00;50,94;43,46;7,48;40307;4852;0.1204;4266;586;49604;3242;0.0654;3168;74
2017-06-01 15:00:00;54,04;45,93;8,11;40307;2046;0.0507;1812;234;49604;3585;0.0722;3488;97
2017-06-01 16:00:00;57,52;51,67;5,85;40307;182;0.0045;154;28;49604;4131;0.0833;4020;111
2017-06-01 17:00:00;64,91;55,8;9,11;40307;0;0;0;0;49604;5008;0.101;4869;139
2017-06-01 18:00:00;59,92;50,98;8,94;40307;0;0;0;0;49604;6237;0.1257;5827;410
2017-06-01 19:00:00;57,99;47,8;10,19;40307;0;0;0;0;49604;7407;0.1493;6654;753
2017-06-01 20:00:00;43,68;38,73;4,95;40307;0;0;0;0;49604;7917;0.1596;7275;642
2017-06-01 21:00:00;38,46;37,24;1,22;40307;0;0;0;0;49604;8026;0.1618;7890;136
2017-06-01 22:00:00;40,94;39,59;1,35;40307;0;0;0;0;49604;8488;0.1711;8449;39
2017-06-01 23:00:00;35,89;34,26;1,63;40307;0;0;0;0;49604;9002;0.1814;8917;85
2017-07-01 00:00:00;36,83;37,77;-0,94;40308;0;0;0;0;49612;9710;0.1957;8566;1144
2017-07-01 01:00:00;34,37;36,23;-1,86;40308;0;0;0;0;49612;10204;0.2057;9038;1166
2017-07-01 02:00:00;33,84;35,2;-1,36;40308;0;0;0;0;49612;10708;0.2158;9589;1119
2017-07-01 03:00:00;33,83;37,08;-3,25;40308;0;0;0;0;49612;11015;0.222;10114;901
2017-07-01 04:00:00;33,62;38,57;-4,95;40308;0;0;0;0;49612;11440;0.2306;10587;853
2017-07-01 05:00:00;32,96;38,25;-5,29;40308;0;0;0;0;49612;12010;0.2421;11015;995
2017-07-01 06:00:00;30,07;33,03;-2,96;40308;0;0;0;0;49612;12347;0.2489;11476;871
2017-07-01 07:00:00;33,58;36,09;-2,51;40308;0;0;1;-1;49612;12438;0.2507;11846;592
2017-07-01 08:00:00;36,02;35,53;0,49;40308;93;0.0023;150;-57;49612;12838;0.2588;11954;884
2017-07-01 09:00:00;36,86;37,14;-0,28;40308;657;0.0163;837;-180;49612;12897;0.26;11973;924
2017-07-01 10:00:00;36,43;36,18;0,25;40308;1372;0.034;1681;-309;49612;12279;0.2475;11828;451
2017-07-01 11:00:00;39,01;39,99;-0,98;40308;1773;0.044;2205;-432;49612;11919;0.2402;11555;364
2017-07-01 12:00:00;39,5;44,35;-4,85;40308;1786;0.0443;2194;-408;49612;10919;0.2201;11356;-437
2017-07-01 13:00:00;39,02;45,19;-6,17;40308;1475;0.0366;1753;-278;49612;10527;0.2122;11321;-794
2017-07-01 14:00:00;38,6;47,71;-9,11;40308;876;0.0217;1099;-223;49612;10544;0.2125;11390;-846
2017-07-01 15:00:00;39,28;48,83;-9,55;40308;326;0.0081;445;-119;49612;10686;0.2154;11556;-870
2017-07-01 16:00:00;46,95;57,76;-10,81;40308;29;0.0007;52;-23;49612;10682;0.2153;11600;-918
2017-07-01 17:00:00;57,01;65,7;-8,69;40308;0;0;1;-1;49612;10099;0.2036;11483;-1384
2017-07-01 18:00:00;54,02;64,46;-10,44;40308;0;0;0;0;49612;9480;0.1911;11462;-1982
2017-07-01 19:00:00;46,92;61,36;-14,44;40308;0;0;0;0;49612;8842;0.1782;11389;-2547
2017-07-01 20:00:00;38,12;57,53;-19,41;40308;0;0;0;0;49612;8712;0.1756;11192;-2480
2017-07-01 21:00:00;35,09;55,0;-19,91;40308;0;0;0;0;49612;8937;0.1801;10890;-1953
2017-07-01 22:00:00;38,1;56,34;-18,24;40308;0;0;0;0;49612;8330;0.1679;10416;-2086
2017-07-01 23:00:00;34,53;49,13;-14,6;40308;0;0;0;0;49612;7732;0.1559;9796;-2064
2017-08-01 00:00:00;33,86;45,65;-11,79;40308;0;0;0;0;49612;6722;0.1355;9572;-2850
2017-08-01 01:00:00;34,14;46,69;-12,55;40308;0;0;0;0;49612;5858;0.1181;8799;-2941
2017-08-01 02:00:00;33,96;48,87;-14,91;40308;0;0;0;0;49612;4800;0.0967;7900;-3100
2017-08-01 03:00:00;35,01;50,85;-15,84;40308;0;0;0;0;49612;3981;0.0802;6924;-2943
2017-08-01 04:00:00;36,07;55,41;-19,34;40308;0;0;0;0;49612;3470;0.07;5889;-2419
2017-08-01 05:00:00;36,07;53,07;-17,0;40308;0;0;0;0;49612;2952;0.0595;4901;-1949
2017-08-01 06:00:00;36,01;49,5;-13,49;40308;0;0;0;0;49612;2627;0.053;4071;-1444
2017-08-01 07:00:00;35,37;47,47;-12,1;40308;0;0;0;0;49612;2240;0.0451;3393;-1153
2017-08-01 08:00:00;37,29;54,28;-16,99;40308;23;0.0005;54;-31;49612;1608;0.0324;2852;-1244
2017-08-01 09:00:00;39,15;57,8;-18,65;40308;239;0.006;368;-129;49612;1234;0.0248;2370;-1136
2017-08-01 10:00:00;41,25;58,34;-17,09;40308;619;0.0154;887;-268;49612;990;0.02;1855;-865
2017-08-01 11:00:00;51,93;62,42;-10,49;40308;966;0.024;1311;-345;49612;775;0.0156;1417;-642
2017-08-01 12:00:00;45,37;61,86;-16,49;40308;1114;0.0276;1487;-373;49612;625;0.0126;1112;-487
2017-08-01 13:00:00;40,53;58,58;-18,05;40308;1016;0.0252;1361;-345;49612;495;0.01;901;-406
2017-08-01 14:00:00;39,73;57,14;-17,41;40308;710;0.0176;929;-219;49612;349;0.007;783;-434
2017-08-01 15:00:00;42,75;57,63;-14,88;40308;279;0.0069;379;-100;49612;284;0.0057;681;-397
2017-08-01 16:00:00;53,87;60,27;-6,4;40308;25;0.0006;48;-23;49612;287;0.0058;659;-372
2017-08-01 17:00:00;60,95;67,84;-6,89;40308;0;0;0;0;49612;394;0.0079;717;-323
2017-08-01 18:00:00;64,93;70,07;-5,14;40308;0;0;0;0;49612;509;0.0102;837;-328
2017-08-01 19:00:00;58,91;64,91;-6,0;40308;0;0;0;0;49612;721;0.0146;988;-267
2017-08-01 20:00:00;50,03;58,19;-8,16;40308;0;0;0;0;49612;995;0.02;1181;-186
2017-08-01 21:00:00;39,06;49,08;-10,02;40308;0;0;0;0;49612;1221;0.0246;1445;-224
2017-08-01 22:00:00;40,06;50,04;-9,98;40308;0;0;0;0;49612;1326;0.0268;1732;-406
2017-08-01 23:00:00;37,09;41,79;-4,7;40308;0;0;0;0;49612;1602;0.0323;1987;-385
2017-09-01 00:00:00;40,0;39,89;0,11;40310;0;0;0;0;49618;1918;0.0387;2657;-739
2017-09-01 01:00:00;39,05;39,76;-0,71;40310;0;0;0;0;49618;2169;0.0437;2855;-686
2017-09-01 02:00:00;39,21;39,71;-0,5;40310;0;0;0;0;49618;2324;0.0469;3096;-772
2017-09-01 03:00:00;39,24;39,95;-0,71;40310;0;0;0;0;49618;2677;0.0539;3350;-673
2017-09-01 04:00:00;40,26;39,35;0,91;40310;0;0;0;0;49618;3138;0.0632;3675;-537
2017-09-01 05:00:00;43,84;41,43;2,41;40310;0;0;0;0;49618;3484;0.0702;4092;-608
2017-09-01 06:00:00;58,99;50,31;8,68;40310;0;0;0;0;49618;3815;0.0769;4597;-782
2017-09-01 07:00:00;74,04;67,25;6,79;40310;0;0;0;0;49618;4496;0.0906;5093;-597
2017-09-01 08:00:00;75,49;67,42;8,07;40310;35;0.0008;89;-54;49618;5285;0.1065;5712;-427
2017-09-01 09:00:00;74,63;64,75;9,88;40310;322;0.008;544;-222;49618;5674;0.1144;6367;-693
2017-09-01 10:00:00;73,97;64,28;9,69;40310;819;0.0203;1191;-372;49618;5692;0.1147;6883;-1191
2017-09-01 11:00:00;72,0;63,07;8,93;40310;1346;0.0334;1681;-335;49618;5730;0.1155;7196;-1466
2017-09-01 12:00:00;72,12;67,02;5,1;40310;1640;0.0407;1848;-208;49618;5868;0.1183;7486;-1618
2017-09-01 13:00:00;70,09;67,03;3,06;40310;1491;0.037;1662;-171;49618;6206;0.1251;7911;-1705
2017-09-01 14:00:00;67,41;65,84;1,57;40310;1022;0.0254;1171;-149;49618;6544;0.1319;8598;-2054
2017-09-01 15:00:00;65,21;65,75;-0,54;40310;357;0.0089;514;-157;49618;7264;0.1464;9375;-2111
2017-09-01 16:00:00;65,09;70,57;-5,48;40310;38;0.0009;65;-27;49618;8940;0.1802;10402;-1462
2017-09-01 17:00:00;74,72;77,48;-2,76;40310;0;0;0;0;49618;10577;0.2132;11717;-1140
2017-09-01 18:00:00;59,94;67,9;-7,96;40310;0;0;0;0;49618;11904;0.2399;13102;-1198
2017-09-01 19:00:00;52,2;57,83;-5,63;40310;0;0;0;0;49618;13056;0.2631;14256;-1200
2017-09-01 20:00:00;39,1;44,19;-5,09;40310;0;0;0;0;49618;14132;0.2848;15147;-1015
2017-09-01 21:00:00;36,62;40,13;-3,51;40310;0;0;0;0;49618;14912;0.3006;15968;-1056
2017-09-01 22:00:00;36,08;38,8;-2,72;40310;0;0;0;0;49618;15129;0.3049;16571;-1442
2017-09-01 23:00:00;32,76;36,43;-3,67;40310;0;0;0;0;49618;15713;0.3167;16923;-1210
2017-10-01 00:00:00;32,45;28,66;3,79;40313;0;0;0;0;49625;16254;0.3276;17720;-1466
2017-10-01 01:00:00;31,52;27,27;4,25;40313;0;0;0;0;49625;16697;0.3364;18020;-1323
2017-10-01 02:00:00;29,08;25,82;3,26;40313;0;0;0;0;49625;16900;0.3406;18135;-1235
2017-10-01 03:00:00;28,92;22,83;6,09;40313;0;0;0;0;49625;17193;0.3465;18033;-840
2017-10-01 04:00:00;31,49;24,2;7,29;40313;0;0;0;0;49625;16838;0.3393;17431;-593
2017-10-01 05:00:00;33,06;27,19;5,87;40313;0;0;0;0;49625;16095;0.3243;16399;-304
2017-10-01 06:00:00;36,26;31,8;4,46;40313;0;0;0;0;49625;15918;0.3208;15438;480
2017-10-01 07:00:00;46,0;40,68;5,32;40313;0;0;0;0;49625;14517;0.2926;14607;-90
2017-10-01 08:00:00;59,89;58,64;1,25;40313;77;0.0019;103;-26;49625;12422;0.2503;13764;-1342
2017-10-01 09:00:00;59,96;68,8;-8,84;40313;722;0.0179;641;81;49625;11518;0.2321;12888;-1370
2017-10-01 10:00:00;62,69;73,82;-11,13;40313;1838;0.0456;1435;403;49625;10564;0.2129;11836;-1272
2017-10-01 11:00:00;66,82;72,91;-6,09;40313;2573;0.0638;2053;520;49625;9864;0.1988;10539;-675
2017-10-01 12:00:00;71,42;72,77;-1,35;40313;2798;0.0694;2263;535;49625;9444;0.1903;9301;143
2017-10-01 13:00:00;72,33;71,72;0,61;40313;2524;0.0626;2021;503;49625;8917;0.1797;8505;412
2017-10-01 14:00:00;69,5;65,1;4,4;40313;1761;0.0437;1365;396;49625;8183;0.1649;8389;-206
2017-10-01 15:00:00;70,64;64,01;6,63;40313;694;0.0172;541;153;49625;7752;0.1562;8563;-811
2017-10-01 16:00:00;66,96;69,88;-2,92;40313;57;0.0014;57;0;49625;7979;0.1608;8954;-975
2017-10-01 17:00:00;88,38;92,26;-3,88;40313;1;0;0;1;49625;8780;0.1769;9494;-714
2017-10-01 18:00:00;98,93;91,15;7,78;40313;0;0;0;0;49625;9298;0.1874;9890;-592
2017-10-01 19:00:00;69,65;66,34;3,31;40313;0;0;0;0;49625;9522;0.1919;10027;-505
2017-10-01 20:00:00;58,82;54,65;4,17;40313;0;0;0;0;49625;9928;0.2;9991;-63
2017-10-01 21:00:00;47,63;41,95;5,68;40313;0;0;0;0;49625;10382;0.2092;9882;500
2017-10-01 22:00:00;40,08;40,17;-0,09;40313;0;0;0;0;49625;10218;0.2059;9904;314
2017-10-01 23:00:00;38,06;39,05;-0,99;40313;0;0;0;0;49625;10404;0.2097;10154;250
2017-11-01 00:00:00;38,99;38,35;0,64;40314;0;0;0;0;49633;11040;0.2224;10895;145
2017-11-01 01:00:00;37,2;37,72;-0,52;40314;0;0;0;0;49633;11893;0.2396;11819;74
2017-11-01 02:00:00;34,03;35,48;-1,45;40314;0;0;0;0;49633;13018;0.2623;13157;-139
2017-11-01 03:00:00;34,78;36,84;-2,06;40314;0;0;0;0;49633;14277;0.2876;14746;-469
2017-11-01 04:00:00;32,7;36,41;-3,71;40314;0;0;0;0;49633;16040;0.3231;16618;-578
2017-11-01 05:00:00;31,21;34,7;-3,49;40314;0;0;0;0;49633;18168;0.3661;18953;-785
2017-11-01 06:00:00;37,2;38,68;-1,48;40314;0;0;0;0;49633;21544;0.434;21410;134
2017-11-01 07:00:00;49,97;50,06;-0,09;40314;0;0;1;-1;49633;24248;0.4885;23981;267
2017-11-01 08:00:00;46,98;43,36;3,62;40314;75;0.0018;137;-62;49633;26608;0.5361;26665;-57
2017-11-01 09:00:00;44,7;44,49;0,21;40314;558;0.0138;766;-208;49633;28345;0.5711;29106;-761
2017-11-01 10:00:00;44,41;48,77;-4,36;40314;1004;0.0249;1471;-467;49633;30334;0.6112;31101;-767
2017-11-01 11:00:00;41,06;46,39;-5,33;40314;1371;0.034;1856;-485;49633;31573;0.6361;32446;-873
2017-11-01 12:00:00;36,94;42,36;-5,42;40314;1507;0.0374;1808;-301;49633;31707;0.6388;33324;-1617
2017-11-01 13:00:00;34,09;41,95;-7,86;40314;1382;0.0343;1492;-110;49633;31168;0.628;33852;-2684
2017-11-01 14:00:00;33,68;42,58;-8,9;40314;1004;0.0249;998;6;49633;30396;0.6124;33967;-3571
2017-11-01 15:00:00;33,64;43,79;-10,15;40314;430;0.0107;411;19;49633;30732;0.6192;33986;-3254
2017-11-01 16:00:00;33,66;48,02;-14,36;40314;46;0.0011;43;3;49633;30638;0.6173;33800;-3162
2017-11-01 17:00:00;38,53;51,04;-12,51;40314;2;0;0;2;49633;29780;0.6;33365;-3585
2017-11-01 18:00:00;37,4;48,26;-10,86;40314;0;0;0;0;49633;30127;0.607;32844;-2717
2017-11-01 19:00:00;37,07;46,83;-9,76;40314;0;0;0;0;49633;30444;0.6134;32490;-2046
2017-11-01 20:00:00;34,0;42,19;-8,19;40314;0;0;0;0;49633;31447;0.6336;32280;-833
2017-11-01 21:00:00;31,83;34,66;-2,83;40314;0;0;0;0;49633;31714;0.639;32307;-593
2017-11-01 22:00:00;26,27;30,55;-4,28;40314;0;0;0;0;49633;30808;0.6207;32452;-1644
2017-11-01 23:00:00;11,68;18,68;-7,0;40314;0;0;0;0;49633;31043;0.6255;32587;-1544
2017-12-01 00:00:00;12,12;17,04;-4,92;40319;0;0;0;0;49649;31207;0.6285;32325;-1118
2017-12-01 01:00:00;9,83;15,75;-5,92;40319;0;0;0;0;49649;30839;0.6212;32412;-1573
2017-12-01 02:00:00;9,02;15,75;-6,73;40319;0;0;0;0;49649;30415;0.6126;32365;-1950
2017-12-01 03:00:00;9,27;13,93;-4,66;40319;0;0;0;0;49649;30150;0.6073;32288;-2138
2017-12-01 04:00:00;9,84;15,58;-5,74;40319;0;0;0;0;49649;29882;0.6019;32117;-2235
2017-12-01 05:00:00;10,55;23,34;-12,79;40319;0;0;0;0;49649;29579;0.5958;31809;-2230
2017-12-01 06:00:00;28,29;39,04;-10,75;40319;0;0;0;0;49649;30768;0.6197;31473;-705
2017-12-01 07:00:00;40,02;47,37;-7,35;40319;0;0;0;0;49649;30285;0.61;31128;-843
2017-12-01 08:00:00;40,07;50,08;-10,01;40319;84;0.0021;113;-29;49649;30072;0.6057;30881;-809
2017-12-01 09:00:00;38,2;49,43;-11,23;40319;904;0.0224;804;100;49649;29740;0.599;30686;-946
2017-12-01 10:00:00;38,61;46,85;-8,24;40319;2421;0.06;1839;582;49649;29631;0.5968;30626;-995
2017-12-01 11:00:00;38,43;42,55;-4,12;40319;3475;0.0862;2654;821;49649;29776;0.5997;30611;-835
2017-12-01 12:00:00;36,7;40,99;-4,29;40319;4026;0.0998;2963;1063;49649;29506;0.5943;30411;-905
2017-12-01 13:00:00;39,61;41,95;-2,34;40319;3520;0.0873;2649;871;49649;28280;0.5696;29556;-1276
2017-12-01 14:00:00;40,05;43,08;-3,03;40319;2327;0.0577;1818;509;49649;25606;0.5158;27913;-2307
2017-12-01 15:00:00;45,32;54,24;-8,92;40319;991;0.0246;703;288;49649;23766;0.4787;25978;-2212
2017-12-01 16:00:00;46,98;57,84;-10,86;40319;113;0.0028;72;41;49649;21204;0.4271;24183;-2979
2017-12-01 17:00:00;57,09;65,36;-8,27;40319;4;0.0001;0;4;49649;18895;0.3806;22839;-3944
2017-12-01 18:00:00;57,13;65,11;-7,98;40319;0;0;0;0;49649;16440;0.3312;21644;-5204
2017-12-01 19:00:00;57,05;64,07;-7,02;40319;0;0;0;0;49649;15244;0.307;20440;-5196
2017-12-01 20:00:00;45,01;54,85;-9,84;40319;0;0;0;0;49649;15028;0.3027;19383;-4355
2017-12-01 21:00:00;40,09;49,15;-9,06;40319;0;0;0;0;49649;14506;0.2922;18389;-3883
2017-12-01 22:00:00;37,89;47,45;-9,56;40319;0;0;0;0;49649;14236;0.2867;17705;-3469
2017-12-01 23:00:00;33,07;37,44;-4,37;40319;0;0;0;0;49649;14969;0.3015;17523;-2554
2017-01-13 00:00:00;35,19;30,05;5,14;40320;0;0;0;0;49661;15975;0.3217;13145;2830
2017-01-13 01:00:00;33,44;26,8;6,64;40320;0;0;0;0;49661;17101;0.3444;13466;3635
2017-01-13 02:00:00;32,44;20,56;11,88;40320;0;0;0;0;49661;17798;0.3584;14542;3256
2017-01-13 03:00:00;29,8;18,88;10,92;40320;0;0;0;0;49661;18515;0.3728;15780;2735
2017-01-13 04:00:00;29,25;24,17;5,08;40320;0;0;0;0;49661;20394;0.4106;17305;3089
2017-01-13 05:00:00;30,64;30,52;0,12;40320;0;0;0;0;49661;21590;0.4348;19208;2382
2017-01-13 06:00:00;37,27;35,4;1,87;40320;0;0;0;0;49661;22796;0.459;20897;1899
2017-01-13 07:00:00;46,98;46,9;0,08;40320;0;0;0;0;49661;23583;0.4749;21946;1637
2017-01-13 08:00:00;45,5;47,98;-2,48;40320;115;0.0028;140;-25;49661;24386;0.491;22613;1773
2017-01-13 09:00:00;45,48;46,9;-1,42;40320;820;0.0203;848;-28;49661;23648;0.4762;23685;-37
2017-01-13 10:00:00;46,96;47,98;-1,02;40320;1822;0.0452;1753;69;49661;23659;0.4764;24678;-1019
2017-01-13 11:00:00;46,7;48,44;-1,74;40320;2538;0.0629;2404;134;49661;23340;0.47;25375;-2035
2017-01-13 12:00:00;43,07;44,81;-1,74;40320;2935;0.0728;2668;267;49661;22399;0.451;25906;-3507
2017-01-13 13:00:00;42,06;44,44;-2,38;40320;2800;0.0694;2453;347;49661;22434;0.4517;25712;-3278
2017-01-13 14:00:00;41,98;43,37;-1,39;40320;2148;0.0533;1776;372;49661;22240;0.4478;24938;-2698
2017-01-13 15:00:00;43,03;41,65;1,38;40320;998;0.0248;804;194;49661;21631;0.4356;23972;-2341
2017-01-13 16:00:00;44,87;45,18;-0,31;40320;132;0.0032;98;34;49661;21989;0.4428;23175;-1186
2017-01-13 17:00:00;48,72;46,67;2,05;40320;3;0.0001;0;3;49661;22198;0.447;22969;-771
2017-01-13 18:00:00;45,17;40,52;4,65;40320;0;0;0;0;49661;22674;0.4566;23203;-529
2017-01-13 19:00:00;44,94;35,59;9,35;40320;0;0;0;0;49661;21980;0.4426;23326;-1346
2017-01-13 20:00:00;39,94;33,22;6,72;40320;0;0;0;0;49661;21570;0.4344;23265;-1695
2017-01-13 21:00:00;36,7;31,39;5,31;40320;0;0;0;0;49661;20766;0.4182;23330;-2564
2017-01-13 22:00:00;33,99;31,09;2,9;40320;0;0;0;0;49661;20273;0.4082;23521;-3248
2017-01-13 23:00:00;30,99;29,31;1,68;40320;0;0;0;0;49661;20306;0.4089;23389;-3083
2017-01-14 00:00:00;29,82;19,58;10,24;40320;0;0;0;0;49661;21348;0.4298;17283;4065
2017-01-14 01:00:00;28,98;14,85;14,13;40320;0;0;0;0;49661;22732;0.4577;17772;4960
2017-01-14 02:00:00;28,64;6,2;22,44;40320;0;0;0;0;49661;23232;0.4678;18109;5123
2017-01-14 03:00:00;28,5;4,27;24,23;40320;0;0;0;0;49661;23108;0.4653;18492;4616
2017-01-14 04:00:00;28,61;4,02;24,59;40320;0;0;0;0;49661;22600;0.4551;18942;3658
2017-01-14 05:00:00;28,05;7,68;20,37;40320;0;0;0;0;49661;22154;0.4461;19313;2841
2017-01-14 06:00:00;29,49;13,77;15,72;40320;0;0;0;0;49661;22776;0.4586;19934;2842
2017-01-14 07:00:00;28,97;16,56;12,41;40320;0;0;0;0;49661;21898;0.441;20074;1824
2017-01-14 08:00:00;33,19;25,14;8,05;40320;80;0.002;127;-47;49661;20533;0.4134;19671;862
2017-01-14 09:00:00;36,78;33,41;3,37;40320;787;0.0195;893;-106;49661;19071;0.384;19325;-254
2017-01-14 10:00:00;39,81;39,15;0,66;40320;1800;0.0446;1955;-155;49661;18406;0.3707;19185;-779
2017-01-14 11:00:00;40,05;40,64;-0,59;40320;2872;0.0713;2686;186;49661;18538;0.3733;19372;-834
2017-01-14 12:00:00;36,47;38,85;-2,38;40320;3646;0.0904;2913;733;49661;19176;0.3861;19790;-614
2017-01-14 13:00:00;34,76;36,13;-1,37;40320;3640;0.0903;2602;1038;49661;19029;0.3832;20300;-1271
2017-01-14 14:00:00;33,37;33,64;-0,27;40320;2630;0.0652;1848;782;49661;19448;0.3916;20483;-1035
2017-01-14 15:00:00;34,29;34,05;0,24;40320;1169;0.029;849;320;49661;19361;0.3899;20357;-996
2017-01-14 16:00:00;38,54;35,45;3,09;40320;140;0.0035;113;27;49661;19838;0.3995;20248;-410
2017-01-14 17:00:00;41,97;35,39;6,58;40320;3;0.0001;0;3;49661;20118;0.4051;20234;-116
2017-01-14 18:00:00;39,64;32,88;6,76;40320;0;0;0;0;49661;21132;0.4255;20532;600
2017-01-14 19:00:00;37,01;31,18;5,83;40320;0;0;0;0;49661;20782;0.4184;20573;209
2017-01-14 20:00:00;32,52;25,26;7,26;40320;0;0;0;0;49661;19795;0.3986;20156;-361
2017-01-14 21:00:00;30,66;25,35;5,31;40320;0;0;0;0;49661;19300;0.3886;19601;-301
2017-01-14 22:00:00;30,25;22,48;7,77;40320;0;0;0;0;49661;18293;0.3684;18900;-607
2017-01-14 23:00:00;29,55;20,88;8,67;40320;0;0;0;0;49661;17955;0.3616;18156;-201
2017-01-15 00:00:00;28,75;24,24;4,51;40320;0;0;0;0;49661;17914;0.3608;17893;21
2017-01-15 01:00:00;28,11;21,25;6,86;40320;0;0;0;0;49661;17607;0.3545;17380;227
2017-01-15 02:00:00;26,03;15,21;10,82;40320;0;0;0;0;49661;17247;0.3473;16863;384
2017-01-15 03:00:00;19,96;10,99;8,97;40320;0;0;0;0;49661;17024;0.3428;16283;741
2017-01-15 04:00:00;22,93;8,31;14,62;40320;0;0;0;0;49661;16416;0.3305;15476;940
2017-01-15 05:00:00;22,8;11,16;11,64;40320;0;0;0;0;49661;15918;0.3205;14436;1482
2017-01-15 06:00:00;14,91;8,16;6,75;40320;0;0;0;0;49661;14995;0.3019;13387;1608
2017-01-15 07:00:00;20,37;10,78;9,59;40320;0;0;0;0;49661;13594;0.2738;12145;1449
2017-01-15 08:00:00;33,28;21,55;11,73;40320;67;0.0017;145;-78;49661;12545;0.2526;10838;1707
2017-01-15 09:00:00;33,96;26,94;7,02;40320;570;0.0141;982;-412;49661;11354;0.2286;9646;1708
2017-01-15 10:00:00;35,98;33,5;2,48;40320;1593;0.0395;2140;-547;49661;10097;0.2033;8509;1588
2017-01-15 11:00:00;44,65;39,85;4,8;40320;2736;0.0679;2998;-262;49661;9083;0.1829;7619;1464
2017-01-15 12:00:00;41,68;38,47;3,21;40320;3394;0.0842;3408;-14;49661;8506;0.1713;7002;1504
2017-01-15 13:00:00;36,66;35,28;1,38;40320;3445;0.0854;3205;240;49661;7633;0.1537;6465;1168
2017-01-15 14:00:00;35,72;34,82;0,9;40320;2729;0.0677;2400;329;49661;7102;0.143;5930;1172
2017-01-15 15:00:00;36,35;34,58;1,77;40320;1376;0.0341;1182;194;49661;6265;0.1262;5468;797
2017-01-15 16:00:00;38,71;35,15;3,56;40320;192;0.0048;176;16;49661;6038;0.1216;5251;787
2017-01-15 17:00:00;54,35;43,77;10,58;40320;3;0.0001;0;3;49661;5786;0.1165;5215;571
2017-01-15 18:00:00;58,02;49,96;8,06;40320;0;0;0;0;49661;5623;0.1132;5176;447
2017-01-15 19:00:00;55,12;48,75;6,37;40320;0;0;0;0;49661;5489;0.1106;4975;514
2017-01-15 20:00:00;47,91;43,12;4,79;40320;0;0;0;0;49661;5072;0.1021;4681;391
2017-01-15 21:00:00;36,92;33,73;3,19;40320;0;0;0;0;49661;4535;0.0913;4398;137
2017-01-15 22:00:00;43,0;40,13;2,87;40320;0;0;0;0;49661;4240;0.0854;4217;23
2017-01-15 23:00:00;38,64;36,25;2,39;40320;0;0;0;0;49661;3897;0.0785;4104;-207
2017-01-16 00:00:00;45,07;44,0;1,07;40322;0;0;0;0;49663;3704;0.0746;3829;-125
2017-01-16 01:00:00;43,25;36,29;6,96;40322;0;0;0;0;49663;3659;0.0737;3625;34
2017-01-16 02:00:00;39,08;37,8;1,28;40322;0;0;0;0;49663;3739;0.0753;3557;182
2017-01-16 03:00:00;37,57;38,24;-0,67;40322;0;0;0;0;49663;3875;0.078;3491;384
2017-01-16 04:00:00;38,24;36,88;1,36;40322;0;0;0;0;49663;3739;0.0753;3498;241
2017-01-16 05:00:00;39,06;39,63;-0,57;40322;0;0;0;0;49663;3477;0.07;3543;-66
2017-01-16 06:00:00;64,8;69,6;-4,8;40322;0;0;0;0;49663;3270;0.0658;3585;-315
2017-01-16 07:00:00;94,43;104,47;-10,04;40322;0;0;0;0;49663;3220;0.0648;3527;-307
2017-01-16 08:00:00;99,76;135,79;-36,03;40322;63;0.0016;210;-147;49663;3082;0.062;3327;-245
2017-01-16 09:00:00;100,88;131,08;-30,2;40322;656;0.0163;1365;-709;49663;2802;0.0564;3033;-231
2017-01-16 10:00:00;99,97;121,65;-21,68;40322;1801;0.0447;2865;-1064;49663;2377;0.0479;2642;-265
2017-01-16 11:00:00;99,56;120,61;-21,05;40322;2950;0.0732;3917;-967;49663;1963;0.0395;2260;-297
2017-01-16 12:00:00;98,56;106,88;-8,32;40322;3749;0.093;4301;-552;49663;1568;0.0316;2026;-458
2017-01-16 13:00:00;98,92;101,17;-2,25;40322;3842;0.0953;3998;-156;49663;1530;0.0308;1996;-466
2017-01-16 14:00:00;100,26;99,36;0,9;40322;2900;0.0719;2996;-96;49663;1715;0.0345;2222;-507
2017-01-16 15:00:00;103,84;97,31;6,53;40322;1408;0.0349;1511;-103;49663;1864;0.0375;2590;-726
2017-01-16 16:00:00;102,06;92,39;9,67;40322;228;0.0056;231;-3;49663;2168;0.0437;3131;-963
2017-01-16 17:00:00;120,0;116,14;3,86;40322;3;0.0001;1;2;49663;2769;0.0558;3782;-1013
2017-01-16 18:00:00;124,83;112,92;11,91;40322;0;0;0;0;49663;3413;0.0687;4311;-898
2017-01-16 19:00:00;113,69;85,64;28,05;40322;0;0;0;0;49663;3507;0.0706;4461;-954
2017-01-16 20:00:00;88,98;87,38;1,6;40322;0;0;0;0;49663;3301;0.0664;4197;-896
2017-01-16 21:00:00;73,59;71,96;1,63;40322;0;0;0;0;49663;3062;0.0617;3852;-790
2017-01-16 22:00:00;55,19;56,24;-1,05;40322;0;0;0;0;49663;2952;0.0594;3509;-557
2017-01-16 23:00:00;45,06;47,57;-2,51;40322;0;0;0;0;49663;3070;0.0618;3221;-151
2017-01-17 00:00:00;45,83;51,26;-5,43;40323;0;0;0;0;49670;3087;0.0621;3491;-404
2017-01-17 01:00:00;41,64;49,06;-7,42;40323;0;0;0;0;49670;3196;0.0644;3347;-151
2017-01-17 02:00:00;34,61;46,6;-11,99;40323;0;0;0;0;49670;3174;0.0639;3236;-62
2017-01-17 03:00:00;36,28;39,44;-3,16;40323;0;0;0;0;49670;2925;0.0589;3110;-185
2017-01-17 04:00:00;35,25;39,32;-4,07;40323;0;0;0;0;49670;2531;0.051;3011;-480
2017-01-17 05:00:00;39,94;47,56;-7,62;40323;0;0;0;0;49670;2494;0.0502;2855;-361
2017-01-17 06:00:00;58,29;60,73;-2,44;40323;0;0;0;0;49670;2468;0.0496;2702;-234
2017-01-17 07:00:00;111,04;110,42;0,62;40323;0;0;0;0;49670;2358;0.0474;2546;-188
2017-01-17 08:00:00;121,67;111,91;9,76;40323;117;0.0029;167;-50;49670;2306;0.0464;2396;-90
2017-01-17 09:00:00;125,61;104,61;21,0;40323;1132;0.0281;1087;45;49670;2200;0.0443;2324;-124
2017-01-17 10:00:00;121,49;95,45;26,04;40323;2786;0.0691;2415;371;49670;1884;0.0379;2268;-384
2017-01-17 11:00:00;117,34;87,55;29,79;40323;4108;0.1019;3460;648;49670;1875;0.0378;2226;-351
2017-01-17 12:00:00;106,15;76,96;29,19;40323;4955;0.1229;3843;1112;49670;1974;0.0397;2240;-266
2017-01-17 13:00:00;101,91;72,25;29,66;40323;4626;0.1147;3509;1117;49670;2119;0.0427;2304;-185
2017-01-17 14:00:00;100,03;70,74;29,29;40323;3340;0.0828;2606;734;49670;2464;0.0496;2403;61
2017-01-17 15:00:00;103,42;66,39;37,03;40323;1589;0.0394;1338;251;49670;2904;0.0584;2512;392
2017-01-17 16:00:00;110,91;68,86;42,05;40323;253;0.0063;222;31;49670;3360;0.0676;2719;641
2017-01-17 17:00:00;142,78;97,08;45,7;40323;3;0.0001;2;1;49670;3787;0.0762;3081;706
2017-01-17 18:00:00;143,09;81,94;61,15;40323;0;0;0;0;49670;4303;0.0866;3465;838
2017-01-17 19:00:00;124,94;77,42;47,52;40323;0;0;0;0;49670;4593;0.0924;3741;852
2017-01-17 20:00:00;84,97;57,01;27,96;40323;0;0;0;0;49670;4840;0.0974;3895;945
2017-01-17 21:00:00;55,08;42,61;12,47;40323;0;0;0;0;49670;5044;0.1016;4094;950
2017-01-17 22:00:00;48,95;40,35;8,6;40323;0;0;0;0;49670;5172;0.1042;4329;843
2017-01-17 23:00:00;37,74;42,41;-4,67;40323;0;0;0;0;49670;5547;0.1116;4552;995
2017-01-18 00:00:00;38,28;38,04;0,24;40325;0;0;0;0;49691;5845;0.1176;4526;1319
2017-01-18 01:00:00;37,74;37,32;0,42;40325;0;0;0;0;49691;6076;0.1223;4694;1382
2017-01-18 02:00:00;35,09;35,15;-0,06;40325;0;0;0;0;49691;6130;0.1234;4853;1277
2017-01-18 03:00:00;35,07;34,79;0,28;40325;0;0;0;0;49691;6227;0.1253;4924;1303
2017-01-18 04:00:00;35,07;37,55;-2,48;40325;0;0;0;0;49691;6296;0.1267;4991;1305
2017-01-18 05:00:00;36,62;36,54;0,08;40325;0;0;0;0;49691;6404;0.1289;5087;1317
2017-01-18 06:00:00;55,08;45,19;9,89;40325;0;0;0;0;49691;6425;0.1293;5195;1230
2017-01-18 07:00:00;89,64;76,71;12,93;40325;0;0;1;-1;49691;6309;0.127;5259;1050
2017-01-18 08:00:00;91,75;73,85;17,9;40325;155;0.0038;194;-39;49691;6482;0.1304;5268;1214
2017-01-18 09:00:00;84,92;69,77;15,15;40325;1194;0.0296;1190;4;49691;6318;0.1272;5254;1064
2017-01-18 10:00:00;82,93;66,28;16,65;40325;2654;0.0658;2588;66;49691;5969;0.1201;5189;780
2017-01-18 11:00:00;85,97;68,29;17,68;40325;3883;0.0963;3701;182;49691;5777;0.1162;5034;743
2017-01-18 12:00:00;86,03;68,75;17,28;40325;4570;0.1133;4172;398;49691;5324;0.1072;4866;458
2017-01-18 13:00:00;91,02;70,2;20,82;40325;4563;0.1132;3835;728;49691;5274;0.1062;4785;489
2017-01-18 14:00:00;89,92;69,07;20,85;40325;3534;0.0877;2878;656;49691;5232;0.1053;4838;394
2017-01-18 15:00:00;86,7;74,3;12,4;40325;1818;0.0451;1499;319;49691;5164;0.1039;4943;221
2017-01-18 16:00:00;92,45;80,65;11,8;40325;334;0.0083;280;54;49691;5248;0.1056;5179;69
2017-01-18 17:00:00;115,7;91,91;23,79;40325;4;0.0001;2;2;49691;5741;0.1155;5557;184
2017-01-18 18:00:00;91,25;81,67;9,58;40325;0;0;0;0;49691;6331;0.1274;5961;370
2017-01-18 19:00:00;83,91;75,36;8,55;40325;0;0;0;0;49691;6805;0.1369;6211;594
2017-01-18 20:00:00;79,73;60,07;19,66;40325;0;0;0;0;49691;6876;0.1384;6220;656
2017-01-18 21:00:00;55,03;45,71;9,32;40325;0;0;0;0;49691;7151;0.1439;6119;1032
2017-01-18 22:00:00;48,86;43,9;4,96;40325;0;0;0;0;49691;7166;0.1442;6010;1156
2017-01-18 23:00:00;44,9;38,48;6,42;40325;0;0;0;0;49691;7226;0.1454;5964;1262
2017-01-19 00:00:00;38,53;34,08;4,45;40327;0;0;0;0;49702;6964;0.1401;6174;790
2017-01-19 01:00:00;37,88;36,86;1,02;40327;0;0;0;0;49702;6479;0.1304;6033;446
2017-01-19 02:00:00;36,61;36,56;0,05;40327;0;0;0;0;49702;6108;0.1229;5923;185
2017-01-19 03:00:00;36,32;37,56;-1,24;40327;0;0;0;0;49702;5939;0.1195;5794;145
2017-01-19 04:00:00;36,45;37,67;-1,22;40327;0;0;0;0;49702;6207;0.1249;5722;485
2017-01-19 05:00:00;38,67;37,95;0,72;40327;0;0;0;0;49702;6648;0.1338;5712;936
2017-01-19 06:00:00;50,04;47,46;2,58;40327;0;0;0;0;49702;6250;0.1258;5696;554
2017-01-19 07:00:00;82,9;76,87;6,03;40327;0;0;1;-1;49702;6185;0.1244;5621;564
2017-01-19 08:00:00;89,95;86,94;3,01;40327;304;0.0075;312;-8;49702;6001;0.1207;5492;509
2017-01-19 09:00:00;82,14;76,75;5,39;40327;2034;0.0504;1677;357;49702;5457;0.1098;5325;132
2017-01-19 10:00:00;80,0;77,91;2,09;40327;4429;0.1098;3408;1021;49702;4848;0.0976;5093;-245
2017-01-19 11:00:00;79,92;73,83;6,09;40327;6435;0.1596;4658;1777;49702;4085;0.0822;4789;-704
2017-01-19 12:00:00;79,97;70,53;9,44;40327;7680;0.1904;5112;2568;49702;3715;0.0748;4486;-771
2017-01-19 13:00:00;79,92;63,98;15,94;40327;7580;0.188;4711;2869;49702;3316;0.0667;4241;-925
2017-01-19 14:00:00;73,95;63,25;10,7;40327;6015;0.1492;3578;2437;49702;3070;0.0618;4131;-1061
2017-01-19 15:00:00;73,91;73,76;0,15;40327;3151;0.0782;1940;1211;49702;3101;0.0624;4115;-1014
2017-01-19 16:00:00;74,62;82,21;-7,59;40327;557;0.0138;390;167;49702;3566;0.0718;4272;-706
2017-01-19 17:00:00;100,1;96,14;3,96;40327;6;0.0001;3;3;49702;4442;0.0894;4604;-162
2017-01-19 18:00:00;114,92;97,14;17,78;40327;0;0;0;0;49702;4997;0.1005;4922;75
2017-01-19 19:00:00;90,75;80,09;10,66;40327;0;0;0;0;49702;5124;0.1031;5075;49
2017-01-19 20:00:00;74,99;65,45;9,54;40327;0;0;0;0;49702;5240;0.1054;5059;181
2017-01-19 21:00:00;56,17;46,54;9,63;40327;0;0;0;0;49702;5132;0.1032;5041;91
2017-01-19 22:00:00;50,05;46,27;3,78;40327;0;0;0;0;49702;4896;0.0985;5023;-127
2017-01-19 23:00:00;45,83;45,27;0,56;40327;0;0;0;0;49702;4630;0.0932;4992;-362
2017-01-20 00:00:00;45,09;48,41;-3,32;40328;0;0;0;0;49726;5836;0.1174;5725;111
2017-01-20 01:00:00;39,51;40,8;-1,29;40328;0;0;0;0;49726;5440;0.1094;5604;-164
2017-01-20 02:00:00;38,03;42,05;-4,02;40328;0;0;0;0;49726;5336;0.1073;5509;-173
2017-01-20 03:00:00;36,85;42,47;-5,62;40328;0;0;0;0;49726;5396;0.1085;5400;-4
2017-01-20 04:00:00;38,06;41,38;-3,32;40328;0;0;0;0;49726;5420;0.109;5278;142
2017-01-20 05:00:00;38,73;40,05;-1,32;40328;0;0;0;0;49726;5300;0.1066;5128;172
2017-01-20 06:00:00;55,63;48,88;6,75;40328;0;0;0;0;49726;5184;0.1042;4935;249
2017-01-20 07:00:00;69,99;68,21;1,78;40328;0;0;3;-3;49726;5189;0.1044;4758;431
2017-01-20 08:00:00;87,42;76,73;10,69;40328;423;0.0105;368;55;49726;5098;0.1025;4552;546
2017-01-20 09:00:00;87,61;74,79;12,82;40328;2476;0.0614;1922;554;49726;4854;0.0976;4315;539
2017-01-20 10:00:00;79,86;68,69;11,17;40328;5059;0.1254;3740;1319;49726;4211;0.0847;3933;278
2017-01-20 11:00:00;77,84;62,46;15,38;40328;6922;0.1716;5106;1816;49726;3562;0.0717;3489;73
2017-01-20 12:00:00;70,44;52,59;17,85;40328;7790;0.1932;5677;2113;49726;3127;0.0629;3202;-75
2017-01-20 13:00:00;72,8;53,31;19,49;40328;7460;0.185;5263;2197;49726;3094;0.0622;3045;49
2017-01-20 14:00:00;65,93;51,95;13,98;40328;5805;0.144;3979;1826;49726;3246;0.0653;3062;184
2017-01-20 15:00:00;72,93;54,24;18,69;40328;3116;0.0772;2125;991;49726;3402;0.0684;3204;198
2017-01-20 16:00:00;77,34;62,3;15,04;40328;576;0.0143;439;137;49726;3765;0.0757;3494;271
2017-01-20 17:00:00;90,07;70,0;20,07;40328;6;0.0001;4;2;49726;4384;0.0882;3871;513
2017-01-20 18:00:00;87,95;68,64;19,31;40328;0;0;0;0;49726;4757;0.0957;4177;580
2017-01-20 19:00:00;76,94;60,78;16,16;40328;0;0;0;0;49726;4984;0.1002;4269;715
2017-01-20 20:00:00;62,98;44,78;18,2;40328;0;0;0;0;49726;5029;0.1012;4132;897
2017-01-20 21:00:00;47,1;39,71;7,39;40328;0;0;0;0;49726;4893;0.0984;3961;932
2017-01-20 22:00:00;45,02;40,35;4,67;40328;0;0;0;0;49726;4714;0.0948;3804;910
2017-01-20 23:00:00;45,09;39,03;6,06;40328;0;0;0;0;49726;4604;0.0926;3668;936
2017-01-21 00:00:00;45,9;40,01;5,89;40328;0;0;0;0;49729;4394;0.0884;3811;583
2017-01-21 01:00:00;39,34;38,81;0,53;40328;0;0;0;0;49729;4169;0.0838;3520;649
2017-01-21 02:00:00;40,99;39,34;1,65;40328;0;0;0;0;49729;3926;0.079;3306;620
2017-01-21 03:00:00;44,04;40,78;3,26;40328;0;0;0;0;49729;3713;0.0746;3102;611
2017-01-21 04:00:00;43,07;40,36;2,71;40328;0;0;0;0;49729;3551;0.0714;2943;608
2017-01-21 05:00:00;41,56;38,5;3,06;40328;0;0;0;0;49729;3520;0.0708;2778;742
2017-01-21 06:00:00;40,62;35,05;5,57;40328;0;0;0;0;49729;3524;0.0709;2619;905
2017-01-21 07:00:00;43,93;36,29;7,64;40328;0;0;5;-5;49729;3482;0.07;2530;952
2017-01-21 08:00:00;50,99;43,23;7,76;40328;391;0.0097;534;-143;49729;3400;0.0684;2497;903
2017-01-21 09:00:00;54,98;46,23;8,75;40328;2521;0.0625;2531;-10;49729;3080;0.0619;2418;662
2017-01-21 10:00:00;53,05;47,11;5,94;40328;5489;0.1361;4838;651;49729;2624;0.0528;2111;513
2017-01-21 11:00:00;48,34;42,09;6,25;40328;7915;0.1963;6509;1406;49729;2008;0.0404;1641;367
2017-01-21 12:00:00;45,89;38,42;7,47;40328;9137;0.2266;7204;1933;49729;1473;0.0296;1269;204
2017-01-21 13:00:00;43,3;36,45;6,85;40328;8866;0.2198;6765;2101;49729;1136;0.0228;1065;71
2017-01-21 14:00:00;44,0;35,57;8,43;40328;6894;0.1709;5151;1743;49729;1055;0.0212;1093;-38
2017-01-21 15:00:00;47,56;37,46;10,1;40328;3601;0.0893;2777;824;49729;1247;0.0251;1229;18
2017-01-21 16:00:00;61,94;47,05;14,89;40328;650;0.0161;605;45;49729;1715;0.0345;1562;153
2017-01-21 17:00:00;65,91;49,59;16,32;40328;13;0.0003;7;6;49729;2736;0.055;2135;601
2017-01-21 18:00:00;65,01;46,89;18,12;40328;0;0;0;0;49729;3889;0.0782;2738;1151
2017-01-21 19:00:00;62,92;43,7;19,22;40328;0;0;0;0;49729;4656;0.0936;3199;1457
2017-01-21 20:00:00;47,01;37,6;9,41;40328;0;0;0;0;49729;4936;0.0993;3415;1521
2017-01-21 21:00:00;44,03;36,78;7,25;40328;0;0;0;0;49729;5104;0.1026;3563;1541
2017-01-21 22:00:00;44,33;40,78;3,55;40328;0;0;0;0;49729;4912;0.0988;3629;1283
2017-01-21 23:00:00;39,54;37,95;1,59;40328;0;0;0;0;49729;4593;0.0924;3562;1031
2017-01-22 00:00:00;38,6;37,26;1,34;40328;0;0;0;0;49741;4444;0.0893;3871;573
2017-01-22 01:00:00;38,22;36,34;1,88;40328;0;0;0;0;49741;4298;0.0864;3541;757
2017-01-22 02:00:00;38,6;39,58;-0,98;40328;0;0;0;0;49741;3994;0.0803;3346;648
2017-01-22 03:00:00;37,43;38,29;-0,86;40328;0;0;0;0;49741;4013;0.0807;3184;829
2017-01-22 04:00:00;38,27;38,82;-0,55;40328;0;0;0;0;49741;4008;0.0806;3160;848
2017-01-22 05:00:00;37,83;38,45;-0,62;40328;0;0;0;0;49741;3817;0.0768;3143;674
2017-01-22 06:00:00;35,97;33,43;2,54;40328;0;0;0;0;49741;3766;0.0757;3100;666
2017-01-22 07:00:00;39,24;40,06;-0,82;40328;0;0;6;-6;49741;3685;0.0741;3016;669
2017-01-22 08:00:00;37,76;41,97;-4,21;40328;461;0.0114;590;-129;49741;3488;0.0701;2809;679
2017-01-22 09:00:00;39,26;45,83;-6,57;40328;2702;0.067;2916;-214;49741;2950;0.0593;2485;465
2017-01-22 10:00:00;38,03;44,12;-6,09;40328;5835;0.1447;5706;129;49741;2168;0.0436;1972;196
2017-01-22 11:00:00;38,16;43,48;-5,32;40328;8241;0.2044;7787;454;49741;1334;0.0268;1387;-53
2017-01-22 12:00:00;37,07;39,58;-2,51;40328;9516;0.236;8609;907;49741;777;0.0156;930;-153
2017-01-22 13:00:00;36,03;36,38;-0,35;40328;9210;0.2284;8104;1106;49741;548;0.011;719;-171
2017-01-22 14:00:00;37,32;35,93;1,39;40328;7064;0.1751;6217;847;49741;490;0.0099;756;-266
2017-01-22 15:00:00;38,29;36,63;1,66;40328;3677;0.0912;3269;408;49741;544;0.011;921;-377
2017-01-22 16:00:00;44,06;46,43;-2,37;40328;664;0.0165;691;-27;49741;767;0.0154;1223;-456
2017-01-22 17:00:00;61,92;57,88;4,04;40328;16;0.0004;11;5;49741;1133;0.0228;1629;-496
2017-01-22 18:00:00;57,72;59,55;-1,83;40328;0;0;0;0;49741;1350;0.0271;1990;-640
2017-01-22 19:00:00;57,38;60,76;-3,38;40328;0;0;0;0;49741;1388;0.0279;2200;-812
2017-01-22 20:00:00;46,0;53,53;-7,53;40328;0;0;0;0;49741;1398;0.0281;2256;-858
2017-01-22 21:00:00;39,39;48,8;-9,41;40328;0;0;0;0;49741;1422;0.0286;2239;-817
2017-01-22 22:00:00;44,05;58,12;-14,07;40328;0;0;0;0;49741;1302;0.0262;2211;-909
2017-01-22 23:00:00;35,93;42,18;-6,25;40328;0;0;0;0;49741;1144;0.023;2252;-1108
2017-01-23 00:00:00;39,1;46,92;-7,82;40332;0;0;0;0;49743;990;0.0199;1920;-930
2017-01-23 01:00:00;38,28;45,05;-6,77;40332;0;0;0;0;49743;931;0.0187;2059;-1128
2017-01-23 02:00:00;39,43;42,8;-3,37;40332;0;0;0;0;49743;1331;0.0268;2177;-846
2017-01-23 03:00:00;37,29;39,75;-2,46;40332;0;0;0;0;49743;1538;0.0309;2287;-749
2017-01-23 04:00:00;36,65;39,04;-2,39;40332;0;0;0;0;49743;1560;0.0314;2401;-841
2017-01-23 05:00:00;44,84;43,92;0,92;40332;0;0;0;0;49743;1504;0.0302;2502;-998
2017-01-23 06:00:00;69,97;72,39;-2,42;40332;0;0;0;0;49743;1464;0.0294;2656;-1192
2017-01-23 07:00:00;98,45;100,68;-2,23;40332;1;0;8;-7;49743;1671;0.0336;2764;-1093
2017-01-23 08:00:00;95,83;129,97;-34,14;40332;435;0.0108;545;-110;49743;1858;0.0374;2907;-1049
2017-01-23 09:00:00;99,99;135,87;-35,88;40332;2033;0.0504;2409;-376;49743;1899;0.0382;3169;-1270
2017-01-23 10:00:00;99,36;148,95;-49,59;40332;4004;0.0992;4513;-509;49743;1932;0.0389;3326;-1394
2017-01-23 11:00:00;87,42;193,5;-106,08;40332;5496;0.1362;5963;-467;49743;1678;0.0338;3302;-1624
2017-01-23 12:00:00;83,43;167,57;-84,14;40332;6164;0.1528;6446;-282;49743;1674;0.0336;3235;-1561
2017-01-23 13:00:00;81,81;159,48;-77,67;40332;5762;0.1429;5973;-211;49743;1696;0.0341;3270;-1574
2017-01-23 14:00:00;85,1;147,52;-62,42;40332;4357;0.108;4478;-121;49743;1532;0.0308;3346;-1814
2017-01-23 15:00:00;82,84;154,46;-71,62;40332;2230;0.0553;2325;-95;49743;1545;0.0311;3485;-1940
2017-01-23 16:00:00;91,14;156,53;-65,39;40332;444;0.011;515;-71;49743;1593;0.032;3724;-2131
2017-01-23 17:00:00;109,98;186,6;-76,62;40332;13;0.0003;8;5;49743;1728;0.0348;3997;-2269
2017-01-23 18:00:00;128,4;189,45;-61,05;40332;0;0;0;0;49743;1902;0.0382;4302;-2400
2017-01-23 19:00:00;103,87;170,9;-67,03;40332;0;0;0;0;49743;2135;0.0429;4445;-2310
2017-01-23 20:00:00;84,55;104,8;-20,25;40332;0;0;0;0;49743;2097;0.0422;4410;-2313
2017-01-23 21:00:00;69,4;88,92;-19,52;40332;0;0;0;0;49743;1971;0.0396;4401;-2430
2017-01-23 22:00:00;65,06;89,21;-24,15;40332;0;0;0;0;49743;1702;0.0342;4366;-2664
2017-01-23 23:00:00;43,08;78,51;-35,43;40332;0;0;0;0;49743;1490;0.03;4329;-2839
2017-01-24 00:00:00;57,01;50,84;6,17;40333;0;0;0;0;49749;1279;0.0257;2014;-735
2017-01-24 01:00:00;51,04;49,36;1,68;40333;0;0;0;0;49749;1086;0.0218;1821;-735
2017-01-24 02:00:00;53,05;48,01;5,04;40333;0;0;0;0;49749;945;0.019;1646;-701
2017-01-24 03:00:00;48,82;44,48;4,34;40333;0;0;0;0;49749;975;0.0196;1451;-476
2017-01-24 04:00:00;51,52;44,94;6,58;40333;0;0;0;0;49749;912;0.0183;1322;-410
2017-01-24 05:00:00;56,06;49,38;6,68;40333;0;0;0;0;49749;898;0.0181;1277;-379
2017-01-24 06:00:00;91,21;76,39;14,82;40333;0;0;0;0;49749;858;0.0173;1269;-411
2017-01-24 07:00:00;163,52;138,34;25,18;40333;0;0;4;-4;49749;778;0.0156;1259;-481
2017-01-24 08:00:00;153,67;128,47;25,2;40333;157;0.0039;331;-174;49749;671;0.0135;1251;-580
2017-01-24 09:00:00;150,1;125,45;24,65;40333;724;0.0179;1453;-729;49749;718;0.0144;1240;-522
2017-01-24 10:00:00;151,07;139,51;11,56;40333;1436;0.0356;2764;-1328;49749;798;0.0161;1180;-382
2017-01-24 11:00:00;135,0;152,95;-17,95;40333;2002;0.0496;3767;-1765;49749;953;0.0192;1084;-131
2017-01-24 12:00:00;121,58;141,74;-20,16;40333;2067;0.0512;4198;-2131;49749;1024;0.0206;1052;-28
2017-01-24 13:00:00;117,68;136,47;-18,79;40333;1834;0.0455;3948;-2114;49749;1202;0.0242;1117;85
2017-01-24 14:00:00;112,21;134,15;-21,94;40333;1323;0.0328;3035;-1712;49749;1277;0.0257;1264;13
2017-01-24 15:00:00;117,18;140,28;-23,1;40333;636;0.0158;1645;-1009;49749;1442;0.029;1430;12
2017-01-24 16:00:00;120,0;137,11;-17,11;40333;113;0.0028;353;-240;49749;1547;0.0311;1607;-60
2017-01-24 17:00:00;131,01;153,83;-22,82;40333;8;0.0002;9;-1;49749;1476;0.0297;1814;-338
2017-01-24 18:00:00;138,91;161,49;-22,58;40333;0;0;0;0;49749;1526;0.0306;2032;-506
2017-01-24 19:00:00;113,8;161,97;-48,17;40333;0;0;0;0;49749;1688;0.0339;2204;-516
2017-01-24 20:00:00;109,92;110,12;-0,2;40333;0;0;0;0;49749;1813;0.0364;2317;-504
2017-01-24 21:00:00;78,98;72,63;6,35;40333;0;0;0;0;49749;1929;0.0388;2468;-539
2017-01-24 22:00:00;66,17;67,66;-1,49;40333;0;0;0;0;49749;2100;0.0422;2601;-501
2017-01-24 23:00:00;56,61;56,69;-0,08;40333;0;0;0;0;49749;2330;0.0468;2715;-385
2017-01-25 00:00:00;54,69;58,3;-3,61;40334;0;0;0;0;49778;2429;0.0488;2688;-259
2017-01-25 01:00:00;46,58;49,17;-2,59;40334;0;0;0;0;49778;2464;0.0495;2720;-256
2017-01-25 02:00:00;42,39;47,67;-5,28;40334;0;0;0;0;49778;2252;0.0452;2779;-527
2017-01-25 03:00:00;40,94;44,46;-3,52;40334;0;0;0;0;49778;1954;0.0393;2774;-820
2017-01-25 04:00:00;43,25;45,64;-2,39;40334;0;0;0;0;49778;1812;0.0364;2733;-921
2017-01-25 05:00:00;48,03;59,84;-11,81;40334;0;0;0;0;49778;1626;0.0327;2640;-1014
2017-01-25 06:00:00;67,35;74,49;-7,14;40334;0;0;0;0;49778;1530;0.0307;2542;-1012
2017-01-25 07:00:00;100,24;126,12;-25,88;40334;1;0;7;-6;49778;1510;0.0304;2457;-947
2017-01-25 08:00:00;105,04;147,68;-42,64;40334;174;0.0043;380;-206;49778;1692;0.034;2410;-718
2017-01-25 09:00:00;109,63;145,67;-36,04;40334;942;0.0234;1738;-796;49778;1971;0.0396;2434;-463
2017-01-25 10:00:00;109,93;143,64;-33,71;40334;1966;0.0488;3405;-1439;49778;2242;0.045;2470;-228
2017-01-25 11:00:00;119,98;138,09;-18,11;40334;2908;0.0721;4680;-1772;49778;2495;0.0502;2443;52
2017-01-25 12:00:00;114,1;130,59;-16,49;40334;3469;0.086;5250;-1781;49778;2688;0.054;2351;337
2017-01-25 13:00:00;101,63;122,66;-21,03;40334;3517;0.0872;4996;-1479;49778;2741;0.0551;2278;463
2017-01-25 14:00:00;107,75;119,98;-12,23;40334;2837;0.0703;3882;-1045;49778;2661;0.0535;2252;409
2017-01-25 15:00:00;111,65;129,14;-17,49;40334;1556;0.0386;2143;-587;49778;2537;0.051;2238;299
2017-01-25 16:00:00;119,63;138,6;-18,97;40334;337;0.0084;509;-172;49778;2582;0.0519;2429;153
2017-01-25 17:00:00;122,9;161,01;-38,11;40334;13;0.0003;9;4;49778;2828;0.0568;2923;-95
2017-01-25 18:00:00;133,18;156,73;-23,55;40334;0;0;0;0;49778;3171;0.0637;3548;-377
2017-01-25 19:00:00;109,96;158,1;-48,14;40334;0;0;0;0;49778;3679;0.0739;4077;-398
2017-01-25 20:00:00;89,96;96,19;-6,23;40334;0;0;0;0;49778;4250;0.0854;4486;-236
2017-01-25 21:00:00;62,34;61,75;0,59;40334;0;0;0;0;49778;4866;0.0978;4843;23
2017-01-25 22:00:00;57,8;55,48;2,32;40334;0;0;0;0;49778;5243;0.1054;5188;55
2017-01-25 23:00:00;45,23;46,03;-0,8;40334;0;0;0;0;49778;5824;0.117;5523;301
2017-01-26 00:00:00;43,85;43,13;0,72;40335;0;0;0;0;49811;6154;0.1236;6438;-284
2017-01-26 01:00:00;42,06;45,41;-3,35;40335;0;0;0;0;49811;6468;0.1299;6731;-263
2017-01-26 02:00:00;40,02;44,79;-4,77;40335;0;0;0;0;49811;6741;0.1353;7051;-310
2017-01-26 03:00:00;37,85;41,36;-3,51;40335;0;0;0;0;49811;6966;0.1398;7346;-380
2017-01-26 04:00:00;38,23;38,42;-0,19;40335;0;0;0;0;49811;7094;0.1424;7675;-581
2017-01-26 05:00:00;41,1;41,93;-0,83;40335;0;0;0;0;49811;7082;0.1422;8093;-1011
2017-01-26 06:00:00;44,28;45,52;-1,24;40335;0;0;0;0;49811;7152;0.1436;8484;-1332
2017-01-26 07:00:00;58,51;61,02;-2,51;40335;2;0;6;-4;49811;7512;0.1508;8884;-1372
2017-01-26 08:00:00;65,05;63,31;1,74;40335;463;0.0115;515;-52;49811;7916;0.1589;9188;-1272
2017-01-26 09:00:00;60,94;63,05;-2,11;40335;2854;0.0708;2344;510;49811;8001;0.1607;9409;-1408
2017-01-26 10:00:00;58,13;60,4;-2,27;40335;6392;0.1585;4549;1843;49811;7941;0.1594;9400;-1459
2017-01-26 11:00:00;59,61;52,16;7,45;40335;9568;0.2372;6346;3222;49811;8436;0.1694;8870;-434
2017-01-26 12:00:00;59,45;44,35;15,1;40335;11205;0.2778;7318;3887;49811;9202;0.1848;8299;903
2017-01-26 13:00:00;53,51;40,18;13,33;40335;10967;0.2719;7142;3825;49811;9436;0.1894;8102;1334
2017-01-26 14:00:00;57,5;40,13;17,37;40335;8876;0.22;5718;3158;49811;9362;0.188;8177;1185
2017-01-26 15:00:00;54,97;41,43;13,54;40335;4990;0.1237;3242;1748;49811;9186;0.1844;8917;269
2017-01-26 16:00:00;55,72;51,66;4,06;40335;1148;0.0285;767;381;49811;9983;0.2004;10410;-427
2017-01-26 17:00:00;54,01;56,27;-2,26;40335;22;0.0005;7;15;49811;12211;0.2452;12466;-255
2017-01-26 18:00:00;53,35;53,61;-0,26;40335;0;0;0;0;49811;13694;0.2749;14348;-654
2017-01-26 19:00:00;44,98;47,14;-2,16;40335;0;0;0;0;49811;14104;0.2832;15287;-1183
2017-01-26 20:00:00;36,08;41,89;-5,81;40335;0;0;0;0;49811;14035;0.2818;15282;-1247
2017-01-26 21:00:00;37,87;42,52;-4,65;40335;0;0;0;0;49811;13528;0.2716;14942;-1414
2017-01-26 22:00:00;41,4;45,47;-4,07;40335;0;0;0;0;49811;12944;0.2599;14550;-1606
2017-01-26 23:00:00;36,7;40,18;-3,48;40335;0;0;0;0;49811;13082;0.2626;14297;-1215
2017-01-27 00:00:00;35,08;40,05;-4,97;40337;0;0;0;0;49836;13052;0.2619;12990;62
2017-01-27 01:00:00;34,31;39,85;-5,54;40337;0;0;0;0;49836;12831;0.2574;13019;-188
2017-01-27 02:00:00;34,05;39,66;-5,61;40337;0;0;0;0;49836;13059;0.262;13276;-217
2017-01-27 03:00:00;33,97;37,76;-3,79;40337;0;0;0;0;49836;13584;0.2726;13540;44
2017-01-27 04:00:00;34,03;33,13;0,9;40337;0;0;0;0;49836;14277;0.2865;13720;557
2017-01-27 05:00:00;34,06;30,38;3,68;40337;0;0;0;0;49836;15187;0.3047;13941;1246
2017-01-27 06:00:00;35,8;29,33;6,47;40337;0;0;0;0;49836;15672;0.3144;14173;1499
2017-01-27 07:00:00;46,39;42,84;3,55;40337;3;0;10;-7;49836;16000;0.3211;14229;1771
2017-01-27 08:00:00;47,4;50,41;-3,01;40337;1106;0.0274;836;270;49836;15222;0.3055;13935;1287
2017-01-27 09:00:00;45,04;42,82;2,22;40337;4775;0.1184;3531;1244;49836;13977;0.2804;13073;904
2017-01-27 10:00:00;43,47;39,5;3,97;40337;9120;0.2261;6339;2781;49836;11712;0.235;11435;277
2017-01-27 11:00:00;44,14;37,11;7,03;40337;12169;0.3017;8350;3819;49836;9381;0.1882;9334;47
2017-01-27 12:00:00;44,36;35,34;9,02;40337;13292;0.3295;9196;4096;49836;7904;0.1586;7437;467
2017-01-27 13:00:00;45,18;35,29;9,89;40337;12349;0.3062;8677;3672;49836;6932;0.1391;6303;629
2017-01-27 14:00:00;48,46;37,36;11,1;40337;9464;0.2346;6785;2679;49836;6458;0.1296;6082;376
2017-01-27 15:00:00;52,92;42,37;10,55;40337;5212;0.1292;3852;1360;49836;6402;0.1285;6569;-167
2017-01-27 16:00:00;55,25;44,8;10,45;40337;1111;0.0275;936;175;49836;7044;0.1413;7768;-724
2017-01-27 17:00:00;60,36;53,98;6,38;40337;24;0.0006;10;14;49836;8114;0.1628;9300;-1186
2017-01-27 18:00:00;56,59;52,98;3,61;40337;0;0;0;0;49836;8781;0.1762;10344;-1563
2017-01-27 19:00:00;54,61;54,74;-0,13;40337;0;0;0;0;49836;8829;0.1772;10704;-1875
2017-01-27 20:00:00;47,65;53,38;-5,73;40337;0;0;0;0;49836;9139;0.1834;10526;-1387
2017-01-27 21:00:00;39,9;42,81;-2,91;40337;0;0;0;0;49836;8774;0.1761;10098;-1324
2017-01-27 22:00:00;39,9;42,29;-2,39;40337;0;0;0;0;49836;8372;0.168;9656;-1284
2017-01-27 23:00:00;38,03;42,38;-4,35;40337;0;0;0;0;49836;8281;0.1662;9324;-1043
2017-01-28 00:00:00;39,67;44,65;-4,98;40337;0;0;0;0;49854;8338;0.1672;10284;-1946
2017-01-28 01:00:00;40,0;45,24;-5,24;40337;0;0;0;0;49854;7690;0.1542;10067;-2377
2017-01-28 02:00:00;36,0;42,98;-6,98;40337;0;0;0;0;49854;7684;0.1542;10035;-2351
2017-01-28 03:00:00;39,0;42,31;-3,31;40337;0;0;0;0;49854;8064;0.1618;10069;-2005
2017-01-28 04:00:00;37,39;40,96;-3,57;40337;0;0;0;0;49854;8533;0.1712;10235;-1702
2017-01-28 05:00:00;37,78;40,13;-2,35;40337;0;0;0;0;49854;8978;0.1801;10569;-1591
2017-01-28 06:00:00;37,38;48,88;-11,5;40337;0;0;0;0;49854;9534;0.1913;10904;-1370
2017-01-28 07:00:00;39,65;50,32;-10,67;40337;4;0.0001;12;-8;49854;9648;0.1935;10996;-1348
2017-01-28 08:00:00;47,34;55,92;-8,58;40337;905;0.0224;1138;-233;49854;9329;0.1872;10793;-1464
2017-01-28 09:00:00;44,9;58,94;-14,04;40337;4236;0.105;4466;-230;49854;8627;0.1731;10215;-1588
2017-01-28 10:00:00;40,09;57,07;-16,98;40337;8391;0.208;7840;551;49854;7092;0.1422;8776;-1684
2017-01-28 11:00:00;43,6;50,3;-6,7;40337;11621;0.2881;10219;1402;49854;5701;0.1144;6773;-1072
2017-01-28 12:00:00;38,4;42,89;-4,49;40337;12875;0.3192;11048;1827;49854;4967;0.0996;5426;-459
2017-01-28 13:00:00;37,74;41,24;-3,5;40337;12275;0.3043;10276;1999;49854;4730;0.0949;4909;-179
2017-01-28 14:00:00;41,01;40,31;0,7;40337;9407;0.2332;7895;1512;49854;4806;0.0964;5071;-265
2017-01-28 15:00:00;49,92;46,06;3,86;40337;5070;0.1257;4373;697;49854;5141;0.1031;5762;-621
2017-01-28 16:00:00;54,15;52,15;2,0;40337;1152;0.0286;1049;103;49854;6228;0.1249;7113;-885
2017-01-28 17:00:00;60,59;63,13;-2,54;40337;28;0.0007;11;17;49854;8458;0.1696;8857;-399
2017-01-28 18:00:00;55,2;59,58;-4,38;40337;0;0;0;0;49854;10245;0.2055;10578;-333
2017-01-28 19:00:00;48,08;52,67;-4,59;40337;0;0;0;0;49854;10858;0.2178;11787;-929
2017-01-28 20:00:00;40,57;47,66;-7,09;40337;0;0;0;0;49854;11538;0.2314;12454;-916
2017-01-28 21:00:00;38,0;42,29;-4,29;40337;0;0;0;0;49854;12182;0.2443;13098;-916
2017-01-28 22:00:00;37,2;42,14;-4,94;40337;0;0;0;0;49854;12616;0.253;13703;-1087
2017-01-28 23:00:00;33,74;41,05;-7,31;40337;0;0;0;0;49854;13046;0.2617;14020;-974
2017-01-29 00:00:00;36,04;44,42;-8,38;40337;0;0;0;0;49854;13132;0.2634;12806;326
2017-01-29 01:00:00;32,95;38,89;-5,94;40337;0;0;0;0;49854;13424;0.2693;13122;302
2017-01-29 02:00:00;32,94;37,08;-4,14;40337;0;0;0;0;49854;13890;0.2786;13264;626
2017-01-29 03:00:00;31,75;35,06;-3,31;40337;0;0;0;0;49854;14306;0.287;13412;894
2017-01-29 04:00:00;34,65;38,84;-4,19;40337;0;0;0;0;49854;14021;0.2812;13633;388
2017-01-29 05:00:00;32,89;37,68;-4,79;40337;0;0;0;0;49854;14363;0.2881;13875;488
2017-01-29 06:00:00;32,96;36,29;-3,33;40337;0;0;0;0;49854;14139;0.2836;14167;-28
2017-01-29 07:00:00;35,01;40,56;-5,55;40337;2;0;13;-11;49854;13784;0.2765;14421;-637
2017-01-29 08:00:00;35,0;40,47;-5,47;40337;859;0.0213;806;53;49854;13732;0.2754;14499;-767
2017-01-29 09:00:00;33,05;38,37;-5,32;40337;3789;0.0939;2917;872;49854;13642;0.2737;14343;-701
2017-01-29 10:00:00;33,07;34,55;-1,48;40337;7206;0.1786;5257;1949;49854;13592;0.2726;13928;-336
2017-01-29 11:00:00;33,07;32,03;1,04;40337;9464;0.2346;7251;2213;49854;13386;0.2685;13547;-161
2017-01-29 12:00:00;33,04;32,9;0,14;40337;10321;0.2559;8139;2182;49854;13370;0.2682;13296;74
2017-01-29 13:00:00;32,91;29,75;3,16;40337;9576;0.2374;7864;1712;49854;13022;0.2612;12953;69
2017-01-29 14:00:00;34,64;30,85;3,79;40337;7401;0.1835;6196;1205;49854;12552;0.2518;12460;92
2017-01-29 15:00:00;37,05;34,01;3,04;40337;4173;0.1034;3449;724;49854;12163;0.244;12060;103
2017-01-29 16:00:00;45,58;38,36;7,22;40337;1037;0.0257;862;175;49854;11868;0.2381;12004;-136
2017-01-29 17:00:00;53,93;49,99;3,94;40337;26;0.0006;11;15;49854;11571;0.2321;12437;-866
2017-01-29 18:00:00;55,25;56,1;-0,85;40337;0;0;0;0;49854;11604;0.2327;13037;-1433
2017-01-29 19:00:00;50,58;56,37;-5,79;40337;0;0;0;0;49854;11922;0.2391;13418;-1496
2017-01-29 20:00:00;39,84;45,97;-6,13;40337;0;0;0;0;49854;11576;0.2322;13359;-1783
2017-01-29 21:00:00;37,08;43,3;-6,22;40337;0;0;0;0;49854;11682;0.2343;13102;-1420
2017-01-29 22:00:00;44,21;44,77;-0,56;40337;0;0;0;0;49854;10988;0.2204;12700;-1712
2017-01-29 23:00:00;36,09;41,6;-5,51;40337;0;0;0;0;49854;10362;0.2078;12116;-1754
2017-01-30 00:00:00;36,51;40,67;-4,16;40338;0;0;0;0;49866;9993;0.2004;10949;-956
2017-01-30 01:00:00;36,49;38,3;-1,81;40338;0;0;0;0;49866;10057;0.2017;10486;-429
2017-01-30 02:00:00;36,62;38,7;-2,08;40338;0;0;0;0;49866;10242;0.2054;10309;-67
2017-01-30 03:00:00;36,05;37,62;-1,57;40338;0;0;0;0;49866;10290;0.2064;10265;25
2017-01-30 04:00:00;35,11;35,19;-0,08;40338;0;0;0;0;49866;10494;0.2105;10352;142
2017-01-30 05:00:00;36,68;37,13;-0,45;40338;0;0;0;0;49866;11138;0.2234;10667;471
2017-01-30 06:00:00;47,14;43,16;3,98;40338;0;0;0;0;49866;12628;0.2532;11158;1470
2017-01-30 07:00:00;59,13;47,05;12,08;40338;2;0;9;-7;49866;13835;0.2774;11662;2173
2017-01-30 08:00:00;65,06;49,07;15,99;40338;570;0.0141;450;120;49866;14174;0.2842;12016;2158
2017-01-30 09:00:00;65,02;48,41;16,61;40338;1856;0.046;1478;378;49866;14410;0.289;12291;2119
2017-01-30 10:00:00;68,77;51,02;17,75;40338;3149;0.0781;2467;682;49866;13801;0.2768;12315;1486
2017-01-30 11:00:00;69,91;52,58;17,33;40338;3685;0.0914;3040;645;49866;13862;0.278;12075;1787
2017-01-30 12:00:00;60,16;52,89;7,27;40338;3355;0.0832;3002;353;49866;14678;0.2943;11835;2843
2017-01-30 13:00:00;63,72;53,22;10,5;40338;2675;0.0663;2538;137;49866;15283;0.3065;11669;3614
2017-01-30 14:00:00;61,32;49,14;12,18;40338;1973;0.0489;1782;191;49866;15745;0.3158;11762;3983
2017-01-30 15:00:00;55,98;48,23;7,75;40338;1062;0.0263;906;156;49866;16234;0.3256;12015;4219
2017-01-30 16:00:00;55,94;51,44;4,5;40338;240;0.006;236;4;49866;16566;0.3322;12307;4259
2017-01-30 17:00:00;68,48;55,23;13,25;40338;10;0.0002;3;7;49866;17172;0.3444;12539;4633
2017-01-30 18:00:00;59,98;54,36;5,62;40338;0;0;0;0;49866;17186;0.3446;12740;4446
2017-01-30 19:00:00;56,0;47,85;8,15;40338;0;0;0;0;49866;17143;0.3438;12747;4396
2017-01-30 20:00:00;47,87;39,35;8,52;40338;0;0;0;0;49866;16601;0.3329;12464;4137
2017-01-30 21:00:00;41,93;36,31;5,62;40338;0;0;0;0;49866;15840;0.3176;12100;3740
2017-01-30 22:00:00;45,6;37,79;7,81;40338;0;0;0;0;49866;14722;0.2952;11637;3085
2017-01-30 23:00:00;36,59;35,18;1,41;40338;0;0;0;0;49866;13605;0.2728;11036;2569
2017-01-31 00:00:00;33,06;41,72;-8,66;40342;0;0;0;0;49881;12586;0.2523;13333;-747
2017-01-31 01:00:00;34,38;36,84;-2,46;40342;0;0;0;0;49881;11589;0.2323;12270;-681
2017-01-31 02:00:00;34,38;41,04;-6,66;40342;0;0;0;0;49881;10843;0.2174;11324;-481
2017-01-31 03:00:00;35,57;39,4;-3,83;40342;0;0;0;0;49881;10022;0.2009;10337;-315
2017-01-31 04:00:00;37,33;36,43;0,9;40342;0;0;0;0;49881;9071;0.1818;9315;-244
2017-01-31 05:00:00;38,95;41,47;-2,52;40342;0;0;0;0;49881;8410;0.1686;8283;127
2017-01-31 06:00:00;56,95;54,54;2,41;40342;0;0;0;0;49881;7979;0.16;7370;609
2017-01-31 07:00:00;81,62;78,32;3,3;40342;1;0;5;-4;49881;7507;0.1505;6583;924
2017-01-31 08:00:00;81,82;93,7;-11,88;40342;160;0.004;222;-62;49881;6872;0.1378;5873;999
2017-01-31 09:00:00;82,02;98,53;-16,51;40342;666;0.0165;907;-241;49881;5940;0.1191;5233;707
2017-01-31 10:00:00;89,8;102,21;-12,41;40342;1366;0.0339;1705;-339;49881;5290;0.1061;4651;639
2017-01-31 11:00:00;89,82;108,57;-18,75;40342;2036;0.0504;2341;-305;49881;4474;0.0897;4124;350
2017-01-31 12:00:00;82,36;105,8;-23,44;40342;2388;0.0592;2627;-239;49881;3628;0.0728;3635;-7
2017-01-31 13:00:00;82,02;114,54;-32,52;40342;2296;0.0569;2532;-236;49881;3047;0.0611;3140;-93
2017-01-31 14:00:00;90,36;124,58;-34,22;40342;1836;0.0455;2050;-214;49881;2655;0.0532;2676;-21
2017-01-31 15:00:00;89,75;148,7;-58,95;40342;1035;0.0256;1209;-174;49881;2566;0.0514;2342;224
2017-01-31 16:00:00;90,2;172,1;-81,9;40342;264;0.0065;342;-78;49881;2499;0.0501;2218;281
2017-01-31 17:00:00;95,0;200,43;-105,43;40342;16;0.0004;7;9;49881;2618;0.0525;2300;318
2017-01-31 18:00:00;104,33;174,54;-70,21;40342;0;0;0;0;49881;2709;0.0543;2464;245
2017-01-31 19:00:00;90,0;131,55;-41,55;40342;0;0;0;0;49881;2663;0.0534;2560;103
2017-01-31 20:00:00;84,15;92,88;-8,73;40342;0;0;0;0;49881;2627;0.0526;2611;16
2017-01-31 21:00:00;60,92;63,04;-2,12;40342;0;0;0;0;49881;2636;0.0528;2692;-56
2017-01-31 22:00:00;54,9;56,25;-1,35;40342;0;0;0;0;49881;2850;0.0572;2766;84
2017-01-31 23:00:00;40,69;45,62;-4,93;40342;0;0;0;0;49881;3221;0.0646;2908;313
2017-01-02 00:00:00;44,91;43,2;1,71;40365;0;0;0;0;49893;3068;0.0615;2633;435
2017-01-02 01:00:00;42,25;41,8;0,45;40365;0;0;0;0;49893;3160;0.0634;2820;340
2017-01-02 02:00:00;39,8;39,36;0,44;40365;0;0;0;0;49893;3264;0.0654;3076;188
2017-01-02 03:00:00;38,15;38,18;-0,03;40365;0;0;0;0;49893;3604;0.0722;3374;230
2017-01-02 04:00:00;38,38;38,99;-0,61;40365;0;0;0;0;49893;3798;0.0761;3734;64
2017-01-02 05:00:00;41,09;41,46;-0,37;40365;0;0;0;0;49893;4235;0.0849;4231;4
2017-01-02 06:00:00;47,86;48,46;-0,6;40365;0;0;0;0;49893;5109;0.1024;4916;193
2017-01-02 07:00:00;65,96;62,39;3,57;40365;2;0;11;-9;49893;6040;0.121;5788;252
2017-01-02 08:00:00;72,93;60,41;12,52;40365;266;0.0066;472;-206;49893;7309;0.1465;6734;575
2017-01-02 09:00:00;65,91;57,68;8,23;40365;1256;0.0311;2025;-769;49893;8166;0.1637;7587;579
2017-01-02 10:00:00;65,02;57,41;7,61;40365;2637;0.0653;3898;-1261;49893;8892;0.1782;8180;712
2017-01-02 11:00:00;62,91;53,59;9,32;40365;3956;0.098;5419;-1463;49893;9112;0.1826;8462;650
2017-01-02 12:00:00;56,99;53,69;3,3;40365;4805;0.119;6084;-1279;49893;9081;0.182;8686;395
2017-01-02 13:00:00;54,18;47,17;7,01;40365;4616;0.1144;5731;-1115;49893;8742;0.1752;8945;-203
2017-01-02 14:00:00;50,49;41,79;8,7;40365;3676;0.0911;4539;-863;49893;9065;0.1817;9393;-328
2017-01-02 15:00:00;52,35;42,67;9,68;40365;2070;0.0513;2680;-610;49893;9809;0.1966;9967;-158
2017-01-02 16:00:00;57,0;41,69;15,31;40365;507;0.0126;750;-243;49893;10970;0.2198;10866;104
2017-01-02 17:00:00;62,58;50,59;11,99;40365;26;0.0006;12;14;49893;12494;0.2504;12223;271
2017-01-02 18:00:00;56,99;48,94;8,05;40365;0;0;0;0;49893;13696;0.2745;13587;109
2017-01-02 19:00:00;49,74;40,38;9,36;40365;0;0;0;0;49893;14638;0.2934;14361;277
2017-01-02 20:00:00;41,04;36,8;4,24;40365;0;0;0;0;49893;14778;0.2962;14348;430
2017-01-02 21:00:00;44,2;34,24;9,96;40365;0;0;0;0;49893;14818;0.297;14053;765
2017-01-02 22:00:00;42,38;36,52;5,86;40365;0;0;0;0;49893;14113;0.2829;13585;528
2017-01-02 23:00:00;38,06;35,73;2,33;40365;0;0;0;0;49893;13638;0.2734;12984;654
2017-02-02 00:00:00;31,05;38,63;-7,58;40375;0;0;0;0;49908;12765;0.2558;13493;-728
2017-02-02 01:00:00;29,8;36,44;-6,64;40375;0;0;0;0;49908;12215;0.2448;12926;-711
2017-02-02 02:00:00;32,66;41,17;-8,51;40375;0;0;0;0;49908;11960;0.2396;12449;-489
2017-02-02 03:00:00;32,3;32,01;0,29;40375;0;0;0;0;49908;11425;0.229;12089;-664
2017-02-02 04:00:00;31,05;30,39;0,66;40375;0;0;0;0;49908;11246;0.2254;11784;-538
2017-02-02 05:00:00;32,66;31,46;1,2;40375;0;0;0;0;49908;11236;0.2252;11521;-285
2017-02-02 06:00:00;39,91;36,77;3,14;40375;0;0;0;0;49908;10991;0.2202;11229;-238
2017-02-02 07:00:00;55,58;49,74;5,84;40375;6;0.0001;19;-13;49908;10814;0.2167;10893;-79
2017-02-02 08:00:00;57,19;51,53;5,66;40375;560;0.0138;740;-180;49908;10441;0.2092;10441;0
2017-02-02 09:00:00;59,1;48,44;10,66;40375;2364;0.0586;2737;-373;49908;9678;0.1939;9784;-106
2017-02-02 10:00:00;58,55;45,76;12,79;40375;4958;0.1228;4970;-12;49908;8437;0.1691;8936;-499
2017-02-02 11:00:00;57,66;43,87;13,79;40375;7616;0.1886;6817;799;49908;7572;0.1517;7982;-410
2017-02-02 12:00:00;57,66;43,03;14,63;40375;8858;0.2194;7714;1144;49908;6536;0.131;7231;-695
2017-02-02 13:00:00;54,44;42,96;11,48;40375;8063;0.1997;7406;657;49908;6200;0.1242;7016;-816
2017-02-02 14:00:00;50,9;43,62;7,28;40375;5716;0.1416;6002;-286;49908;6610;0.1324;7599;-989
2017-02-02 15:00:00;47,1;45,3;1,8;40375;3133;0.0776;3708;-575;49908;7802;0.1563;8750;-948
2017-02-02 16:00:00;45,98;48,77;-2,79;40375;902;0.0223;1136;-234;49908;9616;0.1927;10488;-872
2017-02-02 17:00:00;48,8;51,7;-2,9;40375;43;0.0011;25;18;49908;11981;0.24;12433;-452
2017-02-02 18:00:00;53,3;54,04;-0,74;40375;0;0;0;0;49908;13535;0.2712;14121;-586
2017-02-02 19:00:00;48,84;53,54;-4,7;40375;0;0;0;0;49908;13944;0.2794;15092;-1148
2017-02-02 20:00:00;39,97;51,27;-11,3;40375;0;0;0;0;49908;13691;0.2743;15194;-1503
2017-02-02 21:00:00;39,04;50,83;-11,79;40375;0;0;0;0;49908;13267;0.2658;15030;-1763
2017-02-02 22:00:00;38,78;49,81;-11,03;40375;0;0;0;0;49908;12350;0.2475;14867;-2517
2017-02-02 23:00:00;34,82;45,22;-10,4;40375;0;0;0;0;49908;11812;0.2367;14810;-2998
2017-03-02 00:00:00;39,5;46,56;-7,06;40379;0;0;0;0;49932;11032;0.221;13315;-2283
2017-03-02 01:00:00;34,92;41,3;-6,38;40379;0;0;0;0;49932;10496;0.2102;12962;-2466
2017-03-02 02:00:00;34,26;42,05;-7,79;40379;0;0;0;0;49932;10128;0.2028;12604;-2476
2017-03-02 03:00:00;32,55;36,0;-3,45;40379;0;0;0;0;49932;10015;0.2006;12232;-2217
2017-03-02 04:00:00;32,49;33,6;-1,11;40379;0;0;0;0;49932;9824;0.1967;11840;-2016
2017-03-02 05:00:00;35,85;36,27;-0,42;40379;0;0;0;0;49932;9200;0.1842;11451;-2251
2017-03-02 06:00:00;43,02;44,26;-1,24;40379;0;0;0;0;49932;8469;0.1696;11051;-2582
2017-03-02 07:00:00;56,32;58,23;-1,91;40379;10;0.0002;19;-9;49932;8308;0.1664;10559;-2251
2017-03-02 08:00:00;60,0;62,02;-2,02;40379;456;0.0113;624;-168;49932;7879;0.1578;9942;-2063
2017-03-02 09:00:00;58,0;61,27;-3,27;40379;1605;0.0398;2018;-413;49932;7487;0.15;9218;-1731
2017-03-02 10:00:00;56,67;60,41;-3,74;40379;2791;0.0691;3341;-550;49932;6668;0.1336;8113;-1445
2017-03-02 11:00:00;55,97;60,77;-4,8;40379;3785;0.0937;4205;-420;49932;5379;0.1078;6739;-1360
2017-03-02 12:00:00;54,37;60,89;-6,52;40379;4488;0.1112;4443;45;49932;4596;0.092;5610;-1014
2017-03-02 13:00:00;53,67;58,66;-4,99;40379;4548;0.1126;4097;451;49932;4566;0.0914;4814;-248
2017-03-02 14:00:00;51,96;51,66;0,3;40379;3494;0.0865;3209;285;49932;4444;0.089;4433;11
2017-03-02 15:00:00;48,47;46,27;2,2;40379;2152;0.0533;1964;188;49932;4135;0.0828;4358;-223
2017-03-02 16:00:00;53,33;48,73;4,6;40379;844;0.0209;613;231;49932;3944;0.079;4638;-694
2017-03-02 17:00:00;60,36;57,43;2,93;40379;50;0.0012;19;31;49932;4408;0.0883;5369;-961
2017-03-02 18:00:00;55,79;53,66;2,13;40379;0;0;0;0;49932;5647;0.1131;6283;-636
2017-03-02 19:00:00;59,29;50,17;9,12;40379;0;0;0;0;49932;7240;0.145;7185;55
2017-03-02 20:00:00;53,68;44,73;8,95;40379;0;0;0;0;49932;8536;0.171;8038;498
2017-03-02 21:00:00;44,9;41,07;3,83;40379;0;0;0;0;49932;10015;0.2006;8909;1106
2017-03-02 22:00:00;44,25;40,06;4,19;40379;0;0;0;0;49932;11293;0.2262;9661;1632
2017-03-02 23:00:00;36,08;34,04;2,04;40379;0;0;0;0;49932;12460;0.2496;10223;2237
2017-04-02 00:00:00;37,04;40,33;-3,29;40380;0;0;0;0;49932;12901;0.2584;12570;331
2017-04-02 01:00:00;34,96;33,99;0,97;40380;0;0;0;0;49932;13401;0.2684;13152;249
2017-04-02 02:00:00;34,01;33,17;0,84;40380;0;0;0;0;49932;14283;0.286;13505;778
2017-04-02 03:00:00;31,93;28,98;2,95;40380;0;0;0;0;49932;14553;0.2914;13725;828
2017-04-02 04:00:00;31,89;27,63;4,26;40380;0;0;0;0;49932;14119;0.2828;13595;524
2017-04-02 05:00:00;32,09;30,37;1,72;40380;0;0;0;0;49932;12866;0.2577;13054;-188
2017-04-02 06:00:00;33,82;33,22;0,6;40380;0;0;0;0;49932;11191;0.2241;12360;-1169
2017-04-02 07:00:00;37,04;40,66;-3,62;40380;18;0.0004;27;-9;49932;10189;0.204;11582;-1393
2017-04-02 08:00:00;42,32;48,64;-6,32;40380;1236;0.0306;1022;214;49932;10203;0.2043;10706;-503
2017-04-02 09:00:00;49,58;52,34;-2,76;40380;4531;0.1122;4106;425;49932;9519;0.1906;9746;-227
2017-04-02 10:00:00;51,97;49,24;2,73;40380;7667;0.1898;7348;319;49932;8104;0.1623;8433;-329
2017-04-02 11:00:00;50,0;44,39;5,61;40380;9496;0.2352;9355;141;49932;6193;0.124;6940;-747
2017-04-02 12:00:00;50,0;45,65;4,35;40380;9182;0.2274;9593;-411;49932;5194;0.104;5788;-594
2017-04-02 13:00:00;49,12;47,17;1,95;40380;7788;0.1929;8402;-614;49932;4363;0.0874;5108;-745
2017-04-02 14:00:00;47,22;48,04;-0,82;40380;5473;0.1356;6282;-809;49932;4032;0.0807;5126;-1094
2017-04-02 15:00:00;45,22;50,2;-4,98;40380;3009;0.0745;3684;-675;49932;4020;0.0805;5595;-1575
2017-04-02 16:00:00;46,26;51,36;-5,1;40380;821;0.0203;1083;-262;49932;4369;0.0875;6699;-2330
2017-04-02 17:00:00;56,37;60,85;-4,48;40380;36;0.0009;22;14;49932;5291;0.106;8483;-3192
2017-04-02 18:00:00;66,18;68,74;-2,56;40380;0;0;0;0;49932;5994;0.1201;10170;-4176
2017-04-02 19:00:00;61,61;62,84;-1,23;40380;0;0;0;0;49932;7152;0.1432;11088;-3936
2017-04-02 20:00:00;55,49;55,13;0,36;40380;0;0;0;0;49932;8309;0.1664;11168;-2859
2017-04-02 21:00:00;50,0;47,94;2,06;40380;0;0;0;0;49932;9279;0.1859;11125;-1846
2017-04-02 22:00:00;50,0;48,3;1,7;40380;0;0;0;0;49932;9631;0.1929;11065;-1434
2017-04-02 23:00:00;43,06;44,43;-1,37;40380;0;0;0;0;49932;9833;0.1969;11075;-1242
2017-05-02 00:00:00;35,81;42,6;-6,79;40380;0;0;0;0;49938;9365;0.1875;11679;-2314
2017-05-02 01:00:00;37,3;41,64;-4,34;40380;0;0;0;0;49938;8666;0.1736;11334;-2668
2017-05-02 02:00:00;37,73;38,62;-0,89;40380;0;0;0;0;49938;7798;0.1562;10819;-3021
2017-05-02 03:00:00;36,65;40,77;-4,12;40380;0;0;0;0;49938;6889;0.138;10252;-3363
2017-05-02 04:00:00;33,15;37,0;-3,85;40380;0;0;0;0;49938;6206;0.1243;9660;-3454
2017-05-02 05:00:00;34,55;37,91;-3,36;40380;0;0;0;0;49938;5433;0.1088;9111;-3678
2017-05-02 06:00:00;31,66;36,22;-4,56;40380;0;0;0;0;49938;5484;0.1098;8675;-3191
2017-05-02 07:00:00;36,93;40,73;-3,8;40380;30;0.0008;46;-16;49938;5540;0.111;8143;-2603
2017-05-02 08:00:00;37,52;38,97;-1,45;40380;1304;0.0323;1347;-43;49938;5784;0.1158;7515;-1731
2017-05-02 09:00:00;40,81;45,67;-4,86;40380;3940;0.0976;3817;123;49938;5619;0.1125;6908;-1289
2017-05-02 10:00:00;44,02;42,79;1,23;40380;6287;0.1557;6138;149;49938;5319;0.1065;6155;-836
2017-05-02 11:00:00;50,06;44,46;5,6;40380;7802;0.1932;7735;67;49938;4746;0.095;5323;-577
2017-05-02 12:00:00;46,05;42,91;3,14;40380;8010;0.1984;8141;-131;49938;4393;0.088;4595;-202
2017-05-02 13:00:00;41,45;39,86;1,59;40380;7659;0.1897;7384;275;49938;3847;0.077;3982;-135
2017-05-02 14:00:00;40,88;38,45;2,43;40380;6503;0.1611;5733;770;49938;3348;0.067;3556;-208
2017-05-02 15:00:00;39,97;36,25;3,72;40380;3681;0.0912;3459;222;49938;2983;0.0597;3344;-361
2017-05-02 16:00:00;40,81;39,13;1,68;40380;964;0.0239;1104;-140;49938;2957;0.0592;3425;-468
2017-05-02 17:00:00;48,24;50,15;-1,91;40380;36;0.0009;30;6;49938;3621;0.0725;3736;-115
2017-05-02 18:00:00;65,07;66,1;-1,03;40380;0;0;0;0;49938;4023;0.0806;4150;-127
2017-05-02 19:00:00;60,86;59,89;0,97;40380;0;0;0;0;49938;4092;0.082;4477;-385
2017-05-02 20:00:00;57,91;54,84;3,07;40380;0;0;0;0;49938;4244;0.085;4551;-307
2017-05-02 21:00:00;47,88;48,57;-0,69;40380;0;0;0;0;49938;4291;0.0859;4551;-260
2017-05-02 22:00:00;51,0;49,63;1,37;40380;0;0;0;0;49938;4349;0.0871;4498;-149
2017-05-02 23:00:00;48,0;44,1;3,9;40380;0;0;0;0;49938;4366;0.0874;4413;-47
2017-06-02 00:00:00;43,31;42,0;1,31;40383;0;0;0;0;49954;4334;0.0868;4412;-78
2017-06-02 01:00:00;41,4;37,3;4,1;40383;0;0;0;0;49954;4508;0.0902;4586;-78
2017-06-02 02:00:00;38,27;34,86;3,41;40383;0;0;0;0;49954;4876;0.0976;4959;-83
2017-06-02 03:00:00;35,1;32,46;2,64;40383;0;0;0;0;49954;5628;0.1127;5295;333
2017-06-02 04:00:00;36,3;32,92;3,38;40383;0;0;0;0;49954;6365;0.1274;5579;786
2017-06-02 05:00:00;39,5;36,09;3,41;40383;0;0;0;0;49954;6192;0.124;5789;403
2017-06-02 06:00:00;55,21;59,71;-4,5;40383;0;0;0;0;49954;6202;0.1241;5936;266
2017-06-02 07:00:00;74,95;74,29;0,66;40383;11;0.0002;23;-12;49954;6252;0.1252;5904;348
2017-06-02 08:00:00;82,06;85,57;-3,51;40383;542;0.0134;582;-40;49954;6062;0.1214;5705;357
2017-06-02 09:00:00;84,01;83,98;0,03;40383;1791;0.0444;1952;-161;49954;5576;0.1116;5496;80
2017-06-02 10:00:00;80,44;82,11;-1,67;40383;3181;0.0788;3414;-233;49954;5518;0.1104;5303;215
2017-06-02 11:00:00;79,61;80,45;-0,84;40383;4443;0.11;4511;-68;49954;5752;0.1151;5213;539
2017-06-02 12:00:00;80,37;75,45;4,92;40383;5155;0.1277;4847;308;49954;6093;0.122;5212;881
2017-06-02 13:00:00;77,75;70,75;7,0;40383;5307;0.1314;4498;809;49954;6337;0.1268;5329;1008
2017-06-02 14:00:00;72,93;66,58;6,35;40383;4470;0.1107;3532;938;49954;6073;0.1216;5555;518
2017-06-02 15:00:00;69,5;65,9;3,6;40383;2715;0.0672;2152;563;49954;6244;0.125;5868;376
2017-06-02 16:00:00;67,04;67,46;-0,42;40383;900;0.0223;719;181;49954;6458;0.1293;6317;141
2017-06-02 17:00:00;69,94;71,4;-1,46;40383;61;0.0015;37;24;49954;6715;0.1344;6938;-223
2017-06-02 18:00:00;86,37;81,54;4,83;40383;0;0;1;-1;49954;6748;0.1351;7581;-833
2017-06-02 19:00:00;77,29;75,32;1,97;40383;0;0;0;0;49954;6545;0.131;7960;-1415
2017-06-02 20:00:00;64,69;68,82;-4,13;40383;0;0;0;0;49954;6712;0.1344;8036;-1324
2017-06-02 21:00:00;44,63;54,19;-9,56;40383;0;0;0;0;49954;7431;0.1488;8051;-620
2017-06-02 22:00:00;43,27;54,68;-11,41;40383;0;0;0;0;49954;7646;0.1531;8022;-376
2017-06-02 23:00:00;38,93;47,16;-8,23;40383;0;0;0;0;49954;8015;0.1605;8072;-57
2017-07-02 00:00:00;42,01;44,25;-2,24;40386;0;0;0;0;49960;8171;0.1636;8156;15
2017-07-02 01:00:00;40,4;42,27;-1,87;40386;0;0;0;0;49960;8337;0.1669;8372;-35
2017-07-02 02:00:00;39,01;41,49;-2,48;40386;0;0;0;0;49960;8554;0.1712;8718;-164
2017-07-02 03:00:00;37,78;37,6;0,18;40386;0;0;0;0;49960;8280;0.1657;9051;-771
2017-07-02 04:00:00;38,03;37,64;0,39;40386;0;0;0;0;49960;8844;0.177;9407;-563
2017-07-02 05:00:00;38,09;42,09;-4,0;40386;0;0;0;0;49960;9646;0.1931;9755;-109
2017-07-02 06:00:00;46,82;44,47;2,35;40386;0;0;0;0;49960;10060;0.2014;10058;2
2017-07-02 07:00:00;64,9;53,38;11,52;40386;16;0.0004;33;-17;49960;10586;0.2119;10260;326
2017-07-02 08:00:00;63,0;49,95;13,05;40386;558;0.0138;762;-204;49960;10940;0.219;10342;598
2017-07-02 09:00:00;62,92;52,48;10,44;40386;1974;0.0489;2472;-498;49960;11138;0.2229;10418;720
2017-07-02 10:00:00;64,55;53,9;10,65;40386;3608;0.0893;4231;-623;49960;11077;0.2217;10510;567
2017-07-02 11:00:00;65,91;55,98;9,93;40386;5085;0.1259;5409;-324;49960;11567;0.2315;10630;937
2017-07-02 12:00:00;63,39;51,59;11,8;40386;5776;0.143;5667;109;49960;11465;0.2295;10718;747
2017-07-02 13:00:00;61,3;52,46;8,84;40386;5358;0.1326;5125;233;49960;11247;0.2251;10810;437
2017-07-02 14:00:00;60,49;53,37;7,12;40386;4062;0.1006;3947;115;49960;11264;0.2255;11004;260
2017-07-02 15:00:00;59,79;57,91;1,88;40386;2190;0.0542;2373;-183;49960;11498;0.2302;11282;216
2017-07-02 16:00:00;62,41;60,76;1,65;40386;608;0.015;774;-166;49960;11467;0.2295;11653;-186
2017-07-02 17:00:00;67,14;64,38;2,76;40386;36;0.0009;31;5;49960;11673;0.2337;12133;-460
2017-07-02 18:00:00;66,97;72,37;-5,4;40386;0;0;0;0;49960;12094;0.2421;12636;-542
2017-07-02 19:00:00;64,01;68,74;-4,73;40386;0;0;0;0;49960;12482;0.2498;12894;-412
2017-07-02 20:00:00;45,07;51,02;-5,95;40386;0;0;0;0;49960;12932;0.2588;12789;143
2017-07-02 21:00:00;43,1;46,5;-3,4;40386;0;0;0;0;49960;12874;0.2577;12565;309
2017-07-02 22:00:00;45,02;51,45;-6,43;40386;0;0;0;0;49960;12400;0.2482;12252;148
2017-07-02 23:00:00;39,89;41,69;-1,8;40386;0;0;0;0;49960;12034;0.2408;11916;118
2017-08-02 00:00:00;34,51;37,28;-2,77;40398;0;0;0;0;49972;12054;0.2412;11931;123
2017-08-02 01:00:00;34,59;37,13;-2,54;40398;0;0;0;0;49972;12288;0.2459;11683;605
2017-08-02 02:00:00;34,35;34,95;-0,6;40398;0;0;0;0;49972;12108;0.2423;11637;471
2017-08-02 03:00:00;33,73;31,55;2,18;40398;0;0;0;0;49972;12064;0.2414;11570;494
2017-08-02 04:00:00;35,06;33,15;1,91;40398;0;0;0;0;49972;11960;0.2393;11463;497
2017-08-02 05:00:00;35,9;34,28;1,62;40398;0;0;0;0;49972;12003;0.2402;11218;785
2017-08-02 06:00:00;50,07;43,01;7,06;40398;0;0;0;0;49972;12300;0.2461;10893;1407
2017-08-02 07:00:00;69,92;57,16;12,76;40398;14;0.0004;37;-23;49972;12420;0.2485;10508;1912
2017-08-02 08:00:00;71,1;54,85;16,25;40398;481;0.0119;753;-272;49972;11723;0.2346;10047;1676
2017-08-02 09:00:00;70,9;52,93;17,97;40398;1672;0.0414;2824;-1152;49972;10802;0.2162;9552;1250
2017-08-02 10:00:00;72,5;57,23;15,27;40398;3222;0.0798;5192;-1970;49972;9685;0.1938;8867;818
2017-08-02 11:00:00;71,49;65,16;6,33;40398;4787;0.1185;7003;-2216;49972;8924;0.1786;8042;882
2017-08-02 12:00:00;70,34;69,91;0,43;40398;5867;0.1452;7814;-1947;49972;7981;0.1597;7297;684
2017-08-02 13:00:00;66,94;69,53;-2,59;40398;5994;0.1484;7454;-1460;49972;7561;0.1513;6800;761
2017-08-02 14:00:00;67,43;66,35;1,08;40398;4926;0.1219;6026;-1100;49972;7307;0.1462;6735;572
2017-08-02 15:00:00;68,96;65,01;3,95;40398;2969;0.0735;3785;-816;49972;7308;0.1462;6863;445
2017-08-02 16:00:00;69,13;65,18;3,95;40398;1002;0.0248;1355;-353;49972;7468;0.1494;7186;282
2017-08-02 17:00:00;73,85;74,26;-0,41;40398;62;0.0015;61;1;49972;7678;0.1536;7659;19
2017-08-02 18:00:00;88,18;82,85;5,33;40398;0;0;0;0;49972;7989;0.1599;8082;-93
2017-08-02 19:00:00;84,04;70,67;13,37;40398;0;0;0;0;49972;7710;0.1542;8091;-381
2017-08-02 20:00:00;72,6;57,92;14,68;40398;0;0;0;0;49972;7207;0.1442;7533;-326
2017-08-02 21:00:00;62,5;53,95;8,55;40398;0;0;0;0;49972;6851;0.1371;6847;4
2017-08-02 22:00:00;47,98;50,62;-2,64;40398;0;0;0;0;49972;6493;0.1299;6195;298
2017-08-02 23:00:00;45,82;44,96;0,86;40398;0;0;0;0;49972;6099;0.122;5703;396
2017-09-02 00:00:00;48,1;48,99;-0,89;40402;0;0;0;0;49993;5754;0.1151;5236;518
2017-09-02 01:00:00;48,05;49,83;-1,78;40402;0;0;0;0;49993;5679;0.1136;4954;725
2017-09-02 02:00:00;44,96;44,85;0,11;40402;0;0;0;0;49993;5884;0.1177;4907;977
2017-09-02 03:00:00;42,5;41,49;1,01;40402;0;0;0;0;49993;6140;0.1228;4873;1267
2017-09-02 04:00:00;41,66;42,11;-0,45;40402;0;0;0;0;49993;6157;0.1231;4924;1233
2017-09-02 05:00:00;47,2;47,45;-0,25;40402;0;0;0;0;49993;6248;0.125;5038;1210
2017-09-02 06:00:00;54,58;49,41;5,17;40402;0;0;0;0;49993;6064;0.1213;5158;906
2017-09-02 07:00:00;74,14;68,59;5,55;40402;34;0.0008;67;-33;49993;6220;0.1244;5239;981
2017-09-02 08:00:00;70,0;70,96;-0,96;40402;1077;0.0266;1402;-325;49993;6332;0.1266;5182;1150
2017-09-02 09:00:00;72,79;76,24;-3,45;40402;3440;0.0852;4313;-873;49993;6162;0.1232;5080;1082
2017-09-02 10:00:00;70,97;72,49;-1,52;40402;5824;0.1442;7057;-1233;49993;6224;0.1245;4947;1277
2017-09-02 11:00:00;68,97;70,93;-1,96;40402;7378;0.1826;8734;-1356;49993;6286;0.1257;4853;1433
2017-09-02 12:00:00;66,91;73,33;-6,42;40402;8211;0.2032;9207;-996;49993;6494;0.1299;4843;1651
2017-09-02 13:00:00;65,64;72,06;-6,42;40402;8173;0.2023;8531;-358;49993;7296;0.1459;5137;2159
2017-09-02 14:00:00;65,0;69,75;-4,75;40402;6463;0.16;6797;-334;49993;8153;0.1631;5869;2284
2017-09-02 15:00:00;65,0;70,14;-5,14;40402;3566;0.0883;4257;-691;49993;9321;0.1864;6817;2504
2017-09-02 16:00:00;65,76;69,9;-4,14;40402;1048;0.0259;1583;-535;49993;10298;0.206;7939;2359
2017-09-02 17:00:00;70,43;74,03;-3,6;40402;64;0.0016;84;-20;49993;10738;0.2148;9195;1543
2017-09-02 18:00:00;72,91;73,93;-1,02;40402;0;0;0;0;49993;11574;0.2315;10363;1211
2017-09-02 19:00:00;64,54;69,45;-4,91;40402;0;0;0;0;49993;12412;0.2483;11025;1387
2017-09-02 20:00:00;50,09;57,32;-7,23;40402;0;0;0;0;49993;13065;0.2613;11055;2010
2017-09-02 21:00:00;39,48;49,69;-10,21;40402;0;0;0;0;49993;13260;0.2652;10796;2464
2017-09-02 22:00:00;42,1;53,06;-10,96;40402;0;0;0;0;49993;12771;0.2554;10400;2371
2017-09-02 23:00:00;38,35;42,96;-4,61;40402;0;0;0;0;49993;12620;0.2524;10072;2548
2017-10-02 00:00:00;36,67;40,63;-3,96;40410;0;0;0;0;50010;12140;0.2428;10994;1146
2017-10-02 01:00:00;34,31;38,35;-4,04;40410;0;0;0;0;50010;11920;0.2384;10909;1011
2017-10-02 02:00:00;33,46;38,26;-4,8;40410;0;0;0;0;50010;12302;0.246;11237;1065
2017-10-02 03:00:00;33,1;35,27;-2,17;40410;0;0;0;0;50010;12479;0.2495;11573;906
2017-10-02 04:00:00;32,55;36,06;-3,51;40410;0;0;0;0;50010;12564;0.2512;12015;549
2017-10-02 05:00:00;34,74;42,36;-7,62;40410;0;0;0;0;50010;12843;0.2568;12519;324
2017-10-02 06:00:00;39,17;38,94;0,23;40410;0;0;0;0;50010;13134;0.2626;12938;196
2017-10-02 07:00:00;57,0;55,29;1,71;40410;48;0.0012;82;-34;50010;12904;0.258;13010;-106
2017-10-02 08:00:00;63,08;58,29;4,79;40410;774;0.0192;1170;-396;50010;12379;0.2476;12700;-321
2017-10-02 09:00:00;63,09;63,18;-0,09;40410;2380;0.0589;3514;-1134;50010;12137;0.2427;12341;-204
2017-10-02 10:00:00;61,93;65,18;-3,25;40410;4039;0.0999;5962;-1923;50010;11742;0.2348;11944;-202
2017-10-02 11:00:00;59,04;64,1;-5,06;40410;5466;0.1352;7741;-2275;50010;10931;0.2186;11654;-723
2017-10-02 12:00:00;54,91;58,89;-3,98;40410;6184;0.153;8310;-2126;50010;10793;0.2158;11493;-700
2017-10-02 13:00:00;45,08;51,35;-6,27;40410;6023;0.1491;7780;-1757;50010;10761;0.2152;11637;-876
2017-10-02 14:00:00;42,02;50,13;-8,11;40410;5010;0.124;6236;-1226;50010;10912;0.2182;12217;-1305
2017-10-02 15:00:00;44,97;50,73;-5,76;40410;3006;0.0744;3936;-930;50010;11470;0.2294;12907;-1437
2017-10-02 16:00:00;49,07;55,91;-6,84;40410;910;0.0225;1468;-558;50010;11778;0.2356;13708;-1930
2017-10-02 17:00:00;52,73;62,2;-9,47;40410;60;0.0015;78;-18;50010;12561;0.2512;14619;-2058
2017-10-02 18:00:00;45,06;60,15;-15,09;40410;0;0;0;0;50010;13043;0.2608;15453;-2410
2017-10-02 19:00:00;46,2;56,9;-10,7;40410;0;0;0;0;50010;13483;0.2696;15638;-2155
2017-10-02 20:00:00;39,11;47,68;-8,57;40410;0;0;0;0;50010;13077;0.2615;14962;-1885
2017-10-02 21:00:00;37,08;45,03;-7,95;40410;0;0;0;0;50010;12185;0.2437;14071;-1886
2017-10-02 22:00:00;38,04;46,78;-8,74;40410;0;0;0;0;50010;11998;0.2399;13281;-1283
2017-10-02 23:00:00;34,21;42,27;-8,06;40410;0;0;0;0;50010;11816;0.2363;12729;-913
2017-11-02 00:00:00;39,0;47,85;-8,85;40410;0;0;0;0;50012;11745;0.2348;11906;-161
2017-11-02 01:00:00;36,69;43,47;-6,78;40410;0;0;0;0;50012;11846;0.2368;11862;-16
2017-11-02 02:00:00;35,05;40,69;-5,64;40410;0;0;0;0;50012;11707;0.2341;11981;-274
2017-11-02 03:00:00;36,61;40,95;-4,34;40410;0;0;0;0;50012;11558;0.2311;12036;-478
2017-11-02 04:00:00;32,9;41,47;-8,57;40410;0;0;0;0;50012;12030;0.2406;12125;-95
2017-11-02 05:00:00;37,5;45,15;-7,65;40410;0;0;0;0;50012;12174;0.2434;12201;-27
2017-11-02 06:00:00;33,0;41,75;-8,75;40410;0;0;0;0;50012;12251;0.245;12234;17
2017-11-02 07:00:00;44,15;52,79;-8,64;40410;49;0.0012;89;-40;50012;12396;0.2479;12073;323
2017-11-02 08:00:00;48,48;53,18;-4,7;40410;1276;0.0316;1460;-184;50012;12718;0.2543;11685;1033
2017-11-02 09:00:00;50,78;55,26;-4,48;40410;3929;0.0972;3969;-40;50012;12872;0.2573;11267;1605
2017-11-02 10:00:00;49,57;51,55;-1,98;40410;6889;0.1705;6415;474;50012;12874;0.2574;10986;1888
2017-11-02 11:00:00;44,0;45,41;-1,41;40410;9086;0.2248;8290;796;50012;12623;0.2524;10934;1689
2017-11-02 12:00:00;37,93;38,14;-0,21;40410;10200;0.2524;9141;1059;50012;12314;0.2462;10993;1321
2017-11-02 13:00:00;35,08;39,23;-4,15;40410;9898;0.2449;8704;1194;50012;12590;0.2518;11278;1312
2017-11-02 14:00:00;34,0;41,15;-7,15;40410;8218;0.2034;7007;1211;50012;13089;0.2617;11918;1171
2017-11-02 15:00:00;34,1;41,48;-7,38;40410;5080;0.1257;4430;650;50012;13912;0.2782;12692;1220
2017-11-02 16:00:00;35,09;42,68;-7,59;40410;1687;0.0418;1706;-19;50012;14791;0.2957;13770;1021
2017-11-02 17:00:00;41,56;56,43;-14,87;40410;81;0.002;103;-22;50012;15667;0.3133;15069;598
2017-11-02 18:00:00;43,01;63,15;-20,14;40410;0;0;0;0;50012;16667;0.3333;16190;477
2017-11-02 19:00:00;40,86;63,21;-22,35;40410;0;0;0;0;50012;16835;0.3366;16628;207
2017-11-02 20:00:00;36,09;48,69;-12,6;40410;0;0;0;0;50012;16503;0.33;16235;268
2017-11-02 21:00:00;33,93;48,22;-14,29;40410;0;0;0;0;50012;16445;0.3288;15618;827
2017-11-02 22:00:00;33,92;44,0;-10,08;40410;0;0;0;0;50012;15517;0.3102;15023;494
2017-11-02 23:00:00;31,86;35,55;-3,69;40410;0;0;0;0;50012;15068;0.3013;14536;532
2017-12-02 00:00:00;31,43;39,32;-7,89;40411;0;0;0;0;50012;15204;0.304;15308;-104
2017-12-02 01:00:00;31,06;36,51;-5,45;40411;0;0;0;0;50012;15608;0.3121;15241;367
2017-12-02 02:00:00;31,15;37,0;-5,85;40411;0;0;0;0;50012;15586;0.3116;15392;194
2017-12-02 03:00:00;31,08;36,97;-5,89;40411;0;0;0;0;50012;15523;0.3104;15445;78
2017-12-02 04:00:00;29,78;33,38;-3,6;40411;0;0;0;0;50012;15261;0.3051;15505;-244
2017-12-02 05:00:00;29,88;33,1;-3,22;40411;0;0;0;0;50012;14712;0.2942;15591;-879
2017-12-02 06:00:00;30,36;33,08;-2,72;40411;0;0;0;0;50012;14569;0.2913;15614;-1045
2017-12-02 07:00:00;30,36;35,48;-5,12;40411;31;0.0008;87;-56;50012;14348;0.2869;15397;-1049
2017-12-02 08:00:00;32,33;40,66;-8,33;40411;687;0.017;1180;-493;50012;14112;0.2822;14854;-742
2017-12-02 09:00:00;33,21;46,45;-13,24;40411;2198;0.0544;3670;-1472;50012;13882;0.2776;14288;-406
2017-12-02 10:00:00;34,26;54,95;-20,69;40411;3967;0.0982;6417;-2450;50012;13434;0.2686;13683;-249
2017-12-02 11:00:00;35,03;54,26;-19,23;40411;5654;0.1399;8682;-3028;50012;13062;0.2612;13090;-28
2017-12-02 12:00:00;31,4;40,65;-9,25;40411;6672;0.1651;9881;-3209;50012;12839;0.2567;12669;170
2017-12-02 13:00:00;30,89;37,93;-7,04;40411;6898;0.1707;9751;-2853;50012;12964;0.2592;12567;397
2017-12-02 14:00:00;30,02;35,97;-5,95;40411;6024;0.1491;8243;-2219;50012;13270;0.2653;12977;293
2017-12-02 15:00:00;30,81;35,65;-4,84;40411;3940;0.0975;5477;-1537;50012;14040;0.2808;13606;434
2017-12-02 16:00:00;32,19;35,1;-2,91;40411;1465;0.0363;2217;-752;50012;14365;0.2872;14655;-290
2017-12-02 17:00:00;36,0;41,68;-5,68;40411;131;0.0032;147;-16;50012;15025;0.3004;16149;-1124
2017-12-02 18:00:00;42,59;50,3;-7,71;40411;0;0;0;0;50012;15870;0.3174;17452;-1582
2017-12-02 19:00:00;41,1;47,61;-6,51;40411;0;0;0;0;50012;16247;0.3249;17808;-1561
2017-12-02 20:00:00;40,44;47,82;-7,38;40411;0;0;0;0;50012;16145;0.3228;16911;-766
2017-12-02 21:00:00;32,63;38,43;-5,8;40411;0;0;0;0;50012;15960;0.3191;15773;187
2017-12-02 22:00:00;34,9;38,63;-3,73;40411;0;0;0;0;50012;15073;0.3014;14726;347
2017-12-02 23:00:00;32,12;35,25;-3,13;40411;0;0;0;0;50012;14440;0.2887;14007;433
2017-02-13 00:00:00;28,83;31,73;-2,9;40413;0;0;0;0;50024;13936;0.2786;13746;190
2017-02-13 01:00:00;29,68;31,91;-2,23;40413;0;0;0;0;50024;13608;0.272;13300;308
2017-02-13 02:00:00;31,12;30,64;0,48;40413;0;0;0;0;50024;13623;0.2723;13141;482
2017-02-13 03:00:00;29,85;28,98;0,87;40413;0;0;0;0;50024;13944;0.2787;13040;904
2017-02-13 04:00:00;30,76;26,6;4,16;40413;0;0;0;0;50024;14168;0.2832;13078;1090
2017-02-13 05:00:00;33,01;28,97;4,04;40413;0;0;0;0;50024;14222;0.2843;13213;1009
2017-02-13 06:00:00;39,77;34,7;5,07;40413;0;0;0;0;50024;14292;0.2857;13263;1029
2017-02-13 07:00:00;56,98;44,76;12,22;40413;96;0.0024;132;-36;50024;14393;0.2877;13042;1351
2017-02-13 08:00:00;59,13;51,96;7,17;40413;1886;0.0467;2021;-135;50024;14218;0.2842;12488;1730
2017-02-13 09:00:00;57,9;47,0;10,9;40413;5670;0.1403;5624;46;50024;13057;0.261;11862;1195
2017-02-13 10:00:00;53,97;43,22;10,75;40413;10232;0.2532;9508;724;50024;12166;0.2432;11335;831
2017-02-13 11:00:00;45,2;37,51;7,69;40413;13882;0.3435;12679;1203;50024;11606;0.232;11081;525
2017-02-13 12:00:00;37,24;34,06;3,18;40413;15764;0.39;14430;1334;50024;11002;0.2199;10948;54
2017-02-13 13:00:00;35,06;33,31;1,75;40413;15820;0.3915;14373;1447;50024;10890;0.2177;10965;-75
2017-02-13 14:00:00;38,23;37,01;1,22;40413;13440;0.3326;12302;1138;50024;10955;0.219;11325;-370
2017-02-13 15:00:00;43,52;42,27;1,25;40413;9052;0.224;8283;769;50024;11155;0.223;11868;-713
2017-02-13 16:00:00;49,17;45,67;3,5;40413;3494;0.0864;3470;24;50024;12318;0.2463;12927;-609
2017-02-13 17:00:00;53,84;49,95;3,89;40413;246;0.0061;237;9;50024;15682;0.3135;14695;987
2017-02-13 18:00:00;56,25;49,52;6,73;40413;0;0;0;0;50024;18176;0.3634;16458;1718
2017-02-13 19:00:00;50,08;40,11;9,97;40413;0;0;0;0;50024;18605;0.372;17168;1437
2017-02-13 20:00:00;44,94;38,57;6,37;40413;0;0;0;0;50024;17772;0.3553;16610;1162
2017-02-13 21:00:00;38,14;37,51;0,63;40413;0;0;0;0;50024;17250;0.3448;15707;1543
2017-02-13 22:00:00;39,77;34,66;5,11;40413;0;0;0;0;50024;15987;0.3196;14728;1259
2017-02-13 23:00:00;33,57;30,68;2,89;40413;0;0;0;0;50024;14765;0.2952;13722;1043
2017-02-14 00:00:00;32,35;27,2;5,15;40418;0;0;0;0;50027;14332;0.2865;13147;1185
2017-02-14 01:00:00;31,68;23,65;8,03;40418;0;0;0;0;50027;13296;0.2658;12474;822
2017-02-14 02:00:00;32,11;26,22;5,89;40418;0;0;0;0;50027;12374;0.2473;11991;383
2017-02-14 03:00:00;32,56;30,01;2,55;40418;0;0;0;0;50027;12030;0.2404;11555;475
2017-02-14 04:00:00;33,34;34,04;-0,7;40418;0;0;0;0;50027;11858;0.237;11340;518
2017-02-14 05:00:00;32,84;33,49;-0,65;40418;0;0;0;0;50027;11807;0.236;11347;460
2017-02-14 06:00:00;42,09;36,16;5,93;40418;0;0;0;0;50027;11867;0.2372;11307;560
2017-02-14 07:00:00;47,98;49,12;-1,14;40418;197;0.0048;284;-87;50027;11859;0.2371;10950;909
2017-02-14 08:00:00;50,63;52,79;-2,16;40418;3062;0.0758;3460;-398;50027;11042;0.2207;10111;931
2017-02-14 09:00:00;46,89;43,3;3,59;40418;8282;0.2049;8681;-399;50027;9108;0.1821;9033;75
2017-02-14 10:00:00;38,39;40,32;-1,93;40418;13672;0.3382;13323;349;50027;7272;0.1454;7889;-617
2017-02-14 11:00:00;36,64;36,42;0,22;40418;17406;0.4307;16402;1004;50027;6214;0.1242;6883;-669
2017-02-14 12:00:00;35,86;35,01;0,85;40418;19114;0.4729;17495;1619;50027;5138;0.1027;6042;-904
2017-02-14 13:00:00;38,33;37,25;1,08;40418;18356;0.4542;16656;1700;50027;4835;0.0967;5559;-724
2017-02-14 14:00:00;37,31;36,54;0,77;40418;15462;0.3826;13904;1558;50027;4744;0.0948;5555;-811
2017-02-14 15:00:00;41,88;37,2;4,68;40418;10362;0.2564;9456;906;50027;4678;0.0935;5926;-1248
2017-02-14 16:00:00;54,4;43,14;11,26;40418;4061;0.1004;4122;-61;50027;4868;0.0973;6864;-1996
2017-02-14 17:00:00;61,03;53,24;7,79;40418;314;0.0078;312;2;50027;6152;0.123;8472;-2320
2017-02-14 18:00:00;66,22;56,82;9,4;40418;0;0;0;0;50027;7844;0.1568;10005;-2161
2017-02-14 19:00:00;57,97;52,86;5,11;40418;0;0;0;0;50027;9095;0.1818;10501;-1406
2017-02-14 20:00:00;54,68;41,14;13,54;40418;0;0;0;0;50027;9246;0.1848;9823;-577
2017-02-14 21:00:00;42,26;39,13;3,13;40418;0;0;0;0;50027;8800;0.1759;8939;-139
2017-02-14 22:00:00;43,47;38,0;5,47;40418;0;0;0;0;50027;7902;0.1579;7952;-50
2017-02-14 23:00:00;40,64;35,27;5,37;40418;0;0;0;0;50027;6837;0.1366;6963;-126
2017-02-15 00:00:00;37,39;34,68;2,71;40427;0;0;0;0;50038;6223;0.1244;5749;474
2017-02-15 01:00:00;38,18;32,12;6,06;40427;0;0;0;0;50038;5354;0.107;4993;361
2017-02-15 02:00:00;37,13;31,4;5,73;40427;0;0;0;0;50038;4715;0.0942;4374;341
2017-02-15 03:00:00;35,72;34,5;1,22;40427;0;0;0;0;50038;4079;0.0815;3837;242
2017-02-15 04:00:00;36,51;39,15;-2,64;40427;0;0;0;0;50038;3500;0.07;3523;-23
2017-02-15 05:00:00;37,87;42,84;-4,97;40427;0;0;0;0;50038;3083;0.0616;3434;-351
2017-02-15 06:00:00;48,2;42,48;5,72;40427;0;0;0;0;50038;2923;0.0584;3378;-455
2017-02-15 07:00:00;61,48;59,24;2,24;40427;216;0.0054;283;-67;50038;3048;0.0609;3178;-130
2017-02-15 08:00:00;63,32;59,62;3,7;40427;3441;0.0851;3455;-14;50038;2999;0.06;2816;183
2017-02-15 09:00:00;60,76;52,7;8,06;40427;9482;0.2346;8609;873;50038;2564;0.0512;2406;158
2017-02-15 10:00:00;55,69;42,0;13,69;40427;15047;0.3722;13306;1741;50038;1732;0.0346;1871;-139
2017-02-15 11:00:00;39,66;34,22;5,44;40427;18361;0.4542;16470;1891;50038;1137;0.0228;1348;-211
2017-02-15 12:00:00;37,35;34,4;2,95;40427;19457;0.4813;17615;1842;50038;822;0.0164;978;-156
2017-02-15 13:00:00;38,08;35,41;2,67;40427;18388;0.4548;16755;1633;50038;857;0.0172;824;33
2017-02-15 14:00:00;45,22;38,04;7,18;40427;15227;0.3766;13896;1331;50038;834;0.0167;875;-41
2017-02-15 15:00:00;50,85;41,32;9,53;40427;10070;0.2491;9400;670;50038;1035;0.0207;1065;-30
2017-02-15 16:00:00;54,43;47,23;7,2;40427;3894;0.0963;4094;-200;50038;1544;0.0308;1589;-45
2017-02-15 17:00:00;59,16;49,9;9,26;40427;322;0.008;343;-21;50038;2590;0.0518;2630;-40
2017-02-15 18:00:00;64,48;52,91;11,57;40427;0;0;0;0;50038;4090;0.0817;3950;140
2017-02-15 19:00:00;63,07;51,13;11,94;40427;0;0;0;0;50038;5536;0.1106;5269;267
2017-02-15 20:00:00;54,77;46,08;8,69;40427;0;0;0;0;50038;6962;0.1391;6359;603
2017-02-15 21:00:00;44,92;40,84;4,08;40427;0;0;0;0;50038;8384;0.1675;7458;926
2017-02-15 22:00:00;37,98;44,95;-6,97;40427;0;0;0;0;50038;9670;0.1933;8417;1253
2017-02-15 23:00:00;33,47;34,98;-1,51;40427;0;0;0;0;50038;10483;0.2095;9100;1383
2017-02-16 00:00:00;33,27;33,1;0,17;40431;0;0;0;0;50062;10938;0.2185;11434;-496
2017-02-16 01:00:00;34,93;35,5;-0,57;40431;0;0;0;0;50062;11499;0.2297;11616;-117
2017-02-16 02:00:00;32,09;29,91;2,18;40431;0;0;0;0;50062;11973;0.2392;11856;117
2017-02-16 03:00:00;32,0;31,05;0,95;40431;0;0;0;0;50062;12348;0.2467;12013;335
2017-02-16 04:00:00;32,06;33,16;-1,1;40431;0;0;0;0;50062;12253;0.2448;12071;182
2017-02-16 05:00:00;33,28;33,11;0,17;40431;0;0;0;0;50062;12303;0.2458;12056;247
2017-02-16 06:00:00;38,01;36,01;2,0;40431;0;0;0;0;50062;13048;0.2606;12035;1013
2017-02-16 07:00:00;50,99;47,94;3,05;40431;254;0.0063;271;-17;50062;13588;0.2714;11919;1669
2017-02-16 08:00:00;50,31;45,66;4,65;40431;3322;0.0822;2935;387;50062;13106;0.2618;11695;1411
2017-02-16 09:00:00;43,72;35,09;8,63;40431;8278;0.2047;6866;1412;50062;12530;0.2503;11434;1096
2017-02-16 10:00:00;38,0;31,98;6,02;40431;12595;0.3115;10158;2437;50062;10755;0.2148;11042;-287
2017-02-16 11:00:00;37,09;32,72;4,37;40431;15050;0.3723;12124;2926;50062;9468;0.1891;10503;-1035
2017-02-16 12:00:00;37,91;32,94;4,97;40431;15786;0.3904;12419;3367;50062;9474;0.1892;10186;-712
2017-02-16 13:00:00;37,19;33,04;4,15;40431;14567;0.3603;11424;3143;50062;9676;0.1933;9929;-253
2017-02-16 14:00:00;38,05;33,69;4,36;40431;11592;0.2867;9328;2264;50062;9900;0.1978;9713;187
2017-02-16 15:00:00;43,79;39,83;3,96;40431;7699;0.1904;6209;1490;50062;10054;0.2009;9609;445
2017-02-16 16:00:00;50,82;43,01;7,81;40431;3051;0.0755;2666;385;50062;10022;0.2002;9815;207
2017-02-16 17:00:00;53,3;49,68;3,62;40431;234;0.0058;248;-14;50062;10413;0.208;10453;-40
2017-02-16 18:00:00;54,98;51,4;3,58;40431;0;0;0;0;50062;11184;0.2234;11332;-148
2017-02-16 19:00:00;50,92;51,13;-0,21;40431;0;0;0;0;50062;12118;0.242;12160;-42
2017-02-16 20:00:00;42,06;44,35;-2,29;40431;0;0;0;0;50062;12966;0.259;12802;164
2017-02-16 21:00:00;38,95;43,08;-4,13;40431;0;0;0;0;50062;13098;0.2616;13400;-302
2017-02-16 22:00:00;37,98;43,16;-5,18;40431;0;0;0;0;50062;13486;0.2694;13818;-332
2017-02-16 23:00:00;33,3;38,82;-5,52;40431;0;0;0;0;50062;13640;0.2724;14050;-410
2017-02-17 00:00:00;32,52;34,86;-2,34;40445;0;0;0;0;50090;13502;0.2696;13477;25
2017-02-17 01:00:00;31,69;32,35;-0,66;40445;0;0;0;0;50090;13671;0.2729;13640;31
2017-02-17 02:00:00;31,13;32,48;-1,35;40445;0;0;0;0;50090;13819;0.2758;13910;-91
2017-02-17 03:00:00;31,35;30,16;1,19;40445;0;0;0;0;50090;14398;0.2874;14192;206
2017-02-17 04:00:00;31,69;30,49;1,2;40445;0;0;0;0;50090;13933;0.2782;14403;-470
2017-02-17 05:00:00;32,5;32,22;0,28;40445;0;0;0;0;50090;13696;0.2734;14467;-771
2017-02-17 06:00:00;36,96;43,46;-6,5;40445;0;0;0;0;50090;13265;0.2648;14449;-1184
2017-02-17 07:00:00;47,95;49,02;-1,07;40445;69;0.0017;87;-18;50090;12728;0.2541;14197;-1469
2017-02-17 08:00:00;45,01;49,85;-4,84;40445;967;0.0239;852;115;50090;11982;0.2392;13702;-1720
2017-02-17 09:00:00;44,05;50,12;-6,07;40445;2880;0.0712;2032;848;50090;11165;0.2229;13308;-2143
2017-02-17 10:00:00;48,98;50,67;-1,69;40445;4519;0.1117;3145;1374;50090;10449;0.2086;13064;-2615
2017-02-17 11:00:00;49,9;49,69;0,21;40445;5474;0.1353;3915;1559;50090;10175;0.2031;12982;-2807
2017-02-17 12:00:00;48,98;50,29;-1,31;40445;5405;0.1336;4181;1224;50090;9974;0.1992;12915;-2941
2017-02-17 13:00:00;40,0;48,27;-8,27;40445;4703;0.1163;4048;655;50090;9802;0.1957;12556;-2754
2017-02-17 14:00:00;42,92;52,77;-9,85;40445;3710;0.0917;3561;149;50090;9592;0.1915;11793;-2201
2017-02-17 15:00:00;48,53;50,0;-1,47;40445;2510;0.062;2483;27;50090;9546;0.1906;10946;-1400
2017-02-17 16:00:00;48,81;49,7;-0,89;40445;1096;0.0271;1125;-29;50090;9460;0.1889;10143;-683
2017-02-17 17:00:00;50,92;51,71;-0,79;40445;116;0.0028;129;-13;50090;9286;0.1854;9432;-146
2017-02-17 18:00:00;53,04;51,98;1,06;40445;0;0;0;0;50090;9132;0.1823;8855;277
2017-02-17 19:00:00;51,14;50,28;0,86;40445;0;0;0;0;50090;8708;0.1738;8145;563
2017-02-17 20:00:00;49,77;42,71;7,06;40445;0;0;0;0;50090;8605;0.1718;7306;1299
2017-02-17 21:00:00;49,52;42,43;7,09;40445;0;0;0;0;50090;8724;0.1742;6578;2146
2017-02-17 22:00:00;46,34;41,2;5,14;40445;0;0;0;0;50090;8056;0.1608;5952;2104
2017-02-17 23:00:00;38,82;36,49;2,33;40445;0;0;0;0;50090;7862;0.157;5450;2412
2017-02-18 00:00:00;35,1;33,1;2,0;40445;0;0;0;0;50102;7260;0.1449;6302;958
2017-02-18 01:00:00;33,09;32,18;0,91;40445;0;0;0;0;50102;6596;0.1317;5957;639
2017-02-18 02:00:00;35,08;31,5;3,58;40445;0;0;0;0;50102;6195;0.1236;5798;397
2017-02-18 03:00:00;34,3;31,99;2,31;40445;0;0;0;0;50102;6106;0.1219;5582;524
2017-02-18 04:00:00;34,3;31,98;2,32;40445;0;0;0;0;50102;5909;0.118;5217;692
2017-02-18 05:00:00;35,36;31,58;3,78;40445;0;0;0;0;50102;5404;0.1078;4699;705
2017-02-18 06:00:00;38,81;29,84;8,97;40445;0;0;0;0;50102;4745;0.0947;4195;550
2017-02-18 07:00:00;42,08;33,53;8,55;40445;64;0.0016;104;-40;50102;4187;0.0836;3692;495
2017-02-18 08:00:00;46,81;37,8;9,01;40445;738;0.0182;1078;-340;50102;3776;0.0754;3283;493
2017-02-18 09:00:00;50,0;41,53;8,47;40445;2064;0.0511;2792;-728;50102;3616;0.0722;3043;573
2017-02-18 10:00:00;49,85;44,38;5,47;40445;3838;0.0949;4694;-856;50102;3792;0.0757;3023;769
2017-02-18 11:00:00;48,24;43,74;4,5;40445;5588;0.1382;6135;-547;50102;4354;0.0869;3436;918
2017-02-18 12:00:00;42,25;39,24;3,01;40445;6360;0.1573;6799;-439;50102;5087;0.1015;4053;1034
2017-02-18 13:00:00;36,64;35,97;0,67;40445;6020;0.1488;6675;-655;50102;5544;0.1107;4666;878
2017-02-18 14:00:00;35,64;33,56;2,08;40445;4806;0.1188;5810;-1004;50102;5460;0.109;5116;344
2017-02-18 15:00:00;37,35;36,05;1,3;40445;3316;0.082;4284;-968;50102;5480;0.1094;5448;32
2017-02-18 16:00:00;42,04;37,83;4,21;40445;1530;0.0378;2103;-573;50102;5488;0.1095;5764;-276
2017-02-18 17:00:00;47,94;41,78;6,16;40445;192;0.0047;252;-60;50102;5719;0.1141;6227;-508
2017-02-18 18:00:00;53,94;43,37;10,57;40445;0;0;1;-1;50102;6424;0.1282;6854;-430
2017-02-18 19:00:00;48,46;35,62;12,84;40445;0;0;0;0;50102;7768;0.1551;7635;133
2017-02-18 20:00:00;39,01;33,18;5,83;40445;0;0;0;0;50102;9173;0.1831;8450;723
2017-02-18 21:00:00;35,0;30,71;4,29;40445;0;0;0;0;50102;10504;0.2096;9258;1246
2017-02-18 22:00:00;33,03;29,07;3,96;40445;0;0;0;0;50102;11892;0.2374;9988;1904
2017-02-18 23:00:00;30,29;24,15;6,14;40445;0;0;0;0;50102;12986;0.2592;10664;2322
2017-02-19 00:00:00;30,81;19,69;11,12;40446;0;0;0;0;50102;13958;0.2786;12298;1660
2017-02-19 01:00:00;21,68;12,14;9,54;40446;0;0;0;0;50102;14584;0.2911;13079;1505
2017-02-19 02:00:00;12,44;9,26;3,18;40446;0;0;0;0;50102;15469;0.3088;13872;1597
2017-02-19 03:00:00;9,93;8,7;1,23;40446;0;0;0;0;50102;16560;0.3305;14633;1927
2017-02-19 04:00:00;9,53;9,27;0,26;40446;0;0;0;0;50102;17038;0.34;15247;1791
2017-02-19 05:00:00;10,13;8,59;1,54;40446;0;0;0;0;50102;17234;0.344;15673;1561
2017-02-19 06:00:00;10,3;8,27;2,03;40446;0;0;1;-1;50102;18244;0.3642;16015;2229
2017-02-19 07:00:00;18,12;10,51;7,61;40446;245;0.0061;221;24;50102;18641;0.3721;15991;2650
2017-02-19 08:00:00;25,47;5,92;19,55;40446;2604;0.0644;2090;514;50102;18110;0.3615;15453;2657
2017-02-19 09:00:00;29,59;11,86;17,73;40446;6257;0.1547;5006;1251;50102;16768;0.3346;14855;1913
2017-02-19 10:00:00;29,82;10,49;19,33;40446;8833;0.2184;7667;1166;50102;15583;0.311;14428;1155
2017-02-19 11:00:00;32,09;18,89;13,2;40446;10168;0.2514;9338;830;50102;14058;0.2806;14037;21
2017-02-19 12:00:00;30,17;22,1;8,07;40446;9794;0.2422;9677;117;50102;13056;0.2606;13540;-484
2017-02-19 13:00:00;31,07;27,03;4,04;40446;8661;0.2141;8882;-221;50102;12617;0.2518;13013;-396
2017-02-19 14:00:00;31,41;26,74;4,67;40446;6332;0.1566;7110;-778;50102;12492;0.2493;12562;-70
2017-02-19 15:00:00;30,34;27,18;3,16;40446;3754;0.0928;4650;-896;50102;12734;0.2542;12252;482
2017-02-19 16:00:00;31,99;28,6;3,39;40446;1578;0.039;2030;-452;50102;12771;0.2549;12208;563
2017-02-19 17:00:00;41,37;31,1;10,27;40446;192;0.0048;241;-49;50102;12471;0.2489;12441;30
2017-02-19 18:00:00;53,65;38,01;15,64;40446;2;0;0;2;50102;12448;0.2485;12751;-303
2017-02-19 19:00:00;52,8;43,55;9,25;40446;0;0;0;0;50102;12531;0.2501;12997;-466
2017-02-19 20:00:00;39,28;33,02;6,26;40446;0;0;0;0;50102;12834;0.2562;13256;-422
2017-02-19 21:00:00;33,95;32,75;1,2;40446;0;0;0;0;50102;12440;0.2483;13453;-1013
2017-02-19 22:00:00;35,05;34,74;0,31;40446;0;0;0;0;50102;12530;0.2501;13738;-1208
2017-02-19 23:00:00;31,01;31,83;-0,82;40446;0;0;0;0;50102;13201;0.2635;14344;-1143
2017-02-20 00:00:00;30,75;33,11;-2,36;40453;0;0;0;0;50123;14101;0.2813;14479;-378
2017-02-20 01:00:00;27,22;31,87;-4,65;40453;0;0;0;0;50123;15141;0.3021;15302;-161
2017-02-20 02:00:00;26,5;27,36;-0,86;40453;0;0;0;0;50123;16066;0.3205;16321;-255
2017-02-20 03:00:00;25,04;23,32;1,72;40453;0;0;0;0;50123;16804;0.3352;17332;-528
2017-02-20 04:00:00;20,95;23,07;-2,12;40453;0;0;0;0;50123;16956;0.3382;18510;-1554
2017-02-20 05:00:00;21,93;28,29;-6,36;40453;0;0;0;0;50123;18294;0.365;19971;-1677
2017-02-20 06:00:00;38,49;37,55;0,94;40453;0;0;0;0;50123;20083;0.4007;21554;-1471
2017-02-20 07:00:00;48,35;41,04;7,31;40453;87;0.0022;111;-24;50123;21829;0.4355;22981;-1152
2017-02-20 08:00:00;45,82;40,16;5,66;40453;966;0.0239;894;72;50123;23448;0.4678;24249;-801
2017-02-20 09:00:00;38,92;37,99;0,93;40453;2709;0.067;2082;627;50123;25095;0.5007;25492;-397
2017-02-20 10:00:00;37,92;36,21;1,71;40453;4604;0.1138;3147;1457;50123;27010;0.5389;26634;376
2017-02-20 11:00:00;39,38;32,58;6,8;40453;6043;0.1494;3856;2187;50123;29076;0.5801;27685;1391
2017-02-20 12:00:00;39,18;28,86;10,32;40453;6179;0.1528;3943;2236;50123;30490;0.6083;28560;1930
2017-02-20 13:00:00;36,08;27,34;8,74;40453;4988;0.1234;3511;1477;50123;31368;0.6258;29240;2128
2017-02-20 14:00:00;33,03;27,87;5,16;40453;3302;0.0816;2686;616;50123;31846;0.6354;29669;2177
2017-02-20 15:00:00;31,87;30,76;1,11;40453;2014;0.0498;1697;317;50123;32439;0.6472;30088;2351
2017-02-20 16:00:00;31,63;31,18;0,45;40453;783;0.0193;712;71;50123;32871;0.6558;30521;2350
2017-02-20 17:00:00;34,92;34,69;0,23;40453;91;0.0023;96;-5;50123;33285;0.664;30933;2352
2017-02-20 18:00:00;37,94;35,48;2,46;40453;2;0;0;2;50123;33672;0.6718;31341;2331
2017-02-20 19:00:00;34,27;33,82;0,45;40453;0;0;0;0;50123;33964;0.6776;31591;2373
2017-02-20 20:00:00;29,92;27,28;2,64;40453;0;0;0;0;50123;33866;0.6757;31603;2263
2017-02-20 21:00:00;19,22;19,99;-0,77;40453;0;0;0;0;50123;32998;0.6584;31453;1545
2017-02-20 22:00:00;9,94;16,09;-6,15;40453;0;0;0;0;50123;31830;0.635;30997;833
2017-02-20 23:00:00;9,48;15,16;-5,68;40453;0;0;0;0;50123;30714;0.6127;30237;477
2017-02-21 00:00:00;12,54;11,55;0,99;40468;0;0;0;0;50133;29662;0.5917;28575;1087
2017-02-21 01:00:00;10,19;8,44;1,75;40468;0;0;0;0;50133;28559;0.5697;27726;833
2017-02-21 02:00:00;10,06;5,62;4,44;40468;0;0;0;0;50133;27471;0.548;27056;415
2017-02-21 03:00:00;11,12;5,57;5,55;40468;0;0;0;0;50133;26747;0.5336;26373;374
2017-02-21 04:00:00;12,56;8,23;4,33;40468;0;0;0;0;50133;26271;0.524;25799;472
2017-02-21 05:00:00;25,16;13,41;11,75;40468;0;0;0;0;50133;25799;0.5146;25384;415
2017-02-21 06:00:00;33,0;30,98;2,02;40468;0;0;1;-1;50133;26214;0.5229;25094;1120
2017-02-21 07:00:00;38,96;30,02;8,94;40468;55;0.0014;82;-27;50133;26034;0.5193;24925;1109
2017-02-21 08:00:00;38,94;35,63;3,31;40468;631;0.0156;702;-71;50133;26127;0.5212;24917;1210
2017-02-21 09:00:00;38,94;35,24;3,7;40468;2018;0.0499;1750;268;50133;26944;0.5374;25089;1855
2017-02-21 10:00:00;38,95;33,91;5,04;40468;3532;0.0872;2870;662;50133;27446;0.5475;25546;1900
2017-02-21 11:00:00;38,95;33,03;5,92;40468;4854;0.1199;3842;1012;50133;27764;0.5538;26180;1584
2017-02-21 12:00:00;36,63;31,75;4,88;40468;6376;0.1576;4367;2009;50133;27250;0.5435;26541;709
2017-02-21 13:00:00;36,65;32,85;3,8;40468;6517;0.161;4393;2124;50133;26460;0.5278;26060;400
2017-02-21 14:00:00;36,41;34,69;1,72;40468;5674;0.1402;3914;1760;50133;25323;0.5051;24443;880
2017-02-21 15:00:00;36,68;35,7;0,98;40468;3886;0.096;2785;1101;50133;23403;0.4668;22550;853
2017-02-21 16:00:00;34,98;39,54;-4,56;40468;1926;0.0476;1289;637;50133;20930;0.4175;20678;252
2017-02-21 17:00:00;39,9;49,49;-9,59;40468;274;0.0067;158;116;50133;18836;0.3757;19272;-436
2017-02-21 18:00:00;57,42;56,87;0,55;40468;3;0.0001;0;3;50133;18139;0.3618;18244;-105
2017-02-21 19:00:00;45,8;47,0;-1,2;40468;0;0;0;0;50133;18227;0.3636;17674;553
2017-02-21 20:00:00;46,14;41,01;5,13;40468;0;0;0;0;50133;19100;0.381;17722;1378
2017-02-21 21:00:00;40,0;31,2;8,8;40468;0;0;0;0;50133;20200;0.4029;18096;2104
2017-02-21 22:00:00;34,25;28,73;5,52;40468;0;0;0;0;50133;21023;0.4193;19035;1988
2017-02-21 23:00:00;30,03;25,01;5,02;40468;0;0;0;0;50133;22387;0.4465;20503;1884
2017-02-22 00:00:00;22,92;14,86;8,06;40471;0;0;0;0;50159;24268;0.4838;24376;-108
2017-02-22 01:00:00;10,26;6,72;3,54;40471;0;0;0;0;50159;26394;0.5262;26565;-171
2017-02-22 02:00:00;9,5;2,21;7,29;40471;0;0;0;0;50159;28930;0.5767;29094;-164
2017-02-22 03:00:00;7,66;-1,42;9,08;40471;0;0;0;0;50159;31704;0.632;31649;55
2017-02-22 04:00:00;5,03;-1,32;6,35;40471;0;0;0;0;50159;33588;0.6696;33482;106
2017-02-22 05:00:00;7,68;-4,37;12,05;40471;0;0;0;0;50159;35349;0.7048;34575;774
2017-02-22 06:00:00;21,52;4,63;16,89;40471;0;0;0;0;50159;36981;0.7373;35400;1581
2017-02-22 07:00:00;31,86;18,36;13,5;40471;89;0.0022;94;-5;50159;37503;0.7477;35996;1507
2017-02-22 08:00:00;32,51;23,26;9,25;40471;876;0.0216;628;248;50159;37087;0.7394;36175;912
2017-02-22 09:00:00;32,51;25,04;7,47;40471;2229;0.0551;1449;780;50159;37116;0.74;36172;944
2017-02-22 10:00:00;32,29;27,3;4,99;40471;3405;0.0841;2302;1103;50159;37134;0.7403;36027;1107
2017-02-22 11:00:00;32,96;27,16;5,8;40471;3821;0.0944;2956;865;50159;37044;0.7385;35855;1189
2017-02-22 12:00:00;32,01;27,08;4,93;40471;4040;0.0998;3289;751;50159;36966;0.737;35716;1250
2017-02-22 13:00:00;30,94;28,2;2,74;40471;3950;0.0976;3299;651;50159;36496;0.7276;35494;1002
2017-02-22 14:00:00;29,94;28,17;1,77;40471;3279;0.081;2999;280;50159;35744;0.7126;35005;739
2017-02-22 15:00:00;31,28;31,51;-0,23;40471;2290;0.0566;2215;75;50159;35404;0.7058;34479;925
2017-02-22 16:00:00;31,24;28,67;2,57;40471;1135;0.028;1081;54;50159;35508;0.7079;33901;1607
2017-02-22 17:00:00;32,48;26,56;5,92;40471;161;0.004;156;5;50159;35255;0.7029;33360;1895
2017-02-22 18:00:00;35,93;24,34;11,59;40471;3;0.0001;0;3;50159;34996;0.6977;32900;2096
2017-02-22 19:00:00;34,05;22,63;11,42;40471;0;0;0;0;50159;34780;0.6934;32571;2209
2017-02-22 20:00:00;31,65;16,85;14,8;40471;0;0;0;0;50159;34260;0.6831;32436;1824
2017-02-22 21:00:00;23,45;10,03;13,42;40471;0;0;0;0;50159;33023;0.6584;32284;739
2017-02-22 22:00:00;10,26;6,55;3,71;40471;0;0;0;0;50159;32013;0.6382;31954;59
2017-02-22 23:00:00;9,47;4,69;4,78;40471;0;0;0;0;50159;31781;0.6336;31402;379
2017-02-23 00:00:00;-6,58;6,5;-13,08;40475;0;0;0;0;50194;31222;0.622;33961;-2739
2017-02-23 01:00:00;-5,03;4,45;-9,48;40475;0;0;0;0;50194;30408;0.6058;33251;-2843
2017-02-23 02:00:00;0,01;8,73;-8,72;40475;0;0;0;0;50194;29069;0.5791;31897;-2828
2017-02-23 03:00:00;7,03;13,25;-6,22;40475;0;0;0;0;50194;27152;0.5409;30142;-2990
2017-02-23 04:00:00;9,44;14,92;-5,48;40475;0;0;0;0;50194;24663;0.4914;27620;-2957
2017-02-23 05:00:00;25,53;26,15;-0,62;40475;0;0;0;0;50194;23451;0.4672;24252;-801
2017-02-23 06:00:00;35,0;37,18;-2,18;40475;0;0;0;0;50194;22237;0.443;20862;1375
2017-02-23 07:00:00;46,01;50,05;-4,04;40475;213;0.0052;233;-20;50194;20624;0.4109;17802;2822
2017-02-23 08:00:00;48,5;43,51;4,99;40475;1838;0.0454;1718;120;50194;19605;0.3906;15979;3626
2017-02-23 09:00:00;46,41;43,05;3,36;40475;4656;0.115;3929;727;50194;19785;0.3942;15077;4708
2017-02-23 10:00:00;43,36;34,36;9,0;40475;6718;0.166;6139;579;50194;21376;0.4259;14966;6410
2017-02-23 11:00:00;40,61;28,68;11,93;40475;7930;0.1959;7725;205;50194;23483;0.4678;16458;7025
2017-02-23 12:00:00;32,91;24,24;8,67;40475;8223;0.2032;8382;-159;50194;26362;0.5252;18920;7442
2017-02-23 13:00:00;32,4;23,35;9,05;40475;7505;0.1854;8061;-556;50194;28955;0.5768;21227;7728
2017-02-23 14:00:00;31,24;21,0;10,24;40475;6215;0.1536;6859;-644;50194;30929;0.6162;23273;7656
2017-02-23 15:00:00;27,68;17,61;10,07;40475;4701;0.1162;4885;-184;50194;32368;0.6449;25379;6989
2017-02-23 16:00:00;27,64;15,51;12,13;40475;2318;0.0573;2442;-124;50194;33792;0.6732;27004;6788
2017-02-23 17:00:00;32,03;22,03;10,0;40475;400;0.0099;400;0;50194;35235;0.702;27981;7254
2017-02-23 18:00:00;32,93;26,15;6,78;40475;4;0.0001;1;3;50194;35822;0.7137;28872;6950
2017-02-23 19:00:00;32,09;24,3;7,79;40475;0;0;0;0;50194;36294;0.723;29195;7099
2017-02-23 20:00:00;29,79;18,03;11,76;40475;0;0;0;0;50194;36823;0.7336;29078;7745
2017-02-23 21:00:00;24,07;13,19;10,88;40475;0;0;0;0;50194;37275;0.7426;29287;7988
2017-02-23 22:00:00;12,03;7,26;4,77;40475;0;0;0;0;50194;36846;0.7341;29356;7490
2017-02-23 23:00:00;9,27;1,86;7,41;40475;0;0;0;0;50194;36397;0.7251;29437;6960
2017-02-24 00:00:00;6,93;6,14;0,79;40480;0;0;0;0;50218;36452;0.7259;36467;-15
2017-02-24 01:00:00;-4,99;1,81;-6,8;40480;0;0;0;0;50218;36655;0.7299;36295;360
2017-02-24 02:00:00;-27,08;-3,12;-23,96;40480;0;0;0;0;50218;35752;0.712;35797;-45
2017-02-24 03:00:00;-0,9;1,71;-2,61;40480;0;0;0;0;50218;35000;0.697;35018;-18
2017-02-24 04:00:00;7,0;4,51;2,49;40480;0;0;0;0;50218;33656;0.6702;33686;-30
2017-02-24 05:00:00;9,49;15,53;-6,04;40480;0;0;0;0;50218;32615;0.6495;32043;572
2017-02-24 06:00:00;30,04;34,87;-4,83;40480;0;0;1;-1;50218;31908;0.6354;30182;1726
2017-02-24 07:00:00;33,44;36,26;-2,82;40480;238;0.0058;366;-128;50218;29887;0.5952;27685;2202
2017-02-24 08:00:00;34,3;35,03;-0,73;40480;1978;0.0489;2620;-642;50218;25965;0.517;24702;1263
2017-02-24 09:00:00;33,91;36,51;-2,6;40480;4848;0.1198;5792;-944;50218;22794;0.4539;21934;860
2017-02-24 10:00:00;33,48;42,01;-8,53;40480;7851;0.194;8912;-1061;50218;20790;0.414;19866;924
2017-02-24 11:00:00;33,18;38,61;-5,43;40480;9802;0.2421;10988;-1186;50218;20014;0.3986;18523;1491
2017-02-24 12:00:00;32,49;36,62;-4,13;40480;11338;0.2801;11766;-428;50218;19364;0.3856;17190;2174
2017-02-24 13:00:00;32,41;34,23;-1,82;40480;11501;0.2841;11396;105;50218;18532;0.369;15994;2538
2017-02-24 14:00:00;32,24;31,23;1,01;40480;10554;0.2607;9842;712;50218;17462;0.3477;15021;2441
2017-02-24 15:00:00;34,9;30,41;4,49;40480;7760;0.1917;7107;653;50218;16123;0.3211;13954;2169
2017-02-24 16:00:00;44,92;35,23;9,69;40480;4017;0.0992;3595;422;50218;14347;0.2857;12795;1552
2017-02-24 17:00:00;50,1;43,94;6,16;40480;648;0.016;561;87;50218;12273;0.2444;11862;411
2017-02-24 18:00:00;57,52;53,88;3,64;40480;5;0.0001;1;4;50218;12688;0.2526;11490;1198
2017-02-24 19:00:00;58,19;49,39;8,8;40480;0;0;0;0;50218;14256;0.2838;11606;2650
2017-02-24 20:00:00;43,94;38,22;5,72;40480;0;0;0;0;50218;14507;0.2889;11993;2514
2017-02-24 21:00:00;38,06;34,16;3,9;40480;0;0;0;0;50218;14530;0.2894;12388;2142
2017-02-24 22:00:00;39,68;31,48;8,2;40480;0;0;0;0;50218;14690;0.2925;12538;2152
2017-02-24 23:00:00;36,66;28,33;8,33;40480;0;0;0;0;50218;14337;0.2855;12366;1971
2017-02-25 00:00:00;29,28;30,04;-0,76;40481;0;0;0;0;50224;13964;0.278;12568;1396
2017-02-25 01:00:00;29,09;28,89;0,2;40481;0;0;0;0;50224;13840;0.2756;12116;1724
2017-02-25 02:00:00;28,94;27,41;1,53;40481;0;0;0;0;50224;13328;0.2653;11651;1677
2017-02-25 03:00:00;29,45;27,52;1,93;40481;0;0;0;0;50224;12525;0.2494;11125;1400
2017-02-25 04:00:00;29,93;27,19;2,74;40481;0;0;0;0;50224;12185;0.2426;10684;1501
2017-02-25 05:00:00;29,53;26,87;2,66;40481;0;0;0;0;50224;11572;0.2304;10355;1217
2017-02-25 06:00:00;32,87;29,56;3,31;40481;0;0;2;-2;50224;11441;0.2278;10048;1393
2017-02-25 07:00:00;41,48;34,95;6,53;40481;600;0.0148;646;-46;50224;11586;0.2307;9656;1930
2017-02-25 08:00:00;41,99;32,26;9,73;40481;4174;0.1031;3817;357;50224;11551;0.23;9334;2217
2017-02-25 09:00:00;40,44;29,85;10,59;40481;9016;0.2227;7922;1094;50224;11324;0.2255;9406;1918
2017-02-25 10:00:00;37,13;25,84;11,29;40481;13366;0.3302;11537;1829;50224;11364;0.2262;10215;1149
2017-02-25 11:00:00;32,04;21,68;10,36;40481;15972;0.3946;13914;2058;50224;13003;0.2589;11736;1267
2017-02-25 12:00:00;29,46;17,85;11,61;40481;15982;0.3948;14500;1482;50224;15358;0.3058;13463;1895
2017-02-25 13:00:00;28,01;10,96;17,05;40481;14674;0.3625;13266;1408;50224;16958;0.3377;15099;1859
2017-02-25 14:00:00;22,86;7,76;15,1;40481;11645;0.2876;10719;926;50224;18204;0.3624;16337;1867
2017-02-25 15:00:00;28,88;9,82;19,06;40481;7821;0.1932;7425;396;50224;19036;0.379;17168;1868
2017-02-25 16:00:00;30,16;19,51;10,65;40481;3744;0.0925;3637;107;50224;18724;0.3728;17994;730
2017-02-25 17:00:00;38,0;28,33;9,67;40481;581;0.0144;593;-12;50224;19117;0.3806;19061;56
2017-02-25 18:00:00;39,57;34,65;4,92;40481;4;0.0001;0;4;50224;21164;0.4214;20566;598
2017-02-25 19:00:00;34,65;31,34;3,31;40481;0;0;0;0;50224;23268;0.4633;22042;1226
2017-02-25 20:00:00;26,01;18,03;7,98;40481;0;0;0;0;50224;24468;0.4872;23088;1380
2017-02-25 21:00:00;12,94;10,06;2,88;40481;0;0;0;0;50224;25673;0.5112;24068;1605
2017-02-25 22:00:00;11,91;12,86;-0,95;40481;0;0;0;0;50224;26012;0.5179;24766;1246
2017-02-25 23:00:00;8,8;7,73;1,07;40481;0;0;0;0;50224;26037;0.5184;25111;926
2017-02-26 00:00:00;7,83;10,42;-2,59;40481;0;0;0;0;50230;26033;0.5183;26968;-935
2017-02-26 01:00:00;3,0;8,1;-5,1;40481;0;0;0;0;50230;26204;0.5217;26670;-466
2017-02-26 02:00:00;4,65;9,01;-4,36;40481;0;0;0;0;50230;26186;0.5213;26243;-57
2017-02-26 03:00:00;7,74;5,7;2,04;40481;0;0;0;0;50230;25910;0.5158;25726;184
2017-02-26 04:00:00;8,02;0,89;7,13;40481;0;0;0;0;50230;25350;0.5047;25238;112
2017-02-26 05:00:00;8,95;-1,33;10,28;40481;0;0;0;0;50230;24508;0.4879;24836;-328
2017-02-26 06:00:00;7,83;1,7;6,13;40481;0;0;0;0;50230;24284;0.4835;24484;-200
2017-02-26 07:00:00;7,84;4,11;3,73;40481;270;0.0067;292;-22;50230;23873;0.4753;24191;-318
2017-02-26 08:00:00;9,63;10,2;-0,57;40481;1880;0.0465;1655;225;50230;24420;0.4862;23963;457
2017-02-26 09:00:00;10,36;11,21;-0,85;40481;3983;0.0984;3378;605;50230;24337;0.4845;23795;542
2017-02-26 10:00:00;12,91;11,14;1,77;40481;6381;0.1576;4878;1503;50230;24288;0.4836;23583;705
2017-02-26 11:00:00;12,98;10,21;2,77;40481;8716;0.2153;5960;2756;50230;24138;0.4806;23309;829
2017-02-26 12:00:00;9,92;5,04;4,88;40481;9908;0.2448;6545;3363;50230;24553;0.4888;22945;1608
2017-02-26 13:00:00;9,75;-12,86;22,61;40481;9847;0.2432;6422;3425;50230;23604;0.4699;22323;1281
2017-02-26 14:00:00;9,98;-10,89;20,87;40481;8540;0.211;5569;2971;50230;24017;0.4782;21419;2598
2017-02-26 15:00:00;10,4;-5,51;15,91;40481;6107;0.1509;4084;2023;50230;22522;0.4484;20564;1958
2017-02-26 16:00:00;12,78;8,52;4,26;40481;3190;0.0788;2120;1070;50230;20577;0.4096;20006;571
2017-02-26 17:00:00;28,0;29,35;-1,35;40481;634;0.0157;397;237;50230;19006;0.3784;20022;-1016
2017-02-26 18:00:00;31,76;32,63;-0,87;40481;4;0.0001;0;4;50230;18836;0.375;20359;-1523
2017-02-26 19:00:00;30,96;32,19;-1,23;40481;0;0;0;0;50230;19529;0.3888;20923;-1394
2017-02-26 20:00:00;25,34;32,17;-6,83;40481;0;0;0;0;50230;20213;0.4024;21467;-1254
2017-02-26 21:00:00;23,86;27,74;-3,88;40481;0;0;0;0;50230;20638;0.4109;21847;-1209
2017-02-26 22:00:00;20,86;30,47;-9,61;40481;0;0;0;0;50230;19626;0.3907;21968;-2342
2017-02-26 23:00:00;10,35;24,91;-14,56;40481;0;0;0;0;50230;19394;0.3861;21815;-2421
2017-02-27 00:00:00;22,01;28,18;-6,17;40485;0;0;0;0;50276;19128;0.3805;22040;-2912
2017-02-27 01:00:00;15,48;27,06;-11,58;40485;0;0;0;0;50276;18887;0.3757;21764;-2877
2017-02-27 02:00:00;12,54;25,76;-13,22;40485;0;0;0;0;50276;19232;0.3825;21481;-2249
2017-02-27 03:00:00;15,59;21,19;-5,6;40485;0;0;0;0;50276;19042;0.3787;21032;-1990
2017-02-27 04:00:00;18,84;21,22;-2,38;40485;0;0;0;0;50276;18674;0.3714;20632;-1958
2017-02-27 05:00:00;30,11;29,24;0,87;40485;0;0;0;0;50276;18676;0.3715;20380;-1704
2017-02-27 06:00:00;38,66;42,28;-3,62;40485;0;0;1;-1;50276;19593;0.3897;20073;-480
2017-02-27 07:00:00;47,29;46,94;0,35;40485;550;0.0136;537;13;50276;19578;0.3894;19816;-238
2017-02-27 08:00:00;47,52;43,06;4,46;40485;3026;0.0747;3015;11;50276;19860;0.395;19687;173
2017-02-27 09:00:00;39,94;39,1;0,84;40485;6483;0.1601;6111;372;50276;19660;0.391;19700;-40
2017-02-27 10:00:00;36,87;37,76;-0,89;40485;9654;0.2384;8741;913;50276;19750;0.3928;20412;-662
2017-02-27 11:00:00;36,6;34,61;1,99;40485;12284;0.3034;10457;1827;50276;21716;0.4319;21790;-74
2017-02-27 12:00:00;30,91;25,96;4,95;40485;14033;0.3466;11035;2998;50276;23704;0.4715;23282;422
2017-02-27 13:00:00;30,58;20,58;10,0;40485;13748;0.3396;10440;3308;50276;23784;0.473;24334;-550
2017-02-27 14:00:00;30,59;18,14;12,45;40485;12219;0.3018;8880;3339;50276;23557;0.4686;24301;-744
2017-02-27 15:00:00;30,83;22,49;8,34;40485;9058;0.2237;6291;2767;50276;24159;0.4806;24127;32
2017-02-27 16:00:00;32,15;25,1;7,05;40485;4591;0.1134;3042;1549;50276;24222;0.4818;24242;-20
2017-02-27 17:00:00;32,89;31,05;1,84;40485;739;0.0182;517;222;50276;23879;0.4749;24974;-1095
2017-02-27 18:00:00;34,44;41,23;-6,79;40485;5;0.0001;0;5;50276;24944;0.4961;26174;-1230
2017-02-27 19:00:00;32,46;38,33;-5,87;40485;0;0;0;0;50276;27906;0.555;27618;288
2017-02-27 20:00:00;30,62;33,84;-3,22;40485;0;0;0;0;50276;29175;0.5803;28793;382
2017-02-27 21:00:00;27,05;30,59;-3,54;40485;0;0;0;0;50276;30014;0.597;29670;344
2017-02-27 22:00:00;12,96;24,42;-11,46;40485;0;0;0;0;50276;29549;0.5877;30204;-655
2017-02-27 23:00:00;7,95;20,14;-12,19;40485;0;0;0;0;50276;29643;0.5896;30273;-630
2017-02-28 00:00:00;7,81;18,6;-10,79;40493;0;0;0;0;50362;29201;0.5798;31193;-1992
2017-02-28 01:00:00;7,89;18,55;-10,66;40493;0;0;0;0;50362;28028;0.5565;30595;-2567
2017-02-28 02:00:00;7,86;19,79;-11,93;40493;0;0;0;0;50362;27440;0.5448;29699;-2259
2017-02-28 03:00:00;8,56;17,27;-8,71;40493;0;0;0;0;50362;27099;0.5381;29101;-2002
2017-02-28 04:00:00;9,79;17,68;-7,89;40493;0;0;0;0;50362;27210;0.5403;28694;-1484
2017-02-28 05:00:00;10,34;19,16;-8,82;40493;0;0;0;0;50362;28665;0.5692;28481;184
2017-02-28 06:00:00;28,99;31,17;-2,18;40493;0;0;1;-1;50362;30790;0.6114;28393;2397
2017-02-28 07:00:00;32,86;31,09;1,77;40493;266;0.0066;454;-188;50362;30239;0.6004;28250;1989
2017-02-28 08:00:00;33,2;36,12;-2,92;40493;1564;0.0386;2659;-1095;50362;30229;0.6002;28069;2160
2017-02-28 09:00:00;31,02;38,14;-7,12;40493;3630;0.0896;5779;-2149;50362;30624;0.6081;27972;2652
2017-02-28 10:00:00;30,76;35,62;-4,86;40493;6359;0.157;8829;-2470;50362;31574;0.6269;27559;4015
2017-02-28 11:00:00;30,57;32,43;-1,86;40493;8362;0.2065;10389;-2027;50362;31755;0.6305;26328;5427
2017-02-28 12:00:00;32,42;31,88;0,54;40493;8822;0.2178;9728;-906;50362;30290;0.6014;24652;5638
2017-02-28 13:00:00;39,8;37,3;2,5;40493;7887;0.1948;8047;-160;50362;27656;0.5491;22526;5130
2017-02-28 14:00:00;39,86;41,99;-2,13;40493;6419;0.1585;5983;436;50362;24243;0.4814;20381;3862
2017-02-28 15:00:00;39,17;46,78;-7,61;40493;3975;0.0982;3886;89;50362;21219;0.4214;18648;2571
2017-02-28 16:00:00;39,52;47,1;-7,58;40493;1574;0.0389;1880;-306;50362;18656;0.3704;17441;1215
2017-02-28 17:00:00;40,13;50,46;-10,33;40493;244;0.006;350;-106;50362;17438;0.3463;17228;210
2017-02-28 18:00:00;49,2;59,99;-10,79;40493;6;0.0001;1;5;50362;17874;0.3549;17635;239
2017-02-28 19:00:00;53,12;57,99;-4,87;40493;0;0;0;0;50362;17651;0.3505;18315;-664
2017-02-28 20:00:00;39,11;50,58;-11,47;40493;0;0;0;0;50362;18565;0.3686;19473;-908
2017-02-28 21:00:00;38,78;45,5;-6,72;40493;0;0;0;0;50362;19960;0.3964;20887;-927
2017-02-28 22:00:00;31,4;36,61;-5,21;40493;0;0;0;0;50362;20272;0.4025;21888;-1616
2017-02-28 23:00:00;30,06;34,15;-4,09;40493;0;0;0;0;50362;21614;0.4292;22367;-753
2017-01-03 00:00:00;31,05;24,79;6,26;40500;0;0;0;0;50362;23133;0.4593;19996;3137
2017-01-03 01:00:00;29,57;22,05;7,52;40500;0;0;0;0;50362;23311;0.4629;20693;2618
2017-01-03 02:00:00;28,61;24,7;3,91;40500;0;0;0;0;50362;22889;0.4545;21116;1773
2017-01-03 03:00:00;25,52;24,06;1,46;40500;0;0;0;0;50362;21722;0.4313;21157;565
2017-01-03 04:00:00;28,65;27,04;1,61;40500;0;0;0;0;50362;20952;0.416;20806;146
2017-01-03 05:00:00;29,98;33,88;-3,9;40500;0;0;0;0;50362;20562;0.4083;20190;372
2017-01-03 06:00:00;32,4;36,78;-4,38;40500;1;0;3;-2;50362;20950;0.416;19770;1180
2017-01-03 07:00:00;41,96;50,33;-8,37;40500;409;0.0101;503;-94;50362;20343;0.4039;19634;709
2017-01-03 08:00:00;42,08;50,73;-8,65;40500;2397;0.0592;2468;-71;50362;19491;0.387;19902;-411
2017-01-03 09:00:00;39,99;47,44;-7,45;40500;4912;0.1213;4811;101;50362;20004;0.3972;20536;-532
2017-01-03 10:00:00;39,9;44,15;-4,25;40500;6971;0.1721;6757;214;50362;21257;0.4221;21378;-121
2017-01-03 11:00:00;36,92;37,66;-0,74;40500;8420;0.2079;8589;-169;50362;21716;0.4312;22395;-679
2017-01-03 12:00:00;31,22;34,95;-3,73;40500;8852;0.2186;10097;-1245;50362;22106;0.439;23355;-1249
2017-01-03 13:00:00;30,74;35,26;-4,52;40500;8159;0.2015;10083;-1924;50362;22471;0.4462;23951;-1480
2017-01-03 14:00:00;30,83;35,91;-5,08;40500;6982;0.1724;8653;-1671;50362;22040;0.4376;23885;-1845
2017-01-03 15:00:00;32,16;38,78;-6,62;40500;5094;0.1258;6148;-1054;50362;21319;0.4233;23236;-1917
2017-01-03 16:00:00;38,63;44,42;-5,79;40500;2460;0.0607;3111;-651;50362;19363;0.3845;21859;-2496
2017-01-03 17:00:00;46,82;53,12;-6,3;40500;503;0.0124;568;-65;50362;15742;0.3126;20037;-4295
2017-01-03 18:00:00;51,99;59,31;-7,32;40500;12;0.0003;2;10;50362;14711;0.2921;18735;-4024
2017-01-03 19:00:00;49,68;65,41;-15,73;40500;0;0;0;0;50362;14443;0.2868;18225;-3782
2017-01-03 20:00:00;39,93;55,13;-15,2;40500;0;0;0;0;50362;14526;0.2884;18378;-3852
2017-01-03 21:00:00;34,9;41,88;-6,98;40500;0;0;0;0;50362;15178;0.3014;18682;-3504
2017-01-03 22:00:00;31,93;42,18;-10,25;40500;0;0;0;0;50362;15781;0.3134;19168;-3387
2017-01-03 23:00:00;29,7;34,02;-4,32;40500;0;0;0;0;50362;16180;0.3213;19947;-3767
2017-02-03 00:00:00;29,73;34,0;-4,27;40503;0;0;0;0;50369;16484;0.3273;17493;-1009
2017-02-03 01:00:00;29,49;32,62;-3,13;40503;0;0;0;0;50369;16758;0.3327;18192;-1434
2017-02-03 02:00:00;25,99;30,49;-4,5;40503;0;0;0;0;50369;17646;0.3504;19303;-1657
2017-02-03 03:00:00;26,0;30,41;-4,41;40503;0;0;0;0;50369;18626;0.3698;20739;-2113
2017-02-03 04:00:00;26,17;29,21;-3,04;40503;0;0;0;0;50369;19739;0.3919;22343;-2604
2017-02-03 05:00:00;26,04;32,81;-6,77;40503;0;0;0;0;50369;21166;0.4202;24490;-3324
2017-02-03 06:00:00;31,04;35,58;-4,54;40503;1;0;2;-1;50369;23329;0.4632;26595;-3266
2017-02-03 07:00:00;33,57;44,94;-11,37;40503;492;0.0122;499;-7;50369;25980;0.5158;28393;-2413
2017-02-03 08:00:00;34,19;42,71;-8,52;40503;2933;0.0724;2776;157;50369;28177;0.5594;30234;-2057
2017-02-03 09:00:00;30,85;36,19;-5,34;40503;6718;0.1659;5716;1002;50369;29877;0.5932;31911;-2034
2017-02-03 10:00:00;26,0;29,27;-3,27;40503;10055;0.2483;8705;1350;50369;31628;0.6279;33197;-1569
2017-02-03 11:00:00;25,08;23,38;1,7;40503;12309;0.3039;11300;1009;50369;32819;0.6516;33928;-1109
2017-02-03 12:00:00;12,63;17,53;-4,9;40503;12936;0.3194;12480;456;50369;33580;0.6667;34445;-865
2017-02-03 13:00:00;10,45;20,86;-10,41;40503;11949;0.295;11993;-44;50369;34714;0.6892;34470;244
2017-02-03 14:00:00;10,48;19,24;-8,76;40503;9859;0.2434;10459;-600;50369;34892;0.6927;33921;971
2017-02-03 15:00:00;25,01;25,61;-0,6;40503;7257;0.1792;7815;-558;50369;34402;0.683;33020;1382
2017-02-03 16:00:00;25,92;27,76;-1,84;40503;3791;0.0936;4187;-396;50369;32626;0.6478;31616;1010
2017-02-03 17:00:00;32,17;33,83;-1,66;40503;846;0.0209;869;-23;50369;30352;0.6026;29899;453
2017-02-03 18:00:00;39,9;41,86;-1,96;40503;13;0.0003;6;7;50369;27818;0.5523;28262;-444
2017-02-03 19:00:00;38,91;41,87;-2,96;40503;0;0;0;0;50369;26666;0.5294;26960;-294
2017-02-03 20:00:00;31,95;39,68;-7,73;40503;0;0;0;0;50369;25963;0.5155;26218;-255
2017-02-03 21:00:00;30,47;32,82;-2,35;40503;0;0;0;0;50369;25393;0.5041;25577;-184
2017-02-03 22:00:00;29,25;30,44;-1,19;40503;0;0;0;0;50369;24428;0.485;24815;-387
2017-02-03 23:00:00;25,07;25,44;-0,37;40503;0;0;0;0;50369;22854;0.4538;23867;-1013
2017-03-03 00:00:00;27,02;27,23;-0,21;40505;0;0;0;0;50372;21359;0.424;21233;126
2017-03-03 01:00:00;26,47;28,43;-1,96;40505;0;0;0;0;50372;19239;0.382;19798;-559
2017-03-03 02:00:00;26,03;28,47;-2,44;40505;0;0;0;0;50372;17259;0.3426;18191;-932
2017-03-03 03:00:00;28,99;28,52;0,47;40505;0;0;0;0;50372;15915;0.316;16786;-871
2017-03-03 04:00:00;30,91;28,71;2,2;40505;0;0;0;0;50372;15106;0.2999;15824;-718
2017-03-03 05:00:00;32,36;30,39;1,97;40505;0;0;0;0;50372;16103;0.3197;15445;658
2017-03-03 06:00:00;41,91;36,35;5,56;40505;4;0.0001;6;-2;50372;17804;0.3534;15289;2515
2017-03-03 07:00:00;48,0;40,66;7,34;40505;1284;0.0317;1216;68;50372;18240;0.3621;14845;3395
2017-03-03 08:00:00;47,57;38,49;9,08;40505;5738;0.1417;5129;609;50372;16994;0.3374;13725;3269
2017-03-03 09:00:00;46,5;35,76;10,74;40505;10260;0.2533;9087;1173;50372;13997;0.2778;12351;1646
2017-03-03 10:00:00;43,49;36,24;7,25;40505;13521;0.3338;11983;1538;50372;11985;0.2379;11255;730
2017-03-03 11:00:00;43,47;35,13;8,34;40505;15120;0.3733;13473;1647;50372;11612;0.2305;10473;1139
2017-03-03 12:00:00;41,02;33,33;7,69;40505;14907;0.368;13333;1574;50372;11750;0.2333;9720;2030
2017-03-03 13:00:00;39,83;34,08;5,75;40505;13020;0.3214;11774;1246;50372;11153;0.2214;8898;2255
2017-03-03 14:00:00;39,1;35,82;3,28;40505;10112;0.2496;9396;716;50372;9460;0.1878;8111;1349
2017-03-03 15:00:00;38,6;37,62;0,98;40505;6939;0.1713;6574;365;50372;8663;0.172;7657;1006
2017-03-03 16:00:00;40,97;40,15;0,82;40505;3164;0.0781;3352;-188;50372;8230;0.1634;8205;25
2017-03-03 17:00:00;41,91;40,68;1,23;40505;584;0.0144;683;-99;50372;8664;0.172;10131;-1467
2017-03-03 18:00:00;42,18;43,67;-1,49;40505;10;0.0002;4;6;50372;10432;0.2071;12444;-2012
2017-03-03 19:00:00;44,95;46,47;-1,52;40505;0;0;0;0;50372;11776;0.2338;14179;-2403
2017-03-03 20:00:00;41,01;43,43;-2,42;40505;0;0;0;0;50372;12844;0.255;14932;-2088
2017-03-03 21:00:00;35,29;38,6;-3,31;40505;0;0;0;0;50372;13761;0.2732;15263;-1502
2017-03-03 22:00:00;36,25;39,52;-3,27;40505;0;0;0;0;50372;14150;0.2809;15209;-1059
2017-03-03 23:00:00;34,56;36,26;-1,7;40505;0;0;0;0;50372;14454;0.287;14849;-395
2017-04-03 00:00:00;31,6;30,86;0,74;40506;0;0;0;0;50378;14288;0.2836;13013;1275
2017-04-03 01:00:00;30,25;28,93;1,32;40506;0;0;0;0;50378;14285;0.2836;12904;1381
2017-04-03 02:00:00;30,04;29,3;0,74;40506;0;0;0;0;50378;13766;0.2733;12809;957
2017-04-03 03:00:00;28,44;30,19;-1,75;40506;0;0;0;0;50378;12844;0.255;12740;104
2017-04-03 04:00:00;28,26;30,14;-1,88;40506;0;0;0;0;50378;12821;0.2545;12755;66
2017-04-03 05:00:00;29,22;32,39;-3,17;40506;0;0;0;0;50378;12738;0.2528;12833;-95
2017-04-03 06:00:00;28,16;28,11;0,05;40506;8;0.0002;9;-1;50378;12373;0.2456;12847;-474
2017-04-03 07:00:00;30,0;34,11;-4,11;40506;1532;0.0378;1542;-10;50378;11973;0.2377;12439;-466
2017-04-03 08:00:00;33,96;39,7;-5,74;40506;5998;0.1481;6244;-246;50378;11198;0.2222;11478;-280
2017-04-03 09:00:00;39,34;40,56;-1,22;40506;11232;0.2773;11261;-29;50378;8594;0.1706;10343;-1749
2017-04-03 10:00:00;36,73;40,7;-3,97;40506;14607;0.3606;15133;-526;50378;6180;0.1227;9086;-2906
2017-04-03 11:00:00;36,69;42,39;-5,7;40506;15456;0.3816;17094;-1638;50378;5167;0.1026;7963;-2796
2017-04-03 12:00:00;33,76;42,68;-8,92;40506;15705;0.3878;16948;-1243;50378;4649;0.0923;7193;-2544
2017-04-03 13:00:00;31,44;42,21;-10,77;40506;13890;0.3429;15044;-1154;50378;4729;0.0939;6918;-2189
2017-04-03 14:00:00;31,81;42,02;-10,21;40506;10514;0.2596;11882;-1368;50378;4770;0.0947;7323;-2553
2017-04-03 15:00:00;33,67;41,02;-7,35;40506;6929;0.1711;7929;-1000;50378;5024;0.0998;8127;-3103
2017-04-03 16:00:00;34,9;40,34;-5,44;40506;3337;0.0824;3909;-572;50378;6308;0.1252;9439;-3131
2017-04-03 17:00:00;40,44;45,34;-4,9;40506;730;0.018;790;-60;50378;8726;0.1732;11583;-2857
2017-04-03 18:00:00;44,69;49,7;-5,01;40506;11;0.0003;6;5;50378;11753;0.2333;13602;-1849
2017-04-03 19:00:00;47,25;50,49;-3,24;40506;0;0;0;0;50378;13085;0.2598;14796;-1711
2017-04-03 20:00:00;42,01;47,86;-5,85;40506;0;0;0;0;50378;13003;0.2581;15763;-2760
2017-04-03 21:00:00;35,07;40,55;-5,48;40506;0;0;0;0;50378;13627;0.2705;16714;-3087
2017-04-03 22:00:00;31,87;39,63;-7,76;40506;0;0;0;0;50378;13842;0.2748;17457;-3615
2017-04-03 23:00:00;22,68;33,35;-10,67;40506;0;0;0;0;50378;14844;0.2947;18357;-3513
2017-05-03 00:00:00;21,11;29,77;-8,66;40506;0;0;0;0;50378;16955;0.3366;16385;570
2017-05-03 01:00:00;15,44;22,97;-7,53;40506;0;0;0;0;50378;19394;0.385;17804;1590
2017-05-03 02:00:00;11,56;15,38;-3,82;40506;0;0;0;0;50378;21624;0.4292;18829;2795
2017-05-03 03:00:00;10,6;4,44;6,16;40506;0;0;0;0;50378;20732;0.4116;19774;958
2017-05-03 04:00:00;9,84;2,52;7,32;40506;0;0;0;0;50378;20184;0.4006;20214;-30
2017-05-03 05:00:00;8,06;3,92;4,14;40506;0;0;0;0;50378;19193;0.381;20052;-859
2017-05-03 06:00:00;9,83;10,71;-0,88;40506;6;0.0002;8;-2;50378;18922;0.3756;20022;-1100
2017-05-03 07:00:00;9,13;15,98;-6,85;40506;593;0.0146;789;-196;50378;19652;0.3901;20330;-678
2017-05-03 08:00:00;9,88;16,72;-6,84;40506;2520;0.0622;3207;-687;50378;18862;0.3744;20899;-2037
2017-05-03 09:00:00;11,32;24,79;-13,47;40506;5420;0.1338;6142;-722;50378;18185;0.361;21556;-3371
2017-05-03 10:00:00;9,97;30,51;-20,54;40506;8489;0.2096;8976;-487;50378;19028;0.3777;21903;-2875
2017-05-03 11:00:00;10,0;27,77;-17,77;40506;11353;0.2803;11307;46;50378;19358;0.3843;21290;-1932
2017-05-03 12:00:00;10,8;20,68;-9,88;40506;12430;0.3069;12632;-202;50378;19409;0.3853;20187;-778
2017-05-03 13:00:00;9,96;14,26;-4,3;40506;11781;0.2908;12523;-742;50378;17500;0.3474;18527;-1027
2017-05-03 14:00:00;9,4;17,59;-8,19;40506;10290;0.254;10774;-484;50378;14735;0.2925;16319;-1584
2017-05-03 15:00:00;9,96;20,88;-10,92;40506;7583;0.1872;7582;1;50378;12188;0.242;14311;-2123
2017-05-03 16:00:00;17,22;29,51;-12,29;40506;3840;0.0948;3816;24;50378;9570;0.19;13015;-3445
2017-05-03 17:00:00;30,03;39,46;-9,43;40506;723;0.0179;790;-67;50378;8303;0.1648;12965;-4662
2017-05-03 18:00:00;33,69;47,41;-13,72;40506;18;0.0004;6;12;50378;9259;0.1838;13902;-4643
2017-05-03 19:00:00;37,95;49,61;-11,66;40506;0;0;0;0;50378;10656;0.2115;15076;-4420
2017-05-03 20:00:00;35,02;47,45;-12,43;40506;0;0;0;0;50378;11463;0.2275;15769;-4306
2017-05-03 21:00:00;32,85;39,68;-6,83;40506;0;0;0;0;50378;12466;0.2474;15997;-3531
2017-05-03 22:00:00;32,92;40,67;-7,75;40506;0;0;0;0;50378;12256;0.2433;15633;-3377
2017-05-03 23:00:00;31,67;38,73;-7,06;40506;0;0;0;0;50378;11787;0.234;14814;-3027
2017-06-03 00:00:00;31,24;29,3;1,94;40509;0;0;0;0;50393;11059;0.2194;11353;-294
2017-06-03 01:00:00;29,04;29,21;-0,17;40509;0;0;0;0;50393;10505;0.2085;10718;-213
2017-06-03 02:00:00;27,99;27,65;0,34;40509;0;0;0;0;50393;9874;0.1959;10352;-478
2017-06-03 03:00:00;25,35;25,42;-0,07;40509;0;0;0;0;50393;9949;0.1974;10083;-134
2017-06-03 04:00:00;27,3;26,5;0,8;40509;0;0;0;0;50393;10048;0.1994;9853;195
2017-06-03 05:00:00;29,07;27,82;1,25;40509;0;0;0;0;50393;10012;0.1987;9630;382
2017-06-03 06:00:00;34,98;35,26;-0,28;40509;10;0.0002;8;2;50393;10542;0.2092;9547;995
2017-06-03 07:00:00;42,4;45,13;-2,73;40509;673;0.0166;720;-47;50393;10443;0.2072;9633;810
2017-06-03 08:00:00;44,28;45,89;-1,61;40509;2572;0.0635;2720;-148;50393;10359;0.2056;9782;577
2017-06-03 09:00:00;47,03;45,64;1,39;40509;5155;0.1272;4857;298;50393;9922;0.1969;9935;-13
2017-06-03 10:00:00;46,58;45,36;1,22;40509;7026;0.1734;6674;352;50393;9891;0.1963;9902;-11
2017-06-03 11:00:00;46,36;44,7;1,66;40509;7532;0.1859;8127;-595;50393;9774;0.194;9540;234
2017-06-03 12:00:00;43,92;46,87;-2,95;40509;7672;0.1894;8896;-1224;50393;9646;0.1914;9158;488
2017-06-03 13:00:00;39,9;46,54;-6,64;40509;7448;0.1839;8771;-1323;50393;9278;0.1841;8753;525
2017-06-03 14:00:00;36,07;42,9;-6,83;40509;6289;0.1552;7651;-1362;50393;8893;0.1765;8401;492
2017-06-03 15:00:00;39,9;43,41;-3,51;40509;4557;0.1125;5639;-1082;50393;9243;0.1834;8176;1067
2017-06-03 16:00:00;42,91;44,96;-2,05;40509;2549;0.063;3040;-491;50393;9506;0.1886;8118;1388
2017-06-03 17:00:00;46,15;45,17;0,98;40509;656;0.0162;698;-42;50393;10148;0.2014;8234;1914
2017-06-03 18:00:00;49,59;47,32;2,27;40509;18;0.0004;8;10;50393;10564;0.2096;8519;2045
2017-06-03 19:00:00;51,66;47,61;4,05;40509;0;0;0;0;50393;11362;0.2255;8772;2590
2017-06-03 20:00:00;46,05;39,3;6,75;40509;0;0;0;0;50393;11781;0.2338;8766;3015
2017-06-03 21:00:00;37,4;32,2;5,2;40509;0;0;0;0;50393;11751;0.2332;8591;3160
2017-06-03 22:00:00;35,0;31,57;3,43;40509;0;0;0;0;50393;11106;0.2204;8315;2791
2017-06-03 23:00:00;31,93;29,82;2,11;40509;0;0;0;0;50393;10423;0.2068;7972;2451
2017-07-03 00:00:00;31,07;31,35;-0,28;40513;0;0;0;0;50409;9759;0.1936;8693;1066
2017-07-03 01:00:00;30,01;32,19;-2,18;40513;0;0;0;0;50409;9292;0.1843;8468;824
2017-07-03 02:00:00;29,99;31,53;-1,54;40513;0;0;0;0;50409;9153;0.1816;8419;734
2017-07-03 03:00:00;29,64;30,52;-0,88;40513;0;0;0;0;50409;8576;0.1702;8215;361
2017-07-03 04:00:00;30,6;31,3;-0,7;40513;0;0;0;0;50409;8165;0.162;7936;229
2017-07-03 05:00:00;32,98;33,88;-0,9;40513;0;0;0;0;50409;7714;0.153;7504;210
2017-07-03 06:00:00;36,0;35,97;0,03;40513;7;0.0002;5;2;50409;7197;0.1427;7016;181
2017-07-03 07:00:00;50,19;49,19;1,0;40513;311;0.0077;384;-73;50409;6395;0.1268;6431;-36
2017-07-03 08:00:00;54,25;57,41;-3,16;40513;1409;0.0348;1513;-104;50409;5295;0.105;5768;-473
2017-07-03 09:00:00;54,1;57,1;-3,0;40513;2866;0.0708;2928;-62;50409;4198;0.0833;5120;-922
2017-07-03 10:00:00;53,93;53,54;0,39;40513;4100;0.1013;4218;-118;50409;3279;0.0651;4532;-1253
2017-07-03 11:00:00;51,54;51,49;0,05;40513;5182;0.1279;5251;-69;50409;2730;0.0542;4039;-1309
2017-07-03 12:00:00;49,9;50,36;-0,46;40513;5984;0.1477;5782;202;50409;2466;0.0489;3679;-1213
2017-07-03 13:00:00;49,07;48,62;0,45;40513;6582;0.1625;5732;850;50409;2172;0.0431;3496;-1324
2017-07-03 14:00:00;48,69;48,43;0,26;40513;6324;0.1561;5093;1231;50409;2248;0.0446;3397;-1149
2017-07-03 15:00:00;47,75;48,65;-0,9;40513;4950;0.1222;3958;992;50409;2190;0.0434;3285;-1095
2017-07-03 16:00:00;48,0;48,86;-0,86;40513;2850;0.0704;2286;564;50409;1892;0.0375;3001;-1109
2017-07-03 17:00:00;50,31;54,6;-4,29;40513;774;0.0191;591;183;50409;1783;0.0354;2563;-780
2017-07-03 18:00:00;57,52;68,6;-11,08;40513;20;0.0005;10;10;50409;1414;0.028;2174;-760
2017-07-03 19:00:00;61,05;65,73;-4,68;40513;0;0;0;0;50409;1356;0.0269;1920;-564
2017-07-03 20:00:00;51,93;53,76;-1,83;40513;0;0;0;0;50409;1580;0.0313;1798;-218
2017-07-03 21:00:00;43,93;43,83;0,1;40513;0;0;0;0;50409;1887;0.0374;1780;107
2017-07-03 22:00:00;41,94;44,38;-2,44;40513;0;0;0;0;50409;2224;0.0441;1885;339
2017-07-03 23:00:00;33,73;33,69;0,04;40513;0;0;0;0;50409;2744;0.0544;2112;632
2017-08-03 00:00:00;33,98;34,76;-0,78;40516;0;0;0;0;50420;3013;0.0598;2411;602
2017-08-03 01:00:00;32,76;33,29;-0,53;40516;0;0;0;0;50420;3438;0.0682;2698;740
2017-08-03 02:00:00;32,0;32,02;-0,02;40516;0;0;0;0;50420;4121;0.0817;3214;907
2017-08-03 03:00:00;31,38;29,62;1,76;40516;0;0;0;0;50420;5172;0.1026;3804;1368
2017-08-03 04:00:00;31,2;29,66;1,54;40516;0;0;0;0;50420;6519;0.1293;4639;1880
2017-08-03 05:00:00;32,06;29,56;2,5;40516;0;0;0;0;50420;7665;0.152;5873;1792
2017-08-03 06:00:00;41,04;35,32;5,72;40516;16;0.0004;15;1;50420;9412;0.1867;7293;2119
2017-08-03 07:00:00;49,61;42,36;7,25;40516;958;0.0236;886;72;50420;11041;0.219;8724;2317
2017-08-03 08:00:00;49,93;45,05;4,88;40516;3526;0.087;3489;37;50420;12800;0.2538;10082;2718
2017-08-03 09:00:00;43,44;39,97;3,47;40516;6396;0.1578;6136;260;50420;14164;0.2809;11669;2495
2017-08-03 10:00:00;41,0;31,26;9,74;40516;8325;0.2055;7939;386;50420;15752;0.3124;13880;1872
2017-08-03 11:00:00;38,1;30,43;7,67;40516;9462;0.2335;8440;1022;50420;18236;0.3617;16739;1497
2017-08-03 12:00:00;34,16;29,25;4,91;40516;8708;0.2149;7712;996;50420;20324;0.4031;19727;597
2017-08-03 13:00:00;33,65;30,89;2,76;40516;6707;0.1656;6151;556;50420;22813;0.4524;21854;959
2017-08-03 14:00:00;35,01;31,85;3,16;40516;4992;0.1232;4224;768;50420;24263;0.4812;22491;1772
2017-08-03 15:00:00;33,7;32,94;0,76;40516;3224;0.0796;2587;637;50420;24001;0.476;22816;1185
2017-08-03 16:00:00;34,03;33,43;0,6;40516;1402;0.0346;1241;161;50420;22985;0.4558;22767;218
2017-08-03 17:00:00;35,74;38,98;-3,24;40516;243;0.006;297;-54;50420;22294;0.4422;22493;-199
2017-08-03 18:00:00;42,05;46,31;-4,26;40516;1;0;3;-2;50420;21456;0.4256;22469;-1013
2017-08-03 19:00:00;42,0;45,35;-3,35;40516;0;0;0;0;50420;19614;0.389;21991;-2377
2017-08-03 20:00:00;34,15;39,18;-5,03;40516;0;0;0;0;50420;18321;0.3634;21047;-2726
2017-08-03 21:00:00;31,85;36,54;-4,69;40516;0;0;0;0;50420;16692;0.331;20169;-3477
2017-08-03 22:00:00;32,14;35,41;-3,27;40516;0;0;0;0;50420;15187;0.3012;19052;-3865
2017-08-03 23:00:00;28,97;31,27;-2,3;40516;0;0;0;0;50420;14130;0.2802;17704;-3574
2017-09-03 00:00:00;30,66;30,23;0,43;40525;0;0;0;0;50435;12236;0.2426;12502;-266
2017-09-03 01:00:00;30,56;30,19;0,37;40525;0;0;0;0;50435;10208;0.2024;11265;-1057
2017-09-03 02:00:00;29,78;31,14;-1,36;40525;0;0;0;0;50435;9090;0.1802;10452;-1362
2017-09-03 03:00:00;29,3;31,51;-2,21;40525;0;0;0;0;50435;8352;0.1656;9845;-1493
2017-09-03 04:00:00;29,28;30,58;-1,3;40525;0;0;0;0;50435;7960;0.1578;9346;-1386
2017-09-03 05:00:00;31,12;32,52;-1,4;40525;0;0;0;0;50435;7397;0.1467;8788;-1391
2017-09-03 06:00:00;41,59;39,84;1,75;40525;10;0.0002;12;-2;50435;6793;0.1347;8220;-1427
2017-09-03 07:00:00;48,67;48,84;-0,17;40525;636;0.0157;527;109;50435;6334;0.1256;7699;-1365
2017-09-03 08:00:00;50,02;50,99;-0,97;40525;2374;0.0586;1902;472;50435;6383;0.1266;7336;-953
2017-09-03 09:00:00;49,02;46,34;2,68;40525;4715;0.1164;3738;977;50435;6452;0.1279;7181;-729
2017-09-03 10:00:00;48,62;43,93;4,69;40525;6057;0.1494;5641;416;50435;7143;0.1416;7445;-302
2017-09-03 11:00:00;47,16;43,82;3,34;40525;6390;0.1577;7285;-895;50435;8096;0.1605;8194;-98
2017-09-03 12:00:00;43,82;42,13;1,69;40525;6774;0.1672;8025;-1251;50435;9163;0.1817;9061;102
2017-09-03 13:00:00;41,85;41,91;-0,06;40525;6884;0.1698;7759;-875;50435;10502;0.2082;9967;535
2017-09-03 14:00:00;38,09;39,07;-0,98;40525;6026;0.1487;6476;-450;50435;12770;0.2532;10963;1807
2017-09-03 15:00:00;36,69;35,13;1,56;40525;4816;0.1188;4577;239;50435;15945;0.3162;11969;3976
2017-09-03 16:00:00;35,3;31,43;3,87;40525;2807;0.0693;2508;299;50435;18118;0.3592;12885;5233
2017-09-03 17:00:00;41,47;32,34;9,13;40525;917;0.0226;649;268;50435;20004;0.3966;13905;6099
2017-09-03 18:00:00;44,82;34,18;10,64;40525;20;0.0005;10;10;50435;21940;0.435;15135;6805
2017-09-03 19:00:00;42,84;31,95;10,89;40525;0;0;0;0;50435;24498;0.4857;16466;8032
2017-09-03 20:00:00;33,34;28,06;5,28;40525;0;0;0;0;50435;26524;0.5259;17886;8638
2017-09-03 21:00:00;33,02;21,91;11,11;40525;0;0;0;0;50435;27336;0.542;19267;8069
2017-09-03 22:00:00;31,51;23,59;7,92;40525;0;0;0;0;50435;26691;0.5292;20058;6633
2017-09-03 23:00:00;28,82;21,9;6,92;40525;0;0;0;0;50435;25754;0.5107;20159;5595
2017-10-03 00:00:00;20,82;18,27;2,55;40527;0;0;0;0;50435;25142;0.4985;23139;2003
2017-10-03 01:00:00;18,18;14,98;3,2;40527;0;0;0;0;50435;24283;0.4815;22439;1844
2017-10-03 02:00:00;12,01;13,75;-1,74;40527;0;0;0;0;50435;23327;0.4625;21796;1531
2017-10-03 03:00:00;18,09;16,64;1,45;40527;0;0;0;0;50435;22441;0.445;21006;1435
2017-10-03 04:00:00;26,96;21,28;5,68;40527;0;0;0;0;50435;21304;0.4224;19934;1370
2017-10-03 05:00:00;28,59;29,12;-0,53;40527;0;0;0;0;50435;19378;0.3842;18761;617
2017-10-03 06:00:00;31,9;36,38;-4,48;40527;19;0.0004;21;-2;50435;18373;0.3643;17708;665
2017-10-03 07:00:00;41,98;44,53;-2,55;40527;1057;0.0261;1006;51;50435;16938;0.3358;17048;-110
2017-10-03 08:00:00;41,93;42,37;-0,44;40527;4213;0.104;3745;468;50435;15601;0.3094;16849;-1248
2017-10-03 09:00:00;36,96;38,41;-1,45;40527;8058;0.1988;7033;1025;50435;14821;0.2938;16837;-2016
2017-10-03 10:00:00;33,02;34,02;-1,0;40527;11109;0.2741;9933;1176;50435;14833;0.2941;16718;-1885
2017-10-03 11:00:00;32,09;34,13;-2,04;40527;13840;0.3415;12152;1688;50435;14543;0.2884;16283;-1740
2017-10-03 12:00:00;31,51;32,34;-0,83;40527;15813;0.3902;13588;2225;50435;14194;0.2814;15626;-1432
2017-10-03 13:00:00;31,31;31,02;0,29;40527;16071;0.3966;13799;2272;50435;13644;0.2705;14829;-1185
2017-10-03 14:00:00;31,26;29,91;1,35;40527;14348;0.354;12693;1655;50435;12908;0.2559;13713;-805
2017-10-03 15:00:00;32,11;30,81;1,3;40527;10864;0.2681;9702;1162;50435;11336;0.2248;12308;-972
2017-10-03 16:00:00;36,07;35,04;1,03;40527;6312;0.1558;5559;753;50435;9479;0.188;10586;-1107
2017-10-03 17:00:00;40,37;42,75;-2,38;40527;1812;0.0447;1513;299;50435;6518;0.1292;8655;-2137
2017-10-03 18:00:00;49,17;53,84;-4,67;40527;30;0.0007;30;0;50435;4634;0.0919;7014;-2380
2017-10-03 19:00:00;53,56;59,66;-6,1;40527;0;0;0;0;50435;4242;0.0841;5978;-1736
2017-10-03 20:00:00;45,88;48,5;-2,62;40527;0;0;0;0;50435;3939;0.0781;5479;-1540
2017-10-03 21:00:00;39,67;41,55;-1,88;40527;0;0;0;0;50435;3825;0.0758;5022;-1197
2017-10-03 22:00:00;37,71;37,42;0,29;40527;0;0;0;0;50435;3744;0.0742;4549;-805
2017-10-03 23:00:00;34,25;32,27;1,98;40527;0;0;0;0;50435;3780;0.075;4125;-345
2017-11-03 00:00:00;33,02;33,34;-0,32;40528;0;0;0;0;50441;3844;0.0762;3440;404
2017-11-03 01:00:00;31,24;30,68;0,56;40528;0;0;0;0;50441;3812;0.0756;3332;480
2017-11-03 02:00:00;30,13;30,4;-0,27;40528;0;0;0;0;50441;3935;0.078;3245;690
2017-11-03 03:00:00;29,64;28,13;1,51;40528;0;0;0;0;50441;3767;0.0747;3180;587
2017-11-03 04:00:00;29,07;27,76;1,31;40528;0;0;0;0;50441;3826;0.0759;3119;707
2017-11-03 05:00:00;30,0;29,15;0,85;40528;0;0;0;0;50441;3871;0.0767;3036;835
2017-11-03 06:00:00;31,77;30,78;0,99;40528;52;0.0013;59;-7;50441;3885;0.077;2943;942
2017-11-03 07:00:00;32,4;32,07;0,33;40528;1806;0.0446;2125;-319;50441;3840;0.0762;2753;1087
2017-11-03 08:00:00;35,0;32,8;2,2;40528;5856;0.1445;6735;-879;50441;3347;0.0664;2446;901
2017-11-03 09:00:00;35,05;36,45;-1,4;40528;11132;0.2747;11322;-190;50441;2535;0.0503;2141;394
2017-11-03 10:00:00;33,0;32,34;0,66;40528;15066;0.3718;14875;191;50441;2074;0.0411;1947;127
2017-11-03 11:00:00;31,41;29,14;2,27;40528;17694;0.4366;16946;748;50441;2231;0.0442;1918;313
2017-11-03 12:00:00;31,07;28,11;2,96;40528;18492;0.4563;17628;864;50441;2349;0.0466;1963;386
2017-11-03 13:00:00;30,19;26,85;3,34;40528;17269;0.4261;16907;362;50441;2384;0.0472;2073;311
2017-11-03 14:00:00;29,85;27,41;2,44;40528;14472;0.3571;14725;-253;50441;2688;0.0533;2269;419
2017-11-03 15:00:00;29,98;27,51;2,47;40528;10284;0.2538;11008;-724;50441;3491;0.0692;2533;958
2017-11-03 16:00:00;30,81;27,37;3,44;40528;5553;0.137;6168;-615;50441;4361;0.0864;3180;1181
2017-11-03 17:00:00;34,66;31,62;3,04;40528;1562;0.0385;1666;-104;50441;5091;0.1009;4556;535
2017-11-03 18:00:00;43,97;37,43;6,54;40528;32;0.0008;32;0;50441;7361;0.1459;6323;1038
2017-11-03 19:00:00;45,91;37,62;8,29;40528;0;0;0;0;50441;9719;0.1927;8042;1677
2017-11-03 20:00:00;38,1;31,73;6,37;40528;0;0;0;0;50441;11622;0.2304;9228;2394
2017-11-03 21:00:00;32,26;24,4;7,86;40528;0;0;0;0;50441;13499;0.2676;10117;3382
2017-11-03 22:00:00;32,11;22,67;9,44;40528;0;0;0;0;50441;14338;0.2842;10576;3762
2017-11-03 23:00:00;30,05;20,15;9,9;40528;0;0;0;0;50441;14570;0.2889;10603;3967
2017-12-03 00:00:00;27,9;13,49;14,41;40528;0;0;0;0;50447;14373;0.285;12280;2093
2017-12-03 01:00:00;25,4;11,96;13,44;40528;0;0;0;0;50447;13631;0.2702;12002;1629
2017-12-03 02:00:00;20,36;14,07;6,29;40528;0;0;0;0;50447;13864;0.2748;11882;1982
2017-12-03 03:00:00;13,92;11,7;2,22;40528;0;0;0;0;50447;14361;0.2847;11849;2512
2017-12-03 04:00:00;10,88;9,7;1,18;40528;0;0;0;0;50447;14731;0.292;12047;2684
2017-12-03 05:00:00;11,95;9,36;2,59;40528;0;0;0;0;50447;14833;0.294;12477;2356
2017-12-03 06:00:00;13,92;9,56;4,36;40528;85;0.0021;85;0;50447;15235;0.302;12869;2366
2017-12-03 07:00:00;11,21;9,39;1,82;40528;2786;0.0687;2434;352;50447;15197;0.3013;12788;2409
2017-12-03 08:00:00;10,97;8,86;2,11;40528;8495;0.2096;7838;657;50447;13721;0.272;11995;1726
2017-12-03 09:00:00;13,28;9,8;3,48;40528;14407;0.3555;13451;956;50447;11505;0.228;11207;298
2017-12-03 10:00:00;10,18;11,0;-0,82;40528;18596;0.4588;17660;936;50447;10743;0.2129;10861;-118
2017-12-03 11:00:00;15,63;10,66;4,97;40528;20784;0.5128;20044;740;50447;11990;0.2377;11021;969
2017-12-03 12:00:00;9,6;9,82;-0,22;40528;21356;0.5269;20679;677;50447;13048;0.2586;11222;1826
2017-12-03 13:00:00;12,21;9,34;2,87;40528;20152;0.4972;19553;599;50447;12821;0.2542;11223;1598
2017-12-03 14:00:00;9,55;7,66;1,89;40528;17332;0.4276;16697;635;50447;12443;0.2467;10983;1460
2017-12-03 15:00:00;11,93;8,13;3,8;40528;12680;0.3128;12413;267;50447;12274;0.2433;10853;1421
2017-12-03 16:00:00;11,0;8,29;2,71;40528;7061;0.1742;7025;36;50447;12101;0.2398;11196;905
2017-12-03 17:00:00;26,9;15,59;11,31;40528;1963;0.0484;1973;-10;50447;12138;0.2406;12215;-77
2017-12-03 18:00:00;31,15;30,41;0,74;40528;44;0.0011;42;2;50447;13672;0.271;13512;160
2017-12-03 19:00:00;31,35;33,38;-2,03;40528;0;0;0;0;50447;15471;0.3067;14289;1182
2017-12-03 20:00:00;30,69;31,61;-0,92;40528;0;0;0;0;50447;15600;0.3092;14172;1428
2017-12-03 21:00:00;30,62;29,04;1,58;40528;0;0;0;0;50447;15054;0.2984;13736;1318
2017-12-03 22:00:00;30,4;30,64;-0,24;40528;0;0;0;0;50447;13869;0.2749;12973;896
2017-12-03 23:00:00;29,34;28,79;0,55;40528;0;0;0;0;50447;12480;0.2474;11856;624
2017-03-13 00:00:00;27,04;25,52;1,52;40530;0;0;0;0;50449;11350;0.225;11252;98
2017-03-13 01:00:00;26,82;25,41;1,41;40530;0;0;0;0;50449;10464;0.2074;9840;624
2017-03-13 02:00:00;26,9;24,55;2,35;40530;0;0;0;0;50449;9507;0.1884;8616;891
2017-03-13 03:00:00;27,02;23,44;3,58;40530;0;0;0;0;50449;8314;0.1648;7499;815
2017-03-13 04:00:00;27,77;22,23;5,54;40530;0;0;0;0;50449;7522;0.1491;6598;924
2017-03-13 05:00:00;29,64;26,09;3,55;40530;0;0;0;0;50449;6948;0.1377;5948;1000
2017-03-13 06:00:00;33,83;32,49;1,34;40530;114;0.0028;116;-2;50449;6660;0.132;5262;1398
2017-03-13 07:00:00;41,0;38,53;2,47;40530;2856;0.0705;2902;-46;50449;6153;0.122;4345;1808
2017-03-13 08:00:00;42,86;41,36;1,5;40530;8212;0.2026;8559;-347;50449;4706;0.0933;3191;1515
2017-03-13 09:00:00;40,0;36,79;3,21;40530;14030;0.3462;14206;-176;50449;2720;0.0539;2120;600
2017-03-13 10:00:00;34,57;34,64;-0,07;40530;18227;0.4497;18472;-245;50449;1795;0.0356;1418;377
2017-03-13 11:00:00;32,89;32,09;0,8;40530;20542;0.5068;20706;-164;50449;1450;0.0288;1222;228
2017-03-13 12:00:00;31,97;31,75;0,22;40530;21035;0.519;20730;305;50449;1513;0.03;1131;382
2017-03-13 13:00:00;32,2;31,99;0,21;40530;19134;0.4721;18932;202;50449;1472;0.0292;1100;372
2017-03-13 14:00:00;31,7;34,45;-2,75;40530;15073;0.3719;15654;-581;50449;1508;0.0299;1188;320
2017-03-13 15:00:00;32,0;34,68;-2,68;40530;9434;0.2328;11191;-1757;50449;1936;0.0384;1348;588
2017-03-13 16:00:00;36,61;36,51;0,1;40530;4848;0.1196;6144;-1296;50449;2099;0.0416;1589;510
2017-03-13 17:00:00;41,82;38,78;3,04;40530;1508;0.0372;1784;-276;50449;2480;0.0492;1974;506
2017-03-13 18:00:00;49,9;46,73;3,17;40530;38;0.0009;45;-7;50449;3090;0.0613;2438;652
2017-03-13 19:00:00;56,99;49,69;7,3;40530;0;0;0;0;50449;3854;0.0764;3003;851
2017-03-13 20:00:00;49,51;42,55;6,96;40530;0;0;0;0;50449;4376;0.0867;3619;757
2017-03-13 21:00:00;44,94;36,29;8,65;40530;0;0;0;0;50449;4621;0.0916;4149;472
2017-03-13 22:00:00;39,96;33,38;6,58;40530;0;0;0;0;50449;4604;0.0913;4493;111
2017-03-13 23:00:00;33,55;31,4;2,15;40530;0;0;0;0;50449;5004;0.0992;4693;311
2017-03-14 00:00:00;29,58;30,36;-0,78;40539;0;0;0;0;50455;5200;0.1031;5846;-646
2017-03-14 01:00:00;28,61;26,91;1,7;40539;0;0;0;0;50455;5503;0.1091;6407;-904
2017-03-14 02:00:00;27,73;26,4;1,33;40539;0;0;0;0;50455;6379;0.1264;6987;-608
2017-03-14 03:00:00;27,75;25,3;2,45;40539;0;0;0;0;50455;7152;0.1417;7325;-173
2017-03-14 04:00:00;28,43;25,89;2,54;40539;0;0;0;0;50455;7627;0.1512;7551;76
2017-03-14 05:00:00;29,49;27,05;2,44;40539;0;0;0;0;50455;7989;0.1584;7711;278
2017-03-14 06:00:00;37,72;34,07;3,65;40539;86;0.0021;75;11;50455;8500;0.1685;7854;646
2017-03-14 07:00:00;44,92;42,28;2,64;40539;1755;0.0433;1677;78;50455;8797;0.1744;7851;946
2017-03-14 08:00:00;47,1;46,91;0,19;40539;5024;0.1239;5044;-20;50455;7918;0.157;7702;216
2017-03-14 09:00:00;43,97;40,75;3,22;40539;9313;0.2297;8718;595;50455;7171;0.1421;7686;-515
2017-03-14 10:00:00;41,93;37,95;3,98;40539;13241;0.3266;12087;1154;50455;7812;0.1548;8141;-329
2017-03-14 11:00:00;37,19;30,81;6,38;40539;16255;0.401;14528;1727;50455;9072;0.1798;9181;-109
2017-03-14 12:00:00;31,08;28,67;2,41;40539;17120;0.4223;15644;1476;50455;10660;0.2113;10409;251
2017-03-14 13:00:00;30,08;28,29;1,79;40539;16270;0.4014;15420;850;50455;11966;0.2372;11598;368
2017-03-14 14:00:00;30,08;28,77;1,31;40539;13868;0.3421;13614;254;50455;13196;0.2615;12327;869
2017-03-14 15:00:00;30,16;28,6;1,56;40539;9717;0.2397;10197;-480;50455;13984;0.2772;12762;1222
2017-03-14 16:00:00;35,0;31,86;3,14;40539;5239;0.1292;5819;-580;50455;13721;0.2719;13065;656
2017-03-14 17:00:00;41,15;36,29;4,86;40539;1590;0.0392;1769;-179;50455;13508;0.2677;13435;73
2017-03-14 18:00:00;45,58;41,2;4,38;40539;42;0.001;47;-5;50455;14530;0.288;14096;434
2017-03-14 19:00:00;45,46;38,7;6,76;40539;0;0;0;0;50455;16248;0.322;15127;1121
2017-03-14 20:00:00;35,85;33,67;2,18;40539;0;0;0;0;50455;17536;0.3476;16342;1194
2017-03-14 21:00:00;28,99;29,09;-0,1;40539;0;0;0;0;50455;18390;0.3645;17407;983
2017-03-14 22:00:00;28,08;27,9;0,18;40539;0;0;0;0;50455;18474;0.3661;17963;511
2017-03-14 23:00:00;23,44;24,17;-0,73;40539;0;0;0;0;50455;18185;0.3604;18043;142
2017-03-15 00:00:00;22,21;21,98;0,23;40545;0;0;0;0;50460;17846;0.3537;17384;462
2017-03-15 01:00:00;21,14;19,02;2,12;40545;0;0;0;0;50460;17373;0.3443;16915;458
2017-03-15 02:00:00;18,65;17,34;1,31;40545;0;0;0;0;50460;17212;0.3411;16283;929
2017-03-15 03:00:00;20,16;18,14;2,02;40545;0;0;0;0;50460;17028;0.3374;15625;1403
2017-03-15 04:00:00;24,03;20,91;3,12;40545;0;0;0;0;50460;16626;0.3295;14819;1807
2017-03-15 05:00:00;28,05;21,67;6,38;40545;0;0;0;0;50460;15354;0.3043;13768;1586
2017-03-15 06:00:00;34,96;27,3;7,66;40545;104;0.0026;92;12;50460;14066;0.2788;12778;1288
2017-03-15 07:00:00;40,98;31,76;9,22;40545;1912;0.0472;1701;211;50460;12033;0.2385;12064;-31
2017-03-15 08:00:00;40,97;36,99;3,98;40545;5118;0.1262;4811;307;50460;11106;0.2201;11774;-668
2017-03-15 09:00:00;38,99;39,07;-0,08;40545;8923;0.2201;8015;908;50460;10814;0.2143;11884;-1070
2017-03-15 10:00:00;34,94;34,11;0,83;40545;12763;0.3148;10672;2091;50460;10756;0.2132;12495;-1739
2017-03-15 11:00:00;33,07;32,32;0,75;40545;15690;0.387;12467;3223;50460;11368;0.2253;13572;-2204
2017-03-15 12:00:00;32,14;30,47;1,67;40545;16950;0.4181;13069;3881;50460;12772;0.2531;14724;-1952
2017-03-15 13:00:00;31,5;28,08;3,42;40545;16896;0.4167;12562;4334;50460;14075;0.2789;15393;-1318
2017-03-15 14:00:00;31,42;26,86;4,56;40545;15033;0.3708;10901;4132;50460;14756;0.2924;15299;-543
2017-03-15 15:00:00;32,4;27,6;4,8;40545;11318;0.2792;8191;3127;50460;14464;0.2866;14766;-302
2017-03-15 16:00:00;33,06;29,67;3,39;40545;6752;0.1665;4864;1888;50460;13337;0.2643;13767;-430
2017-03-15 17:00:00;41,0;37,16;3,84;40545;2124;0.0524;1582;542;50460;11162;0.2212;12400;-1238
2017-03-15 18:00:00;47,97;41,9;6,07;40545;78;0.0019;53;25;50460;9978;0.1978;11325;-1347
2017-03-15 19:00:00;52,09;46,88;5,21;40545;0;0;0;0;50460;10376;0.2056;10840;-464
2017-03-15 20:00:00;43,9;38,77;5,13;40545;0;0;0;0;50460;11258;0.2231;10689;569
2017-03-15 21:00:00;38,1;33,23;4,87;40545;0;0;0;0;50460;11433;0.2266;10588;845
2017-03-15 22:00:00;34,82;31,02;3,8;40545;0;0;0;0;50460;11217;0.2223;10517;700
2017-03-15 23:00:00;31,59;29,92;1,67;40545;0;0;0;0;50460;11208;0.2221;10464;744
2017-03-16 00:00:00;29,99;30,2;-0,21;40549;0;0;0;0;50464;10353;0.2052;9371;982
2017-03-16 01:00:00;29,84;28,82;1,02;40549;0;0;0;0;50464;9785;0.1939;9252;533
2017-03-16 02:00:00;28,14;27,96;0,18;40549;0;0;0;0;50464;10052;0.1992;9226;826
2017-03-16 03:00:00;28,29;25,81;2,48;40549;0;0;0;0;50464;10031;0.1988;9183;848
2017-03-16 04:00:00;29,37;25,79;3,58;40549;0;0;0;0;50464;9742;0.193;9210;532
2017-03-16 05:00:00;30,0;28,18;1,82;40549;0;0;0;0;50464;9686;0.1919;9255;431
2017-03-16 06:00:00;38,48;34,61;3,87;40549;121;0.003;166;-45;50464;9246;0.1832;9089;157
2017-03-16 07:00:00;45,18;40,83;4,35;40549;2620;0.0646;2889;-269;50464;8220;0.1629;8551;-331
2017-03-16 08:00:00;40,95;39,89;1,06;40549;8086;0.1994;7888;198;50464;6846;0.1357;7594;-748
2017-03-16 09:00:00;36,15;40,63;-4,48;40549;14411;0.3554;13140;1271;50464;5730;0.1136;6625;-895
2017-03-16 10:00:00;32,94;32,07;0,87;40549;19408;0.4786;17541;1867;50464;5737;0.1136;6328;-591
2017-03-16 11:00:00;31,87;28,14;3,73;40549;21900;0.5401;20407;1493;50464;6336;0.1256;6739;-403
2017-03-16 12:00:00;30,49;28,05;2,44;40549;22409;0.5526;21338;1071;50464;7378;0.1462;7416;-38
2017-03-16 13:00:00;30,45;27,09;3,36;40549;21348;0.5264;20415;933;50464;8224;0.163;8086;138
2017-03-16 14:00:00;30,19;26,93;3,26;40549;18460;0.4552;17761;699;50464;8717;0.1728;8623;94
2017-03-16 15:00:00;30,28;26,58;3,7;40549;13910;0.343;13438;472;50464;8687;0.1722;8879;-192
2017-03-16 16:00:00;33,5;27,92;5,58;40549;8093;0.1996;7825;268;50464;8049;0.1595;8663;-614
2017-03-16 17:00:00;39,9;32,07;7,83;40549;2573;0.0634;2459;114;50464;7042;0.1396;8527;-1485
2017-03-16 18:00:00;45,59;39,6;5,99;40549;113;0.0028;87;26;50464;7704;0.1527;9015;-1311
2017-03-16 19:00:00;50,1;45,44;4,66;40549;0;0;0;0;50464;9324;0.1847;10139;-815
2017-03-16 20:00:00;42,92;35,72;7,2;40549;0;0;0;0;50464;11726;0.2324;11915;-189
2017-03-16 21:00:00;34,81;32,48;2,33;40549;0;0;0;0;50464;14550;0.2883;13896;654
2017-03-16 22:00:00;30,19;29,26;0,93;40549;0;0;0;0;50464;16592;0.3288;15571;1021
2017-03-16 23:00:00;26,36;25,89;0,47;40549;0;0;0;0;50464;17821;0.3531;16707;1114
2017-03-17 00:00:00;21,63;28,98;-7,35;40553;0;0;0;0;50472;18635;0.3692;18685;-50
2017-03-17 01:00:00;18,76;26,52;-7,76;40553;0;0;0;0;50472;19977;0.3958;19116;861
2017-03-17 02:00:00;18,53;23,98;-5,45;40553;0;0;0;0;50472;20646;0.4091;19035;1611
2017-03-17 03:00:00;20,93;21,07;-0,14;40553;0;0;0;0;50472;20526;0.4067;18823;1703
2017-03-17 04:00:00;24,11;21,61;2,5;40553;0;0;0;0;50472;19644;0.3892;18507;1137
2017-03-17 05:00:00;28,0;28,55;-0,55;40553;0;0;0;0;50472;19081;0.378;18089;992
2017-03-17 06:00:00;39,97;39,01;0,96;40553;168;0.0042;161;7;50472;19249;0.3814;17616;1633
2017-03-17 07:00:00;40,91;36,5;4,41;40553;2633;0.0649;2388;245;50472;17995;0.3566;17222;773
2017-03-17 08:00:00;40,45;31,0;9,45;40553;6888;0.1698;5990;898;50472;17976;0.3561;17161;815
2017-03-17 09:00:00;33,97;29,02;4,95;40553;10692;0.2637;9243;1449;50472;17609;0.3489;17523;86
2017-03-17 10:00:00;32,17;26,73;5,44;40553;13660;0.3368;11601;2059;50472;19058;0.3776;18481;577
2017-03-17 11:00:00;29,71;25,63;4,08;40553;14099;0.3476;12861;1238;50472;20672;0.4096;20030;642
2017-03-17 12:00:00;27,83;22,72;5,11;40553;12966;0.3197;12699;267;50472;22820;0.4521;21675;1145
2017-03-17 13:00:00;25,44;23,89;1,55;40553;11522;0.2841;11470;52;50472;24860;0.4925;23212;1648
2017-03-17 14:00:00;22,1;23,53;-1,43;40553;9762;0.2408;9573;189;50472;25597;0.5072;24154;1443
2017-03-17 15:00:00;22,78;24,34;-1,56;40553;6970;0.1719;7120;-150;50472;26350;0.5221;24680;1670
2017-03-17 16:00:00;26,48;25,18;1,3;40553;3500;0.0863;4081;-581;50472;25806;0.5113;24305;1501
2017-03-17 17:00:00;30,96;31,22;-0,26;40553;1071;0.0264;1318;-247;50472;23996;0.4754;22878;1118
2017-03-17 18:00:00;38,1;35,79;2,31;40553;32;0.0008;59;-27;50472;22000;0.4359;21532;468
2017-03-17 19:00:00;40,45;40,93;-0,48;40553;0;0;0;0;50472;20876;0.4136;21142;-266
2017-03-17 20:00:00;32,99;34,4;-1,41;40553;0;0;0;0;50472;20669;0.4095;21980;-1311
2017-03-17 21:00:00;27,91;31,29;-3,38;40553;0;0;0;0;50472;21554;0.427;23169;-1615
2017-03-17 22:00:00;24,5;30,36;-5,86;40553;0;0;0;0;50472;22806;0.4519;24472;-1666
2017-03-17 23:00:00;14,96;21,9;-6,94;40553;0;0;0;0;50472;24462;0.4846;25616;-1154
2017-03-18 00:00:00;11,73;14,01;-2,28;40554;0;0;0;0;50477;26562;0.5262;27610;-1048
2017-03-18 01:00:00;9,42;11,95;-2,53;40554;0;0;0;0;50477;28068;0.5561;28949;-881
2017-03-18 02:00:00;9,39;4,82;4,57;40554;0;0;0;0;50477;29313;0.5807;29824;-511
2017-03-18 03:00:00;8,46;3,1;5,36;40554;0;0;0;0;50477;30353;0.6013;30620;-267
2017-03-18 04:00:00;8,3;5,12;3,18;40554;0;0;0;0;50477;31871;0.6314;30832;1039
2017-03-18 05:00:00;9,37;1,73;7,64;40554;0;0;0;0;50477;33328;0.6602;30336;2992
2017-03-18 06:00:00;10,35;-0,63;10,98;40554;22;0.0006;39;-17;50477;35255;0.6984;29898;5357
2017-03-18 07:00:00;11,25;-0,15;11,4;40554;372;0.0092;402;-30;50477;36614;0.7254;29290;7324
2017-03-18 08:00:00;16,93;-0,26;17,19;40554;1231;0.0304;981;250;50477;37982;0.7525;28408;9574
2017-03-18 09:00:00;28,18;2,52;25,66;40554;2582;0.0637;1676;906;50477;38008;0.753;27688;10320
2017-03-18 10:00:00;25,6;0,41;25,19;40554;4011;0.0989;2473;1538;50477;36682;0.7267;27174;9508
2017-03-18 11:00:00;26,83;2,96;23,87;40554;5396;0.133;3316;2080;50477;35304;0.6994;26759;8545
2017-03-18 12:00:00;25,69;3,22;22,47;40554;6498;0.1602;4101;2397;50477;34070;0.675;26459;7611
2017-03-18 13:00:00;17,01;2,73;14,28;40554;6713;0.1655;4508;2205;50477;33086;0.6555;26230;6856
2017-03-18 14:00:00;9,75;3,39;6,36;40554;5730;0.1413;4254;1476;50477;32186;0.6376;25638;6548
2017-03-18 15:00:00;14,36;4,18;10,18;40554;4142;0.1021;3271;871;50477;30812;0.6104;24789;6023
2017-03-18 16:00:00;9,99;6,02;3,97;40554;2299;0.0567;1947;352;50477;28360;0.5618;23134;5226
2017-03-18 17:00:00;27,44;20,71;6,73;40554;672;0.0166;653;19;50477;25254;0.5003;20483;4771
2017-03-18 18:00:00;32,31;31,76;0,55;40554;22;0.0006;32;-10;50477;21419;0.4243;17684;3735
2017-03-18 19:00:00;37,94;35,29;2,65;40554;0;0;0;0;50477;19099;0.3784;15554;3545
2017-03-18 20:00:00;31,27;31,74;-0,47;40554;0;0;0;0;50477;17348;0.3437;14443;2905
2017-03-18 21:00:00;30,74;29,41;1,33;40554;0;0;0;0;50477;15679;0.3106;13416;2263
2017-03-18 22:00:00;30,75;27,84;2,91;40554;0;0;0;0;50477;13560;0.2686;12348;1212
2017-03-18 23:00:00;29,06;26,47;2,59;40554;0;0;0;0;50477;12128;0.2403;11296;832
2017-03-19 00:00:00;16,62;24,21;-7,59;40554;0;0;0;0;50489;10880;0.2155;11729;-849
2017-03-19 01:00:00;15,79;24,11;-8,32;40554;0;0;0;0;50489;10042;0.1989;10428;-386
2017-03-19 02:00:00;16,12;19,41;-3,29;40554;0;0;0;0;50489;9379;0.1858;9452;-73
2017-03-19 03:00:00;12,67;18,3;-5,63;40554;0;0;0;0;50489;9024;0.1787;8559;465
2017-03-19 04:00:00;13,43;19,96;-6,53;40554;0;0;0;0;50489;8826;0.1748;8173;653
2017-03-19 05:00:00;12,47;17,47;-5,0;40554;0;0;0;0;50489;9716;0.1925;8667;1049
2017-03-19 06:00:00;11,62;13,39;-1,77;40554;94;0.0023;102;-8;50489;12148;0.2406;9571;2577
2017-03-19 07:00:00;9,64;11,69;-2,05;40554;1053;0.026;880;173;50489;14534;0.2878;11111;3423
2017-03-19 08:00:00;13,73;6,28;7,45;40554;2238;0.0552;1908;330;50489;17188;0.3404;13087;4101
2017-03-19 09:00:00;18,44;10,08;8,36;40554;3379;0.0833;2759;620;50489;20053;0.3972;15179;4874
2017-03-19 10:00:00;21,06;9,9;11,16;40554;4280;0.1055;3436;844;50489;21878;0.4333;17292;4586
2017-03-19 11:00:00;17,63;11,41;6,22;40554;4945;0.122;3842;1103;50489;22874;0.453;19541;3333
2017-03-19 12:00:00;18,05;11,91;6,14;40554;4920;0.1213;3923;997;50489;23604;0.4675;21796;1808
2017-03-19 13:00:00;11,35;12,55;-1,2;40554;4764;0.1175;3785;979;50489;25120;0.4976;23528;1592
2017-03-19 14:00:00;10,12;13,32;-3,2;40554;4220;0.104;3347;873;50489;26797;0.5308;24801;1996
2017-03-19 15:00:00;9,44;10,67;-1,23;40554;3414;0.0842;2511;903;50489;27608;0.5468;26304;1304
2017-03-19 16:00:00;9,42;11,98;-2,56;40554;2149;0.053;1506;643;50489;28889;0.5722;27170;1719
2017-03-19 17:00:00;10,15;13,03;-2,88;40554;774;0.0191;559;215;50489;30065;0.5955;27198;2867
2017-03-19 18:00:00;17,09;18,17;-1,08;40554;30;0.0007;33;-3;50489;30809;0.6102;27386;3423
2017-03-19 19:00:00;16,72;17,14;-0,42;40554;0;0;0;0;50489;30962;0.6133;27403;3559
2017-03-19 20:00:00;11,96;11,43;0,53;40554;0;0;0;0;50489;31163;0.6172;27110;4053
2017-03-19 21:00:00;9,47;8,33;1,14;40554;0;0;0;0;50489;31304;0.62;26675;4629
2017-03-19 22:00:00;12,51;10,5;2,01;40554;0;0;0;0;50489;29889;0.592;25868;4021
2017-03-19 23:00:00;10,12;7,66;2,46;40554;0;0;0;0;50489;28720;0.5688;24705;4015
2017-03-20 00:00:00;10,59;5,37;5,22;40560;0;0;0;0;50495;26538;0.5256;23058;3480
2017-03-20 01:00:00;13,87;6,41;7,46;40560;0;0;0;0;50495;24436;0.4839;21349;3087
2017-03-20 02:00:00;10,07;5,89;4,18;40560;0;0;0;0;50495;22628;0.4481;19780;2848
2017-03-20 03:00:00;16,36;9,02;7,34;40560;0;0;0;0;50495;19667;0.3895;18319;1348
2017-03-20 04:00:00;22,06;14,85;7,21;40560;0;0;0;0;50495;17473;0.346;16945;528
2017-03-20 05:00:00;26,08;28,3;-2,22;40560;0;0;0;0;50495;16170;0.3202;16165;5
2017-03-20 06:00:00;36,3;41,64;-5,34;40560;67;0.0016;88;-21;50495;15457;0.3061;15789;-332
2017-03-20 07:00:00;40,98;46,29;-5,31;40560;968;0.0238;988;-20;50495;15548;0.3079;16132;-584
2017-03-20 08:00:00;42,31;48,19;-5,88;40560;2704;0.0667;2552;152;50495;16564;0.328;17149;-585
2017-03-20 09:00:00;39,34;43,38;-4,04;40560;4748;0.1171;4386;362;50495;17738;0.3513;18225;-487
2017-03-20 10:00:00;38,96;39,62;-0,66;40560;6774;0.167;6013;761;50495;19826;0.3927;19375;451
2017-03-20 11:00:00;36,94;38,52;-1,58;40560;8396;0.207;7225;1171;50495;21361;0.423;20471;890
2017-03-20 12:00:00;35,0;34,39;0,61;40560;9052;0.2232;7868;1184;50495;22072;0.4371;21377;695
2017-03-20 13:00:00;32,74;31,72;1,02;40560;8864;0.2185;7796;1068;50495;23056;0.4566;21993;1063
2017-03-20 14:00:00;31,16;31,3;-0,14;40560;7920;0.1953;7028;892;50495;23568;0.4668;22212;1356
2017-03-20 15:00:00;30,82;29,6;1,22;40560;6504;0.1604;5433;1071;50495;23835;0.472;22425;1410
2017-03-20 16:00:00;30,56;30,02;0,54;40560;4250;0.1048;3256;994;50495;24211;0.4795;22696;1515
2017-03-20 17:00:00;32,0;30,09;1,91;40560;1496;0.0369;1128;368;50495;25072;0.4965;23037;2035
2017-03-20 18:00:00;38,38;32,48;5,9;40560;58;0.0014;59;-1;50495;25614;0.5073;23472;2142
2017-03-20 19:00:00;36,94;33,16;3,78;40560;0;0;0;0;50495;26685;0.5284;24099;2586
2017-03-20 20:00:00;32,42;30,72;1,7;40560;0;0;0;0;50495;28165;0.5578;24758;3407
2017-03-20 21:00:00;27,6;25,06;2,54;40560;0;0;0;0;50495;28671;0.5678;25174;3497
2017-03-20 22:00:00;25,2;20,87;4,33;40560;0;0;0;0;50495;27996;0.5544;25034;2962
2017-03-20 23:00:00;10,75;12,98;-2,23;40560;0;0;0;0;50495;27788;0.5503;24316;3472
2017-03-21 00:00:00;18,76;19,09;-0,33;40566;0;0;0;0;50511;26777;0.5301;26034;743
2017-03-21 01:00:00;17,48;15,32;2,16;40566;0;0;0;0;50511;25026;0.4955;24849;177
2017-03-21 02:00:00;15,92;14,49;1,43;40566;0;0;0;0;50511;22584;0.4471;23522;-938
2017-03-21 03:00:00;18,02;21,29;-3,27;40566;0;0;0;0;50511;20794;0.4117;22126;-1332
2017-03-21 04:00:00;22,6;26,35;-3,75;40566;0;0;0;0;50511;19556;0.3872;20783;-1227
2017-03-21 05:00:00;23,99;28,12;-4,13;40566;0;0;0;0;50511;18490;0.3661;19904;-1414
2017-03-21 06:00:00;31,01;42,42;-11,41;40566;134;0.0033;187;-53;50511;18352;0.3633;19428;-1076
2017-03-21 07:00:00;35,96;43,32;-7,36;40566;1569;0.0387;1867;-298;50511;17740;0.3512;19385;-1645
2017-03-21 08:00:00;35,31;43,42;-8,11;40566;4258;0.105;4508;-250;50511;17448;0.3454;19962;-2514
2017-03-21 09:00:00;30,84;40,82;-9,98;40566;7283;0.1795;7230;53;50511;17782;0.3521;21201;-3419
2017-03-21 10:00:00;29,97;37,7;-7,73;40566;8978;0.2213;9371;-393;50511;18822;0.3727;21962;-3140
2017-03-21 11:00:00;29,69;34,85;-5,16;40566;9807;0.2418;10619;-812;50511;18444;0.3652;22778;-4334
2017-03-21 12:00:00;29,08;35,18;-6,1;40566;10000;0.2465;10615;-615;50511;18750;0.3712;23239;-4489
2017-03-21 13:00:00;28,86;35,08;-6,22;40566;9655;0.238;9710;-55;50511;18425;0.3648;23296;-4871
2017-03-21 14:00:00;28,94;35,57;-6,63;40566;8136;0.2006;8173;-37;50511;18034;0.357;22783;-4749
2017-03-21 15:00:00;29,37;38,86;-9,49;40566;5828;0.1436;6094;-266;50511;18098;0.3583;21978;-3880
2017-03-21 16:00:00;30,1;41,17;-11,07;40566;3324;0.082;3678;-354;50511;17952;0.3554;20378;-2426
2017-03-21 17:00:00;36,65;40,95;-4,3;40566;1214;0.03;1364;-150;50511;16385;0.3244;18056;-1671
2017-03-21 18:00:00;42,98;45,97;-2,99;40566;108;0.0027;95;13;50511;13816;0.2735;15730;-1914
2017-03-21 19:00:00;47,25;48,26;-1,01;40566;0;0;0;0;50511;12890;0.2552;14089;-1199
2017-03-21 20:00:00;41,77;44,47;-2,7;40566;0;0;0;0;50511;12132;0.2402;13160;-1028
2017-03-21 21:00:00;37,75;41,19;-3,44;40566;0;0;0;0;50511;11592;0.2295;12508;-916
2017-03-21 22:00:00;34,99;32,08;2,91;40566;0;0;0;0;50511;10812;0.214;11910;-1098
2017-03-21 23:00:00;33,96;30,52;3,44;40566;0;0;0;0;50511;10745;0.2127;11341;-596
2017-03-22 00:00:00;30,45;31,58;-1,13;40571;0;0;0;0;50522;10647;0.2108;11567;-920
2017-03-22 01:00:00;29,98;31,5;-1,52;40571;0;0;0;0;50522;10146;0.2008;11051;-905
2017-03-22 02:00:00;29,2;29,22;-0,02;40571;0;0;0;0;50522;9481;0.1877;10560;-1079
2017-03-22 03:00:00;29,05;29,78;-0,73;40571;0;0;0;0;50522;9460;0.1873;9982;-522
2017-03-22 04:00:00;29,05;29,5;-0,45;40571;0;0;0;0;50522;9064;0.1794;9528;-464
2017-03-22 05:00:00;30,41;32,54;-2,13;40571;0;0;0;0;50522;9068;0.1795;9126;-58
2017-03-22 06:00:00;35,19;37,99;-2,8;40571;242;0.006;290;-48;50522;8849;0.1752;8731;118
2017-03-22 07:00:00;40,19;41,94;-1,75;40571;2228;0.0549;2646;-418;50522;7758;0.1535;7926;-168
2017-03-22 08:00:00;43,02;47,04;-4,02;40571;5602;0.1381;6385;-783;50522;5805;0.1149;6411;-606
2017-03-22 09:00:00;41,74;49,17;-7,43;40571;9263;0.2283;10007;-744;50522;4989;0.0987;5081;-92
2017-03-22 10:00:00;37,54;44,11;-6,57;40571;11939;0.2943;12506;-567;50522;5386;0.1066;4756;630
2017-03-22 11:00:00;36,69;40,62;-3,93;40571;12910;0.3182;13698;-788;50522;5701;0.1128;4781;920
2017-03-22 12:00:00;36,25;38,99;-2,74;40571;12776;0.3149;13526;-750;50522;5095;0.1009;4469;626
2017-03-22 13:00:00;35,95;39,05;-3,1;40571;11712;0.2887;12288;-576;50522;3891;0.077;4113;-222
2017-03-22 14:00:00;35,02;40,16;-5,14;40571;9426;0.2323;10255;-829;50522;3456;0.0684;4043;-587
2017-03-22 15:00:00;36,35;41,46;-5,11;40571;6587;0.1624;7731;-1144;50522;3608;0.0714;4248;-640
2017-03-22 16:00:00;36,9;42,98;-6,08;40571;3610;0.089;4753;-1143;50522;3844;0.0761;4713;-869
2017-03-22 17:00:00;39,6;44,44;-4,84;40571;1225;0.0302;1759;-534;50522;4212;0.0834;5394;-1182
2017-03-22 18:00:00;42,4;48,08;-5,68;40571;85;0.0021;128;-43;50522;4840;0.0958;6611;-1771
2017-03-22 19:00:00;45,0;52,71;-7,71;40571;0;0;0;0;50522;6411;0.1269;8491;-2080
2017-03-22 20:00:00;38,98;46,51;-7,53;40571;0;0;0;0;50522;8036;0.1591;10073;-2037
2017-03-22 21:00:00;32,18;41,42;-9,24;40571;0;0;0;0;50522;9176;0.1816;10800;-1624
2017-03-22 22:00:00;31,65;33,65;-2,0;40571;0;0;0;0;50522;9926;0.1965;10811;-885
2017-03-22 23:00:00;29,17;28,9;0,27;40571;0;0;0;0;50522;10236;0.2026;10457;-221
2017-03-23 00:00:00;29,45;30,85;-1,4;40577;0;0;0;0;50544;9941;0.1967;10896;-955
2017-03-23 01:00:00;29,1;30,44;-1,34;40577;0;0;0;0;50544;9438;0.1868;10649;-1211
2017-03-23 02:00:00;28,91;31,05;-2,14;40577;0;0;0;0;50544;9224;0.1825;10298;-1074
2017-03-23 03:00:00;28,65;30,25;-1,6;40577;0;0;0;0;50544;9060;0.1792;9929;-869
2017-03-23 04:00:00;28,53;30,61;-2,08;40577;0;0;0;0;50544;8928;0.1766;9767;-839
2017-03-23 05:00:00;30,72;32,73;-2,01;40577;0;0;0;0;50544;8711;0.1723;9810;-1099
2017-03-23 06:00:00;32,38;37,63;-5,25;40577;132;0.0033;217;-85;50544;9082;0.1797;9830;-748
2017-03-23 07:00:00;39,61;47,03;-7,42;40577;1552;0.0382;2062;-510;50544;8562;0.1694;9787;-1225
2017-03-23 08:00:00;40,5;45,46;-4,96;40577;4296;0.1059;5138;-842;50544;7693;0.1522;9393;-1700
2017-03-23 09:00:00;38,91;44,08;-5,17;40577;7964;0.1962;8424;-460;50544;7254;0.1435;8822;-1568
2017-03-23 10:00:00;37,1;41,54;-4,44;40577;11145;0.2746;11244;-99;50544;7251;0.1434;8545;-1294
2017-03-23 11:00:00;36,44;38,36;-1,92;40577;13292;0.3276;13101;191;50544;7626;0.1509;8471;-845
2017-03-23 12:00:00;31,54;32,97;-1,43;40577;14387;0.3546;13878;509;50544;8119;0.1606;8417;-298
2017-03-23 13:00:00;32,03;31,95;0,08;40577;13906;0.3427;13589;317;50544;8186;0.1619;8311;-125
2017-03-23 14:00:00;32,05;31,74;0,31;40577;12152;0.2995;12288;-136;50544;8848;0.175;8074;774
2017-03-23 15:00:00;32,72;33,22;-0,5;40577;9300;0.2292;9755;-455;50544;9332;0.1846;7942;1390
2017-03-23 16:00:00;33,24;33,5;-0,26;40577;5682;0.14;6158;-476;50544;9126;0.1806;8151;975
2017-03-23 17:00:00;37,92;38,74;-0,82;40577;2039;0.0503;2357;-318;50544;9141;0.1808;8692;449
2017-03-23 18:00:00;40,0;43,77;-3,77;40577;150;0.0037;174;-24;50544;9341;0.1848;9473;-132
2017-03-23 19:00:00;42,77;48,15;-5,38;40577;0;0;0;0;50544;9947;0.1968;10186;-239
2017-03-23 20:00:00;38,9;41,61;-2,71;40577;0;0;0;0;50544;10005;0.1979;10295;-290
2017-03-23 21:00:00;34,97;36,02;-1,05;40577;0;0;0;0;50544;9782;0.1935;9912;-130
2017-03-23 22:00:00;32,89;32,75;0,14;40577;0;0;0;0;50544;9497;0.1879;9193;304
2017-03-23 23:00:00;30,63;30,06;0,57;40577;0;0;0;0;50544;8911;0.1763;8235;676
2017-03-24 00:00:00;29,04;27,68;1,36;40583;0;0;0;0;50570;8065;0.1595;8011;54
2017-03-24 01:00:00;28,99;27,72;1,27;40583;0;0;0;0;50570;7380;0.1459;7430;-50
2017-03-24 02:00:00;29,21;27,9;1,31;40583;0;0;0;0;50570;6962;0.1377;7182;-220
2017-03-24 03:00:00;28,87;28,74;0,13;40583;0;0;0;0;50570;6940;0.1372;6957;-17
2017-03-24 04:00:00;29,0;28,27;0,73;40583;0;0;0;0;50570;7131;0.141;7004;127
2017-03-24 05:00:00;30,14;27,96;2,18;40583;0;0;0;0;50570;7112;0.1406;7116;-4
2017-03-24 06:00:00;37,91;35,31;2,6;40583;369;0.0091;427;-58;50570;7493;0.1482;6950;543
2017-03-24 07:00:00;41,69;39,68;2,01;40583;2818;0.0694;3459;-641;50570;7702;0.1523;6505;1197
2017-03-24 08:00:00;43,79;38,45;5,34;40583;6651;0.1639;8023;-1372;50570;6404;0.1266;5691;713
2017-03-24 09:00:00;41,09;40,5;0,59;40583;10461;0.2578;12884;-2423;50570;5578;0.1103;4680;898
2017-03-24 10:00:00;35,71;39,66;-3,95;40583;13468;0.3319;16977;-3509;50570;5518;0.1091;4175;1343
2017-03-24 11:00:00;33,07;38,24;-5,17;40583;15608;0.3846;19725;-4117;50570;5252;0.1038;4467;785
2017-03-24 12:00:00;32,09;38,41;-6,32;40583;16750;0.4127;20690;-3940;50570;4470;0.0884;4762;-292
2017-03-24 13:00:00;30,29;34,17;-3,88;40583;16631;0.4098;20013;-3382;50570;3963;0.0784;4938;-975
2017-03-24 14:00:00;29,9;33,75;-3,85;40583;15202;0.3746;17632;-2430;50570;4095;0.081;5106;-1011
2017-03-24 15:00:00;30,07;33,2;-3,13;40583;12154;0.2995;13521;-1367;50570;4662;0.0922;5385;-723
2017-03-24 16:00:00;31,2;34,39;-3,19;40583;7421;0.1829;8178;-757;50570;5266;0.1042;5851;-585
2017-03-24 17:00:00;36,63;41,2;-4,57;40583;2682;0.0661;2990;-308;50570;5471;0.1082;6418;-947
2017-03-24 18:00:00;40,59;44,44;-3,85;40583;212;0.0052;223;-11;50570;6048;0.1196;7006;-958
2017-03-24 19:00:00;42,96;47,42;-4,46;40583;0;0;0;0;50570;7618;0.1506;7651;-33
2017-03-24 20:00:00;38,92;44,11;-5,19;40583;0;0;0;0;50570;8123;0.1607;8262;-139
2017-03-24 21:00:00;34,85;39,21;-4,36;40583;0;0;0;0;50570;7820;0.1546;8360;-540
2017-03-24 22:00:00;34,37;37,66;-3,29;40583;0;0;0;0;50570;7368;0.1457;7921;-553
2017-03-24 23:00:00;32,48;33,17;-0,69;40583;0;0;0;0;50570;7113;0.1407;7188;-75
2017-03-25 00:00:00;32,64;30,77;1,87;40583;0;0;0;0;50576;6881;0.136;6090;791
2017-03-25 01:00:00;29,14;29,91;-0,77;40583;0;0;0;0;50576;6799;0.1344;5886;913
2017-03-25 02:00:00;28,32;28,45;-0,13;40583;0;0;0;0;50576;6702;0.1325;6028;674
2017-03-25 03:00:00;27,13;28,0;-0,87;40583;0;0;0;0;50576;7094;0.1402;6306;788
2017-03-25 04:00:00;27,02;26,27;0,75;40583;0;0;0;0;50576;7452;0.1473;6614;838
2017-03-25 05:00:00;27,56;27,48;0,08;40583;0;0;0;0;50576;7640;0.1511;6862;778
2017-03-25 06:00:00;28,55;28,65;-0,1;40583;550;0.0135;524;26;50576;7860;0.1554;7015;845
2017-03-25 07:00:00;29,92;29,23;0,69;40583;4118;0.1015;4235;-117;50576;7366;0.1456;6847;519
2017-03-25 08:00:00;30,21;28,48;1,73;40583;9551;0.2354;10040;-489;50576;6210;0.1228;6125;85
2017-03-25 09:00:00;29,0;28,85;0,15;40583;15478;0.3814;15918;-440;50576;5542;0.1096;5294;248
2017-03-25 10:00:00;28,19;27,05;1,14;40583;20143;0.4964;20438;-295;50576;6858;0.1356;5280;1578
2017-03-25 11:00:00;25,39;22,58;2,81;40583;22659;0.5584;22872;-213;50576;8386;0.1658;6095;2291
2017-03-25 12:00:00;22,91;15,18;7,73;40583;23570;0.5808;23270;300;50576;9414;0.1861;6941;2473
2017-03-25 13:00:00;21,09;13,6;7,49;40583;22967;0.5659;22118;849;50576;10034;0.1984;7588;2446
2017-03-25 14:00:00;15,97;11,68;4,29;40583;20352;0.5015;19419;933;50576;10474;0.2071;8077;2397
2017-03-25 15:00:00;20,07;13,93;6,14;40583;15606;0.3846;15113;493;50576;10337;0.2044;8511;1826
2017-03-25 16:00:00;23,47;18,57;4,9;40583;9536;0.235;9238;298;50576;9732;0.1924;8832;900
2017-03-25 17:00:00;28,04;28,01;0,03;40583;3534;0.0871;3411;123;50576;8850;0.175;9032;-182
2017-03-25 18:00:00;33,85;34,97;-1,12;40583;296;0.0073;274;22;50576;8554;0.1692;9292;-738
2017-03-25 19:00:00;39,17;39,61;-0,44;40583;0;0;0;0;50576;9690;0.1916;9857;-167
2017-03-25 20:00:00;37,6;37,04;0,56;40583;0;0;0;0;50576;10590;0.2094;10064;526
2017-03-25 21:00:00;33,31;32,4;0,91;40583;0;0;0;0;50576;10298;0.2036;9895;403
2017-03-25 22:00:00;32,94;31,13;1,81;40583;0;0;0;0;50576;9423;0.1863;9362;61
2017-03-25 23:00:00;29,0;28,36;0,64;40583;0;0;0;0;50576;9225;0.1824;8524;701
2017-03-26 00:00:00;28,74;24,77;3,97;40583;0;0;0;0;50576;8505;0.1682;7084;1421
2017-03-26 01:00:00;27,94;19,57;8,37;40583;0;0;0;0;50576;7559;0.1495;6516;1043
2017-03-26 02:00:00;0,0;0,0;0,0;40583;0;0;0;0;50576;0;0;0;0
2017-03-26 03:00:00;26,97;22,27;4,7;40583;0;0;0;0;50576;6547;0.1294;5880;667
2017-03-26 04:00:00;26,62;23,81;2,81;40583;0;0;0;0;50576;5877;0.1162;5199;678
2017-03-26 05:00:00;24,65;23,79;0,86;40583;0;0;0;0;50576;5222;0.1032;4481;741
2017-03-26 06:00:00;26,87;23,9;2,97;40583;0;0;0;0;50576;4294;0.0849;3725;569
2017-03-26 07:00:00;27,67;24,99;2,68;40583;678;0.0167;671;7;50576;3430;0.0679;3026;404
2017-03-26 08:00:00;28,24;26,31;1,93;40583;4456;0.1098;4440;16;50576;2628;0.052;2401;227
2017-03-26 09:00:00;28,58;27,58;1,0;40583;10204;0.2514;9767;437;50576;1633;0.0323;1820;-187
2017-03-26 10:00:00;26,06;25,07;0,99;40583;15644;0.3855;14949;695;50576;1120;0.0221;1374;-254
2017-03-26 11:00:00;24,93;23,16;1,77;40583;20197;0.4977;18983;1214;50576;892;0.0176;1131;-239
2017-03-26 12:00:00;25,82;23,69;2,13;40583;23112;0.5695;21524;1588;50576;743;0.0147;1147;-404
2017-03-26 13:00:00;22,06;14,19;7,87;40583;24096;0.5938;22376;1720;50576;867;0.0172;1227;-360
2017-03-26 14:00:00;18,46;10,08;8,38;40583;23259;0.5731;21406;1853;50576;1186;0.0235;1348;-162
2017-03-26 15:00:00;16,97;9,47;7,5;40583;20512;0.5054;18676;1836;50576;1615;0.032;1527;88
2017-03-26 16:00:00;17,65;10,39;7,26;40583;15886;0.3914;14285;1601;50576;2094;0.0414;1730;364
2017-03-26 17:00:00;22,22;18,79;3,43;40583;9797;0.2414;8677;1120;50576;2368;0.0468;2044;324
2017-03-26 18:00:00;30,31;31,2;-0,89;40583;3649;0.0899;3230;419;50576;2559;0.0506;2518;41
2017-03-26 19:00:00;35,82;36,23;-0,41;40583;316;0.0078;290;26;50576;2723;0.0538;3085;-362
2017-03-26 20:00:00;40,07;36,92;3,15;40583;0;0;0;0;50576;3646;0.0721;3750;-104
2017-03-26 21:00:00;39,64;37,78;1,86;40583;0;0;0;0;50576;4356;0.0861;4299;57
2017-03-26 22:00:00;38,79;35,87;2,92;40583;0;0;0;0;50576;4384;0.0867;4781;-397
2017-03-26 23:00:00;38,06;33,42;4,64;40583;0;0;0;0;50576;4428;0.0875;5086;-658
2017-03-27 00:00:00;28,25;29,74;-1,49;40588;0;0;0;0;50593;4648;0.0919;4757;-109
2017-03-27 01:00:00;28,27;29,57;-1,3;40588;0;0;0;0;50593;4507;0.0891;4798;-291
2017-03-27 02:00:00;28,3;28,96;-0,66;40588;0;0;0;0;50593;4183;0.0827;4707;-524
2017-03-27 03:00:00;26,88;28,04;-1,16;40588;0;0;0;0;50593;3933;0.0778;4557;-624
2017-03-27 04:00:00;27,06;29,68;-2,62;40588;0;0;0;0;50593;3820;0.0755;4373;-553
2017-03-27 05:00:00;30,1;34,73;-4,63;40588;0;0;0;0;50593;3784;0.0748;4227;-443
2017-03-27 06:00:00;39,31;43,64;-4,33;40588;1;0;1;0;50593;4086;0.0808;4112;-26
2017-03-27 07:00:00;48,0;51,25;-3,25;40588;927;0.0229;901;26;50593;4402;0.087;3999;403
2017-03-27 08:00:00;48,16;54,46;-6,3;40588;5869;0.1446;5660;209;50593;4188;0.0828;3649;539
2017-03-27 09:00:00;40,91;41,73;-0,82;40588;12746;0.314;12246;500;50593;2871;0.0568;2938;-67
2017-03-27 10:00:00;36,56;34,74;1,82;40588;18982;0.4677;18325;657;50593;1951;0.0386;2272;-321
2017-03-27 11:00:00;33,24;30,64;2,6;40588;23276;0.5735;22648;628;50593;2025;0.04;2006;19
2017-03-27 12:00:00;30,48;28,42;2,06;40588;25567;0.6299;25028;539;50593;2069;0.0409;2111;-42
2017-03-27 13:00:00;29,67;27,58;2,09;40588;26099;0.643;25559;540;50593;1858;0.0367;2180;-322
2017-03-27 14:00:00;29,11;27,56;1,55;40588;24828;0.6117;24317;511;50593;1673;0.0331;2151;-478
2017-03-27 15:00:00;28,92;29,9;-0,98;40588;21755;0.536;21311;444;50593;1633;0.0323;2072;-439
2017-03-27 16:00:00;29,9;30,43;-0,53;40588;16972;0.4182;16466;506;50593;1554;0.0307;1989;-435
2017-03-27 17:00:00;32,35;33,36;-1,01;40588;10501;0.2587;10119;382;50593;1496;0.0296;2023;-527
2017-03-27 18:00:00;40,0;38,78;1,22;40588;3964;0.0976;3830;134;50593;1449;0.0286;2306;-857
2017-03-27 19:00:00;46,99;44,95;2,04;40588;356;0.0088;372;-16;50593;1718;0.034;2825;-1107
2017-03-27 20:00:00;46,27;42,88;3,39;40588;0;0;0;0;50593;2644;0.0523;3429;-785
2017-03-27 21:00:00;39,98;38,7;1,28;40588;0;0;0;0;50593;3630;0.0718;3936;-306
2017-03-27 22:00:00;37,94;37,67;0,27;40588;0;0;0;0;50593;4084;0.0807;4294;-210
2017-03-27 23:00:00;32,4;32,25;0,15;40588;0;0;0;0;50593;4206;0.0832;4402;-196
2017-03-28 00:00:00;28,71;28,59;0,12;40592;0;0;0;0;50610;4051;0.08;4109;-58
2017-03-28 01:00:00;28,07;28,56;-0,49;40592;0;0;0;0;50610;3908;0.0772;3973;-65
2017-03-28 02:00:00;27,43;28,76;-1,33;40592;0;0;0;0;50610;3753;0.0742;3818;-65
2017-03-28 03:00:00;27,24;27,15;0,09;40592;0;0;0;0;50610;3488;0.0689;3714;-226
2017-03-28 04:00:00;27,72;28,29;-0,57;40592;0;0;0;0;50610;3233;0.0639;3626;-393
2017-03-28 05:00:00;29,06;29,94;-0,88;40592;0;0;0;0;50610;3210;0.0634;3538;-328
2017-03-28 06:00:00;38,91;36,29;2,62;40592;2;0;2;0;50610;3211;0.0634;3486;-275
2017-03-28 07:00:00;46,13;46,71;-0,58;40592;993;0.0244;963;30;50610;3252;0.0642;3448;-196
2017-03-28 08:00:00;50,0;50,74;-0,74;40592;5914;0.1457;5655;259;50610;3073;0.0607;3169;-96
2017-03-28 09:00:00;43,03;40,99;2,04;40592;12744;0.314;12107;637;50610;2164;0.0428;2459;-295
2017-03-28 10:00:00;39,94;33,12;6,82;40592;18679;0.4602;18065;614;50610;926;0.0183;1558;-632
2017-03-28 11:00:00;37,4;32,52;4,88;40592;22829;0.5624;22274;555;50610;637;0.0126;1004;-367
2017-03-28 12:00:00;32,29;29,95;2,34;40592;24964;0.615;24550;414;50610;855;0.0169;1270;-415
2017-03-28 13:00:00;30,71;28,89;1,82;40592;25286;0.6229;24932;354;50610;1748;0.0345;1775;-27
2017-03-28 14:00:00;29,98;28,12;1,86;40592;23976;0.5906;23508;468;50610;2980;0.0589;2479;501
2017-03-28 15:00:00;30,0;26,88;3,12;40592;20778;0.5118;20320;458;50610;4142;0.0819;3315;827
2017-03-28 16:00:00;30,05;27,11;2,94;40592;15714;0.3872;15406;308;50610;4927;0.0974;3994;933
2017-03-28 17:00:00;32,16;28,57;3,59;40592;9478;0.2335;9228;250;50610;5402;0.1067;4468;934
2017-03-28 18:00:00;37,46;31,59;5,87;40592;3525;0.0868;3434;91;50610;5485;0.1084;4698;787
2017-03-28 19:00:00;41,41;35,57;5,84;40592;349;0.0086;352;-3;50610;4870;0.0962;5130;-260
2017-03-28 20:00:00;41,01;38,67;2,34;40592;0;0;0;0;50610;5840;0.1154;6124;-284
2017-03-28 21:00:00;36,4;33,32;3,08;40592;0;0;0;0;50610;7216;0.1426;7983;-767
2017-03-28 22:00:00;33,56;30,61;2,95;40592;0;0;0;0;50610;8419;0.1664;10157;-1738
2017-03-28 23:00:00;28,9;28,07;0,83;40592;0;0;0;0;50610;9580;0.1893;12111;-2531
2017-03-29 00:00:00;28,06;30,91;-2,85;40599;0;0;0;0;50651;10689;0.211;12219;-1530
2017-03-29 01:00:00;26,71;27,94;-1,23;40599;0;0;0;0;50651;12091;0.2387;12974;-883
2017-03-29 02:00:00;26,68;22,85;3,83;40599;0;0;0;0;50651;12696;0.2507;14017;-1321
2017-03-29 03:00:00;26,07;19,21;6,86;40599;0;0;0;0;50651;13438;0.2653;15319;-1881
2017-03-29 04:00:00;26,09;22,64;3,45;40599;0;0;0;0;50651;15359;0.3032;16470;-1111
2017-03-29 05:00:00;26,95;26,75;0,2;40599;0;0;0;0;50651;17720;0.3498;17516;204
2017-03-29 06:00:00;34,16;29,25;4,91;40599;2;0;3;-1;50651;20311;0.401;18321;1990
2017-03-29 07:00:00;39,56;29,48;10,08;40599;751;0.0185;884;-133;50651;21334;0.4212;19047;2287
2017-03-29 08:00:00;39,78;31,37;8,41;40599;4203;0.1035;4780;-577;50651;20712;0.4089;19568;1144
2017-03-29 09:00:00;30,88;28,57;2,31;40599;9074;0.2235;9787;-713;50651;19782;0.3905;19974;-192
2017-03-29 10:00:00;27,66;32,92;-5,26;40599;13347;0.3288;13971;-624;50651;20644;0.4075;20551;93
2017-03-29 11:00:00;26,55;29,4;-2,85;40599;15710;0.387;16566;-856;50651;22494;0.4441;21177;1317
2017-03-29 12:00:00;27,25;27,73;-0,48;40599;15754;0.388;17566;-1812;50651;23368;0.4614;21627;1741
2017-03-29 13:00:00;26,05;29,71;-3,66;40599;14622;0.3602;16962;-2340;50651;21338;0.4213;21595;-257
2017-03-29 14:00:00;26,09;31,8;-5,71;40599;13114;0.323;14629;-1515;50651;18656;0.3683;20813;-2157
2017-03-29 15:00:00;28,05;36,15;-8,1;40599;11501;0.2833;11679;-178;50651;16270;0.3212;19183;-2913
2017-03-29 16:00:00;30,65;36,78;-6,13;40599;9023;0.2222;8402;621;50651;14046;0.2773;17295;-3249
2017-03-29 17:00:00;31,23;37,98;-6,75;40599;5546;0.1366;5099;447;50651;12320;0.2432;15142;-2822
2017-03-29 18:00:00;35,19;40,09;-4,9;40599;2173;0.0536;2033;140;50651;10216;0.2017;12879;-2663
2017-03-29 19:00:00;40,47;43,63;-3,16;40599;236;0.0058;246;-10;50651;8681;0.1714;10864;-2183
2017-03-29 20:00:00;41,81;44,08;-2,27;40599;0;0;0;0;50651;7477;0.1476;9249;-1772
2017-03-29 21:00:00;37,66;39,14;-1,48;40599;0;0;0;0;50651;7012;0.1384;8265;-1253
2017-03-29 22:00:00;35,07;36,43;-1,36;40599;0;0;0;0;50651;6404;0.1265;7540;-1136
2017-03-29 23:00:00;30,72;29,94;0,78;40599;0;0;0;0;50651;5910;0.1167;6951;-1041
2017-03-30 00:00:00;28,73;30,65;-1,92;40608;0;0;0;0;50733;5829;0.1149;6651;-822
2017-03-30 01:00:00;28,02;28,88;-0,86;40608;0;0;0;0;50733;5680;0.112;6344;-664
2017-03-30 02:00:00;27,3;27,85;-0,55;40608;0;0;0;0;50733;5584;0.11;6135;-551
2017-03-30 03:00:00;26,38;28,12;-1,74;40608;0;0;0;0;50733;5780;0.1139;6147;-367
2017-03-30 04:00:00;26,78;28,53;-1,75;40608;0;0;0;0;50733;5918;0.1166;6246;-328
2017-03-30 05:00:00;28,53;29,44;-0,91;40608;0;0;0;0;50733;6326;0.1247;6445;-119
2017-03-30 06:00:00;36,0;36,73;-0,73;40608;1;0;2;-1;50733;7001;0.138;6766;235
2017-03-30 07:00:00;43,06;39,35;3,71;40608;523;0.0128;490;33;50733;7766;0.1531;7078;688
2017-03-30 08:00:00;46,01;41,16;4,85;40608;3121;0.0768;2761;360;50733;8048;0.1587;7242;806
2017-03-30 09:00:00;42,86;38,27;4,59;40608;7396;0.1822;6063;1333;50733;7696;0.1517;7248;448
2017-03-30 10:00:00;39,93;34,48;5,45;40608;12344;0.304;9577;2767;50733;7600;0.1498;7242;358
2017-03-30 11:00:00;38,42;33,26;5,16;40608;16687;0.411;12538;4149;50733;8072;0.1591;7418;654
2017-03-30 12:00:00;33,01;27,17;5,84;40608;19126;0.471;14480;4646;50733;8638;0.1703;7852;786
2017-03-30 13:00:00;30,98;26,5;4,48;40608;20040;0.4935;15246;4794;50733;9272;0.1828;8337;935
2017-03-30 14:00:00;29,58;24,5;5,08;40608;19404;0.4778;14926;4478;50733;10070;0.1985;8517;1553
2017-03-30 15:00:00;29,07;24,28;4,79;40608;17487;0.4306;13496;3991;50733;10412;0.2052;8310;2102
2017-03-30 16:00:00;28,93;25,95;2,98;40608;13646;0.336;10892;2754;50733;10289;0.2028;8052;2237
2017-03-30 17:00:00;30,43;28,65;1,78;40608;8737;0.2151;7161;1576;50733;9333;0.184;8000;1333
2017-03-30 18:00:00;35,93;32,26;3,67;40608;3496;0.0861;2969;527;50733;8318;0.164;8397;-79
2017-03-30 19:00:00;40,46;37,11;3,35;40608;395;0.0097;354;41;50733;8321;0.164;9076;-755
2017-03-30 20:00:00;40,07;37,27;2,8;40608;0;0;0;0;50733;9510;0.1874;10134;-624
2017-03-30 21:00:00;35,0;33,67;1,33;40608;0;0;0;0;50733;10635;0.2096;11448;-813
2017-03-30 22:00:00;32,47;32,79;-0,32;40608;0;0;0;0;50733;11457;0.2258;12564;-1107
2017-03-30 23:00:00;28,94;26,75;2,19;40608;0;0;0;0;50733;11893;0.2344;13452;-1559
2017-03-31 00:00:00;26,91;26,03;0,88;40620;0;0;0;0;50809;12340;0.2429;13913;-1573
2017-03-31 01:00:00;24,77;25,35;-0,58;40620;0;0;0;0;50809;12930;0.2545;14051;-1121
2017-03-31 02:00:00;24,45;24,94;-0,49;40620;0;0;0;0;50809;13368;0.2631;13924;-556
2017-03-31 03:00:00;23,05;25,56;-2,51;40620;0;0;0;0;50809;13612;0.2679;13646;-34
2017-03-31 04:00:00;23,45;20,07;3,38;40620;0;0;0;0;50809;13582;0.2673;13381;201
2017-03-31 05:00:00;27,24;22,84;4,4;40620;0;0;0;0;50809;14048;0.2765;13215;833
2017-03-31 06:00:00;33,09;28,84;4,25;40620;6;0.0001;9;-3;50809;14165;0.2788;13146;1019
2017-03-31 07:00:00;37,95;35,77;2,18;40620;1132;0.0278;1141;-9;50809;14047;0.2764;13036;1011
2017-03-31 08:00:00;38,99;36,31;2,68;40620;5826;0.1434;5766;60;50809;12975;0.2554;12312;663
2017-03-31 09:00:00;37,97;34,8;3,17;40620;12090;0.2977;11767;323;50809;10238;0.2015;10489;-251
2017-03-31 10:00:00;35,93;32,54;3,39;40620;17543;0.4319;17303;240;50809;7779;0.1531;8828;-1049
2017-03-31 11:00:00;33,32;31,29;2,03;40620;21171;0.5212;21265;-94;50809;7488;0.1473;8387;-899
2017-03-31 12:00:00;30,02;30,14;-0,12;40620;22856;0.5626;23426;-570;50809;8487;0.167;9090;-603
2017-03-31 13:00:00;28,09;28,09;0,0;40620;23016;0.5666;23827;-811;50809;9860;0.194;9690;170
2017-03-31 14:00:00;27,63;27,4;0,23;40620;21852;0.538;22621;-769;50809;10946;0.2154;9986;960
2017-03-31 15:00:00;28,29;26,68;1,61;40620;18589;0.4576;19764;-1175;50809;11313;0.2227;9825;1488
2017-03-31 16:00:00;28,36;27,01;1,35;40620;13955;0.3436;15308;-1353;50809;11145;0.2194;9349;1796
2017-03-31 17:00:00;30,43;30,69;-0,26;40620;8292;0.2042;9553;-1261;50809;10939;0.2153;8815;2124
2017-03-31 18:00:00;34,67;33,41;1,26;40620;3166;0.0779;3762;-596;50809;10353;0.2037;8825;1528
2017-03-31 19:00:00;38,98;36,23;2,75;40620;355;0.0087;432;-77;50809;9964;0.1961;9371;593
2017-03-31 20:00:00;39,96;37,53;2,43;40620;0;0;0;0;50809;10722;0.211;9889;833
2017-03-31 21:00:00;37,91;34,85;3,06;40620;0;0;0;0;50809;10866;0.2139;9986;880
2017-03-31 22:00:00;35,95;32,45;3,5;40620;0;0;0;0;50809;10626;0.2091;9757;869
2017-03-31 23:00:00;32,02;32,48;-0,46;40620;0;0;0;0;50809;9449;0.186;9095;354
2017-01-04 00:00:00;27,08;30,04;-2,96;40621;0;0;0;0;50833;8018;0.1578;8469;-451
2017-01-04 01:00:00;28,07;33,77;-5,7;40621;0;0;0;0;50833;6818;0.1341;7105;-287
2017-01-04 02:00:00;28,08;32,32;-4,24;40621;0;0;0;0;50833;5954;0.1171;5973;-19
2017-01-04 03:00:00;26,9;31,02;-4,12;40621;0;0;0;0;50833;5231;0.1029;5090;141
2017-01-04 04:00:00;27,0;30,04;-3,04;40621;0;0;0;0;50833;5272;0.1037;4382;890
2017-01-04 05:00:00;27,98;29,86;-1,88;40621;0;0;0;0;50833;4852;0.0955;3829;1023
2017-01-04 06:00:00;29,87;28,34;1,53;40621;8;0.0002;12;-4;50833;4060;0.0798;3467;593
2017-01-04 07:00:00;32,09;30,69;1,4;40621;1176;0.029;1114;62;50833;3170;0.0624;3196;-26
2017-01-04 08:00:00;34,42;33,11;1,31;40621;5499;0.1354;5211;288;50833;2468;0.0486;2832;-364
2017-01-04 09:00:00;35,1;36,17;-1,07;40621;10798;0.2658;10620;178;50833;1543;0.0304;2227;-684
2017-01-04 10:00:00;28,9;33,76;-4,86;40621;15410;0.3794;15463;-53;50833;929;0.0183;1662;-733
2017-01-04 11:00:00;27,09;31,13;-4,04;40621;18453;0.4543;18995;-542;50833;766;0.0151;1414;-648
2017-01-04 12:00:00;25,99;32,24;-6,25;40621;19886;0.4895;20997;-1111;50833;732;0.0144;1342;-610
2017-01-04 13:00:00;26,07;30,98;-4,91;40621;19784;0.487;21165;-1381;50833;725;0.0142;1280;-555
2017-01-04 14:00:00;25,29;29,33;-4,04;40621;18204;0.4481;19634;-1430;50833;811;0.0159;1267;-456
2017-01-04 15:00:00;24,81;29,4;-4,59;40621;15152;0.373;16543;-1391;50833;1086;0.0214;1272;-186
2017-01-04 16:00:00;25,65;30,33;-4,68;40621;10894;0.2682;12383;-1489;50833;1597;0.0314;1353;244
2017-01-04 17:00:00;27,99;32,43;-4,44;40621;6485;0.1596;7497;-1012;50833;2202;0.0433;1561;641
2017-01-04 18:00:00;33,66;34,28;-0,62;40621;2708;0.0667;2880;-172;50833;2973;0.0585;1936;1037
2017-01-04 19:00:00;38,7;36,38;2,32;40621;344;0.0085;376;-32;50833;4485;0.0882;2361;2124
2017-01-04 20:00:00;39,6;40,31;-0,71;40621;0;0;0;0;50833;6038;0.1188;2520;3518
2017-01-04 21:00:00;38,98;35,51;3,47;40621;0;0;0;0;50833;6776;0.1333;2679;4097
2017-01-04 22:00:00;37,96;32,73;5,23;40621;0;0;0;0;50833;6061;0.1192;2877;3184
2017-01-04 23:00:00;31,86;29,6;2,26;40621;0;0;0;0;50833;4968;0.0977;3009;1959
2017-02-04 00:00:00;32,92;28,9;4,02;40621;0;0;0;0;50839;4640;0.0913;4405;235
2017-02-04 01:00:00;27,5;26,46;1,04;40621;0;0;0;0;50839;5173;0.1018;4488;685
2017-02-04 02:00:00;26,77;25,51;1,26;40621;0;0;0;0;50839;5476;0.1077;4704;772
2017-02-04 03:00:00;26,67;23,94;2,73;40621;0;0;0;0;50839;5485;0.1079;4939;546
2017-02-04 04:00:00;26,49;24,3;2,19;40621;0;0;0;0;50839;5313;0.1045;5149;164
2017-02-04 05:00:00;26,42;22,71;3,71;40621;0;0;0;0;50839;4744;0.0933;5356;-612
2017-02-04 06:00:00;26,65;23,47;3,18;40621;8;0.0002;12;-4;50839;4370;0.086;5431;-1061
2017-02-04 07:00:00;27,14;24,14;3,0;40621;766;0.0188;916;-150;50839;4442;0.0874;5430;-988
2017-02-04 08:00:00;29,06;25,92;3,14;40621;3662;0.0901;4201;-539;50839;3775;0.0743;5256;-1481
2017-02-04 09:00:00;29,56;28,29;1,27;40621;7874;0.1938;8447;-573;50839;3203;0.063;4946;-1743
2017-02-04 10:00:00;28,54;30,72;-2,18;40621;12496;0.3076;12579;-83;50839;3060;0.0602;4877;-1817
2017-02-04 11:00:00;28,2;29,79;-1,59;40621;15863;0.3905;15722;141;50839;3231;0.0636;5109;-1878
2017-02-04 12:00:00;27,22;29,67;-2,45;40621;17690;0.4355;17537;153;50839;3914;0.077;5629;-1715
2017-02-04 13:00:00;26,02;24,23;1,79;40621;18359;0.452;17781;578;50839;4383;0.0862;6183;-1800
2017-02-04 14:00:00;21,05;13,57;7,48;40621;17914;0.441;16712;1202;50839;4843;0.0953;6653;-1810
2017-02-04 15:00:00;20,57;11,07;9,5;40621;15975;0.3932;14495;1480;50839;4885;0.0961;6906;-2021
2017-02-04 16:00:00;23,31;17,71;5,6;40621;12354;0.3041;11315;1039;50839;5011;0.0986;7011;-2000
2017-02-04 17:00:00;26,0;24,37;1,63;40621;7897;0.1944;7277;620;50839;4820;0.0948;6809;-1989
2017-02-04 18:00:00;29,6;28,38;1,22;40621;3371;0.083;3060;311;50839;4455;0.0876;6330;-1875
2017-02-04 19:00:00;39,1;38,0;1,1;40621;445;0.011;416;29;50839;4449;0.0875;5935;-1486
2017-02-04 20:00:00;42,22;40,03;2,19;40621;0;0;0;0;50839;4978;0.098;5777;-799
2017-02-04 21:00:00;39,92;35,68;4,24;40621;0;0;0;0;50839;5424;0.1067;5705;-281
2017-02-04 22:00:00;40,51;36,15;4,36;40621;0;0;0;0;50839;5498;0.1081;5693;-195
2017-02-04 23:00:00;37,78;34,51;3,27;40621;0;0;0;0;50839;5235;0.103;5628;-393
2017-03-04 00:00:00;34,38;31,33;3,05;40626;0;0;0;0;50842;4887;0.0961;4201;686
2017-03-04 01:00:00;31,95;29,04;2,91;40626;0;0;0;0;50842;4630;0.091;4043;587
2017-03-04 02:00:00;29,88;26,21;3,67;40626;0;0;0;0;50842;4201;0.0826;3893;308
2017-03-04 03:00:00;28,75;25,84;2,91;40626;0;0;0;0;50842;4099;0.0806;3685;414
2017-03-04 04:00:00;28,44;23,51;4,93;40626;0;0;0;0;50842;3877;0.0762;3438;439
2017-03-04 05:00:00;31,64;29,61;2,03;40626;0;0;0;0;50842;3533;0.0695;3154;379
2017-03-04 06:00:00;41,77;43,33;-1,56;40626;9;0.0002;12;-3;50842;3305;0.065;2809;496
2017-03-04 07:00:00;49,28;76,05;-26,77;40626;768;0.0189;727;41;50842;2943;0.0579;2446;497
2017-03-04 08:00:00;54,02;72,55;-18,53;40626;3481;0.0857;3200;281;50842;2477;0.0487;2013;464
2017-03-04 09:00:00;50,0;56,87;-6,87;40626;7200;0.1772;6376;824;50842;1850;0.0364;1542;308
2017-03-04 10:00:00;48,43;44,41;4,02;40626;11282;0.2777;9638;1644;50842;1546;0.0304;1177;369
2017-03-04 11:00:00;44,95;41,04;3,91;40626;14256;0.3509;12491;1765;50842;1330;0.0262;962;368
2017-03-04 12:00:00;38,93;36,89;2,04;40626;15822;0.3894;14573;1249;50842;1131;0.0222;903;228
2017-03-04 13:00:00;36,68;37,44;-0,76;40626;16140;0.3973;15527;613;50842;1043;0.0206;906;137
2017-03-04 14:00:00;32,94;33,93;-0,99;40626;15513;0.3818;15266;247;50842;1124;0.0221;979;145
2017-03-04 15:00:00;30,91;33,81;-2,9;40626;14072;0.3464;13709;363;50842;1329;0.0261;1110;219
2017-03-04 16:00:00;31,72;34,0;-2,28;40626;10910;0.2686;10869;41;50842;1385;0.0272;1278;107
2017-03-04 17:00:00;32,19;36,6;-4,41;40626;6879;0.1694;7127;-248;50842;1392;0.0274;1488;-96
2017-03-04 18:00:00;37,46;40,59;-3,13;40626;2954;0.0727;3129;-175;50842;1458;0.0287;1790;-332
2017-03-04 19:00:00;41,78;43,93;-2,15;40626;448;0.011;470;-22;50842;1819;0.0358;2160;-341
2017-03-04 20:00:00;43,59;45,44;-1,85;40626;1;0;0;1;50842;2355;0.0463;2487;-132
2017-03-04 21:00:00;38,97;40,24;-1,27;40626;0;0;0;0;50842;2907;0.0572;2648;259
2017-03-04 22:00:00;35,18;36,56;-1,38;40626;0;0;0;0;50842;3272;0.0643;2755;517
2017-03-04 23:00:00;31,08;31,12;-0,04;40626;0;0;0;0;50842;3360;0.0661;2786;574
2017-04-04 00:00:00;31,57;27,96;3,61;40629;0;0;0;0;50842;3281;0.0646;2964;317
2017-04-04 01:00:00;30,13;27,24;2,89;40629;0;0;0;0;50842;3190;0.0628;2819;371
2017-04-04 02:00:00;29,29;26,79;2,5;40629;0;0;0;0;50842;2928;0.0576;2633;295
2017-04-04 03:00:00;29,47;26,96;2,51;40629;0;0;0;0;50842;2816;0.0554;2403;413
2017-04-04 04:00:00;29,8;27,05;2,75;40629;0;0;0;0;50842;2794;0.055;2174;620
2017-04-04 05:00:00;31,83;29,25;2,58;40629;0;0;0;0;50842;2636;0.0519;2003;633
2017-04-04 06:00:00;41,17;38,47;2,7;40629;11;0.0002;18;-7;50842;2566;0.0505;1921;645
2017-04-04 07:00:00;51,01;44,93;6,08;40629;937;0.0231;996;-59;50842;2514;0.0494;1848;666
2017-04-04 08:00:00;52,39;46,11;6,28;40629;4180;0.1029;4445;-265;50842;2103;0.0414;1649;454
2017-04-04 09:00:00;50,94;42,62;8,32;40629;8591;0.2114;8839;-248;50842;1292;0.0254;1342;-50
2017-04-04 10:00:00;43,3;39,94;3,36;40629;12734;0.3134;13053;-319;50842;1017;0.02;1100;-83
2017-04-04 11:00:00;42,33;37,86;4,47;40629;15573;0.3833;16326;-753;50842;938;0.0184;983;-45
2017-04-04 12:00:00;39,16;36,29;2,87;40629;16203;0.3988;18117;-1914;50842;888;0.0174;945;-57
2017-04-04 13:00:00;37,72;36,09;1,63;40629;15634;0.3848;18210;-2576;50842;832;0.0164;924;-92
2017-04-04 14:00:00;34,6;36,09;-1,49;40629;14596;0.3593;17015;-2419;50842;869;0.0171;942;-73
2017-04-04 15:00:00;34,45;34,97;-0,52;40629;12818;0.3155;14644;-1826;50842;997;0.0196;1019;-22
2017-04-04 16:00:00;34,45;33,62;0,83;40629;10130;0.2493;11348;-1218;50842;1114;0.0219;1092;22
2017-04-04 17:00:00;37,49;33,78;3,71;40629;6614;0.1628;7333;-719;50842;1150;0.0226;1225;-75
2017-04-04 18:00:00;41,59;38,56;3,03;40629;2976;0.0733;3181;-205;50842;1224;0.0241;1452;-228
2017-04-04 19:00:00;45,26;40,52;4,74;40629;488;0.012;467;21;50842;1318;0.0259;1803;-485
2017-04-04 20:00:00;47,57;41,27;6,3;40629;1;0;2;-1;50842;1638;0.0322;2158;-520
2017-04-04 21:00:00;40,07;37,8;2,27;40629;0;0;0;0;50842;1840;0.0362;2349;-509
2017-04-04 22:00:00;38,91;35,34;3,57;40629;0;0;0;0;50842;1780;0.035;2452;-672
2017-04-04 23:00:00;33,04;32,48;0,56;40629;0;0;0;0;50842;1696;0.0334;2575;-879
2017-05-04 00:00:00;30,0;31,06;-1,06;40634;0;0;0;0;50845;1799;0.0354;2223;-424
2017-05-04 01:00:00;29,64;29,02;0,62;40634;0;0;0;0;50845;1920;0.0378;2410;-490
2017-05-04 02:00:00;28,39;27,83;0,56;40634;0;0;0;0;50845;2225;0.0438;2727;-502
2017-05-04 03:00:00;27,94;27,04;0,9;40634;0;0;0;0;50845;2583;0.0508;3284;-701
2017-05-04 04:00:00;27,49;27,34;0,15;40634;0;0;0;0;50845;2994;0.0589;4015;-1021
2017-05-04 05:00:00;29,65;30,37;-0,72;40634;0;0;0;0;50845;3960;0.0779;4831;-871
2017-05-04 06:00:00;37,1;40,63;-3,53;40634;18;0.0004;25;-7;50845;5078;0.0999;5702;-624
2017-05-04 07:00:00;44,2;42,86;1,34;40634;1078;0.0266;1106;-28;50845;5896;0.116;6702;-806
2017-05-04 08:00:00;48,1;44,28;3,82;40634;4769;0.1174;4608;161;50845;6432;0.1265;7410;-978
2017-05-04 09:00:00;44,03;40,42;3,61;40634;9564;0.2354;8905;659;50845;6292;0.1238;7764;-1472
2017-05-04 10:00:00;39,02;34,99;4,03;40634;14040;0.3455;12652;1388;50845;7554;0.1486;8395;-841
2017-05-04 11:00:00;36,98;31,46;5,52;40634;16662;0.41;15039;1623;50845;9357;0.184;9587;-230
2017-05-04 12:00:00;34,03;29,0;5,03;40634;16982;0.4179;15938;1044;50845;10989;0.2161;11294;-305
2017-05-04 13:00:00;32,89;26,91;5,98;40634;15786;0.3885;15089;697;50845;13484;0.2652;13384;100
2017-05-04 14:00:00;30,06;26,62;3,44;40634;13865;0.3412;13179;686;50845;15648;0.3077;15741;-93
2017-05-04 15:00:00;29,53;24,49;5,04;40634;10920;0.2688;10663;257;50845;18182;0.3576;18066;116
2017-05-04 16:00:00;30,01;25,99;4,02;40634;7565;0.1861;7802;-237;50845;20035;0.394;20169;-134
2017-05-04 17:00:00;30,06;27,44;2,62;40634;4414;0.1086;4860;-446;50845;22160;0.4358;21791;369
2017-05-04 18:00:00;29,9;28,77;1,13;40634;1932;0.0476;2149;-217;50845;23185;0.456;22388;797
2017-05-04 19:00:00;32,69;31,26;1,43;40634;318;0.0078;348;-30;50845;22513;0.4428;22686;-173
2017-05-04 20:00:00;35,0;34,83;0,17;40634;0;0;0;0;50845;22446;0.4415;22973;-527
2017-05-04 21:00:00;29,93;31,32;-1,39;40634;0;0;0;0;50845;23006;0.4524;23291;-285
2017-05-04 22:00:00;27,87;26,42;1,45;40634;0;0;0;0;50845;22993;0.4522;23694;-701
2017-05-04 23:00:00;20,0;21,2;-1,2;40634;0;0;0;0;50845;22496;0.4424;23878;-1382
2017-06-04 00:00:00;12,48;18,02;-5,54;40640;0;0;0;0;50869;22433;0.441;23277;-844
2017-06-04 01:00:00;9,87;17,19;-7,32;40640;0;0;0;0;50869;21584;0.4244;22698;-1114
2017-06-04 02:00:00;9,04;16,63;-7,59;40640;0;0;0;0;50869;20149;0.3961;22049;-1900
2017-06-04 03:00:00;14,9;23,12;-8,22;40640;0;0;0;0;50869;19407;0.3815;21200;-1793
2017-06-04 04:00:00;22,0;28,42;-6,42;40640;0;0;0;0;50869;18638;0.3664;20276;-1638
2017-06-04 05:00:00;24,55;29,94;-5,39;40640;0;0;0;0;50869;17424;0.3425;19124;-1700
2017-06-04 06:00:00;35,96;40,06;-4,1;40640;36;0.0009;39;-3;50869;15998;0.3145;17899;-1901
2017-06-04 07:00:00;40,97;45,21;-4,24;40640;1306;0.0321;1261;45;50869;14363;0.2824;16734;-2371
2017-06-04 08:00:00;40,81;49,34;-8,53;40640;4912;0.1209;4762;150;50869;13110;0.2577;15984;-2874
2017-06-04 09:00:00;38,26;47,18;-8,92;40640;9088;0.2236;8913;175;50869;14577;0.2866;15911;-1334
2017-06-04 10:00:00;37,59;43,87;-6,28;40640;11657;0.2868;12347;-690;50869;14072;0.2766;15777;-1705
2017-06-04 11:00:00;35,46;39,2;-3,74;40640;13718;0.3375;14587;-869;50869;13464;0.2647;15612;-2148
2017-06-04 12:00:00;31,07;39,14;-8,07;40640;14876;0.366;15668;-792;50869;13609;0.2675;15495;-1886
2017-06-04 13:00:00;30,08;37,57;-7,49;40640;15876;0.3906;15746;130;50869;13989;0.275;15490;-1501
2017-06-04 14:00:00;28,33;34,09;-5,76;40640;16051;0.395;14852;1199;50869;14076;0.2767;15776;-1700
2017-06-04 15:00:00;28,19;30,63;-2,44;40640;14778;0.3636;12974;1804;50869;15547;0.3056;16394;-847
2017-06-04 16:00:00;28,08;29,72;-1,64;40640;12148;0.2989;10131;2017;50869;16890;0.332;17088;-198
2017-06-04 17:00:00;32,12;31,12;1,0;40640;7986;0.1965;6559;1427;50869;17990;0.3536;17294;696
2017-06-04 18:00:00;38,05;33,9;4,15;40640;3740;0.092;2883;857;50869;17982;0.3535;16793;1189
2017-06-04 19:00:00;40,98;35,33;5,65;40640;684;0.0168;452;232;50869;17061;0.3354;16161;900
2017-06-04 20:00:00;40,87;36,69;4,18;40640;2;0;3;-1;50869;16892;0.3321;16071;821
2017-06-04 21:00:00;38,04;34,39;3,65;40640;0;0;0;0;50869;17371;0.3415;16676;695
2017-06-04 22:00:00;34,27;34,38;-0,11;40640;0;0;0;0;50869;17958;0.353;17606;352
2017-06-04 23:00:00;27,79;30,75;-2,96;40640;0;0;0;0;50869;18587;0.3654;18685;-98
2017-07-04 00:00:00;24,99;27,41;-2,42;40648;0;0;0;0;50881;19363;0.3805;19244;119
2017-07-04 01:00:00;23,02;22,83;0,19;40648;0;0;0;0;50881;19886;0.3908;19980;-94
2017-07-04 02:00:00;18,31;21,17;-2,86;40648;0;0;0;0;50881;19675;0.3866;20496;-821
2017-07-04 03:00:00;19,17;23,92;-4,75;40648;0;0;0;0;50881;19008;0.3736;20623;-1615
2017-07-04 04:00:00;20,87;27,72;-6,85;40648;0;0;0;0;50881;18572;0.365;20693;-2121
2017-07-04 05:00:00;27,07;33,17;-6,1;40648;0;0;0;0;50881;19097;0.3753;20511;-1414
2017-07-04 06:00:00;32,05;37,32;-5,27;40648;12;0.0003;17;-5;50881;19652;0.3862;20097;-445
2017-07-04 07:00:00;39,97;43,69;-3,72;40648;635;0.0156;665;-30;50881;19673;0.3866;19676;-3
2017-07-04 08:00:00;41,57;42,49;-0,92;40648;2814;0.0692;2774;40;50881;19330;0.3799;19244;86
2017-07-04 09:00:00;40,94;36,74;4,2;40648;5768;0.1419;5386;382;50881;19126;0.3759;18952;174
2017-07-04 10:00:00;39,98;34,36;5,62;40648;8980;0.2209;7603;1377;50881;19272;0.3788;18870;402
2017-07-04 11:00:00;40,02;32,28;7,74;40648;11662;0.2869;8985;2677;50881;19233;0.378;18907;326
2017-07-04 12:00:00;38,14;29,58;8,56;40648;13137;0.3232;9617;3520;50881;19411;0.3815;18982;429
2017-07-04 13:00:00;35,29;27,19;8,1;40648;13290;0.327;9535;3755;50881;19990;0.3929;19036;954
2017-07-04 14:00:00;32,67;26,22;6,45;40648;12697;0.3124;8837;3860;50881;20082;0.3947;19002;1080
2017-07-04 15:00:00;32,97;27,06;5,91;40648;11334;0.2788;7597;3737;50881;19769;0.3885;18745;1024
2017-07-04 16:00:00;32,98;27,58;5,4;40648;8718;0.2145;5909;2809;50881;19147;0.3763;18266;881
2017-07-04 17:00:00;36,09;29,06;7,03;40648;5712;0.1405;3892;1820;50881;17794;0.3497;17405;389
2017-07-04 18:00:00;39,12;34,82;4,3;40648;2639;0.0649;1812;827;50881;16180;0.318;16141;39
2017-07-04 19:00:00;39,91;36,51;3,4;40648;480;0.0118;310;170;50881;14512;0.2852;14816;-304
2017-07-04 20:00:00;39,96;38,03;1,93;40648;1;0;1;0;50881;13430;0.264;13658;-228
2017-07-04 21:00:00;39,31;36,7;2,61;40648;0;0;0;0;50881;12109;0.238;12780;-671
2017-07-04 22:00:00;39,61;36,7;2,91;40648;0;0;0;0;50881;11179;0.2197;12045;-866
2017-07-04 23:00:00;37,93;36,69;1,24;40648;0;0;0;0;50881;10560;0.2076;11286;-726
2017-08-04 00:00:00;32,71;36,51;-3,8;40648;0;0;0;0;50893;9403;0.1848;10189;-786
2017-08-04 01:00:00;32,28;35,07;-2,79;40648;0;0;0;0;50893;8529;0.1676;8971;-442
2017-08-04 02:00:00;32,81;33,88;-1,07;40648;0;0;0;0;50893;7565;0.1486;7794;-229
2017-08-04 03:00:00;31,5;30,33;1,17;40648;0;0;0;0;50893;6520;0.1281;6756;-236
2017-08-04 04:00:00;30,44;30,53;-0,09;40648;0;0;0;0;50893;5534;0.1087;5793;-259
2017-08-04 05:00:00;31,7;32,21;-0,51;40648;0;0;0;0;50893;4610;0.0906;4993;-383
2017-08-04 06:00:00;34,72;35,52;-0,8;40648;25;0.0006;33;-8;50893;3696;0.0726;4372;-676
2017-08-04 07:00:00;37,91;35,59;2,32;40648;895;0.022;975;-80;50893;3281;0.0644;3841;-560
2017-08-04 08:00:00;39,43;35,06;4,37;40648;3482;0.0857;3714;-232;50893;2984;0.0586;3365;-381
2017-08-04 09:00:00;38,99;35,8;3,19;40648;6934;0.1706;7231;-297;50893;2810;0.0552;2975;-165
2017-08-04 10:00:00;36,5;34,48;2,02;40648;10718;0.2637;10832;-114;50893;2498;0.0491;2689;-191
2017-08-04 11:00:00;34,94;33,45;1,49;40648;14152;0.3481;13695;457;50893;2423;0.0476;2575;-152
2017-08-04 12:00:00;30,66;30,02;0,64;40648;16597;0.4083;15414;1183;50893;2569;0.0505;2690;-121
2017-08-04 13:00:00;29,5;27,34;2,16;40648;17553;0.4319;15842;1711;50893;2713;0.0533;2896;-183
2017-08-04 14:00:00;27,81;26,72;1,09;40648;16941;0.4168;15310;1631;50893;2681;0.0527;3082;-401
2017-08-04 15:00:00;27,53;26,33;1,2;40648;15125;0.3721;13794;1331;50893;2522;0.0496;3133;-611
2017-08-04 16:00:00;28,28;26,99;1,29;40648;12288;0.3023;11186;1102;50893;2194;0.0431;3027;-833
2017-08-04 17:00:00;30,02;28,2;1,82;40648;8287;0.2039;7601;686;50893;1700;0.0334;2750;-1050
2017-08-04 18:00:00;35,85;34,34;1,51;40648;3886;0.0956;3482;404;50893;1290;0.0254;2362;-1072
2017-08-04 19:00:00;39,3;37,67;1,63;40648;728;0.0179;571;157;50893;1133;0.0222;2067;-934
2017-08-04 20:00:00;41,88;38,75;3,13;40648;4;0.0001;6;-2;50893;1101;0.0216;1944;-843
2017-08-04 21:00:00;41,58;36,85;4,73;40648;0;0;0;0;50893;1184;0.0233;1926;-742
2017-08-04 22:00:00;42,07;37,92;4,15;40648;0;0;0;0;50893;1267;0.0249;1981;-714
2017-08-04 23:00:00;39,02;36,73;2,29;40648;0;0;0;0;50893;1234;0.0242;2043;-809
2017-09-04 00:00:00;33,98;31,21;2,77;40648;0;0;0;0;50905;1237;0.0243;1325;-88
2017-09-04 01:00:00;31,06;27,54;3,52;40648;0;0;0;0;50905;1211;0.0238;1315;-104
2017-09-04 02:00:00;31,04;25,89;5,15;40648;0;0;0;0;50905;1354;0.0266;1283;71
2017-09-04 03:00:00;27,54;24,16;3,38;40648;0;0;0;0;50905;1505;0.0296;1266;239
2017-09-04 04:00:00;28,46;24,83;3,63;40648;0;0;0;0;50905;1675;0.0329;1270;405
2017-09-04 05:00:00;27,79;23,37;4,42;40648;0;0;0;0;50905;1934;0.038;1283;651
2017-09-04 06:00:00;28,48;25,31;3,17;40648;73;0.0018;69;4;50905;2076;0.0408;1334;742
2017-09-04 07:00:00;30,52;25,44;5,08;40648;1981;0.0487;1808;173;50905;2262;0.0445;1447;815
2017-09-04 08:00:00;30,63;25,1;5,53;40648;7123;0.1752;6761;362;50905;2220;0.0436;1565;655
2017-09-04 09:00:00;29,44;28,27;1,17;40648;13674;0.3364;12809;865;50905;1930;0.0379;1585;345
2017-09-04 10:00:00;27,78;24,98;2,8;40648;19532;0.4805;18272;1260;50905;2116;0.0416;1631;485
2017-09-04 11:00:00;26,4;23,4;3,0;40648;23246;0.5719;22262;984;50905;2422;0.0476;1850;572
2017-09-04 12:00:00;24,04;22,21;1,83;40648;25270;0.6217;24432;838;50905;2358;0.0463;2026;332
2017-09-04 13:00:00;20,79;14,93;5,86;40648;25695;0.6321;24913;782;50905;2200;0.0432;2127;73
2017-09-04 14:00:00;12,98;8,61;4,37;40648;24711;0.6079;23881;830;50905;2102;0.0413;2182;-80
2017-09-04 15:00:00;15,0;12,15;2,85;40648;21917;0.5392;21198;719;50905;1985;0.039;2214;-229
2017-09-04 16:00:00;20,07;15,09;4,98;40648;17478;0.43;16974;504;50905;1787;0.0351;2250;-463
2017-09-04 17:00:00;24,44;22,8;1,64;40648;11410;0.2807;11136;274;50905;1690;0.0332;2407;-717
2017-09-04 18:00:00;32,4;31,57;0,83;40648;5058;0.1244;4880;178;50905;1579;0.031;2661;-1082
2017-09-04 19:00:00;38,24;37,48;0,76;40648;908;0.0223;820;88;50905;1910;0.0375;3389;-1479
2017-09-04 20:00:00;39,53;39,12;0,41;40648;6;0.0001;7;-1;50905;3342;0.0656;5159;-1817
2017-09-04 21:00:00;37,57;38,58;-1,01;40648;0;0;0;0;50905;6009;0.118;7868;-1859
2017-09-04 22:00:00;35,2;37,31;-2,11;40648;0;0;0;0;50905;9424;0.1851;10353;-929
2017-09-04 23:00:00;24,08;31,37;-7,29;40648;0;0;0;0;50905;12059;0.2369;12530;-471
2017-10-04 00:00:00;26,03;23,72;2,31;40653;0;0;0;0;50933;14242;0.2796;14195;47
2017-10-04 01:00:00;23,02;18,22;4,8;40653;0;0;0;0;50933;15865;0.3115;15564;301
2017-10-04 02:00:00;20,36;16,26;4,1;40653;0;0;0;0;50933;17731;0.3481;16477;1254
2017-10-04 03:00:00;12,26;10,38;1,88;40653;0;0;0;0;50933;19280;0.3786;16942;2338
2017-10-04 04:00:00;19,95;13,25;6,7;40653;0;0;0;0;50933;19892;0.3906;17341;2551
2017-10-04 05:00:00;26,08;18,58;7,5;40653;0;0;0;0;50933;19864;0.39;17492;2372
2017-10-04 06:00:00;38,93;31,96;6,97;40653;96;0.0024;93;3;50933;20024;0.3932;17352;2672
2017-10-04 07:00:00;38,93;34,31;4,62;40653;2258;0.0556;2049;209;50933;20381;0.4001;16973;3408
2017-10-04 08:00:00;38,09;29,69;8,4;40653;7316;0.18;7011;305;50933;18700;0.3671;16097;2603
2017-10-04 09:00:00;35,25;28,31;6,94;40653;12714;0.3127;12574;140;50933;17122;0.3362;14814;2308
2017-10-04 10:00:00;30,89;28,44;2,45;40653;16825;0.4139;17018;-193;50933;17540;0.3444;14678;2862
2017-10-04 11:00:00;27,57;27,48;0,09;40653;19285;0.4744;19770;-485;50933;19138;0.3757;15669;3469
2017-10-04 12:00:00;24,01;25,54;-1,53;40653;20246;0.498;20769;-523;50933;21545;0.423;17258;4287
2017-10-04 13:00:00;17,91;22,06;-4,15;40653;19772;0.4864;20423;-651;50933;23708;0.4654;19144;4564
2017-10-04 14:00:00;9,37;16,62;-7,25;40653;18510;0.4553;18855;-345;50933;24392;0.4789;20778;3614
2017-10-04 15:00:00;17,92;18,9;-0,98;40653;15712;0.3865;16070;-358;50933;25457;0.4998;22032;3425
2017-10-04 16:00:00;21,63;21,15;0,48;40653;11854;0.2916;12245;-391;50933;26230;0.515;22964;3266
2017-10-04 17:00:00;26,2;25,5;0,7;40653;7344;0.1806;7796;-452;50933;26712;0.5245;23277;3435
2017-10-04 18:00:00;32,26;29,69;2,57;40653;3255;0.0801;3502;-247;50933;25793;0.5064;22727;3066
2017-10-04 19:00:00;38,32;33,36;4,96;40653;690;0.0169;646;44;50933;23708;0.4654;21820;1888
2017-10-04 20:00:00;38,74;37,99;0,75;40653;5;0.0001;7;-2;50933;21478;0.4217;21103;375
2017-10-04 21:00:00;37,95;33,72;4,23;40653;0;0;0;0;50933;19968;0.3921;20452;-484
2017-10-04 22:00:00;31,29;32,57;-1,28;40653;0;0;0;0;50933;18942;0.3719;19933;-991
2017-10-04 23:00:00;24,02;27,25;-3,23;40653;0;0;0;0;50933;18425;0.3617;19593;-1168
2017-11-04 00:00:00;24,83;29,43;-4,6;40657;0;0;0;0;50933;18177;0.3569;19060;-883
2017-11-04 01:00:00;23,52;29,63;-6,11;40657;0;0;0;0;50933;17466;0.343;18747;-1281
2017-11-04 02:00:00;23,55;29,7;-6,15;40657;0;0;0;0;50933;16823;0.3303;18590;-1767
2017-11-04 03:00:00;23,53;28,96;-5,43;40657;0;0;0;0;50933;17159;0.3369;18587;-1428
2017-11-04 04:00:00;25,63;31,39;-5,76;40657;0;0;0;0;50933;17727;0.348;18606;-879
2017-11-04 05:00:00;28,12;31,7;-3,58;40657;0;0;0;0;50933;17752;0.3485;18416;-664
2017-11-04 06:00:00;37,91;37,87;0,04;40657;87;0.0021;79;8;50933;16958;0.333;17927;-969
2017-11-04 07:00:00;41,52;42,48;-0,96;40657;1669;0.0411;1453;216;50933;15446;0.3033;17469;-2023
2017-11-04 08:00:00;43,5;42,25;1,25;40657;5080;0.125;4722;358;50933;15162;0.2977;17330;-2168
2017-11-04 09:00:00;40,93;38,3;2,63;40657;9490;0.2334;8618;872;50933;16598;0.3259;17896;-1298
2017-11-04 10:00:00;37,45;32,32;5,13;40657;13265;0.3263;12307;958;50933;16894;0.3317;18586;-1692
2017-11-04 11:00:00;34,16;32,99;1,17;40657;15730;0.3869;15130;600;50933;16484;0.3237;18724;-2240
2017-11-04 12:00:00;31,0;30,86;0,14;40657;17192;0.4228;16694;498;50933;15731;0.3088;18311;-2580
2017-11-04 13:00:00;29,66;30,79;-1,13;40657;17912;0.4406;16994;918;50933;14928;0.2931;17894;-2966
2017-11-04 14:00:00;29,98;31,3;-1,32;40657;16844;0.4143;16155;689;50933;14778;0.2901;17702;-2924
2017-11-04 15:00:00;31,9;32,34;-0,44;40657;14630;0.3598;14142;488;50933;14860;0.2917;17660;-2800
2017-11-04 16:00:00;31,83;31,4;0,43;40657;11596;0.2852;11093;503;50933;14258;0.28;17415;-3157
2017-11-04 17:00:00;35,3;34,2;1,1;40657;7654;0.1883;7362;292;50933;13954;0.274;16554;-2600
2017-11-04 18:00:00;37,95;37,35;0,6;40657;3528;0.0868;3409;119;50933;12724;0.2498;14977;-2253
2017-11-04 19:00:00;43,1;40,29;2,81;40657;731;0.018;637;94;50933;11837;0.2324;13389;-1552
2017-11-04 20:00:00;43,27;41,03;2,24;40657;6;0.0001;8;-2;50933;11746;0.2306;12730;-984
2017-11-04 21:00:00;38,38;37,01;1,37;40657;0;0;0;0;50933;11978;0.2352;13257;-1279
2017-11-04 22:00:00;37,08;37,73;-0,65;40657;0;0;0;0;50933;13215;0.2595;14345;-1130
2017-11-04 23:00:00;30,17;33,18;-3,01;40657;0;0;0;0;50933;14391;0.2825;15762;-1371
2017-12-04 00:00:00;25,99;29,78;-3,79;40663;0;0;0;0;50948;15763;0.3094;17265;-1502
2017-12-04 01:00:00;24,42;28,96;-4,54;40663;0;0;0;0;50948;16694;0.3276;18775;-2081
2017-12-04 02:00:00;23,02;25,13;-2,11;40663;0;0;0;0;50948;17208;0.3378;20058;-2850
2017-12-04 03:00:00;20,5;24,27;-3,77;40663;0;0;0;0;50948;18340;0.36;20847;-2507
2017-12-04 04:00:00;23,01;23,11;-0,1;40663;0;0;0;0;50948;19340;0.3796;21530;-2190
2017-12-04 05:00:00;23,09;28,14;-5,05;40663;0;0;0;0;50948;20130;0.3951;22010;-1880
2017-12-04 06:00:00;31,02;33,75;-2,73;40663;51;0.0012;57;-6;50948;21443;0.4209;22338;-895
2017-12-04 07:00:00;36,44;38,53;-2,09;40663;1245;0.0306;1170;75;50948;21743;0.4268;22698;-955
2017-12-04 08:00:00;37,95;34,76;3,19;40663;3964;0.0975;3945;19;50948;22168;0.4351;23346;-1178
2017-12-04 09:00:00;34,02;32,29;1,73;40663;7235;0.1779;7256;-21;50948;22429;0.4402;24489;-2060
2017-12-04 10:00:00;29,29;32,72;-3,43;40663;10775;0.265;10433;342;50948;23758;0.4663;25790;-2032
2017-12-04 11:00:00;27,35;30,85;-3,5;40663;13706;0.3371;12895;811;50948;25982;0.51;26862;-880
2017-12-04 12:00:00;23,65;25,62;-1,97;40663;15578;0.3831;14387;1191;50948;27379;0.5374;27509;-130
2017-12-04 13:00:00;23,06;22,45;0,61;40663;15850;0.3897;14587;1263;50948;28136;0.5522;27893;243
2017-12-04 14:00:00;23,4;17,36;6,04;40663;15027;0.3696;13731;1296;50948;28403;0.5575;28011;392
2017-12-04 15:00:00;23,05;17,01;6,04;40663;12910;0.3175;11745;1165;50948;27925;0.5481;27912;13
2017-12-04 16:00:00;26,06;17,86;8,2;40663;9567;0.2353;8776;791;50948;27134;0.5326;27536;-402
2017-12-04 17:00:00;27,56;23,57;3,99;40663;5466;0.1344;5435;31;50948;26434;0.5188;26657;-223
2017-12-04 18:00:00;31,34;29,93;1,41;40663;2344;0.0576;2410;-66;50948;25719;0.5048;25648;71
2017-12-04 19:00:00;33,78;32,65;1,13;40663;502;0.0124;460;42;50948;24122;0.4735;24863;-741
2017-12-04 20:00:00;34,11;34,2;-0,09;40663;3;0.0001;5;-2;50948;23468;0.4606;24218;-750
2017-12-04 21:00:00;31,95;32,38;-0,43;40663;0;0;0;0;50948;22923;0.4499;23817;-894
2017-12-04 22:00:00;27,32;31,19;-3,87;40663;0;0;0;0;50948;22748;0.4465;23651;-903
2017-12-04 23:00:00;23,05;27,02;-3,97;40663;0;0;0;0;50948;22159;0.4349;23402;-1243
2017-04-13 00:00:00;18,01;26,15;-8,14;40673;0;0;0;0;50954;21354;0.4191;22531;-1177
2017-04-13 01:00:00;16,01;26,12;-10,11;40673;0;0;0;0;50954;20684;0.406;22093;-1409
2017-04-13 02:00:00;17,95;26,67;-8,72;40673;0;0;0;0;50954;19947;0.3915;21811;-1864
2017-04-13 03:00:00;19,8;25,4;-5,6;40673;0;0;0;0;50954;19153;0.3759;21496;-2343
2017-04-13 04:00:00;20,02;24,6;-4,58;40673;0;0;0;0;50954;18375;0.3606;21304;-2929
2017-04-13 05:00:00;26,76;33,8;-7,04;40673;0;0;0;0;50954;18218;0.3575;21018;-2800
2017-04-13 06:00:00;31,95;36,94;-4,99;40673;80;0.002;99;-19;50954;18653;0.366;20759;-2106
2017-04-13 07:00:00;35,95;40,96;-5,01;40673;1170;0.0288;1382;-212;50954;18297;0.3591;20574;-2277
2017-04-13 08:00:00;35,99;40,69;-4,7;40673;3641;0.0895;4106;-465;50954;18662;0.3662;20787;-2125
2017-04-13 09:00:00;33,48;39,02;-5,54;40673;6854;0.1685;7289;-435;50954;20319;0.3988;21656;-1337
2017-04-13 10:00:00;31,06;36,28;-5,22;40673;9420;0.2316;10295;-875;50954;22154;0.4348;22642;-488
2017-04-13 11:00:00;28,96;34,44;-5,48;40673;10985;0.2701;12506;-1521;50954;23475;0.4607;23592;-117
2017-04-13 12:00:00;27,01;33,35;-6,34;40673;12058;0.2965;13773;-1715;50954;24436;0.4796;24500;-64
2017-04-13 13:00:00;24,45;33,17;-8,72;40673;12657;0.3112;13845;-1188;50954;24436;0.4796;25241;-805
2017-04-13 14:00:00;24,02;31,06;-7,04;40673;12162;0.299;13016;-854;50954;24222;0.4754;25612;-1390
2017-04-13 15:00:00;26,57;32,05;-5,48;40673;11338;0.2788;11368;-30;50954;23594;0.463;25399;-1805
2017-04-13 16:00:00;27,59;31,09;-3,5;40673;9305;0.2288;9016;289;50954;22926;0.45;24860;-1934
2017-04-13 17:00:00;30,03;33,0;-2,97;40673;6439;0.1583;6239;200;50954;22086;0.4335;23637;-1551
2017-04-13 18:00:00;35,93;37,71;-1,78;40673;3238;0.0796;3121;117;50954;20255;0.3975;21544;-1289
2017-04-13 19:00:00;40,0;38,35;1,65;40673;854;0.021;642;212;50954;18493;0.3629;19169;-676
2017-04-13 20:00:00;42,24;41,7;0,54;40673;16;0.0004;9;7;50954;17089;0.3354;17335;-246
2017-04-13 21:00:00;38,91;37,95;0,96;40673;0;0;0;0;50954;16197;0.3179;16326;-129
2017-04-13 22:00:00;36,82;37,19;-0,37;40673;0;0;0;0;50954;15378;0.3018;15868;-490
2017-04-13 23:00:00;32,97;32,67;0,3;40673;0;0;0;0;50954;14933;0.2931;15756;-823
2017-04-14 00:00:00;30,66;27,68;2,98;40675;0;0;0;0;50960;14472;0.284;14249;223
2017-04-14 01:00:00;26,78;26,66;0,12;40675;0;0;0;0;50960;14457;0.2837;14198;259
2017-04-14 02:00:00;26,96;27,3;-0,34;40675;0;0;0;0;50960;14230;0.2792;14126;104
2017-04-14 03:00:00;26,87;26,8;0,07;40675;0;0;0;0;50960;13747;0.2698;14089;-342
2017-04-14 04:00:00;26,69;28,04;-1,35;40675;0;0;0;0;50960;13262;0.2602;13928;-666
2017-04-14 05:00:00;26,76;28,8;-2,04;40675;0;0;0;0;50960;13396;0.2628;13565;-169
2017-04-14 06:00:00;26,93;28,42;-1,49;40675;121;0.003;131;-10;50960;13515;0.2652;12927;588
2017-04-14 07:00:00;27,7;25,26;2,44;40675;1785;0.0439;1856;-71;50960;11932;0.2341;12215;-283
2017-04-14 08:00:00;28,73;26,77;1,96;40675;5254;0.1291;5582;-328;50960;10891;0.2137;11703;-812
2017-04-14 09:00:00;28,23;29,88;-1,65;40675;9285;0.2283;9762;-477;50960;11278;0.2213;11581;-303
2017-04-14 10:00:00;27,82;30,11;-2,29;40675;12682;0.3118;13011;-329;50960;11486;0.2254;11512;-26
2017-04-14 11:00:00;27,88;27,21;0,67;40675;14742;0.3624;14839;-97;50960;11423;0.2242;11421;2
2017-04-14 12:00:00;25,95;24,82;1,13;40675;14914;0.3667;15530;-616;50960;11931;0.2341;11313;618
2017-04-14 13:00:00;27,69;24,41;3,28;40675;13832;0.34;15346;-1514;50960;12204;0.2395;11181;1023
2017-04-14 14:00:00;27,65;24,87;2,78;40675;12691;0.312;14341;-1650;50960;12320;0.2418;11093;1227
2017-04-14 15:00:00;27,79;24,49;3,3;40675;11002;0.2705;12497;-1495;50960;12236;0.2401;10942;1294
2017-04-14 16:00:00;28,34;24,99;3,35;40675;8488;0.2087;9940;-1452;50960;11370;0.2231;10568;802
2017-04-14 17:00:00;30,66;29,03;1,63;40675;5577;0.1371;6762;-1185;50960;10895;0.2138;9870;1025
2017-04-14 18:00:00;36,9;34,59;2,31;40675;2694;0.0662;3224;-530;50960;9641;0.1892;8763;878
2017-04-14 19:00:00;38,74;34,22;4,52;40675;551;0.0135;640;-89;50960;8054;0.158;7562;492
2017-04-14 20:00:00;38,37;34,16;4,21;40675;6;0.0001;9;-3;50960;7518;0.1475;6885;633
2017-04-14 21:00:00;38,55;33,36;5,19;40675;0;0;0;0;50960;7239;0.142;6972;267
2017-04-14 22:00:00;37,45;33,33;4,12;40675;0;0;0;0;50960;7183;0.141;7416;-233
2017-04-14 23:00:00;36,95;30,99;5,96;40675;0;0;0;0;50960;7692;0.151;8190;-498
2017-04-15 00:00:00;33,88;29,47;4,41;40675;0;0;0;0;50960;8522;0.1672;8302;220
2017-04-15 01:00:00;30,51;25,91;4,6;40675;0;0;0;0;50960;9509;0.1866;9372;137
2017-04-15 02:00:00;28,82;23,97;4,85;40675;0;0;0;0;50960;10623;0.2085;10437;186
2017-04-15 03:00:00;25,98;15,27;10,71;40675;0;0;0;0;50960;11709;0.2298;11631;78
2017-04-15 04:00:00;20,04;11,82;8,22;40675;0;0;0;0;50960;13458;0.2641;12851;607
2017-04-15 05:00:00;19,1;9,12;9,98;40675;0;0;0;0;50960;14092;0.2765;13949;143
2017-04-15 06:00:00;17,67;7,03;10,64;40675;94;0.0023;85;9;50960;15166;0.2976;15021;145
2017-04-15 07:00:00;17,97;8,21;9,76;40675;1274;0.0313;1067;207;50960;17092;0.3354;16386;706
2017-04-15 08:00:00;20,1;11,94;8,16;40675;3749;0.0922;3037;712;50960;18214;0.3574;18321;-107
2017-04-15 09:00:00;19,08;9,15;9,93;40675;6693;0.1646;5226;1467;50960;20444;0.4012;20922;-478
2017-04-15 10:00:00;13,94;4,8;9,14;40675;9468;0.2328;7086;2382;50960;23404;0.4593;23607;-203
2017-04-15 11:00:00;9,43;-7,0;16,43;40675;10268;0.2524;8558;1710;50960;26088;0.5119;25698;390
2017-04-15 12:00:00;13,36;-10,86;24,22;40675;10294;0.2531;9598;696;50960;27530;0.5402;27158;372
2017-04-15 13:00:00;7,56;-5,67;13,23;40675;10184;0.2504;10199;-15;50960;28582;0.5609;28231;351
2017-04-15 14:00:00;0,25;-1,26;1,51;40675;9380;0.2306;10245;-865;50960;29337;0.5757;28785;552
2017-04-15 15:00:00;-1,08;6,31;-7,39;40675;8630;0.2122;9470;-840;50960;30212;0.5929;28882;1330
2017-04-15 16:00:00;-3,23;10,11;-13,34;40675;7083;0.1741;7750;-667;50960;30521;0.599;28858;1663
2017-04-15 17:00:00;7,68;13,12;-5,44;40675;5006;0.1231;5397;-391;50960;29745;0.5837;28170;1575
2017-04-15 18:00:00;10,03;18,78;-8,75;40675;2609;0.0641;2823;-214;50960;28604;0.5613;26683;1921
2017-04-15 19:00:00;14,03;19,8;-5,77;40675;694;0.0171;670;24;50960;26179;0.5137;25027;1152
2017-04-15 20:00:00;13,03;18,49;-5,46;40675;19;0.0005;16;3;50960;23818;0.4674;23646;172
2017-04-15 21:00:00;12,04;16,34;-4,3;40675;0;0;0;0;50960;22810;0.4476;22880;-70
2017-04-15 22:00:00;11,07;13,56;-2,49;40675;0;0;0;0;50960;22312;0.4378;22574;-262
2017-04-15 23:00:00;9,23;13,48;-4,25;40675;0;0;0;0;50960;22615;0.4438;22512;103
2017-04-16 00:00:00;3,94;9,95;-6,01;40675;0;0;0;0;50966;22678;0.445;22734;-56
2017-04-16 01:00:00;7,55;9,17;-1,62;40675;0;0;0;0;50966;22325;0.438;23013;-688
2017-04-16 02:00:00;5,14;11,65;-6,51;40675;0;0;0;0;50966;21849;0.4287;22965;-1116
2017-04-16 03:00:00;1,91;9,29;-7,38;40675;0;0;0;0;50966;20909;0.4102;22193;-1284
2017-04-16 04:00:00;7,55;9,65;-2,1;40675;0;0;0;0;50966;19569;0.3839;21085;-1516
2017-04-16 05:00:00;14,03;13,22;0,81;40675;0;0;0;0;50966;18045;0.354;19465;-1420
2017-04-16 06:00:00;9,2;11,27;-2,07;40675;144;0.0035;152;-8;50966;16857;0.3308;17389;-532
2017-04-16 07:00:00;14,07;11,7;2,37;40675;1766;0.0434;1733;33;50966;14753;0.2895;15292;-539
2017-04-16 08:00:00;15,96;21,84;-5,88;40675;4553;0.1119;4757;-204;50966;13079;0.2566;13683;-604
2017-04-16 09:00:00;19,01;26,73;-7,72;40675;7624;0.1874;8007;-383;50966;12631;0.2478;13007;-376
2017-04-16 10:00:00;19,01;28,91;-9,9;40675;10060;0.2473;10642;-582;50966;12526;0.2458;12653;-127
2017-04-16 11:00:00;28,74;29,12;-0,38;40675;11938;0.2935;12320;-382;50966;11839;0.2323;12332;-493
2017-04-16 12:00:00;24,03;27,91;-3,88;40675;12605;0.3099;13046;-441;50966;12205;0.2394;12015;190
2017-04-16 13:00:00;15,03;18,16;-3,13;40675;12323;0.303;12655;-332;50966;12499;0.2453;11676;823
2017-04-16 14:00:00;16,0;14,92;1,08;40675;11996;0.2949;11556;440;50966;12434;0.244;11672;762
2017-04-16 15:00:00;15,31;16,37;-1,06;40675;10828;0.2662;9826;1002;50966;12235;0.2401;11875;360
2017-04-16 16:00:00;15,06;13,87;1,19;40675;8487;0.2087;7554;933;50966;12104;0.2375;11981;123
2017-04-16 17:00:00;23,03;18,61;4,42;40675;5432;0.1336;5028;404;50966;10950;0.2148;11699;-749
2017-04-16 18:00:00;31,07;25,12;5,95;40675;2901;0.0713;2503;398;50966;9713;0.1906;10872;-1159
2017-04-16 19:00:00;31,07;28,07;3,0;40675;747;0.0184;594;153;50966;8496;0.1667;10071;-1575
2017-04-16 20:00:00;33,95;28,27;5,68;40675;15;0.0004;16;-1;50966;7356;0.1443;9519;-2163
2017-04-16 21:00:00;32,55;26,5;6,05;40675;0;0;0;0;50966;6708;0.1316;9261;-2553
2017-04-16 22:00:00;31,91;26,91;5,0;40675;0;0;0;0;50966;6377;0.1251;9148;-2771
2017-04-16 23:00:00;30,46;24,89;5,57;40675;0;0;0;0;50966;6426;0.1261;9240;-2814
2017-04-17 00:00:00;28,5;22,8;5,7;40676;0;0;0;0;50972;6373;0.125;6766;-393
2017-04-17 01:00:00;24,01;19,0;5,01;40676;0;0;0;0;50972;6411;0.1258;6982;-571
2017-04-17 02:00:00;22,07;18,73;3,34;40676;0;0;0;0;50972;6634;0.1302;7170;-536
2017-04-17 03:00:00;21,08;17,82;3,26;40676;0;0;0;0;50972;6825;0.1339;7427;-602
2017-04-17 04:00:00;22,0;16,98;5,02;40676;0;0;0;0;50972;6598;0.1294;7571;-973
2017-04-17 05:00:00;27,95;19,82;8,13;40676;0;0;0;0;50972;6804;0.1335;7532;-728
2017-04-17 06:00:00;28,21;19,22;8,99;40676;141;0.0035;160;-19;50972;6902;0.1354;7359;-457
2017-04-17 07:00:00;27,44;17,23;10,21;40676;1413;0.0347;1581;-168;50972;6754;0.1325;7206;-452
2017-04-17 08:00:00;29,9;19,28;10,62;40676;3775;0.0928;4226;-451;50972;6150;0.1206;7024;-874
2017-04-17 09:00:00;30,17;21,44;8,73;40676;6474;0.1592;7454;-980;50972;6152;0.1207;7061;-909
2017-04-17 10:00:00;29,6;21,44;8,16;40676;8268;0.2033;10541;-2273;50972;6662;0.1307;7398;-736
2017-04-17 11:00:00;29,0;21,38;7,62;40676;9600;0.236;12869;-3269;50972;7384;0.1448;7823;-439
2017-04-17 12:00:00;25,01;21,05;3,96;40676;10808;0.2657;13916;-3108;50972;8171;0.1603;8494;-323
2017-04-17 13:00:00;19,57;17,17;2,4;40676;11568;0.2844;14148;-2580;50972;9192;0.1803;9385;-193
2017-04-17 14:00:00;15,93;12,87;3,06;40676;11392;0.28;13813;-2421;50972;10862;0.2131;10392;470
2017-04-17 15:00:00;9,28;11,68;-2,4;40676;10340;0.2542;12590;-2250;50972;11704;0.2296;11491;213
2017-04-17 16:00:00;9,36;11,33;-1,97;40676;8754;0.2152;10497;-1743;50972;12560;0.2464;12384;176
2017-04-17 17:00:00;17,8;16,69;1,11;40676;6211;0.1527;7628;-1417;50972;12707;0.2493;12757;-50
2017-04-17 18:00:00;25,36;24,46;0,9;40676;3320;0.0816;3966;-646;50972;11820;0.2319;12307;-487
2017-04-17 19:00:00;32,15;28,5;3,65;40676;866;0.0212;963;-97;50972;11067;0.2171;11488;-421
2017-04-17 20:00:00;33,91;30,09;3,82;40676;23;0.0006;30;-7;50972;10394;0.2039;10488;-94
2017-04-17 21:00:00;33,95;30,21;3,74;40676;0;0;0;0;50972;9961;0.1954;9685;276
2017-04-17 22:00:00;33,93;28,96;4,97;40676;0;0;0;0;50972;10000;0.1962;9163;837
2017-04-17 23:00:00;30,95;25,25;5,7;40676;0;0;0;0;50972;9587;0.1881;8740;847
2017-04-18 00:00:00;29,54;26,93;2,61;40680;0;0;0;0;50978;8765;0.1719;9838;-1073
2017-04-18 01:00:00;28,36;26,51;1,85;40680;0;0;0;0;50978;7878;0.1545;9386;-1508
2017-04-18 02:00:00;27,77;25,31;2,46;40680;0;0;0;0;50978;8014;0.1572;9150;-1136
2017-04-18 03:00:00;27,26;24,33;2,93;40680;0;0;0;0;50978;8958;0.1757;9255;-297
2017-04-18 04:00:00;26,97;21,39;5,58;40680;0;0;0;0;50978;10109;0.1983;9386;723
2017-04-18 05:00:00;30,91;23,27;7,64;40680;0;0;0;0;50978;10250;0.2011;9644;606
2017-04-18 06:00:00;39,94;32,69;7,25;40680;130;0.0032;171;-41;50978;11122;0.2182;10093;1029
2017-04-18 07:00:00;43,35;37,86;5,49;40680;1363;0.0335;1777;-414;50978;11436;0.2244;10830;606
2017-04-18 08:00:00;45,39;40,02;5,37;40680;3584;0.0881;4874;-1290;50978;12529;0.2458;11745;784
2017-04-18 09:00:00;41,05;39,71;1,34;40680;6250;0.1536;8502;-2252;50978;13619;0.2672;12668;951
2017-04-18 10:00:00;39,88;39,42;0,46;40680;8242;0.2026;11876;-3634;50978;14365;0.2818;13542;823
2017-04-18 11:00:00;37,97;40,1;-2,13;40680;9799;0.2409;14430;-4631;50978;14425;0.283;14144;281
2017-04-18 12:00:00;35,9;41,0;-5,1;40680;10993;0.2702;15988;-4995;50978;14336;0.2812;14420;-84
2017-04-18 13:00:00;33,83;40,6;-6,77;40680;12161;0.2989;16452;-4291;50978;13539;0.2656;14777;-1238
2017-04-18 14:00:00;31,04;38,83;-7,79;40680;12975;0.3189;16044;-3069;50978;13619;0.2672;15366;-1747
2017-04-18 15:00:00;30,43;36,78;-6,35;40680;12906;0.3173;14362;-1456;50978;14151;0.2776;16361;-2210
2017-04-18 16:00:00;30,1;35,3;-5,2;40680;10924;0.2686;11511;-587;50978;14419;0.2828;17427;-3008
2017-04-18 17:00:00;30,85;34,69;-3,84;40680;7714;0.1896;7992;-278;50978;14916;0.2926;17874;-2958
2017-04-18 18:00:00;33,92;36,64;-2,72;40680;4045;0.0994;4105;-60;50978;14738;0.2891;17494;-2756
2017-04-18 19:00:00;37,95;38,51;-0,56;40680;1093;0.0268;1036;57;50978;13437;0.2636;16766;-3329
2017-04-18 20:00:00;38,0;40,41;-2,41;40680;36;0.0009;36;0;50978;12150;0.2384;15677;-3527
2017-04-18 21:00:00;37,71;39,62;-1,91;40680;0;0;0;0;50978;10925;0.2143;14593;-3668
2017-04-18 22:00:00;34,08;37,91;-3,83;40680;0;0;0;0;50978;10294;0.2019;13646;-3352
2017-04-18 23:00:00;31,07;34,55;-3,48;40680;0;0;0;0;50978;9610;0.1885;12725;-3115
2017-04-19 00:00:00;30,35;31,42;-1,07;40685;0;0;0;0;50986;8954;0.1756;9782;-828
2017-04-19 01:00:00;30,02;31,9;-1,88;40685;0;0;0;0;50986;8345;0.1637;9071;-726
2017-04-19 02:00:00;29,94;30,57;-0,63;40685;0;0;0;0;50986;7794;0.1528;8551;-757
2017-04-19 03:00:00;30,25;31,17;-0,92;40685;0;0;0;0;50986;7751;0.152;8383;-632
2017-04-19 04:00:00;30,83;32,95;-2,12;40685;0;0;0;0;50986;7608;0.1492;8279;-671
2017-04-19 05:00:00;31,81;33,19;-1,38;40685;0;0;0;0;50986;7569;0.1485;8078;-509
2017-04-19 06:00:00;38,9;39,66;-0,76;40685;241;0.0059;269;-28;50986;7595;0.149;7772;-177
2017-04-19 07:00:00;46,88;44,35;2,53;40685;2376;0.0584;2597;-221;50986;6834;0.134;7191;-357
2017-04-19 08:00:00;48,38;45,42;2,96;40685;6514;0.1601;7055;-541;50986;5720;0.1122;6457;-737
2017-04-19 09:00:00;43,67;45,35;-1,68;40685;11072;0.2722;11983;-911;50986;6982;0.1369;6853;129
2017-04-19 10:00:00;38,97;39,3;-0,33;40685;13010;0.3198;15672;-2662;50986;8865;0.1739;8484;381
2017-04-19 11:00:00;37,4;38,1;-0,7;40685;13294;0.3268;17443;-4149;50986;8734;0.1713;9364;-630
2017-04-19 12:00:00;37,1;41,1;-4,0;40685;13528;0.3325;17591;-4063;50986;8514;0.167;9145;-631
2017-04-19 13:00:00;36,61;38,6;-1,99;40685;14022;0.3446;16799;-2777;50986;8268;0.1621;8803;-535
2017-04-19 14:00:00;34,47;37,06;-2,59;40685;13953;0.3429;15441;-1488;50986;8103;0.1589;8713;-610
2017-04-19 15:00:00;33,07;35,58;-2,51;40685;12692;0.312;13354;-662;50986;7989;0.1567;8834;-845
2017-04-19 16:00:00;33,73;35,95;-2,22;40685;10359;0.2546;10770;-411;50986;8021;0.1573;8962;-941
2017-04-19 17:00:00;36,89;37,47;-0,58;40685;7293;0.1793;7418;-125;50986;7966;0.1562;8877;-911
2017-04-19 18:00:00;38,92;40,45;-1,53;40685;3899;0.0958;3885;14;50986;7335;0.1438;8362;-1027
2017-04-19 19:00:00;41,19;43,89;-2,7;40685;1132;0.0278;1027;105;50986;6101;0.1197;7500;-1399
2017-04-19 20:00:00;44,01;45,16;-1,15;40685;31;0.0008;39;-8;50986;5180;0.1016;6840;-1660
2017-04-19 21:00:00;43,06;44,92;-1,86;40685;0;0;0;0;50986;5055;0.0991;6458;-1403
2017-04-19 22:00:00;38,05;40,26;-2,21;40685;0;0;0;0;50986;5046;0.099;6006;-960
2017-04-19 23:00:00;34,16;35,14;-0,98;40685;0;0;0;0;50986;4556;0.0894;5428;-872
2017-04-20 00:00:00;32,03;33,39;-1,36;40691;0;0;0;0;51011;3887;0.0762;3890;-3
2017-04-20 01:00:00;32,95;34,04;-1,09;40691;0;0;0;0;51011;3154;0.0618;3292;-138
2017-04-20 02:00:00;31,43;33,18;-1,75;40691;0;0;0;0;51011;2725;0.0534;2850;-125
2017-04-20 03:00:00;31,62;33,0;-1,38;40691;0;0;0;0;51011;2562;0.0502;2660;-98
2017-04-20 04:00:00;31,71;33,41;-1,7;40691;0;0;0;0;51011;2696;0.0528;2547;149
2017-04-20 05:00:00;33,2;36,69;-3,49;40691;0;0;0;0;51011;2824;0.0554;2482;342
2017-04-20 06:00:00;42,03;39,14;2,89;40691;310;0.0076;309;1;51011;3028;0.0594;2461;567
2017-04-20 07:00:00;48,41;45,55;2,86;40691;3136;0.0771;2960;176;51011;3046;0.0597;2432;614
2017-04-20 08:00:00;52,0;44,84;7,16;40691;8680;0.2133;8106;574;51011;2458;0.0482;2410;48
2017-04-20 09:00:00;43,87;38,52;5,35;40691;14405;0.354;13496;909;51011;2503;0.0491;2507;-4
2017-04-20 10:00:00;38,47;37,34;1,13;40691;16847;0.414;17369;-522;51011;3443;0.0675;2876;567
2017-04-20 11:00:00;36,32;37,85;-1,53;40691;18496;0.4546;19524;-1028;51011;3930;0.077;3259;671
2017-04-20 12:00:00;33,86;38,27;-4,41;40691;20258;0.4978;20425;-167;51011;4110;0.0806;3635;475
2017-04-20 13:00:00;32,4;34,23;-1,83;40691;21493;0.5282;20466;1027;51011;4444;0.0871;4075;369
2017-04-20 14:00:00;31,07;30,87;0,2;40691;21382;0.5254;19515;1867;51011;4962;0.0973;4612;350
2017-04-20 15:00:00;31,09;29,68;1,41;40691;19346;0.4754;17327;2019;51011;5522;0.1082;5199;323
2017-04-20 16:00:00;33,01;29,55;3,46;40691;15456;0.3798;13893;1563;51011;6249;0.1225;5751;498
2017-04-20 17:00:00;36,89;34,6;2,29;40691;10464;0.2571;9486;978;51011;6793;0.1332;6159;634
2017-04-20 18:00:00;39,94;37,28;2,66;40691;5294;0.1301;4689;605;51011;6592;0.1292;6340;252
2017-04-20 19:00:00;45,01;42,31;2,7;40691;1420;0.0349;1194;226;51011;6227;0.1221;6408;-181
2017-04-20 20:00:00;46,61;44,08;2,53;40691;45;0.0011;52;-7;51011;5992;0.1175;6757;-765
2017-04-20 21:00:00;44,06;43,81;0,25;40691;0;0;0;0;51011;6298;0.1235;7506;-1208
2017-04-20 22:00:00;35,23;42,58;-7,35;40691;0;0;0;0;51011;7298;0.1431;8488;-1190
2017-04-20 23:00:00;29,22;34,99;-5,77;40691;0;0;0;0;51011;8397;0.1646;9428;-1031
2017-04-21 00:00:00;29,3;31,97;-2,67;40696;0;0;0;0;51037;9588;0.1879;10361;-773
2017-04-21 01:00:00;25,05;26,43;-1,38;40696;0;0;0;0;51037;10435;0.2045;11185;-750
2017-04-21 02:00:00;26,52;26,6;-0,08;40696;0;0;0;0;51037;11021;0.216;11788;-767
2017-04-21 03:00:00;25,25;26,48;-1,23;40696;0;0;0;0;51037;11202;0.2195;12189;-987
2017-04-21 04:00:00;24,05;27,07;-3,02;40696;0;0;0;0;51037;11392;0.2232;12452;-1060
2017-04-21 05:00:00;28,25;30,63;-2,38;40696;1;0;0;1;51037;11490;0.2252;12666;-1176
2017-04-21 06:00:00;40,02;39,81;0,21;40696;242;0.0059;259;-17;51037;11684;0.2289;12831;-1147
2017-04-21 07:00:00;42,5;43,24;-0,74;40696;2346;0.0577;2327;19;51037;11947;0.2341;12985;-1038
2017-04-21 08:00:00;42,61;42,2;0,41;40696;6272;0.1541;6127;145;51037;11712;0.2295;13155;-1443
2017-04-21 09:00:00;38,95;37,11;1,84;40696;10783;0.265;10141;642;51037;11705;0.2294;13844;-2139
2017-04-21 10:00:00;34,47;32,08;2,39;40696;15237;0.3744;13402;1835;51037;12916;0.2531;15038;-2122
2017-04-21 11:00:00;31,97;25,21;6,76;40696;18706;0.4596;15496;3210;51037;14792;0.2898;16303;-1511
2017-04-21 12:00:00;28,08;15,18;12,9;40696;19832;0.4874;16401;3431;51037;17556;0.344;17796;-240
2017-04-21 13:00:00;21,15;7,53;13,62;40696;19241;0.4728;16026;3215;51037;19612;0.3843;19366;246
2017-04-21 14:00:00;20,79;8,2;12,59;40696;18136;0.4457;14601;3535;51037;21507;0.4214;20879;628
2017-04-21 15:00:00;19,84;8,36;11,48;40696;15130;0.3718;12355;2775;51037;23314;0.4568;22079;1235
2017-04-21 16:00:00;24,04;10,02;14,02;40696;11315;0.278;9434;1881;51037;23880;0.4679;23008;872
2017-04-21 17:00:00;27,08;17,18;9,9;40696;7176;0.1764;6124;1052;51037;24230;0.4747;23582;648
2017-04-21 18:00:00;29,14;26,36;2,78;40696;3369;0.0828;2937;432;51037;24630;0.4826;23635;995
2017-04-21 19:00:00;31,02;28,63;2,39;40696;800;0.0197;757;43;51037;24678;0.4836;23659;1019
2017-04-21 20:00:00;30,64;27,04;3,6;40696;16;0.0004;32;-16;51037;25036;0.4906;23923;1113
2017-04-21 21:00:00;24,01;21,03;2,98;40696;0;0;0;0;51037;25486;0.4994;24303;1183
2017-04-21 22:00:00;16,26;12,69;3,57;40696;0;0;0;0;51037;25355;0.4968;24714;641
2017-04-21 23:00:00;3,55;6,37;-2,82;40696;0;0;0;0;51037;24933;0.4885;24733;200
2017-04-22 00:00:00;0,88;12,25;-11,37;40697;0;0;0;0;51048;24159;0.4733;23954;205
2017-04-22 01:00:00;8,0;12,46;-4,46;40697;0;0;0;0;51048;23490;0.4601;23129;361
2017-04-22 02:00:00;8,22;13,59;-5,37;40697;0;0;0;0;51048;22671;0.4441;22452;219
2017-04-22 03:00:00;8,03;12,55;-4,52;40697;0;0;0;0;51048;21990;0.4308;21901;89
2017-04-22 04:00:00;9,08;11,15;-2,07;40697;0;0;0;0;51048;21436;0.4199;21460;-24
2017-04-22 05:00:00;9,18;11,88;-2,7;40697;2;0;0;2;51048;20456;0.4007;20970;-514
2017-04-22 06:00:00;9,19;16,7;-7,51;40697;239;0.0058;262;-23;51048;19618;0.3843;20587;-969
2017-04-22 07:00:00;10,72;21,3;-10,58;40697;1840;0.0452;1880;-40;51048;18857;0.3694;20610;-1753
2017-04-22 08:00:00;13,09;26,68;-13,59;40697;4631;0.1138;4608;23;51048;20799;0.4075;21592;-793
2017-04-22 09:00:00;13,47;20,84;-7,37;40697;7339;0.1803;7505;-166;51048;23371;0.4578;23453;-82
2017-04-22 10:00:00;9,54;21,16;-11,62;40697;9190;0.2258;9907;-717;51048;24669;0.4833;25147;-478
2017-04-22 11:00:00;9,12;17,36;-8,24;40697;10570;0.2597;11605;-1035;51048;25511;0.4998;26330;-819
2017-04-22 12:00:00;9,04;18,37;-9,33;40697;11493;0.2824;12539;-1046;51048;26154;0.5124;26899;-745
2017-04-22 13:00:00;8,1;14,61;-6,51;40697;11933;0.2932;12565;-632;51048;26758;0.5241;27370;-612
2017-04-22 14:00:00;5,02;12,26;-7,24;40697;11267;0.2768;11946;-679;51048;26948;0.5279;27695;-747
2017-04-22 15:00:00;7,11;12,97;-5,86;40697;9763;0.2399;10661;-898;51048;27509;0.5389;27902;-393
2017-04-22 16:00:00;9,05;14,33;-5,28;40697;8056;0.198;8696;-640;51048;27400;0.5368;27890;-490
2017-04-22 17:00:00;10,72;15,8;-5,08;40697;5549;0.1363;6168;-619;51048;26628;0.5216;27291;-663
2017-04-22 18:00:00;20,79;21,91;-1,12;40697;3096;0.0761;3309;-213;51048;24804;0.4859;25898;-1094
2017-04-22 19:00:00;23,01;24,52;-1,51;40697;926;0.0228;961;-35;51048;23470;0.4598;24059;-589
2017-04-22 20:00:00;24,5;25,58;-1,08;40697;40;0.001;48;-8;51048;21666;0.4244;22236;-570
2017-04-22 21:00:00;24,2;23,76;0,44;40697;0;0;0;0;51048;20227;0.3962;21105;-878
2017-04-22 22:00:00;24,15;23,73;0,42;40697;0;0;0;0;51048;19170;0.3755;20388;-1218
2017-04-22 23:00:00;20,2;23,24;-3,04;40697;0;0;0;0;51048;19169;0.3755;20019;-850
2017-04-23 00:00:00;9,04;14,95;-5,91;40697;0;0;0;0;51048;18382;0.3601;20055;-1673
2017-04-23 01:00:00;8,97;10,5;-1,53;40697;0;0;0;0;51048;18234;0.3572;19785;-1551
2017-04-23 02:00:00;8,31;12,47;-4,16;40697;0;0;0;0;51048;18209;0.3567;19595;-1386
2017-04-23 03:00:00;8,94;12,86;-3,92;40697;0;0;0;0;51048;17823;0.3491;19302;-1479
2017-04-23 04:00:00;10,05;12,42;-2,37;40697;0;0;0;0;51048;16952;0.3321;19015;-2063
2017-04-23 05:00:00;9,04;17,02;-7,98;40697;2;0;1;1;51048;16237;0.3181;18890;-2653
2017-04-23 06:00:00;9,02;15,24;-6,22;40697;306;0.0075;335;-29;51048;15844;0.3104;19009;-3165
2017-04-23 07:00:00;8,04;14,58;-6,54;40697;2454;0.0603;2561;-107;51048;14541;0.2849;19167;-4626
2017-04-23 08:00:00;8,89;20,97;-12,08;40697;6208;0.1526;6505;-297;51048;14676;0.2875;19065;-4389
2017-04-23 09:00:00;8,86;21,36;-12,5;40697;9712;0.2386;10790;-1078;51048;16341;0.3201;19119;-2778
2017-04-23 10:00:00;2,96;15,97;-13,01;40697;11794;0.2898;14314;-2520;51048;17811;0.3489;19872;-2061
2017-04-23 11:00:00;6,54;18,2;-11,66;40697;13120;0.3224;16221;-3101;51048;18959;0.3714;20843;-1884
2017-04-23 12:00:00;3,72;19,82;-16,1;40697;14752;0.3625;16876;-2124;51048;19665;0.3852;21348;-1683
2017-04-23 13:00:00;-7,65;11,73;-19,38;40697;15257;0.3749;16948;-1691;51048;20706;0.4056;21792;-1086
2017-04-23 14:00:00;-15,03;5,64;-20,67;40697;15369;0.3776;16257;-888;51048;21228;0.4159;22049;-821
2017-04-23 15:00:00;-9,18;1,01;-10,19;40697;14333;0.3522;14532;-199;51048;21654;0.4242;21942;-288
2017-04-23 16:00:00;-0,15;1,27;-1,42;40697;12004;0.295;11679;325;51048;21747;0.426;21424;323
2017-04-23 17:00:00;7,6;7,2;0,4;40697;8641;0.2123;8058;583;51048;20660;0.4047;20068;592
2017-04-23 18:00:00;21,08;22,26;-1,18;40697;4667;0.1146;4174;493;51048;18868;0.3696;17758;1110
2017-04-23 19:00:00;30,63;30,33;0,3;40697;1423;0.035;1169;254;51048;15246;0.2987;14916;330
2017-04-23 20:00:00;34,54;37,54;-3,0;40697;69;0.0017;60;9;51048;12040;0.2359;12411;-371
2017-04-23 21:00:00;36,65;36,8;-0,15;40697;0;0;0;0;51048;10575;0.2072;11033;-458
2017-04-23 22:00:00;37,1;40,09;-2,99;40697;0;0;0;0;51048;10180;0.1994;10373;-193
2017-04-23 23:00:00;29,95;35,12;-5,17;40697;0;0;0;0;51048;10585;0.2074;10256;329
2017-04-24 00:00:00;29,19;26,42;2,77;40701;0;0;0;0;51060;11424;0.2237;10421;1003
2017-04-24 01:00:00;27,65;25,86;1,79;40701;0;0;0;0;51060;11942;0.2339;10977;965
2017-04-24 02:00:00;27,42;24,9;2,52;40701;0;0;0;0;51060;12470;0.2442;11642;828
2017-04-24 03:00:00;26,48;24,34;2,14;40701;0;0;0;0;51060;12694;0.2486;12448;246
2017-04-24 04:00:00;27,46;24,68;2,78;40701;0;0;0;0;51060;13696;0.2682;13242;454
2017-04-24 05:00:00;30,26;28,17;2,09;40701;3;0.0001;5;-2;51060;14740;0.2887;14009;731
2017-04-24 06:00:00;38,83;35,04;3,79;40701;481;0.0118;581;-100;51060;15696;0.3074;14688;1008
2017-04-24 07:00:00;40,89;41,24;-0,35;40701;3731;0.0917;3466;265;51060;16156;0.3164;15336;820
2017-04-24 08:00:00;40,86;37,46;3,4;40701;9294;0.2284;8599;695;51060;16047;0.3143;15956;91
2017-04-24 09:00:00;31,8;26,22;5,58;40701;15027;0.3692;14192;835;51060;17459;0.3419;17136;323
2017-04-24 10:00:00;24,06;19,63;4,43;40701;19857;0.4878;18461;1396;51060;20074;0.3932;19094;980
2017-04-24 11:00:00;12,82;9,78;3,04;40701;22941;0.5636;20989;1952;51060;21900;0.4289;20699;1201
2017-04-24 12:00:00;9,07;-4,8;13,87;40701;24237;0.5955;22066;2171;51060;22384;0.4384;21805;579
2017-04-24 13:00:00;20,01;-0,82;20,83;40701;23940;0.5882;21851;2089;51060;22436;0.4394;22384;52
2017-04-24 14:00:00;22,44;9,12;13,32;40701;22184;0.545;20361;1823;51060;21212;0.4154;22011;-799
2017-04-24 15:00:00;24,9;17,16;7,74;40701;19213;0.4721;17597;1616;51060;19250;0.377;20522;-1272
2017-04-24 16:00:00;27,71;23,36;4,35;40701;15214;0.3738;13958;1256;51060;17350;0.3398;18543;-1193
2017-04-24 17:00:00;32,19;29,99;2,2;40701;9961;0.2447;9515;446;51060;14527;0.2845;15958;-1431
2017-04-24 18:00:00;38,35;37,26;1,09;40701;4808;0.1181;4866;-58;51060;11700;0.2291;12969;-1269
2017-04-24 19:00:00;43,3;44,05;-0,75;40701;1319;0.0324;1460;-141;51060;8174;0.1601;10167;-1993
2017-04-24 20:00:00;43,59;44,31;-0,72;40701;50;0.0012;140;-90;51060;5957;0.1167;8113;-2156
2017-04-24 21:00:00;44,51;44,9;-0,39;40701;0;0;0;0;51060;4954;0.0971;6935;-1981
2017-04-24 22:00:00;44,38;43,91;0,47;40701;0;0;0;0;51060;4516;0.0884;6149;-1633
2017-04-24 23:00:00;38,55;39,78;-1,23;40701;0;0;0;0;51060;4024;0.0788;5706;-1682
2017-04-25 00:00:00;34,01;30,78;3,23;40706;0;0;0;0;51085;3706;0.0726;4835;-1129
2017-04-25 01:00:00;31,07;28,38;2,69;40706;0;0;0;0;51085;3976;0.0778;4931;-955
2017-04-25 02:00:00;31,2;29,23;1,97;40706;0;0;0;0;51085;4532;0.0887;5156;-624
2017-04-25 03:00:00;29,98;27,7;2,28;40706;0;0;0;0;51085;5558;0.1088;5514;44
2017-04-25 04:00:00;29,97;27,14;2,83;40706;0;0;0;0;51085;6932;0.1357;5975;957
2017-04-25 05:00:00;30,5;25,28;5,22;40706;3;0.0001;1;2;51085;8456;0.1655;6380;2076
2017-04-25 06:00:00;37,03;29,23;7,8;40706;315;0.0078;321;-6;51085;9839;0.1926;6661;3178
2017-04-25 07:00:00;41,17;34,8;6,37;40706;2041;0.0502;2060;-19;51085;9846;0.1927;6894;2952
2017-04-25 08:00:00;43,0;36,1;6,9;40706;4825;0.1186;4893;-68;51085;9817;0.1922;7112;2705
2017-04-25 09:00:00;41,94;35,35;6,59;40706;7409;0.182;7948;-539;51085;11440;0.224;7499;3941
2017-04-25 10:00:00;39,81;32,48;7,33;40706;9054;0.2224;10427;-1373;51085;13410;0.2625;8306;5104
2017-04-25 11:00:00;38,1;31,84;6,26;40706;10187;0.2503;12122;-1935;51085;14394;0.2818;9238;5156
2017-04-25 12:00:00;35,09;32,23;2,86;40706;11721;0.288;12975;-1254;51085;14744;0.2886;9937;4807
2017-04-25 13:00:00;33,91;31,72;2,19;40706;12515;0.3074;12806;-291;51085;15263;0.2987;10717;4546
2017-04-25 14:00:00;31,72;29,58;2,14;40706;11790;0.2896;11912;-122;51085;15425;0.302;11437;3988
2017-04-25 15:00:00;31,59;30,41;1,18;40706;10046;0.2468;10328;-282;51085;15512;0.3036;11854;3658
2017-04-25 16:00:00;32,46;31,36;1,1;40706;8425;0.207;7973;452;51085;15250;0.2986;11866;3384
2017-04-25 17:00:00;36,55;32,92;3,63;40706;6139;0.1508;5399;740;51085;13896;0.272;11260;2636
2017-04-25 18:00:00;39,93;35,94;3,99;40706;3536;0.0869;2896;640;51085;12149;0.2378;9965;2184
2017-04-25 19:00:00;42,95;38,75;4,2;40706;1178;0.029;890;288;51085;9268;0.1814;8406;862
2017-04-25 20:00:00;42,94;41,71;1,23;40706;87;0.0021;61;26;51085;7471;0.1462;6952;519
2017-04-25 21:00:00;41,98;40,36;1,62;40706;0;0;0;0;51085;6840;0.1339;6230;610
2017-04-25 22:00:00;38,42;35,08;3,34;40706;0;0;0;0;51085;6167;0.1207;6010;157
2017-04-25 23:00:00;33,4;29,29;4,11;40706;0;0;0;0;51085;5521;0.1081;5869;-348
2017-04-26 00:00:00;30,54;28,23;2,31;40713;0;0;0;0;51107;5196;0.1016;4219;977
2017-04-26 01:00:00;30,99;28,38;2,61;40713;0;0;0;0;51107;4721;0.0924;3962;759
2017-04-26 02:00:00;30,95;27,49;3,46;40713;0;0;0;0;51107;4377;0.0856;3734;643
2017-04-26 03:00:00;30,54;27,59;2,95;40713;0;0;0;0;51107;3829;0.075;3498;331
2017-04-26 04:00:00;30,44;27,37;3,07;40713;0;0;0;0;51107;3726;0.0729;3204;522
2017-04-26 05:00:00;33,1;28,14;4,96;40713;5;0.0001;3;2;51107;3397;0.0665;2834;563
2017-04-26 06:00:00;42,3;39,3;3,0;40713;334;0.0082;344;-10;51107;2828;0.0554;2335;493
2017-04-26 07:00:00;46,95;43,14;3,81;40713;2007;0.0493;2060;-53;51107;1985;0.0388;1759;226
2017-04-26 08:00:00;53,47;47,07;6,4;40713;4919;0.1208;4983;-64;51107;942;0.0184;1220;-278
2017-04-26 09:00:00;46,98;43,93;3,05;40713;8334;0.2047;8394;-60;51107;630;0.0123;952;-322
2017-04-26 10:00:00;45,61;43,1;2,51;40713;10537;0.2588;11280;-743;51107;896;0.0176;801;95
2017-04-26 11:00:00;44,75;42,37;2,38;40713;11799;0.2898;13140;-1341;51107;1202;0.0235;715;487
2017-04-26 12:00:00;44,01;43,3;0,71;40713;12316;0.3025;13990;-1674;51107;1400;0.0274;709;691
2017-04-26 13:00:00;42,0;43,54;-1,54;40713;12631;0.3102;13918;-1287;51107;1382;0.027;758;624
2017-04-26 14:00:00;39,11;40,97;-1,86;40713;12229;0.3004;13059;-830;51107;1670;0.0327;905;765
2017-04-26 15:00:00;38,64;40,05;-1,41;40713;10441;0.2565;11445;-1004;51107;1795;0.0351;1146;649
2017-04-26 16:00:00;38,61;39,09;-0,48;40713;8286;0.2035;9283;-997;51107;2173;0.0425;1406;767
2017-04-26 17:00:00;41,92;41,16;0,76;40713;5982;0.1469;6531;-549;51107;2560;0.0501;1618;942
2017-04-26 18:00:00;43,86;42,79;1,07;40713;3454;0.0849;3618;-164;51107;2813;0.055;1831;982
2017-04-26 19:00:00;44,09;42,17;1,92;40713;1202;0.0295;1176;26;51107;2700;0.0528;2097;603
2017-04-26 20:00:00;44,34;41,44;2,9;40713;83;0.002;83;0;51107;2441;0.0478;2271;170
2017-04-26 21:00:00;42,93;40,03;2,9;40713;0;0;0;0;51107;2396;0.0469;2411;-15
2017-04-26 22:00:00;39,1;37,29;1,81;40713;0;0;0;0;51107;2252;0.0441;2453;-201
2017-04-26 23:00:00;32,58;36,14;-3,56;40713;0;0;0;0;51107;2214;0.0433;2379;-165
2017-04-27 00:00:00;32,19;30,88;1,31;40727;0;0;0;0;51157;2285;0.0446;2244;41
2017-04-27 01:00:00;31,46;32,5;-1,04;40727;0;0;0;0;51157;2331;0.0456;2271;60
2017-04-27 02:00:00;31,06;32,25;-1,19;40727;0;0;0;0;51157;2624;0.0513;2386;238
2017-04-27 03:00:00;31,04;31,5;-0,46;40727;0;0;0;0;51157;2763;0.054;2613;150
2017-04-27 04:00:00;31,52;30,86;0,66;40727;0;0;0;0;51157;2718;0.0531;2778;-60
2017-04-27 05:00:00;32,48;32,58;-0,1;40727;7;0.0002;5;2;51157;2662;0.052;2798;-136
2017-04-27 06:00:00;41,19;41,01;0,18;40727;400;0.0098;435;-35;51157;2488;0.0486;2588;-100
2017-04-27 07:00:00;44,97;44,07;0,9;40727;2382;0.0585;2554;-172;51157;2520;0.0493;2309;211
2017-04-27 08:00:00;45,93;44,71;1,22;40727;5710;0.1402;6135;-425;51157;2153;0.0421;2130;23
2017-04-27 09:00:00;43,67;40,32;3,35;40727;9569;0.235;10127;-558;51157;2513;0.0491;2339;174
2017-04-27 10:00:00;42,92;38,96;3,96;40727;12148;0.2983;13152;-1004;51157;3730;0.0729;2872;858
2017-04-27 11:00:00;40,95;34,9;6,05;40727;13369;0.3282;14932;-1563;51157;4430;0.0866;3603;827
2017-04-27 12:00:00;35,83;33,77;2,06;40727;13240;0.3251;15637;-2397;51157;5771;0.1128;4536;1235
2017-04-27 13:00:00;34,99;33,74;1,25;40727;12598;0.3094;15433;-2835;51157;6749;0.1319;5431;1318
2017-04-27 14:00:00;32,01;32,32;-0,31;40727;11856;0.2911;14423;-2567;51157;7814;0.1528;6165;1649
2017-04-27 15:00:00;32,9;32,36;0,54;40727;10744;0.2638;12657;-1913;51157;8055;0.1574;6573;1482
2017-04-27 16:00:00;32,89;32,33;0,56;40727;8855;0.2174;10145;-1290;51157;8532;0.1668;6716;1816
2017-04-27 17:00:00;35,05;32,52;2,53;40727;6147;0.151;7086;-939;51157;8261;0.1615;6512;1749
2017-04-27 18:00:00;37,96;34,36;3,6;40727;3412;0.0838;3910;-498;51157;7359;0.1438;5943;1416
2017-04-27 19:00:00;41,97;41,65;0,32;40727;1137;0.0279;1267;-130;51157;6448;0.126;5328;1120
2017-04-27 20:00:00;41,91;43,12;-1,21;40727;89;0.0022;95;-6;51157;5992;0.1172;4825;1167
2017-04-27 21:00:00;41,08;41,09;-0,01;40727;0;0;0;0;51157;5424;0.106;4570;854
2017-04-27 22:00:00;34,87;38,05;-3,18;40727;0;0;0;0;51157;5078;0.0992;4491;587
2017-04-27 23:00:00;32,0;34,39;-2,39;40727;0;0;0;0;51157;5267;0.1029;4459;808
2017-04-28 00:00:00;31,38;31,7;-0,32;40752;0;0;0;0;51256;5216;0.1018;5192;24
2017-04-28 01:00:00;31,23;32,83;-1,6;40752;0;0;0;0;51256;4825;0.0942;5034;-209
2017-04-28 02:00:00;30,61;33,18;-2,57;40752;0;0;0;0;51256;4738;0.0924;4853;-115
2017-04-28 03:00:00;30,92;33,11;-2,19;40752;0;0;0;0;51256;4810;0.0939;4688;122
2017-04-28 04:00:00;31,41;32,2;-0,79;40752;0;0;0;0;51256;4604;0.0898;4554;50
2017-04-28 05:00:00;33,52;34,34;-0,82;40752;7;0.0002;5;2;51256;4306;0.084;4334;-28
2017-04-28 06:00:00;37,14;42,46;-5,32;40752;401;0.0098;422;-21;51256;4107;0.0802;3923;184
2017-04-28 07:00:00;45,4;48,7;-3,3;40752;2498;0.0613;2317;181;51256;3210;0.0626;3482;-272
2017-04-28 08:00:00;46,94;49,26;-2,32;40752;5912;0.1451;5442;470;51256;2395;0.0467;3086;-691
2017-04-28 09:00:00;44,99;46,24;-1,25;40752;9600;0.2356;8879;721;51256;2053;0.04;2871;-818
2017-04-28 10:00:00;42,9;43,45;-0,55;40752;12045;0.2956;11422;623;51256;2408;0.047;2842;-434
2017-04-28 11:00:00;41,9;43,1;-1,2;40752;12339;0.3028;12958;-619;51256;2636;0.0514;2924;-288
2017-04-28 12:00:00;38,99;44,67;-5,68;40752;11735;0.288;13639;-1904;51256;3036;0.0592;3034;2
2017-04-28 13:00:00;35,46;41,89;-6,43;40752;11733;0.2879;13474;-1741;51256;3336;0.0651;3226;110
2017-04-28 14:00:00;33,62;40,88;-7,26;40752;10616;0.2605;12659;-2043;51256;3595;0.0701;3597;-2
2017-04-28 15:00:00;33,05;41,68;-8,63;40752;9273;0.2276;11154;-1881;51256;3944;0.077;4129;-185
2017-04-28 16:00:00;32,76;40,86;-8,1;40752;7820;0.1919;9140;-1320;51256;4129;0.0805;4633;-504
2017-04-28 17:00:00;33,78;40,34;-6,56;40752;5961;0.1463;6641;-680;51256;4794;0.0935;4849;-55
2017-04-28 18:00:00;40,29;42,44;-2,15;40752;3628;0.089;3810;-182;51256;5000;0.0976;4767;233
2017-04-28 19:00:00;43,91;44,36;-0,45;40752;1394;0.0342;1271;123;51256;4768;0.093;4710;58
2017-04-28 20:00:00;42,99;42,96;0,03;40752;112;0.0028;103;9;51256;3928;0.0766;4546;-618
2017-04-28 21:00:00;37,97;37,85;0,12;40752;0;0;0;0;51256;4188;0.0817;4575;-387
2017-04-28 22:00:00;32,65;34,35;-1,7;40752;0;0;0;0;51256;4414;0.0861;4745;-331
2017-04-28 23:00:00;31,08;32,34;-1,26;40752;0;0;0;0;51256;4474;0.0873;5005;-531
2017-04-29 00:00:00;33,61;34,63;-1,02;40767;0;0;0;0;51280;4628;0.0902;4975;-347
2017-04-29 01:00:00;28,44;32,35;-3,91;40767;0;0;0;0;51280;4966;0.0968;5333;-367
2017-04-29 02:00:00;29,88;31,64;-1,76;40767;0;0;0;0;51280;5292;0.1032;5725;-433
2017-04-29 03:00:00;29,86;31,2;-1,34;40767;0;0;0;0;51280;5718;0.1115;6039;-321
2017-04-29 04:00:00;30,16;30,43;-0,27;40767;0;0;0;0;51280;6346;0.1238;6225;121
2017-04-29 05:00:00;30,58;31,54;-0,96;40767;8;0.0002;6;2;51280;6419;0.1252;6159;260
2017-04-29 06:00:00;32,46;33,23;-0,77;40767;518;0.0127;505;13;51280;6304;0.123;5820;484
2017-04-29 07:00:00;33,72;34,55;-0,83;40767;2956;0.0725;2856;100;51280;5447;0.1062;5314;133
2017-04-29 08:00:00;32,69;33,81;-1,12;40767;7028;0.1724;6791;237;51280;4247;0.0828;4924;-677
2017-04-29 09:00:00;32,56;34,29;-1,73;40767;11630;0.2853;11143;487;51280;4756;0.0927;4928;-172
2017-04-29 10:00:00;28,81;30,99;-2,18;40767;14142;0.3469;14710;-568;51280;5155;0.1005;5143;12
2017-04-29 11:00:00;26,82;29,4;-2,58;40767;15127;0.371;16905;-1778;51280;4971;0.097;5209;-238
2017-04-29 12:00:00;25,43;31,79;-6,36;40767;15937;0.3909;18019;-2082;51280;4816;0.0939;4954;-138
2017-04-29 13:00:00;23,09;30,7;-7,61;40767;16735;0.4105;18147;-1412;51280;4441;0.0866;4577;-136
2017-04-29 14:00:00;25,24;27,26;-2,02;40767;16335;0.4007;17380;-1045;51280;3818;0.0744;4145;-327
2017-04-29 15:00:00;25,04;28,23;-3,19;40767;15505;0.3803;15699;-194;51280;3415;0.0666;3648;-233
2017-04-29 16:00:00;27,46;30,03;-2,57;40767;13213;0.3241;13096;117;51280;2806;0.0547;3091;-285
2017-04-29 17:00:00;29,19;30,28;-1,09;40767;9808;0.2406;9445;363;51280;2220;0.0433;2517;-297
2017-04-29 18:00:00;32,54;31,1;1,44;40767;5702;0.1399;5139;563;51280;1593;0.0311;2005;-412
2017-04-29 19:00:00;34,93;32,04;2,89;40767;1939;0.0476;1611;328;51280;1193;0.0232;1724;-531
2017-04-29 20:00:00;34,79;33,28;1,51;40767;159;0.0039;134;25;51280;1487;0.029;1928;-441
2017-04-29 21:00:00;34,9;33,17;1,73;40767;0;0;0;0;51280;2994;0.0584;2784;210
2017-04-29 22:00:00;32,93;32,63;0,3;40767;0;0;0;0;51280;4412;0.086;3890;522
2017-04-29 23:00:00;30,47;30,22;0,25;40767;0;0;0;0;51280;5795;0.113;4913;882
2017-04-30 00:00:00;29,29;20,99;8,3;40773;0;0;0;0;51293;7285;0.142;5618;1667
2017-04-30 01:00:00;26,02;10,39;15,63;40773;0;0;0;0;51293;8210;0.16;6499;1711
2017-04-30 02:00:00;22,06;5,9;16,16;40773;0;0;0;0;51293;9075;0.177;7130;1945
2017-04-30 03:00:00;13,13;7,57;5,56;40773;0;0;0;0;51293;9968;0.1943;7716;2252
2017-04-30 04:00:00;9,63;7,3;2,33;40773;0;0;0;0;51293;11053;0.2155;8370;2683
2017-04-30 05:00:00;10,06;6,68;3,38;40773;11;0.0002;12;-1;51293;12070;0.2353;8832;3238
2017-04-30 06:00:00;16,8;7,12;9,68;40773;780;0.0191;635;145;51293;12720;0.248;8955;3765
2017-04-30 07:00:00;9,6;3,16;6,44;40773;4582;0.1124;3954;628;51293;12268;0.2392;8888;3380
2017-04-30 08:00:00;9,56;-2,16;11,72;40773;11076;0.2716;9900;1176;51293;9778;0.1906;8839;939
2017-04-30 09:00:00;8,71;-9,14;17,85;40773;17655;0.433;16286;1369;51293;11138;0.2171;9776;1362
2017-04-30 10:00:00;3,23;-16,16;19,39;40773;22892;0.5614;21174;1718;51293;14851;0.2895;11611;3240
2017-04-30 11:00:00;-1,9;-37,85;35,95;40773;26073;0.6395;24284;1789;51293;16462;0.3209;13759;2703
2017-04-30 12:00:00;-1,18;-58,3;57,12;40773;27375;0.6714;25811;1564;51293;16527;0.3222;15838;689
2017-04-30 13:00:00;-70,01;-94,55;24,54;40773;27500;0.6744;25999;1501;51293;15428;0.3008;17663;-2235
2017-04-30 14:00:00;-74,92;-100,57;25,65;40773;26626;0.653;24758;1868;51293;15456;0.3013;19142;-3686
2017-04-30 15:00:00;-71,96;-103,33;31,37;40773;24208;0.5937;22010;2198;51293;16558;0.3228;20295;-3737
2017-04-30 16:00:00;-49,97;-110,94;60,97;40773;19829;0.4863;17772;2057;51293;18518;0.361;21292;-2774
2017-04-30 17:00:00;-6,0;-68,71;62,71;40773;13718;0.3364;12011;1707;51293;21952;0.428;22046;-94
2017-04-30 18:00:00;-1,21;-41,26;40,05;40773;7067;0.1733;5931;1136;51293;24157;0.471;22372;1785
2017-04-30 19:00:00;8,86;-32,68;41,54;40773;2079;0.051;1657;422;51293;25870;0.5044;22653;3217
2017-04-30 20:00:00;10,08;-22,92;33,0;40773;172;0.0042;155;17;51293;26165;0.5101;23463;2702
2017-04-30 21:00:00;8,87;-23,8;32,67;40773;0;0;0;0;51293;27403;0.5343;24484;2919
2017-04-30 22:00:00;-0,54;-28,54;28,0;40773;0;0;0;0;51293;27472;0.5356;25389;2083
2017-04-30 23:00:00;-70,01;-64,93;-5,08;40773;0;0;0;0;51293;26762;0.5218;25693;1069
2017-01-05 00:00:00;-26,94;-20,32;-6,62;40774;0;0;0;0;51303;27360;0.5333;27168;192
2017-01-05 01:00:00;-25,0;-13,38;-11,62;40774;0;0;0;0;51303;26476;0.5161;26701;-225
2017-01-05 02:00:00;-30,11;-13,32;-16,79;40774;0;0;0;0;51303;25572;0.4984;26093;-521
2017-01-05 03:00:00;-30,03;-11,93;-18,1;40774;0;0;0;0;51303;24278;0.4733;25403;-1125
2017-01-05 04:00:00;-24,9;-0,99;-23,91;40774;0;0;0;0;51303;22768;0.4438;24635;-1867
2017-01-05 05:00:00;-30,05;-0,31;-29,74;40774;13;0.0003;15;-2;51303;21870;0.4263;23696;-1826
2017-01-05 06:00:00;-62,95;-2,13;-60,82;40774;763;0.0187;649;114;51303;21073;0.4107;22523;-1450
2017-01-05 07:00:00;-53,85;-1,25;-52,6;40774;3759;0.0922;3482;277;51303;19966;0.3892;21315;-1349
2017-01-05 08:00:00;-67,02;-7,52;-59,5;40774;7974;0.1956;7887;87;51303;18252;0.3558;20428;-2176
2017-01-05 09:00:00;-65,0;-2,44;-62,56;40774;11750;0.2882;12140;-390;51303;17685;0.3447;19897;-2212
2017-01-05 10:00:00;-67,08;1,29;-68,37;40774;14256;0.3496;14904;-648;51303;18063;0.3521;19635;-1572
2017-01-05 11:00:00;-66,85;6,35;-73,2;40774;15383;0.3772;16215;-832;51303;18425;0.3592;19654;-1229
2017-01-05 12:00:00;-60,39;11,35;-71,74;40774;15042;0.3689;16256;-1214;51303;18483;0.3603;19719;-1236
2017-01-05 13:00:00;-61,14;13,58;-74,72;40774;13710;0.3362;14836;-1126;51303;18684;0.3642;19643;-959
2017-01-05 14:00:00;-27,22;16,26;-43,48;40774;11906;0.292;12664;-758;51303;18207;0.3549;19394;-1187
2017-01-05 15:00:00;-12,01;16,16;-28,17;40774;9758;0.2393;10252;-494;51303;17488;0.3408;18920;-1432
2017-01-05 16:00:00;-1,2;17,31;-18,51;40774;7372;0.1808;7695;-323;51303;16942;0.3302;18421;-1479
2017-01-05 17:00:00;7,42;19,93;-12,51;40774;4671;0.1146;5103;-432;51303;17022;0.3318;17985;-963
2017-01-05 18:00:00;14,01;24,35;-10,34;40774;2468;0.0605;2754;-286;51303;16698;0.3255;17650;-952
2017-01-05 19:00:00;25,78;26,72;-0,94;40774;846;0.0208;937;-91;51303;15992;0.3117;17550;-1558
2017-01-05 20:00:00;24,9;29,31;-4,41;40774;67;0.0016;83;-16;51303;15986;0.3116;17699;-1713
2017-01-05 21:00:00;22,98;27,62;-4,64;40774;0;0;0;0;51303;16080;0.3134;17790;-1710
2017-01-05 22:00:00;22,09;27,3;-5,21;40774;0;0;0;0;51303;15852;0.309;17762;-1910
2017-01-05 23:00:00;12,05;22,35;-10,3;40774;0;0;0;0;51303;15444;0.301;17593;-2149
2017-02-05 00:00:00;13,47;22,08;-8,61;40802;0;0;0;0;51303;15016;0.2927;17381;-2365
2017-02-05 01:00:00;12,01;18,1;-6,09;40802;0;0;0;0;51303;14867;0.2898;16926;-2059
2017-02-05 02:00:00;10,41;16,31;-5,9;40802;0;0;0;0;51303;15098;0.2943;16494;-1396
2017-02-05 03:00:00;12,03;13,95;-1,92;40802;0;0;0;0;51303;15590;0.3039;16257;-667
2017-02-05 04:00:00;9,69;13,83;-4,14;40802;0;0;0;0;51303;16079;0.3134;16162;-83
2017-02-05 05:00:00;25,03;22,29;2,74;40802;10;0.0002;9;1;51303;16568;0.3229;16131;437
2017-02-05 06:00:00;33,95;32,3;1,65;40802;339;0.0083;355;-16;51303;16929;0.33;16095;834
2017-02-05 07:00:00;38,97;36,4;2,57;40802;1604;0.0393;1668;-64;51303;16986;0.3311;16137;849
2017-02-05 08:00:00;39,98;38,17;1,81;40802;3446;0.0844;3766;-320;51303;17596;0.3429;16464;1132
2017-02-05 09:00:00;35,84;36,67;-0,83;40802;5639;0.1382;6118;-479;51303;18116;0.3531;17120;996
2017-02-05 10:00:00;34,85;37,14;-2,29;40802;7956;0.195;8197;-241;51303;18696;0.3644;17793;903
2017-02-05 11:00:00;33,47;36,4;-2,93;40802;10002;0.2451;9846;156;51303;19577;0.3816;18425;1152
2017-02-05 12:00:00;31,04;34,38;-3,34;40802;11444;0.2804;10966;478;51303;20424;0.3981;18921;1503
2017-02-05 13:00:00;30,78;31,51;-0,73;40802;11714;0.2871;11410;304;51303;20452;0.3986;19110;1342
2017-02-05 14:00:00;30,4;32,26;-1,86;40802;11300;0.2769;11194;106;51303;19884;0.3876;18856;1028
2017-02-05 15:00:00;30,41;34,97;-4,56;40802;9900;0.2426;10257;-357;51303;19167;0.3736;18142;1025
2017-02-05 16:00:00;30,43;35,38;-4,95;40802;8096;0.1984;8577;-481;51303;17542;0.3419;17394;148
2017-02-05 17:00:00;31,02;38,9;-7,88;40802;5680;0.1392;6200;-520;51303;16592;0.3234;16770;-178
2017-02-05 18:00:00;34,97;41,96;-6,99;40802;2943;0.0721;3408;-465;51303;15987;0.3116;16350;-363
2017-02-05 19:00:00;38,52;44,1;-5,58;40802;945;0.0232;1084;-139;51303;15306;0.2984;16101;-795
2017-02-05 20:00:00;38,57;42,75;-4,18;40802;52;0.0012;101;-49;51303;14936;0.2911;15924;-988
2017-02-05 21:00:00;35,23;40,84;-5,61;40802;0;0;0;0;51303;15312;0.2985;15685;-373
2017-02-05 22:00:00;33,34;37,78;-4,44;40802;0;0;0;0;51303;14582;0.2842;15483;-901
2017-02-05 23:00:00;28,46;33,7;-5,24;40802;0;0;0;0;51303;14580;0.2842;15183;-603
2017-03-05 00:00:00;28,59;31,3;-2,71;40825;0;0;0;0;51308;13982;0.2725;15306;-1324
2017-03-05 01:00:00;27,43;29,44;-2,01;40825;0;0;0;0;51308;13359;0.2604;14630;-1271
2017-03-05 02:00:00;27,48;28,73;-1,25;40825;0;0;0;0;51308;12688;0.2473;13945;-1257
2017-03-05 03:00:00;28,5;28,4;0,1;40825;0;0;0;0;51308;11924;0.2324;13213;-1289
2017-03-05 04:00:00;30,35;25,96;4,39;40825;0;0;0;0;51308;10938;0.2132;12484;-1546
2017-03-05 05:00:00;31,95;32,24;-0,29;40825;16;0.0004;17;-1;51308;10514;0.2049;11792;-1278
2017-03-05 06:00:00;39,51;37,81;1,7;40825;574;0.014;639;-65;51308;10479;0.2042;11138;-659
2017-03-05 07:00:00;44,99;42,6;2,39;40825;2591;0.0635;2862;-271;51308;10294;0.2006;10559;-265
2017-03-05 08:00:00;45,0;41,1;3,9;40825;5501;0.1348;6219;-718;51308;9721;0.1895;10109;-388
2017-03-05 09:00:00;39,73;43,61;-3,88;40825;8900;0.218;9822;-922;51308;9102;0.1774;9919;-817
2017-03-05 10:00:00;38,97;40,71;-1,74;40825;12207;0.299;12635;-428;51308;9032;0.176;9919;-887
2017-03-05 11:00:00;38,48;39,78;-1,3;40825;14263;0.3494;14419;-156;51308;9600;0.1871;10146;-546
2017-03-05 12:00:00;34,27;34,04;0,23;40825;15071;0.3692;15275;-204;51308;10519;0.205;10579;-60
2017-03-05 13:00:00;33,94;35,75;-1,81;40825;15004;0.3675;15052;-48;51308;11300;0.2202;11200;100
2017-03-05 14:00:00;34,01;35,26;-1,25;40825;14327;0.3509;13954;373;51308;12662;0.2468;11997;665
2017-03-05 15:00:00;32,83;32,91;-0,08;40825;12933;0.3168;12064;869;51308;13984;0.2726;12913;1071
2017-03-05 16:00:00;31,79;32,81;-1,02;40825;10822;0.2651;9628;1194;51308;15088;0.2941;13742;1346
2017-03-05 17:00:00;32,43;30,67;1,76;40825;7821;0.1916;6810;1011;51308;16172;0.3152;14423;1749
2017-03-05 18:00:00;34,9;32,68;2,22;40825;4437;0.1087;3855;582;51308;16399;0.3196;14907;1492
2017-03-05 19:00:00;37,66;35,48;2,18;40825;1514;0.0371;1359;155;51308;15829;0.3085;15279;550
2017-03-05 20:00:00;38,94;38,12;0,82;40825;116;0.0028;134;-18;51308;15713;0.3063;15627;86
2017-03-05 21:00:00;36,97;37,2;-0,23;40825;0;0;0;0;51308;16387;0.3194;15854;533
2017-03-05 22:00:00;30,52;33,71;-3,19;40825;0;0;0;0;51308;16167;0.3151;15917;250
2017-03-05 23:00:00;28,6;30,12;-1,52;40825;0;0;0;0;51308;15928;0.3104;15830;98
2017-04-05 00:00:00;26,91;31,74;-4,83;40838;0;0;0;0;51329;15951;0.3108;18006;-2055
2017-04-05 01:00:00;26,26;29,39;-3,13;40838;0;0;0;0;51329;15811;0.308;17681;-1870
2017-04-05 02:00:00;24,57;28,5;-3,93;40838;0;0;0;0;51329;15566;0.3032;17468;-1902
2017-04-05 03:00:00;24,82;29,12;-4,3;40838;0;0;0;0;51329;15401;0.3;17445;-2044
2017-04-05 04:00:00;25,8;30,06;-4,26;40838;0;0;0;0;51329;15154;0.2952;17455;-2301
2017-04-05 05:00:00;27,57;33,58;-6,01;40838;8;0.0002;10;-2;51329;14877;0.2898;17490;-2613
2017-04-05 06:00:00;33,23;41,34;-8,11;40838;410;0.01;405;5;51329;15108;0.2944;17515;-2407
2017-04-05 07:00:00;38,94;46,62;-7,68;40838;2026;0.0496;1861;165;51329;14848;0.2893;17573;-2725
2017-04-05 08:00:00;39,91;49,46;-9,55;40838;4276;0.1047;3947;329;51329;14511;0.2827;17788;-3277
2017-04-05 09:00:00;39,14;51,38;-12,24;40838;6568;0.1608;6114;454;51329;14112;0.2749;18191;-4079
2017-04-05 10:00:00;38,94;47,41;-8,47;40838;8742;0.214;7813;929;51329;14036;0.2734;18602;-4566
2017-04-05 11:00:00;38,95;45,61;-6,66;40838;10120;0.2478;8967;1153;51329;14787;0.2881;18977;-4190
2017-04-05 12:00:00;34,17;41,23;-7,06;40838;10666;0.2612;9669;997;51329;15428;0.3006;19317;-3889
2017-04-05 13:00:00;31,94;38,37;-6,43;40838;10457;0.256;9816;641;51329;16068;0.313;19581;-3513
2017-04-05 14:00:00;30,46;36,31;-5,85;40838;9639;0.236;9352;287;51329;16483;0.3211;19668;-3185
2017-04-05 15:00:00;30,4;35,4;-5,0;40838;7992;0.1957;8294;-302;51329;17169;0.3345;19554;-2385
2017-04-05 16:00:00;29,79;35,08;-5,29;40838;6040;0.1479;6674;-634;51329;17648;0.3438;19472;-1824
2017-04-05 17:00:00;34,4;37,17;-2,77;40838;4145;0.1015;4719;-574;51329;17302;0.3371;19391;-2089
2017-04-05 18:00:00;36,97;42,32;-5,35;40838;2339;0.0573;2664;-325;51329;16964;0.3305;19276;-2312
2017-04-05 19:00:00;38,97;46,2;-7,23;40838;861;0.0211;930;-69;51329;17049;0.3321;19159;-2110
2017-04-05 20:00:00;38,95;43,34;-4,39;40838;68;0.0016;98;-30;51329;16308;0.3177;18913;-2605
2017-04-05 21:00:00;36,54;38,96;-2,42;40838;0;0;0;0;51329;15251;0.2971;18402;-3151
2017-04-05 22:00:00;32,23;35,55;-3,32;40838;0;0;0;0;51329;13938;0.2716;17640;-3702
2017-04-05 23:00:00;26,97;32,94;-5,97;40838;0;0;0;0;51329;13643;0.2658;16643;-3000
2017-05-05 00:00:00;28,97;30,99;-2,02;40843;0;0;0;0;51334;13209;0.2573;13779;-570
2017-05-05 01:00:00;28,82;27,33;1,49;40843;0;0;0;0;51334;12555;0.2446;13163;-608
2017-05-05 02:00:00;28,42;26,74;1,68;40843;0;0;0;0;51334;11878;0.2314;12603;-725
2017-05-05 03:00:00;28,61;24,95;3,66;40843;0;0;0;0;51334;11430;0.2227;12185;-755
2017-05-05 04:00:00;29,4;26,21;3,19;40843;0;0;0;0;51334;10711;0.2086;11787;-1076
2017-05-05 05:00:00;30,99;30,9;0,09;40843;8;0.0002;11;-3;51334;9964;0.1941;11345;-1381
2017-05-05 06:00:00;37,17;38,51;-1,34;40843;220;0.0054;376;-156;51334;9868;0.1922;10832;-964
2017-05-05 07:00:00;43,82;44,92;-1,1;40843;1226;0.03;1660;-434;51334;9098;0.1772;10356;-1258
2017-05-05 08:00:00;48,98;53,03;-4,05;40843;2870;0.0703;3459;-589;51334;8471;0.165;9887;-1416
2017-05-05 09:00:00;49,91;52,97;-3,06;40843;4728;0.1158;5352;-624;51334;7938;0.1546;9443;-1505
2017-05-05 10:00:00;47,9;47,83;0,07;40843;6592;0.1614;7213;-621;51334;7236;0.141;9019;-1783
2017-05-05 11:00:00;46,38;48,23;-1,85;40843;8136;0.1992;8950;-814;51334;6240;0.1216;8588;-2348
2017-05-05 12:00:00;42,0;50,9;-8,9;40843;9150;0.224;10477;-1327;51334;5542;0.108;8132;-2590
2017-05-05 13:00:00;40,09;46,36;-6,27;40843;9933;0.2432;11420;-1487;51334;4706;0.0917;7601;-2895
2017-05-05 14:00:00;36,97;43,17;-6,2;40843;9942;0.2434;11613;-1671;51334;4003;0.078;6972;-2969
2017-05-05 15:00:00;35,37;41,65;-6,28;40843;9686;0.2371;10949;-1263;51334;3810;0.0742;6359;-2549
2017-05-05 16:00:00;34,9;41,05;-6,15;40843;8598;0.2105;9323;-725;51334;2974;0.0579;5873;-2899
2017-05-05 17:00:00;37,67;40,91;-3,24;40843;6764;0.1656;6871;-107;51334;2659;0.0518;5547;-2888
2017-05-05 18:00:00;40,33;41,75;-1,42;40843;4180;0.1024;3932;248;51334;2668;0.052;5391;-2723
2017-05-05 19:00:00;42,09;42,95;-0,86;40843;1604;0.0393;1406;198;51334;2994;0.0583;5299;-2305
2017-05-05 20:00:00;41,16;42,11;-0,95;40843;162;0.0039;156;6;51334;3326;0.0648;5246;-1920
2017-05-05 21:00:00;38,98;42,56;-3,58;40843;0;0;0;0;51334;3997;0.0778;5249;-1252
2017-05-05 22:00:00;39,27;37,3;1,97;40843;0;0;0;0;51334;4225;0.0823;5226;-1001
2017-05-05 23:00:00;34,9;30,81;4,09;40843;0;0;0;0;51334;4364;0.085;5004;-640
2017-06-05 00:00:00;37,04;31,79;5,25;40844;0;0;0;0;51340;4678;0.0911;4151;527
2017-06-05 01:00:00;32,47;29,88;2,59;40844;0;0;0;0;51340;4648;0.0905;3982;666
2017-06-05 02:00:00;31,04;23,89;7,15;40844;0;0;0;0;51340;4606;0.0897;3872;734
2017-06-05 03:00:00;30,71;25,55;5,16;40844;0;0;0;0;51340;4601;0.0896;3890;711
2017-06-05 04:00:00;30,57;25,47;5,1;40844;0;0;0;0;51340;4468;0.087;3938;530
2017-06-05 05:00:00;30,86;26,08;4,78;40844;17;0.0004;26;-9;51340;4438;0.0864;3884;554
2017-06-05 06:00:00;30,92;27,59;3,33;40844;764;0.0187;792;-28;51340;4410;0.0859;3708;702
2017-06-05 07:00:00;31,14;28,45;2,69;40844;3412;0.0835;3481;-69;51340;4147;0.0808;3433;714
2017-06-05 08:00:00;33,92;30,48;3,44;40844;7509;0.1839;7462;47;51340;3410;0.0664;3089;321
2017-06-05 09:00:00;33,06;31,39;1,67;40844;12136;0.2971;11584;552;51340;3188;0.0621;2966;222
2017-06-05 10:00:00;31,53;27,83;3,7;40844;16056;0.3931;14710;1346;51340;3413;0.0665;3087;326
2017-06-05 11:00:00;30,64;27,85;2,79;40844;18763;0.4594;16547;2216;51340;3769;0.0734;3305;464
2017-06-05 12:00:00;30,79;25,4;5,39;40844;20242;0.4956;17289;2953;51340;3991;0.0778;3532;459
2017-06-05 13:00:00;30,1;24,28;5,82;40844;20218;0.495;17122;3096;51340;4003;0.0779;3694;309
2017-06-05 14:00:00;29,6;23,62;5,98;40844;18997;0.4651;15830;3167;51340;4178;0.0814;3742;436
2017-06-05 15:00:00;28,93;24,7;4,23;40844;16486;0.4036;13671;2815;51340;4342;0.0846;3820;522
2017-06-05 16:00:00;28,28;26,18;2,1;40844;12928;0.3165;10804;2124;51340;4484;0.0874;4054;430
2017-06-05 17:00:00;31,02;27,95;3,07;40844;9091;0.2226;7379;1712;51340;4527;0.0882;4411;116
2017-06-05 18:00:00;33,82;33,09;0,73;40844;4996;0.1223;4040;956;51340;4376;0.0852;4844;-468
2017-06-05 19:00:00;37,94;35,83;2,11;40844;1827;0.0447;1507;320;51340;4450;0.0867;5381;-931
2017-06-05 20:00:00;39,9;37,59;2,31;40844;189;0.0046;191;-2;51340;4608;0.0898;5910;-1302
2017-06-05 21:00:00;39,5;37,36;2,14;40844;0;0;0;0;51340;5425;0.1057;6316;-891
2017-06-05 22:00:00;38,92;34,0;4,92;40844;0;0;0;0;51340;5776;0.1125;6481;-705
2017-06-05 23:00:00;33,93;27,02;6,91;40844;0;0;0;0;51340;5396;0.1051;6165;-769
2017-07-05 00:00:00;28,31;24,33;3,98;40844;0;0;0;0;51358;4835;0.0941;4555;280
2017-07-05 01:00:00;26,73;22,56;4,17;40844;0;0;0;0;51358;4033;0.0785;3892;141
2017-07-05 02:00:00;26,48;22,83;3,65;40844;0;0;0;0;51358;3207;0.0625;3339;-132
2017-07-05 03:00:00;26,17;23,38;2,79;40844;0;0;0;0;51358;2458;0.0478;2906;-448
2017-07-05 04:00:00;26,83;24,67;2,16;40844;0;0;0;0;51358;2055;0.04;2576;-521
2017-07-05 05:00:00;26,25;24,14;2,11;40844;22;0.0005;31;-9;51358;1783;0.0347;2250;-467
2017-07-05 06:00:00;25,43;23,48;1,95;40844;588;0.0144;646;-58;51358;1672;0.0326;1918;-246
2017-07-05 07:00:00;26,66;24,61;2,05;40844;2248;0.055;2369;-121;51358;1332;0.0259;1623;-291
2017-07-05 08:00:00;28,66;25,26;3,4;40844;4511;0.1104;4631;-120;51358;1072;0.0208;1430;-358
2017-07-05 09:00:00;30,06;29,7;0,36;40844;7216;0.1766;6937;279;51358;1096;0.0214;1465;-369
2017-07-05 10:00:00;30,33;28,87;1,46;40844;9765;0.2391;9026;739;51358;1455;0.0283;1676;-221
2017-07-05 11:00:00;30,18;28,66;1,52;40844;11528;0.2822;10717;811;51358;1916;0.0373;2024;-108
2017-07-05 12:00:00;29,5;27,03;2,47;40844;12952;0.3171;11644;1308;51358;2352;0.0458;2488;-136
2017-07-05 13:00:00;27,06;27,27;-0,21;40844;13745;0.3365;11758;1987;51358;2682;0.0522;3025;-343
2017-07-05 14:00:00;24,0;25,0;-1,0;40844;13494;0.3304;11295;2199;51358;3301;0.0643;3634;-333
2017-07-05 15:00:00;24,15;25,08;-0,93;40844;12062;0.2953;10143;1919;51358;4235;0.0825;4289;-54
2017-07-05 16:00:00;25,51;24,63;0,88;40844;9890;0.2422;8282;1608;51358;5378;0.1048;4869;509
2017-07-05 17:00:00;27,4;26,28;1,12;40844;7004;0.1715;5895;1109;51358;6292;0.1225;5335;957
2017-07-05 18:00:00;29,8;27,08;2,72;40844;3854;0.0944;3357;497;51358;6753;0.1315;5562;1191
2017-07-05 19:00:00;31,18;28,76;2,42;40844;1357;0.0332;1271;86;51358;7043;0.1371;5692;1351
2017-07-05 20:00:00;32,13;31,8;0,33;40844;160;0.0039;172;-12;51358;7404;0.1442;5852;1552
2017-07-05 21:00:00;32,01;32,49;-0,48;40844;0;0;0;0;51358;7855;0.1529;6162;1693
2017-07-05 22:00:00;31,26;31,29;-0,03;40844;0;0;0;0;51358;8130;0.1583;6534;1596
2017-07-05 23:00:00;27,0;26,36;0,64;40844;0;0;0;0;51358;8084;0.1574;6743;1341
2017-08-05 00:00:00;27,48;26,67;0,81;40847;0;0;0;0;51360;7739;0.1506;5688;2051
2017-08-05 01:00:00;26,1;24,58;1,52;40847;0;0;0;0;51360;7083;0.1379;5612;1471
2017-08-05 02:00:00;25,81;24,66;1,15;40847;0;0;0;0;51360;6774;0.1319;5609;1165
2017-08-05 03:00:00;24,73;25,74;-1,01;40847;0;0;0;0;51360;6840;0.1332;5834;1006
2017-08-05 04:00:00;25,14;26,13;-0,99;40847;0;0;0;0;51360;7071;0.1377;6299;772
2017-08-05 05:00:00;27,91;28,04;-0,13;40847;18;0.0004;26;-8;51360;8232;0.1603;7025;1207
2017-08-05 06:00:00;32,0;29,29;2,71;40847;343;0.0084;520;-177;51360;10000;0.1947;7930;2070
2017-08-05 07:00:00;36,06;34,3;1,76;40847;1358;0.0332;1841;-483;51360;11544;0.2248;8874;2670
2017-08-05 08:00:00;40,02;37,24;2,78;40847;2755;0.0674;3535;-780;51360;12614;0.2456;9697;2917
2017-08-05 09:00:00;39,93;37,32;2,61;40847;4173;0.1022;5329;-1156;51360;13272;0.2584;10318;2954
2017-08-05 10:00:00;38,97;37,44;1,53;40847;5400;0.1322;7013;-1613;51360;14015;0.2729;10892;3123
2017-08-05 11:00:00;39,98;42,11;-2,13;40847;6486;0.1588;8511;-2025;51360;14436;0.2811;11346;3090
2017-08-05 12:00:00;40,55;40,59;-0,04;40847;7246;0.1774;9627;-2381;51360;14676;0.2858;11635;3041
2017-08-05 13:00:00;36,74;38,82;-2,08;40847;7430;0.1819;9941;-2511;51360;14300;0.2784;12005;2295
2017-08-05 14:00:00;32,06;39,07;-7,01;40847;7289;0.1784;9656;-2367;51360;14398;0.2803;12408;1990
2017-08-05 15:00:00;31,44;36,4;-4,96;40847;6827;0.1671;8880;-2053;51360;14756;0.2873;12771;1985
2017-08-05 16:00:00;31,05;33,59;-2,54;40847;5988;0.1466;7492;-1504;51360;14732;0.2868;13062;1670
2017-08-05 17:00:00;32,41;34,04;-1,63;40847;4551;0.1114;5617;-1066;51360;14828;0.2887;13041;1787
2017-08-05 18:00:00;34,0;37,95;-3,95;40847;2739;0.0671;3422;-683;51360;14285;0.2781;12532;1753
2017-08-05 19:00:00;38,8;40,41;-1,61;40847;1144;0.028;1402;-258;51360;12873;0.2506;11807;1066
2017-08-05 20:00:00;37,62;40,36;-2,74;40847;180;0.0044;203;-23;51360;10926;0.2127;10892;34
2017-08-05 21:00:00;37,99;40,27;-2,28;40847;1;0;0;1;51360;9496;0.1849;10001;-505
2017-08-05 22:00:00;35,07;39,96;-4,89;40847;0;0;0;0;51360;8696;0.1693;9267;-571
2017-08-05 23:00:00;32,44;34,03;-1,59;40847;0;0;0;0;51360;7869;0.1532;8495;-626
2017-09-05 00:00:00;30,81;32,22;-1,41;40850;0;0;0;0;51373;6426;0.1251;6427;-1
2017-09-05 01:00:00;30,56;31,12;-0,56;40850;0;0;0;0;51373;4880;0.095;5122;-242
2017-09-05 02:00:00;29,5;32,74;-3,24;40850;0;0;0;0;51373;3910;0.0761;4147;-237
2017-09-05 03:00:00;28,94;32,6;-3,66;40850;0;0;0;0;51373;3006;0.0585;3455;-449
2017-09-05 04:00:00;29,9;33,66;-3,76;40850;0;0;0;0;51373;2390;0.0465;2945;-555
2017-09-05 05:00:00;32,07;39,96;-7,89;40850;34;0.0008;45;-11;51373;2063;0.0402;2516;-453
2017-09-05 06:00:00;42,83;47,41;-4,58;40850;915;0.0224;884;31;51373;1764;0.0343;2219;-455
2017-09-05 07:00:00;50,45;53,53;-3,08;40850;3592;0.0879;3552;40;51373;1326;0.0258;1967;-641
2017-09-05 08:00:00;54,99;62,45;-7,46;40850;7746;0.1896;7486;260;51373;944;0.0183;1882;-938
2017-09-05 09:00:00;48,65;56,75;-8,1;40850;12514;0.3064;11689;825;51373;1314;0.0256;2316;-1002
2017-09-05 10:00:00;44,75;46,6;-1,85;40850;16053;0.393;14848;1205;51373;1703;0.0332;3010;-1307
2017-09-05 11:00:00;43,83;43,31;0,52;40850;17382;0.4255;16776;606;51373;2043;0.0398;3690;-1647
2017-09-05 12:00:00;40,63;41,38;-0,75;40850;16760;0.4103;17601;-841;51373;2424;0.0472;4350;-1926
2017-09-05 13:00:00;38,0;43,85;-5,85;40850;16056;0.393;17611;-1555;51373;2932;0.0571;5030;-2098
2017-09-05 14:00:00;35,57;42,49;-6,92;40850;15741;0.3853;16631;-890;51373;3370;0.0656;5713;-2343
2017-09-05 15:00:00;36,2;40,46;-4,26;40850;14537;0.3558;14698;-161;51373;3960;0.0771;6450;-2490
2017-09-05 16:00:00;34,44;38,96;-4,52;40850;12283;0.3007;11973;310;51373;4424;0.0861;7173;-2749
2017-09-05 17:00:00;39,64;39,56;0,08;40850;8960;0.2194;8610;350;51373;4528;0.0881;7535;-3007
2017-09-05 18:00:00;44,9;43,79;1,11;40850;5460;0.1337;4993;467;51373;4090;0.0796;7495;-3405
2017-09-05 19:00:00;47,45;45,58;1,87;40850;2225;0.0545;1981;244;51373;3614;0.0703;7144;-3530
2017-09-05 20:00:00;49,12;47,4;1,72;40850;303;0.0074;280;23;51373;3278;0.0638;6704;-3426
2017-09-05 21:00:00;46,93;45,99;0,94;40850;0;0;0;0;51373;3282;0.0639;6423;-3141
2017-09-05 22:00:00;39,9;40,59;-0,69;40850;0;0;0;0;51373;3976;0.0774;6341;-2365
2017-09-05 23:00:00;34,06;36,6;-2,54;40850;0;0;0;0;51373;4849;0.0944;6381;-1532
2017-10-05 00:00:00;32,06;34,81;-2,75;40854;0;0;0;0;51381;5625;0.1094;6904;-1279
2017-10-05 01:00:00;30,99;33,57;-2,58;40854;0;0;0;0;51381;6237;0.1214;7501;-1264
2017-10-05 02:00:00;30,75;29,66;1,09;40854;0;0;0;0;51381;6604;0.1286;7996;-1392
2017-10-05 03:00:00;30,72;28,59;2,13;40854;0;0;0;0;51381;7014;0.1365;8368;-1354
2017-10-05 04:00:00;31,03;28,62;2,41;40854;0;0;0;0;51381;6834;0.133;8633;-1799
2017-10-05 05:00:00;33,11;32,23;0,88;40854;34;0.0008;39;-5;51381;6707;0.1305;8606;-1899
2017-10-05 06:00:00;42,04;41,71;0,33;40854;1102;0.027;894;208;51381;6160;0.1199;8144;-1984
2017-10-05 07:00:00;49,98;49,99;-0,01;40854;4405;0.1078;3855;550;51381;5038;0.0981;7603;-2565
2017-10-05 08:00:00;49,07;46,68;2,39;40854;9508;0.2327;8471;1037;51381;4500;0.0876;7377;-2877
2017-10-05 09:00:00;43,86;39,51;4,35;40854;14798;0.3622;13213;1585;51381;4232;0.0824;7394;-3162
2017-10-05 10:00:00;39,16;35,75;3,41;40854;19063;0.4666;16816;2247;51381;4512;0.0878;7364;-2852
2017-10-05 11:00:00;39,22;34,0;5,22;40854;21958;0.5375;19034;2924;51381;4898;0.0954;7156;-2258
2017-10-05 12:00:00;36,13;32,33;3,8;40854;23298;0.5703;20096;3202;51381;5246;0.1021;6782;-1536
2017-10-05 13:00:00;36,12;31,71;4,41;40854;24009;0.5877;20520;3489;51381;5273;0.1026;6430;-1157
2017-10-05 14:00:00;34,52;30,58;3,94;40854;23541;0.5762;19802;3739;51381;5104;0.0993;6176;-1072
2017-10-05 15:00:00;34,12;30,09;4,03;40854;21636;0.5296;17996;3640;51381;4879;0.095;5882;-1003
2017-10-05 16:00:00;35,01;30,4;4,61;40854;18076;0.4424;15078;2998;51381;4273;0.0832;5338;-1065
2017-10-05 17:00:00;41,08;35,19;5,89;40854;13085;0.3203;10959;2126;51381;3321;0.0646;4545;-1224
2017-10-05 18:00:00;44,01;41,55;2,46;40854;7346;0.1798;6197;1149;51381;2458;0.0479;3578;-1120
2017-10-05 19:00:00;48,04;42,27;5,77;40854;2669;0.0653;2328;341;51381;1989;0.0387;2750;-761
2017-10-05 20:00:00;47,35;42,53;4,82;40854;372;0.0091;328;44;51381;1926;0.0375;2325;-399
2017-10-05 21:00:00;48,04;42,22;5,82;40854;1;0;0;1;51381;2422;0.0471;2467;-45
2017-10-05 22:00:00;42,94;40,85;2,09;40854;0;0;0;0;51381;3007;0.0585;2826;181
2017-10-05 23:00:00;32,6;32,2;0,4;40854;0;0;0;0;51381;3475;0.0676;3047;428
2017-11-05 00:00:00;31,16;32,37;-1,21;40857;0;0;0;0;51396;3636;0.0707;3397;239
2017-11-05 01:00:00;30,41;31,14;-0,73;40857;0;0;0;0;51396;3738;0.0728;3772;-34
2017-11-05 02:00:00;29,5;32,33;-2,83;40857;0;0;0;0;51396;4024;0.0783;3986;38
2017-11-05 03:00:00;29,17;32,32;-3,15;40857;0;0;0;0;51396;4409;0.0858;3982;427
2017-11-05 04:00:00;29,59;32,72;-3,13;40857;0;0;0;0;51396;4665;0.0908;3944;721
2017-11-05 05:00:00;30,89;34,87;-3,98;40857;54;0.0013;58;-4;51396;5058;0.0984;4001;1057
2017-11-05 06:00:00;34,91;39,66;-4,75;40857;1311;0.0321;1090;221;51396;5556;0.1081;3996;1560
2017-11-05 07:00:00;43,1;43,62;-0,52;40857;5210;0.1275;4438;772;51396;5058;0.0984;3775;1283
2017-11-05 08:00:00;44,49;42,86;1,63;40857;10853;0.2657;9346;1507;51396;3398;0.0661;3290;108
2017-11-05 09:00:00;41,93;38,55;3,38;40857;16370;0.4006;14333;2037;51396;3108;0.0605;2940;168
2017-11-05 10:00:00;38,54;34,74;3,8;40857;20539;0.5027;18191;2348;51396;3183;0.0619;3135;48
2017-11-05 11:00:00;37,47;33,67;3,8;40857;23613;0.5779;20461;3152;51396;3473;0.0676;3473;0
2017-11-05 12:00:00;35,32;32,2;3,12;40857;25119;0.6148;21166;3953;51396;4423;0.0861;4002;421
2017-11-05 13:00:00;34,38;29,52;4,86;40857;24766;0.6062;20864;3902;51396;5647;0.1099;4571;1076
2017-11-05 14:00:00;32,64;28,63;4,01;40857;22420;0.5488;19355;3065;51396;6728;0.1309;5135;1593
2017-11-05 15:00:00;33,82;32,5;1,32;40857;18245;0.4465;16711;1534;51396;7750;0.1508;5792;1958
2017-11-05 16:00:00;33,19;38,31;-5,12;40857;13489;0.3302;12969;520;51396;8744;0.1701;6498;2246
2017-11-05 17:00:00;34,8;39,2;-4,4;40857;8702;0.213;8706;-4;51396;10070;0.196;7565;2505
2017-11-05 18:00:00;35,75;38,73;-2,98;40857;4636;0.1135;4687;-51;51396;11714;0.2279;9223;2491
2017-11-05 19:00:00;34,94;39,74;-4,8;40857;1746;0.0428;1773;-27;51396;12547;0.2441;11220;1327
2017-11-05 20:00:00;33,11;38,54;-5,43;40857;250;0.0061;270;-20;51396;13497;0.2626;13384;113
2017-11-05 21:00:00;31,5;40,22;-8,72;40857;1;0;1;0;51396;15918;0.3097;15178;740
2017-11-05 22:00:00;27,6;35,62;-8,02;40857;0;0;0;0;51396;16334;0.3178;16167;167
2017-11-05 23:00:00;26,01;31,95;-5,94;40857;0;0;0;0;51396;15465;0.3009;16392;-927
2017-12-05 00:00:00;26,05;31,87;-5,82;40861;0;0;0;0;51438;14744;0.2866;16248;-1504
2017-12-05 01:00:00;27,23;31,98;-4,75;40861;0;0;0;0;51438;13723;0.2668;15410;-1687
2017-12-05 02:00:00;27,29;30,89;-3,6;40861;0;0;0;0;51438;12982;0.2524;14546;-1564
2017-12-05 03:00:00;27,27;28,62;-1,35;40861;0;0;0;0;51438;12393;0.241;13821;-1428
2017-12-05 04:00:00;27,08;27,85;-0,77;40861;0;0;0;0;51438;11894;0.2312;13161;-1267
2017-12-05 05:00:00;29,0;30,55;-1,55;40861;52;0.0012;56;-4;51438;11120;0.2162;12412;-1292
2017-12-05 06:00:00;34,37;40,6;-6,23;40861;824;0.0202;871;-47;51438;10464;0.2034;11510;-1046
2017-12-05 07:00:00;41,95;46,36;-4,41;40861;2885;0.0706;3017;-132;51438;9287;0.1806;10561;-1274
2017-12-05 08:00:00;43,91;54,54;-10,63;40861;6163;0.1508;5865;298;51438;7854;0.1527;9808;-1954
2017-12-05 09:00:00;42,0;51,55;-9,55;40861;10102;0.2472;8957;1145;51438;6638;0.129;9366;-2728
2017-12-05 10:00:00;42,95;48,76;-5,81;40861;13716;0.3357;11835;1881;51438;6058;0.1178;9119;-3061
2017-12-05 11:00:00;42,02;44,1;-2,08;40861;16587;0.4059;14184;2403;51438;6055;0.1177;9057;-3002
2017-12-05 12:00:00;36,03;41,51;-5,48;40861;18257;0.4468;15649;2608;51438;6489;0.1262;9153;-2664
2017-12-05 13:00:00;31,62;37,18;-5,56;40861;18450;0.4515;16048;2402;51438;7042;0.1369;9205;-2163
2017-12-05 14:00:00;30,86;36,41;-5,55;40861;17472;0.4276;15428;2044;51438;7540;0.1466;9014;-1474
2017-12-05 15:00:00;30,45;36,68;-6,23;40861;15399;0.3768;13911;1488;51438;8003;0.1556;8538;-535
2017-12-05 16:00:00;31,38;39,33;-7,95;40861;12459;0.3049;11528;931;51438;8148;0.1584;8058;90
2017-12-05 17:00:00;36,46;41,27;-4,81;40861;8406;0.2057;8367;39;51438;8034;0.1562;7590;444
2017-12-05 18:00:00;40,65;45,68;-5,03;40861;4715;0.1154;4903;-188;51438;7758;0.1508;7126;632
2017-12-05 19:00:00;42,0;46,07;-4,07;40861;2144;0.0525;2009;135;51438;6910;0.1343;6863;47
2017-12-05 20:00:00;42,62;46,15;-3,53;40861;342;0.0084;326;16;51438;6702;0.1303;6898;-196
2017-12-05 21:00:00;42,93;44,45;-1,52;40861;1;0;1;0;51438;6352;0.1235;7125;-773
2017-12-05 22:00:00;42,93;40,69;2,24;40861;0;0;0;0;51438;6250;0.1215;7275;-1025
2017-12-05 23:00:00;35,91;33,53;2,38;40861;0;0;0;0;51438;6285;0.1222;7183;-898
2017-05-13 00:00:00;29,9;29,5;0,4;40861;0;0;0;0;51444;6067;0.1179;6756;-689
2017-05-13 01:00:00;29,66;30,48;-0,82;40861;0;0;0;0;51444;5975;0.1161;6334;-359
2017-05-13 02:00:00;29,05;35,28;-6,23;40861;0;0;0;0;51444;5371;0.1044;5887;-516
2017-05-13 03:00:00;28,52;29,95;-1,43;40861;0;0;0;0;51444;4992;0.0971;5452;-460
2017-05-13 04:00:00;28,12;29,0;-0,88;40861;0;0;0;0;51444;4821;0.0937;5080;-259
2017-05-13 05:00:00;28,73;29,57;-0,84;40861;51;0.0012;64;-13;51444;4852;0.0943;4732;120
2017-05-13 06:00:00;29,05;29,87;-0,82;40861;1055;0.0258;1066;-11;51444;4820;0.0937;4398;422
2017-05-13 07:00:00;30,91;29,37;1,54;40861;3819;0.0934;3772;47;51444;4211;0.0819;3982;229
2017-05-13 08:00:00;35,02;29,82;5,2;40861;7772;0.1902;7546;226;51444;2943;0.0572;3525;-582
2017-05-13 09:00:00;35,45;28,0;7,45;40861;11798;0.2887;11434;364;51444;2264;0.044;3137;-873
2017-05-13 10:00:00;32,0;28,74;3,26;40861;14956;0.366;14611;345;51444;1855;0.0361;2911;-1056
2017-05-13 11:00:00;31,04;28,21;2,83;40861;17617;0.4311;16965;652;51444;2133;0.0415;2871;-738
2017-05-13 12:00:00;30,28;27,78;2,5;40861;18692;0.4574;18176;516;51444;2732;0.0531;2988;-256
2017-05-13 13:00:00;28,75;24,57;4,18;40861;18069;0.4422;18451;-382;51444;3028;0.0589;3176;-148
2017-05-13 14:00:00;27,09;26,15;0,94;40861;16733;0.4095;17643;-910;51444;3099;0.0602;3274;-175
2017-05-13 15:00:00;27,07;26,69;0,38;40861;15685;0.3839;15759;-74;51444;3063;0.0596;3246;-183
2017-05-13 16:00:00;27,44;27,36;0,08;40861;12674;0.3102;12882;-208;51444;2815;0.0547;3217;-402
2017-05-13 17:00:00;29,9;27,94;1,96;40861;8968;0.2194;9181;-213;51444;2806;0.0546;3070;-264
2017-05-13 18:00:00;34,79;32,32;2,47;40861;5229;0.128;5360;-131;51444;2665;0.0518;2773;-108
2017-05-13 19:00:00;40,0;33,94;6,06;40861;2004;0.049;2207;-203;51444;2768;0.0538;2567;201
2017-05-13 20:00:00;41,91;32,5;9,41;40861;302;0.0074;370;-68;51444;2786;0.0542;2482;304
2017-05-13 21:00:00;41,88;32,94;8,94;40861;4;0.0001;1;3;51444;2587;0.0503;2601;-14
2017-05-13 22:00:00;40,0;34,7;5,3;40861;0;0;0;0;51444;2724;0.0529;2842;-118
2017-05-13 23:00:00;31,08;32,33;-1,25;40861;0;0;0;0;51444;2765;0.0538;3113;-348
2017-05-14 00:00:00;27,66;29,23;-1,57;40861;0;0;0;0;51444;2712;0.0527;2956;-244
2017-05-14 01:00:00;26,54;28,35;-1,81;40861;0;0;0;0;51444;2924;0.0568;3204;-280
2017-05-14 02:00:00;25,65;26,01;-0,36;40861;0;0;0;0;51444;3406;0.0662;3455;-49
2017-05-14 03:00:00;25,63;22,81;2,82;40861;0;0;0;0;51444;3690;0.0717;3531;159
2017-05-14 04:00:00;25,2;20,27;4,93;40861;0;0;0;0;51444;4195;0.0815;3498;697
2017-05-14 05:00:00;25,0;20,17;4,83;40861;67;0.0016;75;-8;51444;4208;0.0818;3365;843
2017-05-14 06:00:00;25,56;17,26;8,3;40861;1156;0.0283;1105;51;51444;4002;0.0778;3045;957
2017-05-14 07:00:00;25,46;17,9;7,56;40861;3845;0.0941;3868;-23;51444;3692;0.0718;2683;1009
2017-05-14 08:00:00;25,34;21,61;3,73;40861;7759;0.1899;7785;-26;51444;2872;0.0558;2387;485
2017-05-14 09:00:00;26,04;21,66;4,38;40861;12337;0.3019;11779;558;51444;2828;0.055;2321;507
2017-05-14 10:00:00;25,04;17,9;7,14;40861;16257;0.3979;14840;1417;51444;3289;0.0639;2458;831
2017-05-14 11:00:00;26,48;16,63;9,85;40861;17831;0.4364;16803;1028;51444;3763;0.0731;2701;1062
2017-05-14 12:00:00;27,02;17,25;9,77;40861;17798;0.4356;17565;233;51444;4212;0.0819;2987;1225
2017-05-14 13:00:00;24,3;15,78;8,52;40861;16854;0.4125;17619;-765;51444;4365;0.0848;3312;1053
2017-05-14 14:00:00;21,06;15,94;5,12;40861;15816;0.387;16638;-822;51444;4544;0.0883;3545;999
2017-05-14 15:00:00;20,99;14,76;6,23;40861;14064;0.3442;14644;-580;51444;4666;0.0907;3591;1075
2017-05-14 16:00:00;23,9;16,66;7,24;40861;11580;0.2834;11978;-398;51444;4089;0.0795;3700;389
2017-05-14 17:00:00;27,63;22,9;4,73;40861;8394;0.2054;8686;-292;51444;3709;0.0721;3655;54
2017-05-14 18:00:00;32,07;29,67;2,4;40861;5012;0.1227;5134;-122;51444;3343;0.065;3284;59
2017-05-14 19:00:00;35,96;35,13;0,83;40861;2238;0.0548;2193;45;51444;3059;0.0595;2876;183
2017-05-14 20:00:00;39,55;34,16;5,39;40861;408;0.01;381;27;51444;2896;0.0563;2625;271
2017-05-14 21:00:00;40,99;35,03;5,96;40861;2;0;2;0;51444;2767;0.0538;2530;237
2017-05-14 22:00:00;38,17;35,61;2,56;40861;0;0;0;0;51444;2864;0.0556;2610;254
2017-05-14 23:00:00;31,46;32,49;-1,03;40861;0;0;0;0;51444;3369;0.0655;2851;518
2017-05-15 00:00:00;30,32;30,95;-0,63;40867;0;0;0;0;51457;3641;0.0707;3636;5
2017-05-15 01:00:00;27,43;30,29;-2,86;40867;0;0;0;0;51457;4119;0.08;4040;79
2017-05-15 02:00:00;27,18;30,2;-3,02;40867;0;0;0;0;51457;4460;0.0866;4166;294
2017-05-15 03:00:00;26,7;28,09;-1,39;40867;0;0;0;0;51457;4394;0.0854;3967;427
2017-05-15 04:00:00;27,16;26,59;0,57;40867;0;0;0;0;51457;3971;0.0772;3741;230
2017-05-15 05:00:00;29,77;29,01;0,76;40867;67;0.0016;80;-13;51457;3630;0.0706;3304;326
2017-05-15 06:00:00;35,38;38,77;-3,39;40867;1246;0.0305;1194;52;51457;3147;0.0612;2677;470
2017-05-15 07:00:00;44,02;42,74;1,28;40867;4493;0.11;4213;280;51457;2474;0.0481;2036;438
2017-05-15 08:00:00;46,1;44,05;2,05;40867;9307;0.2277;8589;718;51457;1742;0.0338;1619;123
2017-05-15 09:00:00;43,95;39,1;4,85;40867;14206;0.3476;13189;1017;51457;1482;0.0288;1566;-84
2017-05-15 10:00:00;41,94;35,07;6,87;40867;18006;0.4406;16997;1009;51457;1430;0.0278;1675;-245
2017-05-15 11:00:00;40,07;34,75;5,32;40867;20522;0.5022;19536;986;51457;1827;0.0355;1859;-32
2017-05-15 12:00:00;35,66;33,93;1,73;40867;21898;0.5359;20848;1050;51457;2468;0.048;2140;328
2017-05-15 13:00:00;35,04;33,2;1,84;40867;22120;0.5413;21134;986;51457;3023;0.0587;2448;575
2017-05-15 14:00:00;33,48;32,27;1,21;40867;21700;0.531;20294;1406;51457;3252;0.0632;2684;568
2017-05-15 15:00:00;32,98;32,57;0,41;40867;19846;0.4856;18282;1564;51457;3221;0.0626;2758;463
2017-05-15 16:00:00;33,14;31,57;1,57;40867;16804;0.4112;15054;1750;51457;3086;0.06;2748;338
2017-05-15 17:00:00;37,74;35,5;2,24;40867;12267;0.3002;10751;1516;51457;2668;0.0518;2560;108
2017-05-15 18:00:00;42,82;40,67;2,15;40867;7189;0.1759;6097;1092;51457;2110;0.041;2164;-54
2017-05-15 19:00:00;45,73;43,78;1,95;40867;2786;0.0682;2431;355;51457;1632;0.0317;1787;-155
2017-05-15 20:00:00;44,2;44,49;-0,29;40867;464;0.0113;442;22;51457;1864;0.0362;1643;221
2017-05-15 21:00:00;42,29;42,51;-0,22;40867;1;0;2;-1;51457;2320;0.0451;1861;459
2017-05-15 22:00:00;40,22;40,34;-0,12;40867;0;0;0;0;51457;2907;0.0565;2305;602
2017-05-15 23:00:00;31,08;32,43;-1,35;40867;0;0;0;0;51457;3793;0.0737;2956;837
2017-05-16 00:00:00;29,5;30,26;-0,76;40872;0;0;0;0;51476;4710;0.0915;4261;449
2017-05-16 01:00:00;28,01;27,42;0,59;40872;0;0;0;0;51476;5668;0.1101;4910;758
2017-05-16 02:00:00;26,7;25,43;1,27;40872;0;0;0;0;51476;5886;0.1144;5373;513
2017-05-16 03:00:00;26,53;24,74;1,79;40872;0;0;0;0;51476;5640;0.1096;5529;111
2017-05-16 04:00:00;26,38;25,71;0,67;40872;0;0;0;0;51476;5698;0.1107;5608;90
2017-05-16 05:00:00;27,93;26,79;1,14;40872;74;0.0018;77;-3;51476;6226;0.1209;5684;542
2017-05-16 06:00:00;31,81;30,83;0,98;40872;1252;0.0306;1094;158;51476;6644;0.129;5804;840
2017-05-16 07:00:00;39,96;38,58;1,38;40872;4286;0.1048;3738;548;51476;7020;0.1364;5944;1076
2017-05-16 08:00:00;41,35;36,75;4,6;40872;8921;0.2182;7415;1506;51476;6594;0.1281;6048;546
2017-05-16 09:00:00;38,42;32,06;6,36;40872;13693;0.335;11241;2452;51476;6031;0.1172;6061;-30
2017-05-16 10:00:00;34,53;31,4;3,13;40872;17353;0.4246;14468;2885;51476;5836;0.1134;6035;-199
2017-05-16 11:00:00;34,84;31,43;3,41;40872;19638;0.4805;16849;2789;51476;5587;0.1085;5965;-378
2017-05-16 12:00:00;31,88;30,47;1,41;40872;20955;0.5127;18281;2674;51476;5332;0.1036;5845;-513
2017-05-16 13:00:00;31,06;30,47;0,59;40872;21102;0.5163;18665;2437;51476;5008;0.0973;5717;-709
2017-05-16 14:00:00;31,58;30,79;0,79;40872;20147;0.493;17987;2160;51476;4676;0.0908;5466;-790
2017-05-16 15:00:00;32,33;30,74;1,59;40872;17856;0.4369;16196;1660;51476;4544;0.0883;5132;-588
2017-05-16 16:00:00;34,52;32,7;1,82;40872;14806;0.3623;13332;1474;51476;4254;0.0826;4885;-631
2017-05-16 17:00:00;37,04;36,56;0,48;40872;10680;0.2613;9497;1183;51476;4103;0.0797;4771;-668
2017-05-16 18:00:00;41,0;40,11;0,89;40872;6036;0.1476;5322;714;51476;3970;0.0771;4937;-967
2017-05-16 19:00:00;42,94;41,41;1,53;40872;2381;0.0582;2102;279;51476;4082;0.0793;5259;-1177
2017-05-16 20:00:00;42,77;40,88;1,89;40872;388;0.0095;388;0;51476;4385;0.0852;5757;-1372
2017-05-16 21:00:00;41,5;42,01;-0,51;40872;1;0;3;-2;51476;4570;0.0888;6440;-1870
2017-05-16 22:00:00;37,01;40,56;-3,55;40872;0;0;0;0;51476;4756;0.0924;7192;-2436
2017-05-16 23:00:00;31,92;36,15;-4,23;40872;0;0;0;0;51476;4952;0.0962;7679;-2727
2017-05-17 00:00:00;29,66;33,44;-3,78;40878;0;0;0;0;51523;4636;0.09;5694;-1058
2017-05-17 01:00:00;27,7;32,71;-5,01;40878;0;0;0;0;51523;4471;0.0868;5566;-1095
2017-05-17 02:00:00;27,17;30,76;-3,59;40878;0;0;0;0;51523;4230;0.0821;5391;-1161
2017-05-17 03:00:00;26,45;27,98;-1,53;40878;0;0;0;0;51523;4078;0.0792;5213;-1135
2017-05-17 04:00:00;26,49;26,86;-0,37;40878;0;0;0;0;51523;3931;0.0763;5052;-1121
2017-05-17 05:00:00;27,58;29,12;-1,54;40878;78;0.0019;83;-5;51523;3842;0.0746;4864;-1022
2017-05-17 06:00:00;36,19;36,66;-0,47;40878;1311;0.032;1166;145;51523;3956;0.0768;4571;-615
2017-05-17 07:00:00;41,0;38,58;2,42;40878;4688;0.1147;4308;380;51523;3286;0.0638;4165;-879
2017-05-17 08:00:00;41,0;40,03;0,97;40878;10059;0.2461;9026;1033;51523;2232;0.0433;3594;-1362
2017-05-17 09:00:00;38,95;38,48;0,47;40878;15807;0.3867;14117;1690;51523;1742;0.0338;2953;-1211
2017-05-17 10:00:00;33,54;34,86;-1,32;40878;20611;0.5042;18464;2147;51523;1888;0.0366;2581;-693
2017-05-17 11:00:00;32,94;32,98;-0,04;40878;24090;0.5893;21735;2355;51523;2252;0.0437;2677;-425
2017-05-17 12:00:00;31,03;33,81;-2,78;40878;25930;0.6344;23766;2164;51523;2776;0.0539;3143;-367
2017-05-17 13:00:00;30,21;31,42;-1,21;40878;26290;0.6432;24313;1977;51523;3527;0.0685;3669;-142
2017-05-17 14:00:00;29,14;30,77;-1,63;40878;25307;0.6191;23411;1896;51523;4453;0.0865;4191;262
2017-05-17 15:00:00;28,22;30,35;-2,13;40878;22865;0.5593;21109;1756;51523;5465;0.106;4753;712
2017-05-17 16:00:00;29,48;31,85;-2,37;40878;18914;0.4627;17481;1433;51523;6540;0.127;5336;1204
2017-05-17 17:00:00;34,77;36,09;-1,32;40878;13531;0.331;12514;1017;51523;8100;0.1572;6164;1936
2017-05-17 18:00:00;38,34;39,29;-0,95;40878;7616;0.1863;6992;624;51523;9527;0.1849;7348;2179
2017-05-17 19:00:00;40,98;40,15;0,83;40878;2908;0.0712;2746;162;51523;10408;0.202;8851;1557
2017-05-17 20:00:00;37,9;36,98;0,92;40878;500;0.0122;541;-41;51523;11710;0.2273;10933;777
2017-05-17 21:00:00;34,02;37,82;-3,8;40878;3;0.0001;5;-2;51523;15544;0.3017;13430;2114
2017-05-17 22:00:00;31,01;32,2;-1,19;40878;0;0;0;0;51523;18677;0.3625;15608;3069
2017-05-17 23:00:00;26,68;28,52;-1,84;40878;0;0;0;0;51523;20028;0.3887;16891;3137
2017-05-18 00:00:00;26,04;23,91;2,13;40883;0;0;0;0;51565;19970;0.3872;18270;1700
2017-05-18 01:00:00;24,31;19,63;4,68;40883;0;0;0;0;51565;19394;0.3761;18207;1187
2017-05-18 02:00:00;22,43;20,53;1,9;40883;0;0;0;0;51565;18920;0.3669;17970;950
2017-05-18 03:00:00;20,68;20,93;-0,25;40883;0;0;0;0;51565;18018;0.3494;17464;554
2017-05-18 04:00:00;22,46;25,17;-2,71;40883;0;0;0;0;51565;17497;0.3393;16883;614
2017-05-18 05:00:00;26,06;27,12;-1,06;40883;114;0.0028;122;-8;51565;15939;0.3091;16027;-88
2017-05-18 06:00:00;32,68;30,11;2,57;40883;1616;0.0395;1406;210;51565;14342;0.2782;14732;-390
2017-05-18 07:00:00;40,4;42,05;-1,65;40883;5319;0.1301;4987;332;51565;11390;0.2209;13041;-1651
2017-05-18 08:00:00;42,98;43,6;-0,62;40883;10492;0.2567;9909;583;51565;8317;0.1613;11305;-2988
2017-05-18 09:00:00;37,93;42,22;-4,29;40883;15132;0.3701;14635;497;51565;7529;0.146;10063;-2534
2017-05-18 10:00:00;33,14;36,44;-3,3;40883;18544;0.4536;18098;446;51565;7617;0.1477;9151;-1534
2017-05-18 11:00:00;31,75;34,21;-2,46;40883;20485;0.5011;20195;290;51565;7747;0.1502;8472;-725
2017-05-18 12:00:00;31,02;34,52;-3,5;40883;20797;0.5087;21040;-243;51565;7256;0.1407;7961;-705
2017-05-18 13:00:00;29,99;35,09;-5,1;40883;20265;0.4957;20461;-196;51565;5895;0.1143;7494;-1599
2017-05-18 14:00:00;31,0;38,19;-7,19;40883;18802;0.4599;18732;70;51565;4784;0.0928;6927;-2143
2017-05-18 15:00:00;30,78;40,3;-9,52;40883;16628;0.4067;16067;561;51565;4369;0.0847;6324;-1955
2017-05-18 16:00:00;36,1;42,11;-6,01;40883;13251;0.3241;12617;634;51565;4005;0.0777;5726;-1721
2017-05-18 17:00:00;37,98;42,6;-4,62;40883;9258;0.2264;8597;661;51565;3622;0.0702;5158;-1536
2017-05-18 18:00:00;39,45;43,8;-4,35;40883;5393;0.1319;4756;637;51565;3342;0.0648;4618;-1276
2017-05-18 19:00:00;39,54;43,39;-3,85;40883;2317;0.0567;1957;360;51565;3583;0.0695;4248;-665
2017-05-18 20:00:00;39,91;40,74;-0,83;40883;441;0.0108;393;48;51565;3773;0.0732;4095;-322
2017-05-18 21:00:00;38,95;38,45;0,5;40883;6;0.0001;3;3;51565;3736;0.0725;4089;-353
2017-05-18 22:00:00;37,86;36,66;1,2;40883;0;0;0;0;51565;4343;0.0842;4147;196
2017-05-18 23:00:00;32,26;29,88;2,38;40883;0;0;0;0;51565;4395;0.0853;4119;276
2017-05-19 00:00:00;30,0;26,56;3,44;40888;0;0;0;0;51627;4550;0.0882;3790;760
2017-05-19 01:00:00;28,6;25,34;3,26;40888;0;0;0;0;51627;4910;0.0951;3755;1155
2017-05-19 02:00:00;26,67;23,85;2,82;40888;0;0;0;0;51627;5082;0.0985;3798;1284
2017-05-19 03:00:00;26,31;20,64;5,67;40888;0;0;0;0;51627;5065;0.0981;3933;1132
2017-05-19 04:00:00;25,97;22,99;2,98;40888;0;0;0;0;51627;5183;0.1004;4262;921
2017-05-19 05:00:00;27,6;25,92;1,68;40888;106;0.0026;116;-10;51627;5589;0.1083;4536;1053
2017-05-19 06:00:00;30,9;32,84;-1,94;40888;1237;0.0303;1230;7;51627;5926;0.1148;4617;1309
2017-05-19 07:00:00;39,91;37,62;2,29;40888;3782;0.0925;3857;-75;51627;5552;0.1076;4772;780
2017-05-19 08:00:00;41,55;39,02;2,53;40888;7368;0.1802;7281;87;51627;5052;0.0979;4890;162
2017-05-19 09:00:00;39,9;38,43;1,47;40888;10872;0.2659;10600;272;51627;4944;0.0958;5029;-85
2017-05-19 10:00:00;38,95;38,24;0,71;40888;13742;0.3361;13048;694;51627;4847;0.0939;5364;-517
2017-05-19 11:00:00;39,8;39,06;0,74;40888;15388;0.3764;14560;828;51627;5352;0.1036;5680;-328
2017-05-19 12:00:00;37,72;36,51;1,21;40888;15624;0.3821;15204;420;51627;6355;0.1231;5828;527
2017-05-19 13:00:00;36,38;35,56;0,82;40888;14628;0.3578;14711;-83;51627;6864;0.133;6037;827
2017-05-19 14:00:00;35,05;34,49;0,56;40888;13022;0.3185;13362;-340;51627;7258;0.1406;6308;950
2017-05-19 15:00:00;34,59;32,14;2,45;40888;10620;0.2597;11360;-740;51627;8036;0.1556;6729;1307
2017-05-19 16:00:00;31,06;30,45;0,61;40888;7788;0.1905;8855;-1067;51627;9364;0.1814;7376;1988
2017-05-19 17:00:00;36,01;31,46;4,55;40888;4896;0.1198;6114;-1218;51627;11290;0.2187;7940;3350
2017-05-19 18:00:00;38,5;32,28;6,22;40888;2559;0.0626;3491;-932;51627;13213;0.2559;8260;4953
2017-05-19 19:00:00;38,97;31,79;7,18;40888;1055;0.0258;1457;-402;51627;13911;0.2695;8730;5181
2017-05-19 20:00:00;36,04;30,22;5,82;40888;195;0.0048;288;-93;51627;13913;0.2695;9256;4657
2017-05-19 21:00:00;37,0;29,53;7,47;40888;2;0;2;0;51627;14408;0.2791;9661;4747
2017-05-19 22:00:00;36,98;27,75;9,23;40888;0;0;0;0;51627;15055;0.2916;10005;5050
2017-05-19 23:00:00;32,76;23,61;9,15;40888;0;0;0;0;51627;15064;0.2918;10038;5026
2017-05-20 00:00:00;24,02;19,61;4,41;40888;0;0;0;0;51639;14389;0.2786;11066;3323
2017-05-20 01:00:00;24,26;19,41;4,85;40888;0;0;0;0;51639;13772;0.2667;10916;2856
2017-05-20 02:00:00;24,74;21,01;3,73;40888;0;0;0;0;51639;13560;0.2626;10701;2859
2017-05-20 03:00:00;26,71;20,02;6,69;40888;0;0;0;0;51639;12622;0.2444;10301;2321
2017-05-20 04:00:00;25,93;20,16;5,77;40888;0;0;0;0;51639;11514;0.223;9868;1646
2017-05-20 05:00:00;24,08;21,07;3,01;40888;109;0.0026;81;28;51639;10176;0.197;9304;872
2017-05-20 06:00:00;26,5;24,85;1,65;40888;1337;0.0327;1037;300;51639;8991;0.1741;8655;336
2017-05-20 07:00:00;26,06;27,01;-0,95;40888;4639;0.1134;3527;1112;51639;7914;0.1532;8007;-93
2017-05-20 08:00:00;27,0;25,17;1,83;40888;9598;0.2347;7160;2438;51639;7627;0.1477;7561;66
2017-05-20 09:00:00;25,3;20,7;4,6;40888;14517;0.355;10907;3610;51639;7630;0.1478;7333;297
2017-05-20 10:00:00;23,99;15,93;8,06;40888;17884;0.4374;13547;4337;51639;7212;0.1397;7176;36
2017-05-20 11:00:00;24,11;15,48;8,63;40888;19193;0.4694;15038;4155;51639;7238;0.1402;6949;289
2017-05-20 12:00:00;23,83;16,54;7,29;40888;18921;0.4628;15599;3322;51639;6960;0.1348;6492;468
2017-05-20 13:00:00;22,83;16,39;6,44;40888;18438;0.4509;15461;2977;51639;6508;0.1261;6014;494
2017-05-20 14:00:00;21,44;16,0;5,44;40888;17501;0.428;14577;2924;51639;6094;0.118;5593;501
2017-05-20 15:00:00;21,73;13,66;8,07;40888;15835;0.3873;13016;2819;51639;5671;0.1098;5154;517
2017-05-20 16:00:00;23,92;15,93;7,99;40888;13536;0.331;10922;2614;51639;5296;0.1026;4656;640
2017-05-20 17:00:00;25,64;16,61;9,03;40888;10111;0.2473;8188;1923;51639;4763;0.0922;4120;643
2017-05-20 18:00:00;29,0;25,23;3,77;40888;6298;0.154;5096;1202;51639;4057;0.0786;3596;461
2017-05-20 19:00:00;33,34;28,14;5,2;40888;2924;0.0715;2342;582;51639;3207;0.0621;3149;58
2017-05-20 20:00:00;33,5;28,48;5,02;40888;628;0.0154;522;106;51639;2444;0.0474;2833;-389
2017-05-20 21:00:00;33,08;27,96;5,12;40888;10;0.0002;8;2;51639;2406;0.0466;2766;-360
2017-05-20 22:00:00;34,12;28,07;6,05;40888;0;0;0;0;51639;2498;0.0484;2870;-372
2017-05-20 23:00:00;30,05;25,78;4,27;40888;0;0;0;0;51639;2730;0.0529;3029;-299
2017-05-21 00:00:00;23,66;23,26;0,4;40889;0;0;0;0;51639;3139;0.0608;3156;-17
2017-05-21 01:00:00;18,12;21,02;-2,9;40889;0;0;0;0;51639;3539;0.0686;3347;192
2017-05-21 02:00:00;14,12;17,86;-3,74;40889;0;0;0;0;51639;3910;0.0757;3624;286
2017-05-21 03:00:00;12,18;13,07;-0,89;40889;0;0;0;0;51639;4280;0.0829;3880;400
2017-05-21 04:00:00;11,65;11,68;-0,03;40889;0;0;0;0;51639;4498;0.0871;4113;385
2017-05-21 05:00:00;11,52;10,31;1,21;40889;255;0.0062;147;108;51639;4579;0.0887;4124;455
2017-05-21 06:00:00;11,98;9,74;2,24;40889;1854;0.0454;1524;330;51639;4303;0.0833;3745;558
2017-05-21 07:00:00;12,36;10,73;1,63;40889;5810;0.1421;5404;406;51639;3269;0.0633;3243;26
2017-05-21 08:00:00;13,7;12,99;0,71;40889;11573;0.2831;11017;556;51639;2148;0.0416;2753;-605
2017-05-21 09:00:00;12,07;13,7;-1,63;40889;17392;0.4254;16611;781;51639;2332;0.0451;2560;-228
2017-05-21 10:00:00;10,02;10,29;-0,27;40889;21279;0.5204;20304;975;51639;3024;0.0586;2708;316
2017-05-21 11:00:00;11,86;10,39;1,47;40889;21684;0.5303;21881;-197;51639;2898;0.0561;2787;111
2017-05-21 12:00:00;12,29;12,05;0,24;40889;21308;0.5211;22192;-884;51639;2608;0.0505;2709;-101
2017-05-21 13:00:00;11,93;12,82;-0,89;40889;20837;0.5096;21514;-677;51639;2489;0.0482;2579;-90
2017-05-21 14:00:00;10,28;12,25;-1,97;40889;19999;0.4891;19797;202;51639;2400;0.0464;2437;-37
2017-05-21 15:00:00;11,93;10,43;1,5;40889;18423;0.4505;17238;1185;51639;2243;0.0434;2278;-35
2017-05-21 16:00:00;16,92;11,21;5,71;40889;15628;0.3822;14098;1530;51639;2000;0.0387;2135;-135
2017-05-21 17:00:00;23,05;14,95;8,1;40889;11583;0.2833;10202;1381;51639;1863;0.0361;2027;-164
2017-05-21 18:00:00;28,12;25,58;2,54;40889;7098;0.1736;6006;1092;51639;1800;0.0349;1922;-122
2017-05-21 19:00:00;32,91;29,76;3,15;40889;3137;0.0767;2608;529;51639;1625;0.0315;1915;-290
2017-05-21 20:00:00;35,07;32,45;2,62;40889;696;0.017;582;114;51639;1813;0.0351;2084;-271
2017-05-21 21:00:00;35,32;32,95;2,37;40889;16;0.0004;10;6;51639;2406;0.0466;2440;-34
2017-05-21 22:00:00;36,11;31,67;4,44;40889;0;0;0;0;51639;3173;0.0614;2884;289
2017-05-21 23:00:00;33,43;28,9;4,53;40889;0;0;0;0;51639;3784;0.0733;3194;590
2017-05-22 00:00:00;29,84;26,2;3,64;40895;0;0;0;0;51659;4290;0.083;3190;1100
2017-05-22 01:00:00;28,01;23,55;4,46;40895;0;0;0;0;51659;4620;0.0894;3269;1351
2017-05-22 02:00:00;26,9;22,33;4,57;40895;0;0;0;0;51659;4510;0.0873;3360;1150
2017-05-22 03:00:00;26,01;21,84;4,17;40895;0;0;0;0;51659;4226;0.0818;3322;904
2017-05-22 04:00:00;26,86;21,85;5,01;40895;0;0;0;0;51659;4024;0.0779;3225;799
2017-05-22 05:00:00;27,38;23,32;4,06;40895;168;0.0041;154;14;51659;4055;0.0785;3078;977
2017-05-22 06:00:00;35,49;29,99;5,5;40895;1760;0.0431;1558;202;51659;3810;0.0737;2829;981
2017-05-22 07:00:00;40,0;39,5;0,5;40895;5452;0.1333;5211;241;51659;3079;0.0596;2455;624
2017-05-22 08:00:00;42,2;39,54;2,66;40895;10776;0.2635;10454;322;51659;1900;0.0368;1908;-8
2017-05-22 09:00:00;38,82;36,67;2,15;40895;16439;0.402;15804;635;51659;1458;0.0282;1403;55
2017-05-22 10:00:00;37,02;34,27;2,75;40895;21138;0.5169;19918;1220;51659;1449;0.028;1242;207
2017-05-22 11:00:00;36,99;34,42;2,57;40895;23514;0.575;22133;1381;51659;1518;0.0294;1268;250
2017-05-22 12:00:00;36,96;33,86;3,1;40895;23990;0.5866;22762;1228;51659;1374;0.0266;1266;108
2017-05-22 13:00:00;37,91;33,28;4,63;40895;23230;0.568;22239;991;51659;1207;0.0234;1224;-17
2017-05-22 14:00:00;36,93;33,5;3,43;40895;22067;0.5396;20724;1343;51659;1029;0.0199;1228;-199
2017-05-22 15:00:00;36,94;33,16;3,78;40895;20215;0.4943;18278;1937;51659;934;0.0181;1336;-402
2017-05-22 16:00:00;36,2;33,98;2,22;40895;17344;0.4241;15293;2051;51659;944;0.0183;1400;-456
2017-05-22 17:00:00;38,71;38,26;0,45;40895;12938;0.3164;11316;1622;51659;1103;0.0213;1540;-437
2017-05-22 18:00:00;43,65;40,83;2,82;40895;7712;0.1886;6684;1028;51659;1352;0.0262;1774;-422
2017-05-22 19:00:00;44,36;41,87;2,49;40895;3172;0.0775;2821;351;51659;1728;0.0334;2209;-481
2017-05-22 20:00:00;41,95;40,76;1,19;40895;662;0.0162;641;21;51659;2328;0.045;2895;-567
2017-05-22 21:00:00;41,21;40,95;0,26;40895;8;0.0002;10;-2;51659;3317;0.0642;3696;-379
2017-05-22 22:00:00;40,84;39,96;0,88;40895;0;0;0;0;51659;4437;0.0859;4574;-137
2017-05-22 23:00:00;34,07;35,34;-1,27;40895;0;0;0;0;51659;5302;0.1026;5166;136
2017-05-23 00:00:00;32,24;29,69;2,55;40902;0;0;0;0;51709;5863;0.1134;5593;270
2017-05-23 01:00:00;32,17;30,26;1,91;40902;0;0;0;0;51709;6181;0.1195;5635;546
2017-05-23 02:00:00;29,72;30,63;-0,91;40902;0;0;0;0;51709;6156;0.1191;5563;593
2017-05-23 03:00:00;28,05;28,05;0,0;40902;0;0;0;0;51709;6000;0.116;5440;560
2017-05-23 04:00:00;28,04;26,96;1,08;40902;0;0;0;0;51709;5615;0.1086;5340;275
2017-05-23 05:00:00;29,71;28,05;1,66;40902;174;0.0042;170;4;51709;5466;0.1057;5206;260
2017-05-23 06:00:00;36,99;34,43;2,56;40902;1777;0.0434;1644;133;51709;5216;0.1009;4892;324
2017-05-23 07:00:00;41,78;41,82;-0,04;40902;5558;0.1359;5230;328;51709;4226;0.0817;4416;-190
2017-05-23 08:00:00;41,4;44,83;-3,43;40902;10928;0.2672;10353;575;51709;2335;0.0452;3668;-1333
2017-05-23 09:00:00;41,89;42,71;-0,82;40902;16354;0.3998;15616;738;51709;1432;0.0277;3017;-1585
2017-05-23 10:00:00;38,05;39,78;-1,73;40902;20676;0.5055;19833;843;51709;1563;0.0302;2861;-1298
2017-05-23 11:00:00;36,94;38,13;-1,19;40902;23267;0.5688;22395;872;51709;2656;0.0514;3299;-643
2017-05-23 12:00:00;33,97;35,97;-2,0;40902;23932;0.5851;23353;579;51709;4970;0.0961;4553;417
2017-05-23 13:00:00;30,5;33,34;-2,84;40902;23243;0.5683;22990;253;51709;7461;0.1443;6222;1239
2017-05-23 14:00:00;31,01;32,26;-1,25;40902;21332;0.5215;21589;-257;51709;10430;0.2017;8077;2353
2017-05-23 15:00:00;29,1;31,0;-1,9;40902;18560;0.4538;18953;-393;51709;13039;0.2522;9677;3362
2017-05-23 16:00:00;29,06;29,07;-0,01;40902;14824;0.3625;15351;-527;51709;14666;0.2836;11078;3588
2017-05-23 17:00:00;31,84;34,21;-2,37;40902;10280;0.2513;10930;-650;51709;15433;0.2985;12095;3338
2017-05-23 18:00:00;33,75;38,88;-5,13;40902;5978;0.1461;6354;-376;51709;16907;0.3269;12567;4340
2017-05-23 19:00:00;37,11;39,87;-2,76;40902;2748;0.0672;2801;-53;51709;16978;0.3283;12842;4136
2017-05-23 20:00:00;35,64;37,42;-1,78;40902;616;0.0151;648;-32;51709;16642;0.3218;12977;3665
2017-05-23 21:00:00;35,0;35,49;-0,49;40902;12;0.0003;12;0;51709;16250;0.3142;13113;3137
2017-05-23 22:00:00;30,99;36,28;-5,29;40902;0;0;0;0;51709;16057;0.3105;13432;2625
2017-05-23 23:00:00;28,41;31,23;-2,82;40902;0;0;0;0;51709;15896;0.3074;13706;2190
2017-05-24 00:00:00;27,15;30,29;-3,14;40910;0;0;0;0;51737;16124;0.3116;15754;370
2017-05-24 01:00:00;24,45;29,37;-4,92;40910;0;0;0;0;51737;16248;0.314;16122;126
2017-05-24 02:00:00;20,09;26,55;-6,46;40910;0;0;0;0;51737;16190;0.3129;16276;-86
2017-05-24 03:00:00;20,13;27,06;-6,93;40910;0;0;0;0;51737;14734;0.2848;16155;-1421
2017-05-24 04:00:00;21,56;31,45;-9,89;40910;0;0;0;0;51737;13758;0.2659;15835;-2077
2017-05-24 05:00:00;26,03;36,52;-10,49;40910;158;0.0039;129;29;51737;12777;0.2469;15375;-2598
2017-05-24 06:00:00;30,1;39,64;-9,54;40910;1492;0.0365;1307;185;51737;11426;0.2208;14918;-3492
2017-05-24 07:00:00;36,93;44,7;-7,77;40910;4480;0.1095;4195;285;51737;10978;0.2122;14682;-3704
2017-05-24 08:00:00;37,55;45,33;-7,78;40910;8682;0.2122;8268;414;51737;12034;0.2326;14609;-2575
2017-05-24 09:00:00;34,97;39,12;-4,15;40910;12992;0.3176;12295;697;51737;12199;0.2358;14645;-2446
2017-05-24 10:00:00;31,98;36,78;-4,8;40910;16110;0.3938;15339;771;51737;12574;0.243;14639;-2065
2017-05-24 11:00:00;32,35;37,45;-5,1;40910;17490;0.4275;17314;176;51737;13107;0.2534;14566;-1459
2017-05-24 12:00:00;30,09;36,56;-6,47;40910;17468;0.427;18148;-680;51737;12999;0.2512;14501;-1502
2017-05-24 13:00:00;28,8;36,44;-7,64;40910;16528;0.404;17715;-1187;51737;13012;0.2515;14383;-1371
2017-05-24 14:00:00;29,79;37,59;-7,8;40910;14198;0.347;16323;-2125;51737;13035;0.252;14119;-1084
2017-05-24 15:00:00;32,96;38,64;-5,68;40910;11764;0.2875;14281;-2517;51737;12618;0.2439;13574;-956
2017-05-24 16:00:00;32,13;39,36;-7,23;40910;9290;0.2271;11646;-2356;51737;11940;0.2308;12772;-832
2017-05-24 17:00:00;36,91;41,59;-4,68;40910;6863;0.1678;8411;-1548;51737;11263;0.2177;11684;-421
2017-05-24 18:00:00;39,92;42,62;-2,7;40910;4490;0.1098;5075;-585;51737;9878;0.1909;10231;-353
2017-05-24 19:00:00;40,57;43,86;-3,29;40910;2263;0.0553;2347;-84;51737;7901;0.1527;8630;-729
2017-05-24 20:00:00;40,84;42,44;-1,6;40910;521;0.0127;563;-42;51737;6129;0.1184;7482;-1353
2017-05-24 21:00:00;40,06;42,73;-2,67;40910;14;0.0004;11;3;51737;5360;0.1036;6888;-1528
2017-05-24 22:00:00;40,98;42,05;-1,07;40910;0;0;0;0;51737;5226;0.101;6712;-1486
2017-05-24 23:00:00;36,91;36,7;0,21;40910;0;0;0;0;51737;5391;0.1042;6728;-1337
2017-05-25 00:00:00;33,41;30,71;2,7;40911;0;0;0;0;51743;5777;0.1117;6128;-351
2017-05-25 01:00:00;31,98;30,89;1,09;40911;0;0;0;0;51743;5979;0.1155;6211;-232
2017-05-25 02:00:00;28,07;28,01;0,06;40911;0;0;0;0;51743;6192;0.1196;6316;-124
2017-05-25 03:00:00;28,0;27,08;0,92;40911;0;0;0;0;51743;6261;0.121;6369;-108
2017-05-25 04:00:00;27,97;25,62;2,35;40911;1;0;0;1;51743;6256;0.1209;6355;-99
2017-05-25 05:00:00;26,97;26,04;0,93;40911;160;0.0039;174;-14;51743;5942;0.1149;6167;-225
2017-05-25 06:00:00;24,59;22,49;2,1;40911;1609;0.0393;1516;93;51743;5548;0.1072;5795;-247
2017-05-25 07:00:00;24,93;22,36;2,57;40911;4764;0.1165;4732;32;51743;5412;0.1046;5513;-101
2017-05-25 08:00:00;25,85;24,36;1,49;40911;9079;0.2219;9146;-67;51743;6021;0.1164;5693;328
2017-05-25 09:00:00;25,79;23,3;2,49;40911;13816;0.3377;13667;149;51743;6384;0.1234;6122;262
2017-05-25 10:00:00;25,59;19,98;5,61;40911;17289;0.4226;17192;97;51743;6655;0.1286;6703;-48
2017-05-25 11:00:00;26,02;18,0;8,02;40911;19118;0.4673;19365;-247;51743;6768;0.1308;7241;-473
2017-05-25 12:00:00;25,16;20,73;4,43;40911;20333;0.497;20343;-10;51743;7058;0.1364;7836;-778
2017-05-25 13:00:00;21,74;15,97;5,77;40911;20788;0.5081;20253;535;51743;7066;0.1366;8467;-1401
2017-05-25 14:00:00;19,97;14,46;5,51;40911;20903;0.5109;19177;1726;51743;6888;0.1331;9058;-2170
2017-05-25 15:00:00;19,99;12,38;7,61;40911;19512;0.4769;17002;2510;51743;7184;0.1388;9612;-2428
2017-05-25 16:00:00;21,12;10,94;10,18;40911;16432;0.4016;13743;2689;51743;7368;0.1424;9942;-2574
2017-05-25 17:00:00;27,08;21,53;5,55;40911;12346;0.3018;9923;2423;51743;7343;0.1419;9836;-2493
2017-05-25 18:00:00;29,9;28,74;1,16;40911;7579;0.1853;5999;1580;51743;6908;0.1335;9219;-2311
2017-05-25 19:00:00;33,92;33,81;0,11;40911;3345;0.0818;2722;623;51743;5904;0.1141;8360;-2456
2017-05-25 20:00:00;36,7;33,8;2,9;40911;779;0.019;662;117;51743;4975;0.0962;7645;-2670
2017-05-25 21:00:00;36,69;33,71;2,98;40911;18;0.0004;17;1;51743;5139;0.0993;7397;-2258
2017-05-25 22:00:00;36,98;33,36;3,62;40911;0;0;0;0;51743;5664;0.1095;7511;-1847
2017-05-25 23:00:00;31,08;28,38;2,7;40911;0;0;0;0;51743;5981;0.1156;7598;-1617
2017-05-26 00:00:00;28,12;27,44;0,68;40914;0;0;0;0;51774;6074;0.1173;6625;-551
2017-05-26 01:00:00;25,38;24,55;0,83;40914;0;0;0;0;51774;5760;0.1112;6496;-736
2017-05-26 02:00:00;24,06;23,11;0,95;40914;0;0;0;0;51774;5682;0.1097;6392;-710
2017-05-26 03:00:00;23,51;22,82;0,69;40914;0;0;0;0;51774;5501;0.1062;6221;-720
2017-05-26 04:00:00;24,27;20,3;3,97;40914;1;0;0;1;51774;5201;0.1005;5955;-754
2017-05-26 05:00:00;26,39;22,42;3,97;40914;172;0.0042;186;-14;51774;4893;0.0945;5476;-583
2017-05-26 06:00:00;33,94;26,31;7,63;40914;1736;0.0424;1580;156;51774;4429;0.0856;4691;-262
2017-05-26 07:00:00;37,93;30,51;7,42;40914;5577;0.1363;5184;393;51774;3370;0.0651;3795;-425
2017-05-26 08:00:00;38,3;29,49;8,81;40914;10661;0.2606;10254;407;51774;2426;0.0469;3126;-700
2017-05-26 09:00:00;36,48;29,78;6,7;40914;16177;0.3954;15191;986;51774;2287;0.0442;2787;-500
2017-05-26 10:00:00;34,01;27,82;6,19;40914;20950;0.512;19036;1914;51774;2230;0.043;2534;-304
2017-05-26 11:00:00;33,08;26,16;6,92;40914;24663;0.6028;21640;3023;51774;2366;0.0457;2387;-21
2017-05-26 12:00:00;30,86;23,43;7,43;40914;26864;0.6566;23134;3730;51774;2483;0.048;2359;124
2017-05-26 13:00:00;28,32;20,79;7,53;40914;27281;0.6668;23619;3662;51774;2558;0.0494;2366;192
2017-05-26 14:00:00;27,12;20,77;6,35;40914;26228;0.641;22986;3242;51774;2643;0.051;2409;234
2017-05-26 15:00:00;27,53;20,86;6,67;40914;23627;0.5774;21157;2470;51774;2638;0.0509;2442;196
2017-05-26 16:00:00;28,63;23,83;4,8;40914;19839;0.4849;17956;1883;51774;2589;0.05;2480;109
2017-05-26 17:00:00;34,64;32,95;1,69;40914;14594;0.3567;13241;1353;51774;2547;0.0492;2501;46
2017-05-26 18:00:00;38,85;37,88;0,97;40914;8460;0.2068;7613;847;51774;2548;0.0492;2540;8
2017-05-26 19:00:00;41,97;39,56;2,41;40914;3432;0.0838;3046;386;51774;2556;0.0494;2612;-56
2017-05-26 20:00:00;41,95;40,99;0,96;40914;753;0.0184;764;-11;51774;2709;0.0523;2856;-147
2017-05-26 21:00:00;39,99;40,94;-0,95;40914;20;0.0005;22;-2;51774;3696;0.0714;3379;317
2017-05-26 22:00:00;39,96;39,54;0,42;40914;0;0;0;0;51774;4554;0.088;3962;592
2017-05-26 23:00:00;35,2;34,73;0,47;40914;0;0;0;0;51774;5460;0.1054;4307;1153
2017-05-27 00:00:00;35,91;30,47;5,44;40915;0;0;0;0;51783;6328;0.1222;5704;624
2017-05-27 01:00:00;31,03;27,34;3,69;40915;0;0;0;0;51783;7022;0.1356;5832;1190
2017-05-27 02:00:00;27,6;24,83;2,77;40915;0;0;0;0;51783;7689;0.1485;5914;1775
2017-05-27 03:00:00;26,0;23,66;2,34;40915;0;0;0;0;51783;8321;0.1607;5956;2365
2017-05-27 04:00:00;24,58;21,76;2,82;40915;1;0;0;1;51783;8707;0.1682;6018;2689
2017-05-27 05:00:00;24,4;21,73;2,67;40915;197;0.0048;210;-13;51783;8710;0.1682;5971;2739
2017-05-27 06:00:00;26,1;22,89;3,21;40915;1895;0.0464;1745;150;51783;8376;0.1618;5653;2723
2017-05-27 07:00:00;29,14;25,27;3,87;40915;6300;0.154;5968;332;51783;6540;0.1263;4883;1657
2017-05-27 08:00:00;30,13;26,54;3,59;40915;12492;0.3053;12109;383;51783;4407;0.0851;3922;485
2017-05-27 09:00:00;29,36;23,44;5,92;40915;18453;0.451;18088;365;51783;3977;0.0768;3671;306
2017-05-27 10:00:00;26,1;18,38;7,72;40915;23024;0.5627;22737;287;51783;4384;0.0847;3943;441
2017-05-27 11:00:00;24,69;14,02;10,67;40915;25976;0.6348;25798;178;51783;5102;0.0985;4405;697
2017-05-27 12:00:00;22,04;11,72;10,32;40915;27488;0.6719;27378;110;51783;6044;0.1168;4981;1063
2017-05-27 13:00:00;15,27;10,29;4,98;40915;27634;0.6754;27523;111;51783;7223;0.1395;5574;1649
2017-05-27 14:00:00;13,38;9,42;3,96;40915;26486;0.6473;26346;140;51783;8156;0.1575;6131;2025
2017-05-27 15:00:00;14,9;7,54;7,36;40915;24030;0.5874;23760;270;51783;8607;0.1662;6650;1957
2017-05-27 16:00:00;20,09;10,93;9,16;40915;20117;0.4917;19750;367;51783;8692;0.1679;7158;1534
2017-05-27 17:00:00;27,31;20,71;6,6;40915;14713;0.3596;14290;423;51783;8513;0.1644;7586;927
2017-05-27 18:00:00;34,3;30,59;3,71;40915;8609;0.2104;8182;427;51783;8592;0.1659;7967;625
2017-05-27 19:00:00;37,13;33,27;3,86;40915;3380;0.0826;3334;46;51783;8334;0.161;8519;-185
2017-05-27 20:00:00;35,97;35,41;0,56;40915;767;0.0187;817;-50;51783;8529;0.1647;9758;-1229
2017-05-27 21:00:00;34,34;38,2;-3,86;40915;18;0.0004;26;-8;51783;11388;0.22;11883;-495
2017-05-27 22:00:00;33,98;36,53;-2,55;40915;0;0;0;0;51783;14019;0.2708;14030;-11
2017-05-27 23:00:00;24,68;27,4;-2,72;40915;0;0;0;0;51783;15292;0.2953;15081;211
2017-05-28 00:00:00;20,72;19,43;1,29;40915;0;0;0;0;51789;15224;0.294;15555;-331
2017-05-28 01:00:00;16,08;18,45;-2,37;40915;0;0;0;0;51789;14348;0.277;14914;-566
2017-05-28 02:00:00;18,66;18,59;0,07;40915;0;0;0;0;51789;13002;0.2511;14095;-1093
2017-05-28 03:00:00;16,58;17,15;-0,57;40915;0;0;0;0;51789;11497;0.222;12979;-1482
2017-05-28 04:00:00;14,25;18,35;-4,1;40915;2;0;0;2;51789;10604;0.2047;11760;-1156
2017-05-28 05:00:00;9,91;11,9;-1,99;40915;209;0.0051;214;-5;51789;10166;0.1963;10523;-357
2017-05-28 06:00:00;14,36;10,31;4,05;40915;1834;0.0448;1697;137;51789;9201;0.1777;9020;181
2017-05-28 07:00:00;18,27;12,09;6,18;40915;5698;0.1393;5766;-68;51789;7455;0.1439;7171;284
2017-05-28 08:00:00;19,04;14,4;4,64;40915;11185;0.2734;11401;-216;51789;5830;0.1126;5779;51
2017-05-28 09:00:00;17,18;15,85;1,33;40915;16733;0.409;16807;-74;51789;5011;0.0968;5248;-237
2017-05-28 10:00:00;11,65;18,97;-7,32;40915;20704;0.506;21124;-420;51789;5184;0.1001;5017;167
2017-05-28 11:00:00;11,63;16,86;-5,23;40915;23334;0.5703;24024;-690;51789;5868;0.1133;5040;828
2017-05-28 12:00:00;15,07;16,25;-1,18;40915;24948;0.6098;25458;-510;51789;7042;0.136;5299;1743
2017-05-28 13:00:00;10,18;14,92;-4,74;40915;25070;0.6127;25382;-312;51789;7797;0.1506;5581;2216
2017-05-28 14:00:00;10,08;12,7;-2,62;40915;23885;0.5838;24012;-127;51789;7956;0.1536;5759;2197
2017-05-28 15:00:00;10,14;14,06;-3,92;40915;21469;0.5248;21338;131;51789;7417;0.1432;5772;1645
2017-05-28 16:00:00;10,08;16,73;-6,65;40915;17481;0.4272;17426;55;51789;6750;0.1303;5730;1020
2017-05-28 17:00:00;21,95;25,76;-3,81;40915;12571;0.3072;12441;130;51789;6513;0.1258;5451;1062
2017-05-28 18:00:00;31,05;38,62;-7,57;40915;7325;0.1791;7042;283;51789;5805;0.1121;5007;798
2017-05-28 19:00:00;36,95;40,99;-4,04;40915;3166;0.0774;2929;237;51789;4702;0.0908;4692;10
2017-05-28 20:00:00;38,66;41,6;-2,94;40915;807;0.0197;753;54;51789;4183;0.0808;4566;-383
2017-05-28 21:00:00;38,65;42,45;-3,8;40915;30;0.0007;24;6;51789;4601;0.0888;4693;-92
2017-05-28 22:00:00;40,66;46,3;-5,64;40915;0;0;0;0;51789;4383;0.0846;4933;-550
2017-05-28 23:00:00;36,92;42,88;-5,96;40915;0;0;0;0;51789;4023;0.0777;5025;-1002
2017-05-29 00:00:00;29,02;36,29;-7,27;40922;0;0;0;0;51820;3564;0.0688;4190;-626
2017-05-29 01:00:00;28,3;30,81;-2,51;40922;0;0;0;0;51820;3357;0.0648;3873;-516
2017-05-29 02:00:00;26,27;30,11;-3,84;40922;0;0;0;0;51820;3236;0.0624;3518;-282
2017-05-29 03:00:00;25,6;28,02;-2,42;40922;0;0;0;0;51820;2940;0.0568;3195;-255
2017-05-29 04:00:00;25,6;26,29;-0,69;40922;2;0;0;2;51820;2845;0.0549;2902;-57
2017-05-29 05:00:00;26,4;28,79;-2,39;40922;194;0.0048;210;-16;51820;2994;0.0578;2565;429
2017-05-29 06:00:00;35,97;37,7;-1,73;40922;1686;0.0412;1636;50;51820;2568;0.0496;2234;334
2017-05-29 07:00:00;42,7;48,19;-5,49;40922;4869;0.119;5358;-489;51820;1820;0.0351;1887;-67
2017-05-29 08:00:00;43,06;59,13;-16,07;40922;9306;0.2274;10388;-1082;51820;1172;0.0226;1582;-410
2017-05-29 09:00:00;42,71;52,15;-9,44;40922;14381;0.3514;15382;-1001;51820;1111;0.0214;1383;-272
2017-05-29 10:00:00;41,82;49,73;-7,91;40922;19014;0.4646;19676;-662;51820;1319;0.0254;1293;26
2017-05-29 11:00:00;41,32;46,09;-4,77;40922;22638;0.5532;22748;-110;51820;1037;0.02;1336;-299
2017-05-29 12:00:00;37,99;42,49;-4,5;40922;24666;0.6028;24485;181;51820;1160;0.0224;1479;-319
2017-05-29 13:00:00;37,41;42,8;-5,39;40922;24880;0.608;24754;126;51820;1428;0.0276;1668;-240
2017-05-29 14:00:00;35,58;43,01;-7,43;40922;24032;0.5873;23698;334;51820;1621;0.0313;1856;-235
2017-05-29 15:00:00;36,32;43,75;-7,43;40922;21540;0.5264;21165;375;51820;1983;0.0383;2002;-19
2017-05-29 16:00:00;37,91;46,7;-8,79;40922;17693;0.4324;17336;357;51820;2118;0.0409;2127;-9
2017-05-29 17:00:00;42,18;53,53;-11,35;40922;12606;0.308;12431;175;51820;2211;0.0427;2199;12
2017-05-29 18:00:00;44,08;63,85;-19,77;40922;7270;0.1777;7173;97;51820;2491;0.0481;2309;182
2017-05-29 19:00:00;46,15;69,23;-23,08;40922;3104;0.0758;3081;23;51820;2419;0.0467;2749;-330
2017-05-29 20:00:00;43,76;70,67;-26,91;40922;799;0.0195;800;-1;51820;2241;0.0432;3431;-1190
2017-05-29 21:00:00;42,02;73,82;-31,8;40922;26;0.0006;29;-3;51820;2554;0.0493;4191;-1637
2017-05-29 22:00:00;40,91;66,57;-25,66;40922;0;0;0;0;51820;3124;0.0603;5139;-2015
2017-05-29 23:00:00;32,69;50,13;-17,44;40922;0;0;0;0;51820;3629;0.07;5776;-2147
2017-05-30 00:00:00;35,81;42,06;-6,25;40942;0;0;0;0;51885;3808;0.0734;4608;-800
2017-05-30 01:00:00;32,55;37,67;-5,12;40942;0;0;0;0;51885;3813;0.0735;4760;-947
2017-05-30 02:00:00;30,93;35,66;-4,73;40942;0;0;0;0;51885;4281;0.0825;4924;-643
2017-05-30 03:00:00;28,77;35,55;-6,78;40942;0;0;0;0;51885;4900;0.0945;5124;-224
2017-05-30 04:00:00;28,41;31,6;-3,19;40942;2;0;1;1;51885;5332;0.1028;5434;-102
2017-05-30 05:00:00;31,3;35,48;-4,18;40942;200;0.0049;225;-25;51885;5602;0.108;5577;25
2017-05-30 06:00:00;38,05;42,88;-4,83;40942;1692;0.0414;1691;1;51885;5299;0.1021;5389;-90
2017-05-30 07:00:00;49,6;51,3;-1,7;40942;4845;0.1184;5176;-331;51885;4848;0.0934;5047;-199
2017-05-30 08:00:00;52,23;63,24;-11,01;40942;9075;0.2217;9869;-794;51885;4460;0.086;4838;-378
2017-05-30 09:00:00;50,08;55,4;-5,32;40942;13063;0.3191;14472;-1409;51885;5283;0.1018;5200;83
2017-05-30 10:00:00;45,02;51,11;-6,09;40942;16120;0.3938;18182;-2062;51885;7304;0.1408;6148;1156
2017-05-30 11:00:00;43,26;46,36;-3,1;40942;17939;0.4382;20643;-2704;51885;8836;0.1703;7573;1263
2017-05-30 12:00:00;35,0;44,68;-9,68;40942;18747;0.4579;21780;-3033;51885;9038;0.1742;9324;-286
2017-05-30 13:00:00;31,09;45,07;-13,98;40942;18778;0.4586;21609;-2831;51885;9898;0.1908;11130;-1232
2017-05-30 14:00:00;30,3;43,9;-13,6;40942;18054;0.441;20431;-2377;51885;10447;0.2014;12423;-1976
2017-05-30 15:00:00;30,95;43,35;-12,4;40942;16628;0.4061;18174;-1546;51885;9626;0.1856;12854;-3228
2017-05-30 16:00:00;31,57;44,61;-13,04;40942;13369;0.3266;14892;-1523;51885;10206;0.1967;12962;-2756
2017-05-30 17:00:00;35,1;46,14;-11,04;40942;9272;0.2265;10739;-1467;51885;9960;0.192;12736;-2776
2017-05-30 18:00:00;39,91;47,48;-7,57;40942;5377;0.1314;6362;-985;51885;9858;0.19;12130;-2272
2017-05-30 19:00:00;41,96;49,17;-7,21;40942;2510;0.0613;2905;-395;51885;10393;0.2003;11505;-1112
2017-05-30 20:00:00;40,06;46,92;-6,86;40942;734;0.0179;761;-27;51885;10643;0.2051;11029;-386
2017-05-30 21:00:00;39,21;43,83;-4,62;40942;26;0.0006;27;-1;51885;11956;0.2304;10945;1011
2017-05-30 22:00:00;34,44;38,7;-4,26;40942;0;0;0;0;51885;13043;0.2514;11283;1760
2017-05-30 23:00:00;28,44;32,17;-3,73;40942;0;0;0;0;51885;13415;0.2586;11785;1630
2017-05-31 00:00:00;28,68;29,59;-0,91;40973;0;0;0;0;52035;13837;0.2659;12261;1576
2017-05-31 01:00:00;28,38;27,82;0,56;40973;0;0;0;0;52035;14032;0.2696;12979;1053
2017-05-31 02:00:00;27,28;27,27;0,01;40973;0;0;0;0;52035;13490;0.2592;13403;87
2017-05-31 03:00:00;27,09;29,05;-1,96;40973;0;0;0;0;52035;13633;0.262;13518;115
2017-05-31 04:00:00;27,37;26,15;1,22;40973;2;0;1;1;52035;13547;0.2603;13506;41
2017-05-31 05:00:00;28,33;28,42;-0,09;40973;200;0.0049;216;-16;52035;13407;0.2576;13350;57
2017-05-31 06:00:00;32,09;34,11;-2,02;40973;1714;0.0418;1660;54;52035;13128;0.2523;13117;11
2017-05-31 07:00:00;39,07;40,71;-1,64;40973;4948;0.1208;4854;94;52035;12974;0.2493;13156;-182
2017-05-31 08:00:00;39,94;40,64;-0,7;40973;9637;0.2352;9286;351;52035;13243;0.2545;13578;-335
2017-05-31 09:00:00;35,13;34,8;0,33;40973;14646;0.3575;13725;921;52035;13482;0.2591;14177;-695
2017-05-31 10:00:00;30,08;30,71;-0,63;40973;18322;0.4472;17323;999;52035;14168;0.2723;14795;-627
2017-05-31 11:00:00;29,61;31,22;-1,61;40973;20462;0.4994;19853;609;52035;15326;0.2945;15281;45
2017-05-31 12:00:00;29,75;30,58;-0,83;40973;21690;0.5294;21375;315;52035;15516;0.2982;15630;-114
2017-05-31 13:00:00;28,7;30,85;-2,15;40973;21781;0.5316;21888;-107;52035;15596;0.2997;15863;-267
2017-05-31 14:00:00;28,37;31,97;-3,6;40973;21323;0.5204;21265;58;52035;15142;0.291;15984;-842
2017-05-31 15:00:00;29,98;32,04;-2,06;40973;20027;0.4888;19441;586;52035;14747;0.2834;15959;-1212
2017-05-31 16:00:00;29,9;32,51;-2,61;40973;17051;0.4162;16332;719;52035;14498;0.2786;15787;-1289
2017-05-31 17:00:00;35,29;33,45;1,84;40973;12938;0.3158;12056;882;52035;13958;0.2682;15281;-1323
2017-05-31 18:00:00;38,95;40,76;-1,81;40973;7966;0.1944;7139;827;52035;13506;0.2596;14300;-794
2017-05-31 19:00:00;42,11;41,36;0,75;40973;3560;0.0869;3099;461;52035;12251;0.2354;13032;-781
2017-05-31 20:00:00;41,45;40,81;0,64;40973;915;0.0223;824;91;52035;10423;0.2003;11723;-1300
2017-05-31 21:00:00;41,75;40,19;1,56;40973;37;0.0009;35;2;52035;9329;0.1793;10612;-1283
2017-05-31 22:00:00;40,51;40,23;0,28;40973;0;0;0;0;52035;8999;0.1729;9749;-750
2017-05-31 23:00:00;31,2;32,98;-1,78;40973;0;0;0;0;52035;8602;0.1653;9051;-449
2017-01-06 00:00:00;30,51;29,53;0,98;40987;0;0;0;0;52035;7902;0.1519;7489;413
2017-01-06 01:00:00;28,85;29,52;-0,67;40987;0;0;0;0;52035;7233;0.139;6988;245
2017-01-06 02:00:00;28,94;28,26;0,68;40987;0;0;0;0;52035;6642;0.1277;6609;33
2017-01-06 03:00:00;29,1;25,22;3,88;40987;0;0;0;0;52035;6174;0.1187;6270;-96
2017-01-06 04:00:00;28,8;25,44;3,36;40987;3;0.0001;1;2;52035;6160;0.1184;5969;191
2017-01-06 05:00:00;28,81;25,75;3,06;40987;238;0.0058;247;-9;52035;5821;0.1119;5599;222
2017-01-06 06:00:00;34,43;27,72;6,71;40987;2016;0.0492;1793;223;52035;4987;0.0958;5151;-164
2017-01-06 07:00:00;39,35;37,24;2,11;40987;5950;0.1452;5736;214;52035;4103;0.0788;4734;-631
2017-01-06 08:00:00;41,28;38,61;2,67;40987;11070;0.2701;11296;-226;52035;4424;0.085;4372;52
2017-01-06 09:00:00;38,03;34,95;3,08;40987;16493;0.4024;16710;-217;52035;4196;0.0806;4028;168
2017-01-06 10:00:00;33,24;31,5;1,74;40987;21298;0.5196;21106;192;52035;3880;0.0746;3721;159
2017-01-06 11:00:00;33,0;31,8;1,2;40987;24244;0.5915;24101;143;52035;3955;0.076;3487;468
2017-01-06 12:00:00;31,01;30,71;0,3;40987;25473;0.6215;25655;-182;52035;3783;0.0727;3327;456
2017-01-06 13:00:00;31,86;29,58;2,28;40987;25483;0.6217;25741;-258;52035;3577;0.0687;3238;339
2017-01-06 14:00:00;31,34;30,11;1,23;40987;24452;0.5965;24597;-145;52035;3412;0.0656;3212;200
2017-01-06 15:00:00;34,08;30,34;3,74;40987;22407;0.5467;22205;202;52035;3156;0.0606;3181;-25
2017-01-06 16:00:00;35,08;31,51;3,57;40987;18871;0.4604;18430;441;52035;2977;0.0572;3050;-73
2017-01-06 17:00:00;40,96;34,41;6,55;40987;13955;0.3405;13362;593;52035;2885;0.0554;2830;55
2017-01-06 18:00:00;44,92;38,61;6,31;40987;8321;0.203;7708;613;52035;2721;0.0523;2518;203
2017-01-06 19:00:00;50,0;42,2;7,8;40987;3680;0.0898;3187;493;52035;2404;0.0462;2247;157
2017-01-06 20:00:00;46,88;41,92;4,96;40987;990;0.0242;845;145;52035;1874;0.036;2177;-303
2017-01-06 21:00:00;44,91;40,51;4,4;40987;40;0.001;39;1;52035;2088;0.0402;2383;-295
2017-01-06 22:00:00;44,95;39,54;5,41;40987;0;0;0;0;52035;2450;0.0471;2741;-291
2017-01-06 23:00:00;39,94;33,99;5,95;40987;0;0;0;0;52035;2485;0.0478;2964;-479
2017-02-06 00:00:00;30,41;30,47;-0,06;40990;0;0;0;0;52050;2280;0.0438;2863;-583
2017-02-06 01:00:00;29,32;30,69;-1,37;40990;0;0;0;0;52050;2124;0.0409;2639;-515
2017-02-06 02:00:00;28,38;29,94;-1,56;40990;0;0;0;0;52050;1824;0.035;2457;-633
2017-02-06 03:00:00;28,04;26,95;1,09;40990;0;0;0;0;52050;1619;0.0311;2271;-652
2017-02-06 04:00:00;28,32;27,1;1,22;40990;4;0.0001;1;3;52050;1400;0.0269;2037;-637
2017-02-06 05:00:00;28,36;28,3;0,06;40990;242;0.0059;252;-10;52050;1320;0.0253;1799;-479
2017-02-06 06:00:00;35,33;33,14;2,19;40990;2049;0.05;1813;236;52050;1248;0.024;1552;-304
2017-02-06 07:00:00;40,24;38,61;1,63;40990;6091;0.1486;5744;347;52050;992;0.019;1269;-277
2017-02-06 08:00:00;41,5;39,45;2,05;40990;11312;0.276;11194;118;52050;568;0.0109;972;-404
2017-02-06 09:00:00;39,96;36,54;3,42;40990;16531;0.4033;16489;42;52050;424;0.0082;758;-334
2017-02-06 10:00:00;38,67;35,78;2,89;40990;20722;0.5055;20612;110;52050;410;0.0079;684;-274
2017-02-06 11:00:00;37,89;35,0;2,89;40990;23736;0.5791;23269;467;52050;484;0.0093;664;-180
2017-02-06 12:00:00;37,34;34,15;3,19;40990;24694;0.6024;24353;341;52050;651;0.0125;674;-23
2017-02-06 13:00:00;35,08;33,34;1,74;40990;23812;0.5809;23893;-81;52050;806;0.0155;687;119
2017-02-06 14:00:00;33,62;34,7;-1,08;40990;21991;0.5365;22401;-410;52050;886;0.017;713;173
2017-02-06 15:00:00;34,82;34,68;0,14;40990;19243;0.4694;19854;-611;52050;918;0.0176;758;160
2017-02-06 16:00:00;35,96;36,0;-0,04;40990;15822;0.386;16256;-434;52050;1055;0.0202;805;250
2017-02-06 17:00:00;39,7;38,46;1,24;40990;11719;0.2859;11724;-5;52050;1105;0.0212;909;196
2017-02-06 18:00:00;42,78;39,87;2,91;40990;7046;0.1719;6869;177;52050;1520;0.0292;1136;384
2017-02-06 19:00:00;44,9;39,05;5,85;40990;3169;0.0773;3018;151;52050;2020;0.0388;1522;498
2017-02-06 20:00:00;43,52;38,98;4,54;40990;784;0.0191;808;-24;52050;2308;0.0443;2179;129
2017-02-06 21:00:00;41,98;38,94;3,04;40990;26;0.0006;38;-12;52050;3615;0.0695;3077;538
2017-02-06 22:00:00;41,96;38,91;3,05;40990;0;0;0;0;52050;5198;0.0999;4028;1170
2017-02-06 23:00:00;36,64;33,71;2,93;40990;0;0;0;0;52050;6364;0.1222;4764;1600
2017-03-06 00:00:00;30,08;30,64;-0,56;40991;0;0;0;0;52056;6986;0.1342;5692;1294
2017-03-06 01:00:00;30,76;33,51;-2,75;40991;0;0;0;0;52056;7095;0.1363;5574;1521
2017-03-06 02:00:00;28,74;30,9;-2,16;40991;0;0;0;0;52056;7090;0.1362;5434;1656
2017-03-06 03:00:00;27,06;29,4;-2,34;40991;0;0;0;0;52056;7247;0.1392;5284;1963
2017-03-06 04:00:00;26,49;27,58;-1,09;40991;4;0.0001;1;3;52056;7175;0.1378;5132;2043
2017-03-06 05:00:00;25,0;24,93;0,07;40991;216;0.0053;251;-35;52056;6893;0.1324;4867;2026
2017-03-06 06:00:00;26,51;26,56;-0,05;40991;1656;0.0404;1796;-140;52056;6326;0.1215;4394;1932
2017-03-06 07:00:00;26,89;26,27;0,62;40991;4748;0.1158;5117;-369;52056;5006;0.0962;3705;1301
2017-03-06 08:00:00;30,79;33,07;-2,28;40991;8898;0.2171;9607;-709;52056;3893;0.0748;3054;839
2017-03-06 09:00:00;31,25;33,74;-2,49;40991;13212;0.3223;14059;-847;52056;3306;0.0635;2639;667
2017-03-06 10:00:00;28,31;31,64;-3,33;40991;17069;0.4164;17653;-584;52056;3032;0.0582;2479;553
2017-03-06 11:00:00;27,03;29,31;-2,28;40991;19557;0.4771;20061;-504;52056;3425;0.0658;2726;699
2017-03-06 12:00:00;26,49;28,49;-2,0;40991;20205;0.4929;21224;-1019;52056;3762;0.0723;3183;579
2017-03-06 13:00:00;26,93;29,03;-2,1;40991;19155;0.4673;20807;-1652;52056;3762;0.0723;3574;188
2017-03-06 14:00:00;26,71;28,1;-1,39;40991;17234;0.4204;19277;-2043;52056;3546;0.0681;3715;-169
2017-03-06 15:00:00;26,97;28,29;-1,32;40991;14757;0.36;16839;-2082;52056;3170;0.0609;3690;-520
2017-03-06 16:00:00;28,29;28,42;-0,13;40991;11736;0.2863;13342;-1606;52056;2951;0.0567;3660;-709
2017-03-06 17:00:00;33,94;34,59;-0,65;40991;8747;0.2134;9234;-487;52056;2770;0.0532;3690;-920
2017-03-06 18:00:00;37,3;38,23;-0,93;40991;5077;0.1238;5455;-378;52056;2436;0.0468;3929;-1493
2017-03-06 19:00:00;38,16;39,02;-0,86;40991;2277;0.0556;2515;-238;52056;2610;0.0502;4367;-1757
2017-03-06 20:00:00;36,96;39,48;-2,52;40991;522;0.0127;636;-114;52056;2928;0.0562;4852;-1924
2017-03-06 21:00:00;36,97;39,27;-2,3;40991;14;0.0003;27;-13;52056;2896;0.0556;5438;-2542
2017-03-06 22:00:00;38,57;41,4;-2,83;40991;0;0;0;0;52056;2848;0.0547;6138;-3290
2017-03-06 23:00:00;35,91;38,13;-2,22;40991;0;0;0;0;52056;3332;0.064;6680;-3348
2017-04-06 00:00:00;29,93;31,3;-1,37;40991;0;0;0;0;52062;3406;0.0654;4487;-1081
2017-04-06 01:00:00;26,93;27,35;-0,42;40991;0;0;0;0;52062;3941;0.0757;4826;-885
2017-04-06 02:00:00;23,24;24,44;-1,2;40991;0;0;0;0;52062;4430;0.0851;5222;-792
2017-04-06 03:00:00;22,54;24,12;-1,58;40991;0;0;0;0;52062;5191;0.0997;5594;-403
2017-04-06 04:00:00;21,58;18,78;2,8;40991;3;0;1;2;52062;5827;0.112;6046;-219
2017-04-06 05:00:00;19,5;13,63;5,87;40991;89;0.0021;111;-22;52062;6382;0.1226;6522;-140
2017-04-06 06:00:00;19,85;12,88;6,97;40991;660;0.0161;763;-103;52062;6912;0.1328;6903;9
2017-04-06 07:00:00;20,33;16,0;4,33;40991;1698;0.0414;2095;-397;52062;7252;0.1393;7329;-77
2017-04-06 08:00:00;22,55;24,59;-2,04;40991;3200;0.0781;3859;-659;52062;7843;0.1506;7749;94
2017-04-06 09:00:00;23,79;26,62;-2,83;40991;5435;0.1326;5935;-500;52062;8947;0.1718;8254;693
2017-04-06 10:00:00;22,99;24,9;-1,91;40991;8344;0.2036;8460;-116;52062;10570;0.203;8936;1634
2017-04-06 11:00:00;23,06;20,76;2,3;40991;10774;0.2628;11113;-339;52062;12006;0.2306;9751;2255
2017-04-06 12:00:00;19,34;12,86;6,48;40991;12496;0.3048;13373;-877;52062;13640;0.262;10760;2880
2017-04-06 13:00:00;15,08;7,31;7,77;40991;13703;0.3343;14691;-988;52062;15684;0.3012;11847;3837
2017-04-06 14:00:00;9,98;-10,14;20,12;40991;14377;0.3507;15162;-785;52062;16376;0.3146;12660;3716
2017-04-06 15:00:00;10,41;-7,58;17,99;40991;14605;0.3563;14795;-190;52062;16922;0.325;12836;4086
2017-04-06 16:00:00;3,43;-13,35;16,78;40991;13439;0.3279;13141;298;52062;16150;0.3102;12506;3644
2017-04-06 17:00:00;10,23;-0,55;10,78;40991;10976;0.2678;10343;633;52062;15144;0.2909;11612;3532
2017-04-06 18:00:00;25,76;14,34;11,42;40991;7184;0.1753;6617;567;52062;13655;0.2623;10081;3574
2017-04-06 19:00:00;31,06;24,82;6,24;40991;3389;0.0827;3109;280;52062;11138;0.2139;8355;2783
2017-04-06 20:00:00;34,91;26,66;8,25;40991;900;0.022;892;8;52062;8508;0.1634;7004;1504
2017-04-06 21:00:00;34,99;30,45;4,54;40991;49;0.0012;45;4;52062;6900;0.1326;6144;756
2017-04-06 22:00:00;39,91;33,37;6,54;40991;0;0;0;0;52062;6391;0.1228;5653;738
2017-04-06 23:00:00;34,9;26,24;8,66;40991;0;0;0;0;52062;5964;0.1146;5247;717
2017-05-06 00:00:00;28,92;25,96;2,96;40991;0;0;0;0;52074;5167;0.0992;6040;-873
2017-05-06 01:00:00;24,72;18,47;6,25;40991;0;0;0;0;52074;4532;0.087;5482;-950
2017-05-06 02:00:00;23,09;18,48;4,61;40991;0;0;0;0;52074;4525;0.0869;4996;-471
2017-05-06 03:00:00;22,22;13,73;8,49;40991;0;0;0;0;52074;4396;0.0844;4603;-207
2017-05-06 04:00:00;22,19;13,09;9,1;40991;4;0.0001;2;2;52074;4243;0.0815;4316;-73
2017-05-06 05:00:00;23,09;15,3;7,79;40991;267;0.0065;263;4;52074;4279;0.0822;4142;137
2017-05-06 06:00:00;24,1;14,69;9,41;40991;1924;0.0469;1794;130;52074;4482;0.0861;4062;420
2017-05-06 07:00:00;24,62;15,82;8,8;40991;4945;0.1206;4969;-24;52074;4198;0.0806;4010;188
2017-05-06 08:00:00;27,02;21,45;5,57;40991;8804;0.2148;9092;-288;52074;4181;0.0803;4195;-14
2017-05-06 09:00:00;27,12;26,75;0,37;40991;12582;0.3069;13112;-530;52074;4702;0.0903;4732;-30
2017-05-06 10:00:00;24,35;23,72;0,63;40991;15722;0.3836;16100;-378;52074;5035;0.0967;5389;-354
2017-05-06 11:00:00;25,31;22,45;2,86;40991;17649;0.4306;17895;-246;52074;4948;0.095;5833;-885
2017-05-06 12:00:00;24,52;23,1;1,42;40991;18634;0.4546;18544;90;52074;4919;0.0945;5834;-915
2017-05-06 13:00:00;24,11;17,92;6,19;40991;18448;0.45;18075;373;52074;4760;0.0914;5528;-768
2017-05-06 14:00:00;23,08;16,64;6,44;40991;17370;0.4238;16690;680;52074;4524;0.0869;5020;-496
2017-05-06 15:00:00;23,84;14,5;9,34;40991;15252;0.3721;14541;711;52074;3718;0.0714;4326;-608
2017-05-06 16:00:00;26,86;17,63;9,23;40991;12212;0.2979;11986;226;52074;3195;0.0613;3556;-361
2017-05-06 17:00:00;30,02;24,13;5,89;40991;9114;0.2223;8970;144;52074;3166;0.0608;2776;390
2017-05-06 18:00:00;35,94;28,14;7,8;40991;5917;0.1443;5673;244;52074;2958;0.0568;2173;785
2017-05-06 19:00:00;39,01;31,62;7,39;40991;2978;0.0727;2763;215;52074;3009;0.0578;1977;1032
2017-05-06 20:00:00;39,65;28,44;11,21;40991;876;0.0214;802;74;52074;3138;0.0603;2430;708
2017-05-06 21:00:00;38,61;29,64;8,97;40991;45;0.0011;41;4;52074;4082;0.0784;3716;366
2017-05-06 22:00:00;38,42;33,4;5,02;40991;0;0;0;0;52074;5912;0.1135;5456;456
2017-05-06 23:00:00;30,14;27,24;2,9;40991;0;0;0;0;52074;8584;0.1648;7220;1364
2017-06-06 00:00:00;24,22;20,96;3,26;40994;0;0;0;0;52077;11356;0.2181;9906;1450
2017-06-06 01:00:00;19,3;12,64;6,66;40994;0;0;0;0;52077;13250;0.2544;11054;2196
2017-06-06 02:00:00;14,49;6,68;7,81;40994;0;0;0;0;52077;14337;0.2753;11790;2547
2017-06-06 03:00:00;10,54;5,64;4,9;40994;0;0;0;0;52077;13954;0.268;12209;1745
2017-06-06 04:00:00;10,22;7,0;3,22;40994;4;0.0001;2;2;52077;13730;0.2636;12518;1212
2017-06-06 05:00:00;13,38;8,35;5,03;40994;256;0.0062;258;-2;52077;13586;0.2609;12619;967
2017-06-06 06:00:00;29,22;24,58;4,64;40994;1804;0.044;1744;60;52077;13183;0.2532;12377;806
2017-06-06 07:00:00;30,36;33,37;-3,01;40994;4676;0.114;4631;45;52077;12270;0.2356;11985;285
2017-06-06 08:00:00;36,08;35,88;0,2;40994;8062;0.1966;8173;-111;52077;12058;0.2315;12140;-82
2017-06-06 09:00:00;30,11;32,71;-2,6;40994;11124;0.2714;11509;-385;52077;13411;0.2575;13215;196
2017-06-06 10:00:00;28,09;32,59;-4,5;40994;12975;0.3165;13871;-896;52077;16114;0.3094;14772;1342
2017-06-06 11:00:00;27,27;31,38;-4,11;40994;13061;0.3186;15049;-1988;52077;18574;0.3566;16673;1901
2017-06-06 12:00:00;25,95;27,78;-1,83;40994;13500;0.3293;15320;-1820;52077;21135;0.4059;18667;2468
2017-06-06 13:00:00;23,45;26,11;-2,66;40994;13507;0.3295;14574;-1067;52077;22902;0.4398;20447;2455
2017-06-06 14:00:00;22,67;21,23;1,44;40994;12510;0.3052;13359;-849;52077;24410;0.4688;21558;2852
2017-06-06 15:00:00;19,94;20,58;-0,64;40994;10514;0.2565;11724;-1210;52077;24778;0.4758;22216;2562
2017-06-06 16:00:00;18,62;21,31;-2,69;40994;8634;0.2106;9782;-1148;52077;24610;0.4726;22814;1796
2017-06-06 17:00:00;20,04;23,18;-3,14;40994;7063;0.1723;7500;-437;52077;23161;0.4448;23103;58
2017-06-06 18:00:00;22,72;25,09;-2,37;40994;4924;0.1201;4941;-17;52077;21720;0.4171;23023;-1303
2017-06-06 19:00:00;23,08;27,65;-4,57;40994;2702;0.0659;2546;156;52077;21850;0.4196;22904;-1054
2017-06-06 20:00:00;21,92;26,05;-4,13;40994;843;0.0206;735;108;52077;21142;0.406;22516;-1374
2017-06-06 21:00:00;20,44;26,29;-5,85;40994;50;0.0012;36;14;52077;20331;0.3904;22320;-1989
2017-06-06 22:00:00;20,23;27,1;-6,87;40994;0;0;0;0;52077;19965;0.3834;22662;-2697
2017-06-06 23:00:00;4,39;19,6;-15,21;40994;0;0;0;0;52077;20331;0.3904;23193;-2862
2017-07-06 00:00:00;10,67;15,62;-4,95;41008;0;0;0;0;52077;22098;0.4243;22981;-883
2017-07-06 01:00:00;8,8;10,9;-2,1;41008;0;0;0;0;52077;22963;0.4409;23814;-851
2017-07-06 02:00:00;6,82;2,53;4,29;41008;0;0;0;0;52077;24256;0.4658;24628;-372
2017-07-06 03:00:00;2,1;-4,19;6,29;41008;0;0;0;0;52077;24658;0.4735;25199;-541
2017-07-06 04:00:00;1,74;-6,32;8,06;41008;4;0.0001;2;2;52077;25194;0.4838;25924;-730
2017-07-06 05:00:00;5,26;1,57;3,69;41008;243;0.0059;272;-29;52077;25705;0.4936;26780;-1075
2017-07-06 06:00:00;12,33;11,09;1,24;41008;1831;0.0446;1808;23;52077;27133;0.521;28004;-871
2017-07-06 07:00:00;23,07;22,16;0,91;41008;4998;0.1219;5063;-65;52077;28574;0.5487;29562;-988
2017-07-06 08:00:00;18,06;15,31;2,75;41008;8855;0.2159;9098;-243;52077;30485;0.5854;31082;-597
2017-07-06 09:00:00;10,05;2,22;7,83;41008;12208;0.2977;12812;-604;52077;31242;0.5999;32070;-828
2017-07-06 10:00:00;9,66;0,64;9,02;41008;14320;0.3492;15701;-1381;52077;31614;0.6071;32727;-1113
2017-07-06 11:00:00;10,3;9,24;1,06;41008;16320;0.398;17587;-1267;52077;32705;0.628;33225;-520
2017-07-06 12:00:00;9,65;5,92;3,73;41008;17336;0.4227;18551;-1215;52077;32887;0.6315;33519;-632
2017-07-06 13:00:00;10,19;6,09;4,1;41008;18995;0.4632;18605;390;52077;32947;0.6326;33672;-725
2017-07-06 14:00:00;8,97;3,34;5,63;41008;18218;0.4442;17992;226;52077;33108;0.6358;33538;-430
2017-07-06 15:00:00;9,71;-1,11;10,82;41008;16315;0.3978;16613;-298;52077;32900;0.6318;33090;-190
2017-07-06 16:00:00;10,17;2,37;7,8;41008;14230;0.347;14159;71;52077;32096;0.6163;32435;-339
2017-07-06 17:00:00;11,79;6,86;4,93;41008;10689;0.2607;10764;-75;52077;31268;0.6004;31316;-48
2017-07-06 18:00:00;20,37;18,39;1,98;41008;6770;0.1651;6736;34;52077;29584;0.5681;29536;48
2017-07-06 19:00:00;25,78;25,18;0,6;41008;3066;0.0748;3161;-95;52077;26929;0.5171;27298;-369
2017-07-06 20:00:00;24,08;27,09;-3,01;41008;858;0.0209;897;-39;52077;24219;0.4651;25158;-939
2017-07-06 21:00:00;25,56;30,58;-5,02;41008;37;0.0009;39;-2;52077;23025;0.4422;23623;-598
2017-07-06 22:00:00;25,45;30,88;-5,43;41008;0;0;0;0;52077;22380;0.4298;22719;-339
2017-07-06 23:00:00;18,93;23,4;-4,47;41008;0;0;0;0;52077;22477;0.4316;22186;291
2017-08-06 00:00:00;14,09;17,28;-3,19;41012;0;0;0;0;52080;22059;0.4236;21753;306
2017-08-06 01:00:00;10,2;11,01;-0,81;41012;0;0;0;0;52080;21774;0.4181;21373;401
2017-08-06 02:00:00;9,91;11,17;-1,26;41012;0;0;0;0;52080;20924;0.4017;20749;175
2017-08-06 03:00:00;9,86;11,83;-1,97;41012;0;0;0;0;52080;19428;0.373;19780;-352
2017-08-06 04:00:00;9,92;11,42;-1,5;41012;2;0;2;0;52080;17621;0.3383;18560;-939
2017-08-06 05:00:00;19,06;19,37;-0,31;41012;258;0.0063;280;-22;52080;15918;0.3056;16978;-1060
2017-08-06 06:00:00;32,77;32,49;0,28;41012;1894;0.0462;1824;70;52080;13831;0.2656;15157;-1326
2017-08-06 07:00:00;35,51;34,12;1,39;41012;5294;0.1291;4948;346;52080;12259;0.2354;13469;-1210
2017-08-06 08:00:00;35,51;35,4;0,11;41012;9809;0.2392;8990;819;52080;11280;0.2166;12391;-1111
2017-08-06 09:00:00;33,65;32,26;1,39;41012;13988;0.3411;12875;1113;52080;11148;0.214;12036;-888
2017-08-06 10:00:00;32,25;29,87;2,38;41012;16811;0.4099;16168;643;52080;11714;0.2249;12172;-458
2017-08-06 11:00:00;32,45;30,53;1,92;41012;19268;0.4698;18617;651;52080;12695;0.2438;12289;406
2017-08-06 12:00:00;31,13;27,59;3,54;41012;20629;0.503;19950;679;52080;13462;0.2585;12195;1267
2017-08-06 13:00:00;30,0;27,67;2,33;41012;21157;0.5159;20117;1040;52080;13402;0.2573;11968;1434
2017-08-06 14:00:00;29,88;28,59;1,29;41012;21021;0.5126;19371;1650;52080;12744;0.2447;11454;1290
2017-08-06 15:00:00;30,02;27,99;2,03;41012;19489;0.4752;17664;1825;52080;11436;0.2196;10610;826
2017-08-06 16:00:00;31,65;30,13;1,52;41012;16886;0.4118;15016;1870;52080;10330;0.1984;9608;722
2017-08-06 17:00:00;34,79;32,53;2,26;41012;12780;0.3117;11324;1456;52080;8734;0.1677;8303;431
2017-08-06 18:00:00;38,01;36,69;1,32;41012;7878;0.1921;6926;952;52080;7272;0.1396;6789;483
2017-08-06 19:00:00;43,91;43,05;0,86;41012;3642;0.0888;3205;437;52080;6272;0.1204;5621;651
2017-08-06 20:00:00;41,87;43,2;-1,33;41012;988;0.0241;923;65;52080;6321;0.1214;5446;875
2017-08-06 21:00:00;37,6;39,99;-2,39;41012;46;0.0011;45;1;52080;7271;0.1396;6661;610
2017-08-06 22:00:00;36,13;40,0;-3,87;41012;0;0;0;0;52080;8770;0.1684;8579;191
2017-08-06 23:00:00;30,75;35,64;-4,89;41012;0;0;0;0;52080;9666;0.1856;10185;-519
2017-09-06 00:00:00;28,18;31,58;-3,4;41027;0;0;0;0;52087;10180;0.1954;12078;-1898
2017-09-06 01:00:00;27,92;31,08;-3,16;41027;0;0;0;0;52087;10074;0.1934;12303;-2229
2017-09-06 02:00:00;25,88;32,07;-6,19;41027;0;0;0;0;52087;10305;0.1978;12305;-2000
2017-09-06 03:00:00;24,63;30,19;-5,56;41027;0;0;0;0;52087;10820;0.2077;12051;-1231
2017-09-06 04:00:00;24,9;26,79;-1,89;41027;2;0;2;0;52087;11332;0.2176;11640;-308
2017-09-06 05:00:00;28,21;27,2;1,01;41027;306;0.0074;296;10;52087;10791;0.2072;10957;-166
2017-09-06 06:00:00;33,29;32,4;0,89;41027;2174;0.053;1874;300;52087;8964;0.1721;9865;-901
2017-09-06 07:00:00;39,38;43,17;-3,79;41027;6058;0.1476;5282;776;52087;6743;0.1295;8511;-1768
2017-09-06 08:00:00;42,59;45,79;-3,2;41027;10985;0.2678;9707;1278;52087;4554;0.0874;7265;-2711
2017-09-06 09:00:00;40,59;43,32;-2,73;41027;15433;0.3762;13641;1792;52087;4313;0.0828;6666;-2353
2017-09-06 10:00:00;40,22;43,03;-2,81;41027;18019;0.4392;16234;1785;52087;5305;0.1018;6820;-1515
2017-09-06 11:00:00;40,81;40,85;-0,04;41027;18779;0.4577;17535;1244;52087;7724;0.1483;7478;246
2017-09-06 12:00:00;36,38;37,56;-1,18;41027;18570;0.4526;17831;739;52087;10170;0.1952;8670;1500
2017-09-06 13:00:00;33,83;36,26;-2,43;41027;17380;0.4236;17122;258;52087;12814;0.246;10048;2766
2017-09-06 14:00:00;31,05;34,35;-3,3;41027;15395;0.3752;15667;-272;52087;14140;0.2715;11038;3102
2017-09-06 15:00:00;29,09;32,08;-2,99;41027;13235;0.3226;13655;-420;52087;14368;0.2759;11465;2903
2017-09-06 16:00:00;29,69;30,63;-0,94;41027;10736;0.2617;11206;-470;52087;14629;0.2808;11733;2896
2017-09-06 17:00:00;31,44;31,34;0,1;41027;8094;0.1973;8493;-399;52087;14936;0.2868;11509;3427
2017-09-06 18:00:00;33,2;34,37;-1,17;41027;5508;0.1342;5587;-79;52087;14014;0.269;10825;3189
2017-09-06 19:00:00;35,07;35,07;0,0;41027;2835;0.0691;2817;18;52087;12663;0.2431;9913;2750
2017-09-06 20:00:00;34,97;35,64;-0,67;41027;838;0.0204;878;-40;52087;11317;0.2173;8852;2465
2017-09-06 21:00:00;35,9;35,89;0,01;41027;59;0.0014;54;5;52087;10114;0.1942;7846;2268
2017-09-06 22:00:00;37,86;36,45;1,41;41027;0;0;0;0;52087;7986;0.1533;7244;742
2017-09-06 23:00:00;36,01;36,69;-0,68;41027;0;0;0;0;52087;6692;0.1285;7159;-467
2017-10-06 00:00:00;34,65;34,71;-0,06;41029;0;0;0;0;52096;5954;0.1143;6299;-345
2017-10-06 01:00:00;31,92;34,05;-2,13;41029;0;0;0;0;52096;5471;0.105;6181;-710
2017-10-06 02:00:00;28,9;33,6;-4,7;41029;0;0;0;0;52096;5093;0.0978;6072;-979
2017-10-06 03:00:00;27,68;33,26;-5,58;41029;0;0;0;0;52096;5105;0.098;5867;-762
2017-10-06 04:00:00;27,06;30,84;-3,78;41029;2;0;2;0;52096;4854;0.0932;5593;-739
2017-10-06 05:00:00;27,05;29,22;-2,17;41029;281;0.0068;316;-35;52096;4551;0.0874;5133;-582
2017-10-06 06:00:00;27,79;30,02;-2,23;41029;2033;0.0495;1988;45;52096;3911;0.075;4494;-583
2017-10-06 07:00:00;29,71;31,15;-1,44;41029;5952;0.1451;5633;319;52096;2523;0.0484;3817;-1294
2017-10-06 08:00:00;30,9;35,78;-4,88;41029;11524;0.2809;10720;804;52096;2294;0.044;3431;-1137
2017-10-06 09:00:00;31,94;31,43;0,51;41029;17047;0.4155;15820;1227;52096;2989;0.0574;3645;-656
2017-10-06 10:00:00;29,9;29,08;0,82;41029;21012;0.5121;19829;1183;52096;3857;0.074;4121;-264
2017-10-06 11:00:00;29,94;28,18;1,76;41029;22560;0.5498;22451;109;52096;4312;0.0828;4576;-264
2017-10-06 12:00:00;28,35;29,7;-1,35;41029;23240;0.5664;23653;-413;52096;4734;0.0908;4805;-71
2017-10-06 13:00:00;25,86;26,53;-0,67;41029;23660;0.5767;23536;124;52096;5013;0.0962;4832;181
2017-10-06 14:00:00;25,01;25,48;-0,47;41029;23038;0.5615;22226;812;52096;4692;0.09;4691;1
2017-10-06 15:00:00;25,03;23,13;1,9;41029;20927;0.51;19737;1190;52096;4100;0.0787;4318;-218
2017-10-06 16:00:00;26,6;24,5;2,1;41029;17442;0.4251;16277;1165;52096;3156;0.0606;3783;-627
2017-10-06 17:00:00;29,1;29,03;0,07;41029;12986;0.3165;11991;995;52096;2397;0.046;3108;-711
2017-10-06 18:00:00;35,41;35,39;0,02;41029;7946;0.1937;7302;644;52096;1919;0.0368;2371;-452
2017-10-06 19:00:00;38,24;33,44;4,8;41029;3671;0.0894;3424;247;52096;1697;0.0325;1756;-59
2017-10-06 20:00:00;38,78;32,53;6,25;41029;1048;0.0255;1075;-27;52096;1322;0.0254;1485;-163
2017-10-06 21:00:00;38,28;33,74;4,54;41029;57;0.0014;69;-12;52096;1354;0.026;1645;-291
2017-10-06 22:00:00;39,68;35,62;4,06;41029;0;0;0;0;52096;2126;0.0408;2186;-60
2017-10-06 23:00:00;36,94;33,74;3,2;41029;0;0;0;0;52096;3781;0.0726;3074;707
2017-11-06 00:00:00;29,1;33,85;-4,75;41029;0;0;0;0;52096;5902;0.1133;5387;515
2017-11-06 01:00:00;25,12;26,7;-1,58;41029;0;0;0;0;52096;7792;0.1496;6910;882
2017-11-06 02:00:00;21,78;20,69;1,09;41029;0;0;0;0;52096;9248;0.1775;8153;1095
2017-11-06 03:00:00;18,0;12,68;5,32;41029;0;0;0;0;52096;10054;0.193;8881;1173
2017-11-06 04:00:00;15,39;12,36;3,03;41029;2;0;2;0;52096;10717;0.2057;9315;1402
2017-11-06 05:00:00;12,6;8,11;4,49;41029;285;0.007;297;-12;52096;10731;0.206;9315;1416
2017-11-06 06:00:00;12,84;7,84;5,0;41029;2088;0.0509;1963;125;52096;10320;0.1981;8684;1636
2017-11-06 07:00:00;16,49;12,85;3,64;41029;6246;0.1522;5977;269;52096;8292;0.1592;7728;564
2017-11-06 08:00:00;18,0;16,02;1,98;41029;11938;0.291;11555;383;52096;6089;0.1169;6646;-557
2017-11-06 09:00:00;18,75;22,84;-4,09;41029;17430;0.4248;16876;554;52096;5684;0.1091;6004;-320
2017-11-06 10:00:00;18,95;20,45;-1,5;41029;21924;0.5344;21052;872;52096;6001;0.1152;5733;268
2017-11-06 11:00:00;20,58;21,71;-1,13;41029;24786;0.6041;24036;750;52096;6503;0.1248;5680;823
2017-11-06 12:00:00;10,19;11,6;-1,41;41029;26265;0.6402;25558;707;52096;6648;0.1276;5849;799
2017-11-06 13:00:00;8,35;9,77;-1,42;41029;26220;0.6391;25584;636;52096;6808;0.1307;6154;654
2017-11-06 14:00:00;10,34;7,48;2,86;41029;24785;0.6041;24287;498;52096;7026;0.1348;6474;552
2017-11-06 15:00:00;10,18;7,59;2,59;41029;21530;0.5248;21657;-127;52096;7177;0.1378;6726;451
2017-11-06 16:00:00;18,87;15,01;3,86;41029;16915;0.4122;17615;-700;52096;6876;0.132;6896;-20
2017-11-06 17:00:00;23,58;23,78;-0,2;41029;11658;0.2842;12542;-884;52096;6910;0.1326;6873;37
2017-11-06 18:00:00;30,36;32,88;-2,52;41029;6462;0.1575;7297;-835;52096;6872;0.1319;6790;82
2017-11-06 19:00:00;33,13;33,99;-0,86;41029;2634;0.0642;3237;-603;52096;7085;0.136;7123;-38
2017-11-06 20:00:00;33,62;32,19;1,43;41029;750;0.0183;973;-223;52096;7987;0.1533;8031;-44
2017-11-06 21:00:00;33,4;33,54;-0,14;41029;44;0.001;67;-23;52096;7911;0.1518;9425;-1514
2017-11-06 22:00:00;33,7;36,13;-2,43;41029;0;0;0;0;52096;8661;0.1663;11045;-2384
2017-11-06 23:00:00;28,61;39,65;-11,04;41029;0;0;0;0;52096;10344;0.1986;11917;-1573
2017-12-06 00:00:00;25,02;27,27;-2,25;41041;0;0;0;0;52096;10695;0.2053;12158;-1463
2017-12-06 01:00:00;20,66;24,59;-3,93;41041;0;0;0;0;52096;11630;0.2232;12825;-1195
2017-12-06 02:00:00;18,15;23,76;-5,61;41041;0;0;0;0;52096;13472;0.2586;13578;-106
2017-12-06 03:00:00;14,6;16,81;-2,21;41041;0;0;0;0;52096;15066;0.2892;14067;999
2017-12-06 04:00:00;15,66;12,8;2,86;41041;1;0;2;-1;52096;15974;0.3066;14585;1389
2017-12-06 05:00:00;20,37;15,81;4,56;41041;209;0.0051;261;-52;52096;16190;0.3107;15071;1119
2017-12-06 06:00:00;30,08;25,73;4,35;41041;1643;0.04;1704;-61;52096;16041;0.3079;15364;677
2017-12-06 07:00:00;36,04;33,5;2,54;41041;4470;0.1089;4631;-161;52096;16328;0.3134;15635;693
2017-12-06 08:00:00;36,45;36,06;0,39;41041;8145;0.1984;8501;-356;52096;18290;0.3511;16361;1929
2017-12-06 09:00:00;34,49;29,86;4,63;41041;11920;0.2904;12455;-535;52096;19828;0.3806;18332;1496
2017-12-06 10:00:00;28,81;26,02;2,79;41041;14973;0.3648;15712;-739;52096;22125;0.4247;20599;1526
2017-12-06 11:00:00;26,83;25,87;0,96;41041;16427;0.4003;18023;-1596;52096;24630;0.4728;22455;2175
2017-12-06 12:00:00;18,51;9,94;8,57;41041;17926;0.4368;19477;-1551;52096;26778;0.514;24185;2593
2017-12-06 13:00:00;11,31;1,49;9,82;41041;19070;0.4646;20123;-1053;52096;27498;0.5278;25694;1804
2017-12-06 14:00:00;10,92;-0,07;10,99;41041;19600;0.4776;19763;-163;52096;27599;0.5298;26752;847
2017-12-06 15:00:00;11,72;4,13;7,59;41041;18370;0.4476;18111;259;52096;27614;0.53;27213;401
2017-12-06 16:00:00;10,01;6,8;3,21;41041;15562;0.3792;15186;376;52096;27156;0.5213;27293;-137
2017-12-06 17:00:00;19,77;20,47;-0,7;41041;11816;0.2879;11319;497;52096;26699;0.5125;26694;5
2017-12-06 18:00:00;28,98;30,55;-1,57;41041;7258;0.1768;6909;349;52096;25817;0.4956;25258;559
2017-12-06 19:00:00;35,91;35,42;0,49;41041;3313;0.0807;3192;121;52096;24368;0.4678;23424;944
2017-12-06 20:00:00;35,91;34,77;1,14;41041;979;0.0238;1005;-26;52096;22114;0.4245;21698;416
2017-12-06 21:00:00;35,43;34,79;0,64;41041;47;0.0012;70;-23;52096;20625;0.3959;20299;326
2017-12-06 22:00:00;36,99;35,76;1,23;41041;0;0;0;0;52096;19299;0.3704;19547;-248
2017-12-06 23:00:00;29,97;32,95;-2,98;41041;0;0;0;0;52096;19078;0.3662;19051;27
2017-06-13 00:00:00;28,06;32,75;-4,69;41047;0;0;0;0;52108;18334;0.3518;18706;-372
2017-06-13 01:00:00;27,0;33,64;-6,64;41047;0;0;0;0;52108;17841;0.3424;18454;-613
2017-06-13 02:00:00;24,63;32,13;-7,5;41047;0;0;0;0;52108;17276;0.3315;18114;-838
2017-06-13 03:00:00;23,47;31,17;-7,7;41047;0;0;0;0;52108;16690;0.3203;17483;-793
2017-06-13 04:00:00;23,95;30,98;-7,03;41047;2;0;2;0;52108;15966;0.3064;16889;-923
2017-06-13 05:00:00;25,5;32,48;-6,98;41047;268;0.0066;309;-41;52108;15396;0.2954;16327;-931
2017-06-13 06:00:00;33,12;35,94;-2,82;41047;1901;0.0463;1889;12;52108;15077;0.2893;16067;-990
2017-06-13 07:00:00;39,47;42,45;-2,98;41047;5334;0.13;5375;-41;52108;14355;0.2755;15729;-1374
2017-06-13 08:00:00;40,0;40,85;-0,85;41047;9770;0.238;10170;-400;52108;14478;0.2778;15603;-1125
2017-06-13 09:00:00;33,9;34,05;-0,15;41047;13936;0.3395;14786;-850;52108;15165;0.291;16342;-1177
2017-06-13 10:00:00;29,92;32,88;-2,96;41047;16161;0.3937;18109;-1948;52108;15128;0.2903;16686;-1558
2017-06-13 11:00:00;29,65;35,07;-5,42;41047;17356;0.4228;20022;-2666;52108;14984;0.2876;16780;-1796
2017-06-13 12:00:00;28,07;35,67;-7,6;41047;18284;0.4454;20816;-2532;52108;15205;0.2918;16617;-1412
2017-06-13 13:00:00;28,43;34,55;-6,12;41047;18992;0.4627;20813;-1821;52108;14768;0.2834;16321;-1553
2017-06-13 14:00:00;28,46;34,78;-6,32;41047;18698;0.4555;19916;-1218;52108;14339;0.2752;15967;-1628
2017-06-13 15:00:00;29,17;35,24;-6,07;41047;17302;0.4215;18113;-811;52108;14208;0.2726;15487;-1279
2017-06-13 16:00:00;33,98;37,38;-3,4;41047;15276;0.3722;15273;3;52108;13936;0.2674;14773;-837
2017-06-13 17:00:00;36,9;40,07;-3,17;41047;11693;0.2848;11454;239;52108;13174;0.2528;13671;-497
2017-06-13 18:00:00;38,52;42,19;-3,67;41047;7356;0.1792;7094;262;52108;12639;0.2426;12143;496
2017-06-13 19:00:00;42,92;45,73;-2,81;41047;3655;0.089;3354;301;52108;10856;0.2083;10330;526
2017-06-13 20:00:00;41,95;44,77;-2,82;41047;1136;0.0276;1084;52;52108;9013;0.173;8728;285
2017-06-13 21:00:00;40,96;44,03;-3,07;41047;81;0.002;81;0;52108;7550;0.1449;7660;-110
2017-06-13 22:00:00;41,12;43,4;-2,28;41047;0;0;0;0;52108;7018;0.1347;6964;54
2017-06-13 23:00:00;36,9;38,79;-1,89;41047;0;0;0;0;52108;6822;0.1309;6359;463
2017-06-14 00:00:00;32,21;35,13;-2,92;41052;0;0;0;0;52111;6482;0.1244;5628;854
2017-06-14 01:00:00;29,18;29,23;-0,05;41052;0;0;0;0;52111;5990;0.115;5340;650
2017-06-14 02:00:00;28,95;26,35;2,6;41052;0;0;0;0;52111;5486;0.1052;5105;381
2017-06-14 03:00:00;27,86;26,16;1,7;41052;0;0;0;0;52111;4763;0.0914;4858;-95
2017-06-14 04:00:00;27,5;26,5;1,0;41052;3;0.0001;2;1;52111;4267;0.0819;4611;-344
2017-06-14 05:00:00;28,98;26,42;2,56;41052;319;0.0078;338;-19;52111;4162;0.0798;4280;-118
2017-06-14 06:00:00;34,4;31,86;2,54;41052;2206;0.0538;2010;196;52111;3927;0.0754;3846;81
2017-06-14 07:00:00;41,26;39,27;1,99;41052;6304;0.1536;5714;590;52111;3171;0.0608;3329;-158
2017-06-14 08:00:00;43,76;39,67;4,09;41052;11664;0.2841;10893;771;52111;3118;0.0598;2997;121
2017-06-14 09:00:00;41,63;38,9;2,73;41052;16545;0.403;15875;670;52111;2831;0.0543;2786;45
2017-06-14 10:00:00;41,12;35,59;5,53;41052;20564;0.5009;19773;791;52111;2319;0.0445;2563;-244
2017-06-14 11:00:00;39,93;35,74;4,19;41052;23560;0.5739;22350;1210;52111;2057;0.0395;2438;-381
2017-06-14 12:00:00;36,94;34,03;2,91;41052;25594;0.6235;23643;1951;52111;1955;0.0375;2396;-441
2017-06-14 13:00:00;35,99;32,4;3,59;41052;26237;0.6391;23745;2492;52111;2050;0.0393;2401;-351
2017-06-14 14:00:00;35,92;31,55;4,37;41052;25464;0.6203;22712;2752;52111;2020;0.0388;2396;-376
2017-06-14 15:00:00;35,02;31,92;3,1;41052;23370;0.5693;20517;2853;52111;2012;0.0386;2371;-359
2017-06-14 16:00:00;35,85;34,95;0,9;41052;19734;0.4807;17250;2484;52111;1803;0.0346;2316;-513
2017-06-14 17:00:00;40,53;39,78;0,75;41052;14903;0.363;12912;1991;52111;1642;0.0315;2198;-556
2017-06-14 18:00:00;45,26;43,07;2,19;41052;9113;0.222;7902;1211;52111;1414;0.0272;2051;-637
2017-06-14 19:00:00;49,95;49,73;0,22;41052;4032;0.0982;3606;426;52111;1396;0.0268;1956;-560
2017-06-14 20:00:00;44,64;51,55;-6,91;41052;1151;0.028;1156;-5;52111;1634;0.0314;1985;-351
2017-06-14 21:00:00;42,91;48,47;-5,56;41052;73;0.0018;89;-16;52111;2333;0.0448;2318;15
2017-06-14 22:00:00;42,8;41,61;1,19;41052;0;0;0;0;52111;3118;0.0598;2806;312
2017-06-14 23:00:00;35,44;35,51;-0,07;41052;0;0;0;0;52111;3367;0.0646;3102;265
2017-06-15 00:00:00;33,0;33,74;-0,74;41055;0;0;0;0;52122;3518;0.0675;3756;-238
2017-06-15 01:00:00;31,04;32,06;-1,02;41055;0;0;0;0;52122;3595;0.069;3885;-290
2017-06-15 02:00:00;30,97;32,69;-1,72;41055;0;0;0;0;52122;3849;0.0738;4009;-160
2017-06-15 03:00:00;29,39;32,64;-3,25;41055;0;0;0;0;52122;3950;0.0758;4162;-212
2017-06-15 04:00:00;28,8;32,65;-3,85;41055;3;0.0001;3;0;52122;4211;0.0808;4285;-74
2017-06-15 05:00:00;28,88;32,44;-3,56;41055;318;0.0078;329;-11;52122;4618;0.0886;4250;368
2017-06-15 06:00:00;32,02;34,13;-2,11;41055;2160;0.0526;2030;130;52122;4854;0.0931;3966;888
2017-06-15 07:00:00;37,81;35,52;2,29;41055;6292;0.1532;6179;113;52122;3980;0.0764;3402;578
2017-06-15 08:00:00;38,0;35,27;2,73;41055;11964;0.2914;12078;-114;52122;2935;0.0563;2809;126
2017-06-15 09:00:00;35,49;34,72;0,77;41055;17452;0.4251;17715;-263;52122;2899;0.0556;2787;112
2017-06-15 10:00:00;29,95;32,4;-2,45;41055;21616;0.5265;21960;-344;52122;3090;0.0593;3011;79
2017-06-15 11:00:00;31,97;32,62;-0,65;41055;24376;0.5938;24596;-220;52122;3193;0.0613;3334;-141
2017-06-15 12:00:00;28,44;30,53;-2,09;41055;25504;0.6212;25762;-258;52122;3650;0.07;3735;-85
2017-06-15 13:00:00;27,73;30,41;-2,68;41055;25216;0.6142;25333;-117;52122;4258;0.0817;4119;139
2017-06-15 14:00:00;28,55;28,36;0,19;41055;22978;0.5597;23619;-641;52122;4431;0.085;4342;89
2017-06-15 15:00:00;27,16;28,79;-1,63;41055;19374;0.4719;20659;-1285;52122;4515;0.0866;4340;175
2017-06-15 16:00:00;29,51;31,2;-1,69;41055;14818;0.3609;16420;-1602;52122;4958;0.0951;4309;649
2017-06-15 17:00:00;33,81;36,78;-2,97;41055;9781;0.2382;11443;-1662;52122;6295;0.1208;4321;1974
2017-06-15 18:00:00;36,9;39,46;-2,56;41055;5695;0.1387;6600;-905;52122;8223;0.1577;4592;3631
2017-06-15 19:00:00;37,01;38,6;-1,59;41055;2750;0.067;2946;-196;52122;9163;0.1758;5279;3884
2017-06-15 20:00:00;36,62;35,58;1,04;41055;850;0.0207;871;-21;52122;9571;0.1836;6231;3340
2017-06-15 21:00:00;35,02;36,27;-1,25;41055;80;0.002;66;14;52122;10692;0.2051;7304;3388
2017-06-15 22:00:00;34,58;35,86;-1,28;41055;0;0;0;0;52122;11797;0.2263;8449;3348
2017-06-15 23:00:00;30,0;31,82;-1,82;41055;0;0;0;0;52122;12157;0.2332;9475;2682
2017-06-16 00:00:00;28,5;33,48;-4,98;41071;0;0;0;0;52134;11960;0.2294;11615;345
2017-06-16 01:00:00;23,93;27,7;-3,77;41071;0;0;0;0;52134;10602;0.2034;12047;-1445
2017-06-16 02:00:00;22,0;27,75;-5,75;41071;0;0;0;0;52134;10472;0.2009;12419;-1947
2017-06-16 03:00:00;21,07;29,01;-7,94;41071;0;0;0;0;52134;11708;0.2246;12708;-1000
2017-06-16 04:00:00;21,05;27,76;-6,71;41071;2;0;2;0;52134;12824;0.246;13243;-419
2017-06-16 05:00:00;22,41;28,2;-5,79;41071;244;0.006;263;-19;52134;13611;0.2611;13935;-324
2017-06-16 06:00:00;28,69;34,36;-5,67;41071;1817;0.0442;1681;136;52134;14094;0.2703;14624;-530
2017-06-16 07:00:00;33,53;38,75;-5,22;41071;4699;0.1144;4658;41;52134;14322;0.2747;15310;-988
2017-06-16 08:00:00;28,66;36,1;-7,44;41071;8341;0.2031;8827;-486;52134;15815;0.3034;16399;-584
2017-06-16 09:00:00;27,32;34,25;-6,93;41071;12760;0.3107;13287;-527;52134;18064;0.3465;17842;222
2017-06-16 10:00:00;21,97;26,37;-4,4;41071;16324;0.3974;16979;-655;52134;19872;0.3812;19427;445
2017-06-16 11:00:00;18,84;20,11;-1,27;41071;17810;0.4337;19507;-1697;52134;21862;0.4194;21084;778
2017-06-16 12:00:00;9,82;9,35;0,47;41071;18468;0.4497;20777;-2309;52134;23706;0.4547;22728;978
2017-06-16 13:00:00;7,53;4,38;3,15;41071;18466;0.4496;20788;-2322;52134;24784;0.4754;24132;652
2017-06-16 14:00:00;0,88;3,41;-2,53;41071;17681;0.4305;19765;-2084;52134;26328;0.505;25287;1041
2017-06-16 15:00:00;1,52;3,35;-1,83;41071;15732;0.383;17582;-1850;52134;27161;0.521;25907;1254
2017-06-16 16:00:00;7,51;7,63;-0,12;41071;13325;0.3244;14500;-1175;52134;27747;0.5322;26238;1509
2017-06-16 17:00:00;10,1;14,36;-4,26;41071;9629;0.2344;10700;-1071;52134;27559;0.5286;25905;1654
2017-06-16 18:00:00;20,73;20,75;-0,02;41071;5916;0.144;6682;-766;52134;26440;0.5072;24786;1654
2017-06-16 19:00:00;25,08;26,62;-1,54;41071;3008;0.0732;3229;-221;52134;24948;0.4786;23269;1679
2017-06-16 20:00:00;26,49;26,98;-0,49;41071;1032;0.0251;989;43;52134;22756;0.4365;21694;1062
2017-06-16 21:00:00;26,56;27,28;-0,72;41071;90;0.0022;71;19;52134;20651;0.3961;20333;318
2017-06-16 22:00:00;28,67;31,81;-3,14;41071;0;0;0;0;52134;19093;0.3662;19402;-309
2017-06-16 23:00:00;21,83;25,86;-4,03;41071;0;0;0;0;52134;18960;0.3637;18892;68
2017-06-17 00:00:00;19,81;24,67;-4,86;41072;0;0;0;0;52140;19055;0.3655;18043;1012
2017-06-17 01:00:00;14,97;20,18;-5,21;41072;0;0;0;0;52140;19308;0.3703;17775;1533
2017-06-17 02:00:00;17,08;16,57;0,51;41072;0;0;0;0;52140;18829;0.3611;17370;1459
2017-06-17 03:00:00;19,49;18,55;0,94;41072;0;0;0;0;52140;18197;0.349;16755;1442
2017-06-17 04:00:00;18,46;20,39;-1,93;41072;2;0;1;1;52140;17345;0.3327;16196;1149
2017-06-17 05:00:00;19,77;21,97;-2,2;41072;238;0.0058;259;-21;52140;16249;0.3116;15652;597
2017-06-17 06:00:00;19,14;21,87;-2,73;41072;1692;0.0412;1712;-20;52140;14648;0.281;15210;-562
2017-06-17 07:00:00;21,0;27,34;-6,34;41072;4333;0.1055;4717;-384;52140;13485;0.2586;14964;-1479
2017-06-17 08:00:00;23,01;31,03;-8,02;41072;7694;0.1873;8628;-934;52140;13079;0.2508;14710;-1631
2017-06-17 09:00:00;23,49;31,94;-8,45;41072;10800;0.263;12389;-1589;52140;13034;0.25;14347;-1313
2017-06-17 10:00:00;22,76;31,74;-8,98;41072;13316;0.3242;15455;-2139;52140;13160;0.2524;13774;-614
2017-06-17 11:00:00;22,35;31,25;-8,9;41072;15835;0.3855;17558;-1723;52140;12961;0.2486;13224;-263
2017-06-17 12:00:00;21,03;29,9;-8,87;41072;17637;0.4294;18687;-1050;52140;12479;0.2393;12751;-272
2017-06-17 13:00:00;21,08;29,5;-8,42;41072;18505;0.4506;18805;-300;52140;11976;0.2297;12303;-327
2017-06-17 14:00:00;20,16;28,32;-8,16;41072;18064;0.4398;18038;26;52140;11549;0.2215;11734;-185
2017-06-17 15:00:00;20,1;27,84;-7,74;41072;16186;0.3941;16365;-179;52140;10940;0.2098;11076;-136
2017-06-17 16:00:00;22,68;28,01;-5,33;41072;13420;0.3267;13753;-333;52140;9650;0.1851;10273;-623
2017-06-17 17:00:00;27,62;34,02;-6,4;41072;10126;0.2466;10376;-250;52140;8420;0.1615;9187;-767
2017-06-17 18:00:00;31,63;38,01;-6,38;41072;6405;0.156;6546;-141;52140;7030;0.1348;7788;-758
2017-06-17 19:00:00;35,1;39,29;-4,19;41072;3125;0.0761;3055;70;52140;5526;0.106;6368;-842
2017-06-17 20:00:00;35,83;39,31;-3,48;41072;924;0.0225;959;-35;52140;4480;0.086;5207;-727
2017-06-17 21:00:00;36,97;39,99;-3,02;41072;56;0.0013;76;-20;52140;3934;0.0755;4497;-563
2017-06-17 22:00:00;38,0;38,61;-0,61;41072;0;0;0;0;52140;3938;0.0756;4083;-145
2017-06-17 23:00:00;35,85;34,94;0,91;41072;0;0;0;0;52140;3999;0.0767;3752;247
2017-06-18 00:00:00;35,99;35,01;0,98;41072;0;0;0;0;52140;3931;0.0754;3700;231
2017-06-18 01:00:00;30,08;31,31;-1,23;41072;0;0;0;0;52140;3743;0.0718;3395;348
2017-06-18 02:00:00;28,53;26,87;1,66;41072;0;0;0;0;52140;3389;0.065;3159;230
2017-06-18 03:00:00;26,81;24,85;1,96;41072;0;0;0;0;52140;3034;0.0582;2966;68
2017-06-18 04:00:00;25,11;22,86;2,25;41072;3;0.0001;3;0;52140;2714;0.052;2735;-21
2017-06-18 05:00:00;24,29;22,26;2,03;41072;258;0.0063;282;-24;52140;2190;0.042;2390;-200
2017-06-18 06:00:00;24,33;20,72;3,61;41072;1889;0.046;1798;91;52140;1658;0.0318;1954;-296
2017-06-18 07:00:00;25,68;23,15;2,53;41072;5411;0.1318;5322;89;52140;1172;0.0225;1560;-388
2017-06-18 08:00:00;25,54;25,66;-0,12;41072;10524;0.2562;10302;222;52140;1056;0.0202;1351;-295
2017-06-18 09:00:00;24,4;24,51;-0,11;41072;15772;0.384;15178;594;52140;1196;0.0229;1356;-160
2017-06-18 10:00:00;24,34;22,05;2,29;41072;19360;0.4714;18907;453;52140;1322;0.0253;1474;-152
2017-06-18 11:00:00;24,24;22,69;1,55;41072;21607;0.5261;21316;291;52140;1412;0.0271;1637;-225
2017-06-18 12:00:00;24,13;22,09;2,04;41072;23693;0.5768;22620;1073;52140;1478;0.0284;1799;-321
2017-06-18 13:00:00;23,53;19,84;3,69;41072;24730;0.6021;23077;1653;52140;1606;0.0308;1957;-351
2017-06-18 14:00:00;21,98;16,42;5,56;41072;24412;0.5944;22580;1832;52140;1752;0.0336;2095;-343
2017-06-18 15:00:00;22,9;13,77;9,13;41072;22608;0.5505;20880;1728;52140;1880;0.036;2185;-305
2017-06-18 16:00:00;23,6;15,06;8,54;41072;19469;0.474;17829;1640;52140;1835;0.0352;2228;-393
2017-06-18 17:00:00;27,18;20,08;7,1;41072;14812;0.3606;13473;1339;52140;1669;0.032;2162;-493
2017-06-18 18:00:00;33,52;31,24;2,28;41072;9202;0.224;8261;941;52140;1635;0.0314;2035;-400
2017-06-18 19:00:00;37,48;38,89;-1,41;41072;4150;0.101;3714;436;52140;1637;0.0314;1953;-316
2017-06-18 20:00:00;38,98;37,4;1,58;41072;1195;0.0291;1195;0;52140;1536;0.0294;1965;-429
2017-06-18 21:00:00;39,09;37,04;2,05;41072;85;0.002;95;-10;52140;1826;0.035;2110;-284
2017-06-18 22:00:00;41,22;40,95;0,27;41072;0;0;0;0;52140;2297;0.0441;2315;-18
2017-06-18 23:00:00;37,08;35,93;1,15;41072;0;0;0;0;52140;2610;0.0501;2408;202
2017-06-19 00:00:00;33,88;35,0;-1,12;41077;0;0;0;0;52142;2585;0.0496;2560;25
2017-06-19 01:00:00;30,2;29,9;0,3;41077;0;0;0;0;52142;2511;0.0482;2447;64
2017-06-19 02:00:00;29,1;27,72;1,38;41077;0;0;0;0;52142;2324;0.0446;2317;7
2017-06-19 03:00:00;28,67;27,5;1,17;41077;0;0;0;0;52142;2071;0.0397;2132;-61
2017-06-19 04:00:00;28,57;28,56;0,01;41077;3;0.0001;3;0;52142;1961;0.0376;1966;-5
2017-06-19 05:00:00;29,1;30,81;-1,71;41077;295;0.0072;308;-13;52142;1917;0.0368;1804;113
2017-06-19 06:00:00;38,3;40,81;-2,51;41077;2070;0.0504;1916;154;52142;1762;0.0338;1651;111
2017-06-19 07:00:00;42,97;43,38;-0,41;41077;6348;0.1545;6095;253;52142;1466;0.0281;1428;38
2017-06-19 08:00:00;44,03;42,81;1,22;41077;12284;0.2991;12089;195;52142;899;0.0173;1150;-251
2017-06-19 09:00:00;40,98;39,07;1,91;41077;17987;0.4379;17853;134;52142;790;0.0152;982;-192
2017-06-19 10:00:00;38,24;37,96;0,28;41077;22373;0.5446;22348;25;52142;966;0.0185;1072;-106
2017-06-19 11:00:00;38,49;37,33;1,16;41077;25018;0.609;25291;-273;52142;1184;0.0227;1162;22
2017-06-19 12:00:00;34,96;37,46;-2,5;41077;26386;0.6424;26858;-472;52142;1130;0.0217;1201;-71
2017-06-19 13:00:00;35,06;37,73;-2,67;41077;26536;0.646;27064;-528;52142;987;0.0189;1200;-213
2017-06-19 14:00:00;35,88;38,53;-2,65;41077;25596;0.6231;25995;-399;52142;882;0.0169;1191;-309
2017-06-19 15:00:00;38,33;39,72;-1,39;41077;23455;0.571;23563;-108;52142;827;0.0159;1168;-341
2017-06-19 16:00:00;39,51;40,23;-0,72;41077;19930;0.4852;19804;126;52142;798;0.0153;1154;-356
2017-06-19 17:00:00;42,1;42,22;-0,12;41077;14993;0.365;14771;222;52142;758;0.0145;1147;-389
2017-06-19 18:00:00;45,6;47,24;-1,64;41077;9242;0.225;8890;352;52142;828;0.0159;1162;-334
2017-06-19 19:00:00;49,99;54,6;-4,61;41077;4060;0.0988;3858;202;52142;841;0.0161;1247;-406
2017-06-19 20:00:00;45,4;50,52;-5,12;41077;1177;0.0287;1221;-44;52142;868;0.0167;1401;-533
2017-06-19 21:00:00;44,13;53,37;-9,24;41077;88;0.0021;105;-17;52142;1069;0.0205;1636;-567
2017-06-19 22:00:00;43,68;49,76;-6,08;41077;0;0;0;0;52142;1274;0.0244;1944;-670
2017-06-19 23:00:00;36,66;40,29;-3,63;41077;0;0;0;0;52142;1608;0.0308;2192;-584
2017-06-20 00:00:00;32,39;36,23;-3,84;41081;0;0;0;0;52149;1857;0.0356;1904;-47
2017-06-20 01:00:00;32,1;35,17;-3,07;41081;0;0;0;0;52149;2120;0.0406;2153;-33
2017-06-20 02:00:00;30,15;34,9;-4,75;41081;0;0;0;0;52149;2627;0.0504;2458;169
2017-06-20 03:00:00;28,74;33,56;-4,82;41081;0;0;0;0;52149;3030;0.0581;2816;214
2017-06-20 04:00:00;28,47;32,2;-3,73;41081;2;0;3;-1;52149;3848;0.0738;3199;649
2017-06-20 05:00:00;30,47;33,72;-3,25;41081;292;0.0071;309;-17;52149;4617;0.0885;3447;1170
2017-06-20 06:00:00;36,81;38,98;-2,17;41081;2063;0.0502;1931;132;52149;4978;0.0955;3407;1571
2017-06-20 07:00:00;43,36;43,53;-0,17;41081;5984;0.1456;6001;-17;52149;4475;0.0858;3254;1221
2017-06-20 08:00:00;44,02;45,57;-1,55;41081;11341;0.276;11751;-410;52149;3528;0.0676;3163;365
2017-06-20 09:00:00;42,3;38,88;3,42;41081;16756;0.4079;17275;-519;52149;3227;0.0619;3273;-46
2017-06-20 10:00:00;39,66;37,45;2,21;41081;20961;0.5102;21628;-667;52149;3260;0.0625;3625;-365
2017-06-20 11:00:00;36,99;37,16;-0,17;41081;23815;0.5797;24481;-666;52149;4005;0.0768;4228;-223
2017-06-20 12:00:00;32,75;36,73;-3,98;41081;24927;0.6068;25898;-971;52149;4830;0.0926;5162;-332
2017-06-20 13:00:00;32,0;35,35;-3,35;41081;24476;0.5958;26011;-1535;52149;5781;0.1108;6308;-527
2017-06-20 14:00:00;31,84;35,78;-3,94;41081;22984;0.5595;24687;-1703;52149;7037;0.135;7535;-498
2017-06-20 15:00:00;31,86;35,49;-3,63;41081;20708;0.5041;22164;-1456;52149;7978;0.153;8629;-651
2017-06-20 16:00:00;31,99;35,21;-3,22;41081;17412;0.4238;18538;-1126;52149;8803;0.1688;9539;-736
2017-06-20 17:00:00;37,34;38,52;-1,18;41081;13016;0.3168;13764;-748;52149;9209;0.1766;10041;-832
2017-06-20 18:00:00;38,08;43,12;-5,04;41081;8020;0.1952;8303;-283;52149;9662;0.1853;10152;-490
2017-06-20 19:00:00;39,71;44,05;-4,34;41081;3904;0.095;3735;169;52149;9691;0.1859;10066;-375
2017-06-20 20:00:00;39,95;43,01;-3,06;41081;1254;0.0305;1251;3;52149;9292;0.1782;9770;-478
2017-06-20 21:00:00;38,9;40,98;-2,08;41081;108;0.0026;110;-2;52149;8508;0.1632;9205;-697
2017-06-20 22:00:00;38,57;36,92;1,65;41081;0;0;0;0;52149;8242;0.158;8631;-389
2017-06-20 23:00:00;34,91;33,86;1,05;41081;0;0;0;0;52149;7986;0.1531;7960;26
2017-06-21 00:00:00;32,05;33,78;-1,73;41085;0;0;0;0;52154;7394;0.1417;5947;1447
2017-06-21 01:00:00;31,94;30,93;1,01;41085;0;0;0;0;52154;6460;0.1238;5252;1208
2017-06-21 02:00:00;31,34;30,42;0,92;41085;0;0;0;0;52154;5894;0.113;4724;1170
2017-06-21 03:00:00;30,87;27,7;3,17;41085;0;0;0;0;52154;5472;0.1049;4282;1190
2017-06-21 04:00:00;30,68;27,71;2,97;41085;3;0.0001;3;0;52154;5008;0.096;3831;1177
2017-06-21 05:00:00;30,92;28,77;2,15;41085;303;0.0074;309;-6;52154;4602;0.0882;3336;1266
2017-06-21 06:00:00;38,41;40,4;-1,99;41085;2095;0.051;1943;152;52154;3688;0.0707;2800;888
2017-06-21 07:00:00;44,02;44,28;-0,26;41085;5926;0.1442;5952;-26;52154;2113;0.0405;2247;-134
2017-06-21 08:00:00;44,65;45,47;-0,82;41085;11142;0.2712;11764;-622;52154;1482;0.0284;1806;-324
2017-06-21 09:00:00;43,24;44,69;-1,45;41085;16371;0.3985;17275;-904;52154;1357;0.026;1500;-143
2017-06-21 10:00:00;40,06;42,02;-1,96;41085;20532;0.4997;21615;-1083;52154;1433;0.0275;1330;103
2017-06-21 11:00:00;39,54;37,67;1,87;41085;23605;0.5745;24576;-971;52154;1579;0.0303;1289;290
2017-06-21 12:00:00;37,64;35,23;2,41;41085;25016;0.6089;26042;-1026;52154;1649;0.0316;1328;321
2017-06-21 13:00:00;36,09;34,83;1,26;41085;24559;0.5978;26120;-1561;52154;1649;0.0316;1388;261
2017-06-21 14:00:00;33,65;34,38;-0,73;41085;23135;0.5631;24885;-1750;52154;1568;0.0301;1461;107
2017-06-21 15:00:00;34,69;35,62;-0,93;41085;21010;0.5114;22390;-1380;52154;1514;0.029;1490;24
2017-06-21 16:00:00;38,2;37,67;0,53;41085;17896;0.4356;18779;-883;52154;1364;0.0262;1500;-136
2017-06-21 17:00:00;45,64;44,7;0,94;41085;13387;0.3259;13879;-492;52154;1332;0.0256;1498;-166
2017-06-21 18:00:00;50,94;48,81;2,13;41085;8149;0.1984;8294;-145;52154;1250;0.024;1463;-213
2017-06-21 19:00:00;56,95;53,93;3,02;41085;3776;0.0919;3681;95;52154;1148;0.022;1478;-330
2017-06-21 20:00:00;51,03;52,8;-1,77;41085;1309;0.0318;1233;76;52154;1232;0.0236;1617;-385
2017-06-21 21:00:00;45,44;43,17;2,27;41085;109;0.0026;114;-5;52154;1189;0.0228;1936;-747
2017-06-21 22:00:00;44,05;43,1;0,95;41085;0;0;0;0;52154;1226;0.0235;2419;-1193
2017-06-21 23:00:00;36,68;36,62;0,06;41085;0;0;0;0;52154;1416;0.0271;2910;-1494
2017-06-22 00:00:00;35,94;36,53;-0,59;41089;0;0;0;0;52197;1700;0.0326;2562;-862
2017-06-22 01:00:00;34,45;36,76;-2,31;41089;0;0;0;0;52197;2190;0.042;3003;-813
2017-06-22 02:00:00;32,04;34,45;-2,41;41089;0;0;0;0;52197;2436;0.0467;3493;-1057
2017-06-22 03:00:00;30,96;32,91;-1,95;41089;0;0;0;0;52197;2734;0.0524;3947;-1213
2017-06-22 04:00:00;29,2;30,4;-1,2;41089;3;0.0001;2;1;52197;3638;0.0697;4467;-829
2017-06-22 05:00:00;30,2;32,19;-1,99;41089;284;0.0069;309;-25;52197;4252;0.0814;4930;-678
2017-06-22 06:00:00;36,46;38,45;-1,99;41089;2002;0.0487;1951;51;52197;5233;0.1002;5338;-105
2017-06-22 07:00:00;42,39;47,36;-4,97;41089;5728;0.1394;5627;101;52197;5268;0.1009;5604;-336
2017-06-22 08:00:00;44,8;44,83;-0,03;41089;10898;0.2652;10745;153;52197;4185;0.0802;5324;-1139
2017-06-22 09:00:00;40,88;42,05;-1,17;41089;15683;0.3817;15736;-53;52197;4500;0.0862;5015;-515
2017-06-22 10:00:00;38,91;41,64;-2,73;41089;19237;0.4682;19560;-323;52197;6415;0.1229;5422;993
2017-06-22 11:00:00;37,15;39,12;-1,97;41089;21878;0.5324;22173;-295;52197;9865;0.189;6358;3507
2017-06-22 12:00:00;34,96;32,41;2,55;41089;23248;0.5658;23495;-247;52197;10782;0.2066;7758;3024
2017-06-22 13:00:00;31,71;31,81;-0,1;41089;22742;0.5535;23349;-607;52197;12479;0.2391;9439;3040
2017-06-22 14:00:00;30,29;29,88;0,41;41089;20493;0.4987;21933;-1440;52197;14249;0.273;10735;3514
2017-06-22 15:00:00;30,37;30,41;-0,04;41089;17064;0.4153;19558;-2494;52197;14907;0.2856;11385;3522
2017-06-22 16:00:00;30,17;33,77;-3,6;41089;12801;0.3115;16166;-3365;52197;15333;0.2938;11958;3375
2017-06-22 17:00:00;37,43;38,64;-1,21;41089;8416;0.2048;11769;-3353;52197;15112;0.2895;12240;2872
2017-06-22 18:00:00;39,9;40,49;-0,59;41089;4658;0.1134;7066;-2408;52197;16220;0.3108;11994;4226
2017-06-22 19:00:00;41,91;37,98;3,93;41089;2236;0.0544;3286;-1050;52197;16201;0.3104;11434;4767
2017-06-22 20:00:00;38,99;34,36;4,63;41089;822;0.02;1046;-224;52197;16910;0.324;10839;6071
2017-06-22 21:00:00;37,56;33,61;3,95;41089;80;0.0019;83;-3;52197;18415;0.3528;10426;7989
2017-06-22 22:00:00;36,07;28,83;7,24;41089;0;0;0;0;52197;18022;0.3453;10424;7598
2017-06-22 23:00:00;30,95;22,94;8,01;41089;0;0;0;0;52197;19198;0.3678;10591;8607
2017-06-23 00:00:00;25,33;21,7;3,63;41095;0;0;0;0;52221;18364;0.3517;17642;722
2017-06-23 01:00:00;23,55;22,22;1,33;41095;0;0;0;0;52221;17423;0.3336;18037;-614
2017-06-23 02:00:00;22,43;29,29;-6,86;41095;0;0;0;0;52221;18391;0.3522;18435;-44
2017-06-23 03:00:00;21,41;26,93;-5,52;41095;0;0;0;0;52221;20199;0.3868;18616;1583
2017-06-23 04:00:00;21,59;25,09;-3,5;41095;2;0;1;1;52221;20706;0.3965;18599;2107
2017-06-23 05:00:00;23,34;24,53;-1,19;41095;169;0.0041;242;-73;52221;19684;0.377;18163;1521
2017-06-23 06:00:00;28,09;43,98;-15,89;41095;1385;0.0337;1658;-273;52221;19695;0.3772;17367;2328
2017-06-23 07:00:00;36,26;50,74;-14,48;41095;3836;0.0934;4460;-624;52221;18422;0.3528;16545;1877
2017-06-23 08:00:00;38,28;62,73;-24,45;41095;6816;0.1658;8305;-1489;52221;17452;0.3342;15972;1480
2017-06-23 09:00:00;34,09;52,22;-18,13;41095;9870;0.2402;12336;-2466;52221;17762;0.3401;15676;2086
2017-06-23 10:00:00;30,45;43,3;-12,85;41095;12868;0.3131;15993;-3125;52221;19592;0.3752;15612;3980
2017-06-23 11:00:00;29,05;37,49;-8,44;41095;15968;0.3886;18868;-2900;52221;20604;0.3946;15785;4819
2017-06-23 12:00:00;27,77;34,81;-7,04;41095;18521;0.4507;20676;-2155;52221;20848;0.3992;16181;4667
2017-06-23 13:00:00;26,1;27,64;-1,54;41095;20046;0.4878;21303;-1257;52221;21138;0.4048;16698;4440
2017-06-23 14:00:00;25,07;21,71;3,36;41095;20241;0.4926;20851;-610;52221;21470;0.4112;17139;4331
2017-06-23 15:00:00;24,98;17,85;7,13;41095;18728;0.4557;19183;-455;52221;22341;0.4278;17273;5068
2017-06-23 16:00:00;25,01;15,74;9,27;41095;15790;0.3843;16281;-491;52221;21058;0.4032;16931;4127
2017-06-23 17:00:00;29,06;21,72;7,34;41095;12286;0.299;12291;-5;52221;19850;0.3801;15806;4044
2017-06-23 18:00:00;36,46;33,08;3,38;41095;7889;0.192;7610;279;52221;18126;0.3471;13921;4205
2017-06-23 19:00:00;38,42;33,31;5,11;41095;3772;0.0918;3549;223;52221;15288;0.2927;11953;3335
2017-06-23 20:00:00;38,44;33,47;4,97;41095;1148;0.0279;1143;5;52221;13210;0.253;10361;2849
2017-06-23 21:00:00;37,98;33,8;4,18;41095;76;0.0018;93;-17;52221;12460;0.2386;9380;3080
2017-06-23 22:00:00;39,23;34,91;4,32;41095;0;0;0;0;52221;12273;0.235;8987;3286
2017-06-23 23:00:00;36,43;29,04;7,39;41095;0;0;0;0;52221;12329;0.2361;9076;3253
2017-06-24 00:00:00;29,33;28,0;1,33;41095;0;0;0;0;52221;12429;0.238;9727;2702
2017-06-24 01:00:00;28,01;29,91;-1,9;41095;0;0;0;0;52221;12369;0.2369;10585;1784
2017-06-24 02:00:00;24,01;30,65;-6,64;41095;0;0;0;0;52221;12480;0.239;11430;1050
2017-06-24 03:00:00;23,02;28,75;-5,73;41095;0;0;0;0;52221;12806;0.2452;12084;722
2017-06-24 04:00:00;20,6;28,04;-7,44;41095;1;0;1;0;52221;13272;0.2542;12668;604
2017-06-24 05:00:00;19,99;25,3;-5,31;41095;178;0.0043;220;-42;52221;13420;0.257;13048;372
2017-06-24 06:00:00;22,09;27,73;-5,64;41095;1532;0.0373;1517;15;52221;13639;0.2612;13259;380
2017-06-24 07:00:00;24,53;28,96;-4,43;41095;4338;0.1056;4572;-234;52221;14115;0.2703;13524;591
2017-06-24 08:00:00;25,66;31,69;-6,03;41095;8026;0.1953;8843;-817;52221;15614;0.299;14218;1396
2017-06-24 09:00:00;24,8;32,58;-7,78;41095;11704;0.2848;12977;-1273;52221;17869;0.3422;15416;2453
2017-06-24 10:00:00;22,0;24,04;-2,04;41095;14971;0.3643;16253;-1282;52221;19869;0.3805;16739;3130
2017-06-24 11:00:00;11,82;6,81;5,01;41095;17030;0.4144;18526;-1496;52221;21134;0.4047;17782;3352
2017-06-24 12:00:00;11,79;5,18;6,61;41095;18557;0.4516;19845;-1288;52221;22149;0.4242;18332;3817
2017-06-24 13:00:00;10,32;3,19;7,13;41095;19520;0.475;20195;-675;52221;22720;0.4351;18554;4166
2017-06-24 14:00:00;7,38;-24,35;31,73;41095;19550;0.4757;19460;90;52221;22463;0.4302;18503;3960
2017-06-24 15:00:00;9,77;-26,18;35,95;41095;18150;0.4416;17665;485;52221;22120;0.4236;18045;4075
2017-06-24 16:00:00;12,64;-19,85;32,49;41095;15287;0.372;14899;388;52221;21966;0.4206;17403;4563
2017-06-24 17:00:00;20,31;2,36;17,95;41095;11236;0.2734;11151;85;52221;19900;0.3811;16477;3423
2017-06-24 18:00:00;29,59;18,01;11,58;41095;7045;0.1714;6773;272;52221;17881;0.3424;15106;2775
2017-06-24 19:00:00;31,07;25,17;5,9;41095;3332;0.0811;3014;318;52221;15282;0.2926;13561;1721
2017-06-24 20:00:00;29,82;27,4;2,42;41095;1004;0.0244;916;88;52221;12212;0.2338;12130;82
2017-06-24 21:00:00;31,38;29,05;2,33;41095;60;0.0014;71;-11;52221;10480;0.2007;10948;-468
2017-06-24 22:00:00;31,94;33,39;-1,45;41095;0;0;0;0;52221;9692;0.1856;10227;-535
2017-06-24 23:00:00;29,75;30,67;-0,92;41095;0;0;0;0;52221;9174;0.1756;10006;-832
2017-06-25 00:00:00;28,06;30,68;-2,62;41095;0;0;0;0;52221;8921;0.1708;10106;-1185
2017-06-25 01:00:00;23,59;26,23;-2,64;41095;0;0;0;0;52221;9040;0.1731;10438;-1398
2017-06-25 02:00:00;20,79;22,09;-1,3;41095;0;0;0;0;52221;9360;0.1792;10857;-1497
2017-06-25 03:00:00;18,25;20,11;-1,86;41095;0;0;0;0;52221;9989;0.1913;11205;-1216
2017-06-25 04:00:00;14,45;16,91;-2,46;41095;1;0;1;0;52221;10638;0.2037;11557;-919
2017-06-25 05:00:00;10,25;11,63;-1,38;41095;190;0.0046;211;-21;52221;11760;0.2252;11938;-178
2017-06-25 06:00:00;10,26;10,01;0,25;41095;1408;0.0343;1391;17;52221;12398;0.2374;12279;119
2017-06-25 07:00:00;17,69;12,62;5,07;41095;3662;0.0891;3739;-77;52221;12307;0.2356;12692;-385
2017-06-25 08:00:00;17,77;19,1;-1,33;41095;6177;0.1503;6703;-526;52221;13353;0.2557;13739;-386
2017-06-25 09:00:00;16,11;22,09;-5,98;41095;8634;0.2101;9602;-968;52221;15962;0.3056;15509;453
2017-06-25 10:00:00;13,29;20,54;-7,25;41095;11194;0.2724;12048;-854;52221;18264;0.3497;17450;814
2017-06-25 11:00:00;13,61;13,79;-0,18;41095;13016;0.3168;13983;-967;52221;20126;0.3854;19022;1104
2017-06-25 12:00:00;11,27;5,52;5,75;41095;13577;0.3304;15237;-1660;52221;21112;0.4043;20034;1078
2017-06-25 13:00:00;7,32;6,48;0,84;41095;13227;0.3219;15466;-2239;52221;21296;0.4078;20726;570
2017-06-25 14:00:00;0,65;9,1;-8,45;41095;12655;0.308;14882;-2227;52221;20516;0.3929;20946;-430
2017-06-25 15:00:00;3,3;10,21;-6,91;41095;11676;0.2841;13536;-1860;52221;19894;0.381;20565;-671
2017-06-25 16:00:00;8,17;8,55;-0,38;41095;10334;0.2514;11399;-1065;52221;19003;0.3639;19857;-854
2017-06-25 17:00:00;17,01;14,44;2,57;41095;7748;0.1886;8602;-854;52221;17714;0.3392;18522;-808
2017-06-25 18:00:00;21,69;18,67;3,02;41095;4884;0.1188;5460;-576;52221;15912;0.3047;16575;-663
2017-06-25 19:00:00;29,21;32,58;-3,37;41095;2481;0.0604;2678;-197;52221;13316;0.255;14546;-1230
2017-06-25 20:00:00;33,94;38,15;-4,21;41095;775;0.0189;839;-64;52221;11942;0.2287;12928;-986
2017-06-25 21:00:00;35,21;38,3;-3,09;41095;48;0.0012;64;-16;52221;11553;0.2212;11903;-350
2017-06-25 22:00:00;38,91;40,02;-1,11;41095;0;0;0;0;52221;10607;0.2031;11448;-841
2017-06-25 23:00:00;36,21;38,99;-2,78;41095;0;0;0;0;52221;10011;0.1917;11562;-1551
2017-06-26 00:00:00;33,29;32,23;1,06;41106;0;0;0;0;52255;9476;0.1814;11035;-1559
2017-06-26 01:00:00;30,8;30,95;-0,15;41106;0;0;0;0;52255;9868;0.1888;11655;-1787
2017-06-26 02:00:00;28,03;31,15;-3,12;41106;0;0;0;0;52255;10744;0.2056;12190;-1446
2017-06-26 03:00:00;26,16;28,47;-2,31;41106;0;0;0;0;52255;11256;0.2154;12518;-1262
2017-06-26 04:00:00;23,96;26,11;-2,15;41106;1;0;1;0;52255;11126;0.2129;12886;-1760
2017-06-26 05:00:00;26,21;29,06;-2,85;41106;186;0.0045;225;-39;52255;10814;0.2069;13072;-2258
2017-06-26 06:00:00;37,12;38,16;-1,04;41106;1504;0.0366;1583;-79;52255;10684;0.2045;13093;-2409
2017-06-26 07:00:00;39,43;40,09;-0,66;41106;4579;0.1114;4561;18;52255;9809;0.1877;13160;-3351
2017-06-26 08:00:00;38,98;41,27;-2,29;41106;9133;0.2222;8774;359;52255;10296;0.197;13258;-2962
2017-06-26 09:00:00;34,43;34,77;-0,34;41106;13495;0.3283;13135;360;52255;11330;0.2168;13321;-1991
2017-06-26 10:00:00;28,85;28,83;0,02;41106;17106;0.4162;16584;522;52255;11668;0.2233;13309;-1641
2017-06-26 11:00:00;28,09;30,3;-2,21;41106;19360;0.471;19034;326;52255;11459;0.2193;13246;-1787
2017-06-26 12:00:00;27,49;30,91;-3,42;41106;20873;0.5078;20641;232;52255;11420;0.2186;13035;-1615
2017-06-26 13:00:00;27,35;30,78;-3,43;41106;21433;0.5214;21351;82;52255;11324;0.2167;12657;-1333
2017-06-26 14:00:00;26,2;30,2;-4,0;41106;20976;0.5103;21063;-87;52255;11104;0.2125;12166;-1062
2017-06-26 15:00:00;27,2;31,11;-3,91;41106;19552;0.4756;19560;-8;52255;10518;0.2013;11581;-1063
2017-06-26 16:00:00;28,03;31,89;-3,86;41106;16782;0.4083;16894;-112;52255;9389;0.1797;10880;-1491
2017-06-26 17:00:00;35,38;36,56;-1,18;41106;13026;0.3169;12971;55;52255;8372;0.1602;9959;-1587
2017-06-26 18:00:00;39,9;41,75;-1,85;41106;8373;0.2037;8056;317;52255;7508;0.1437;8752;-1244
2017-06-26 19:00:00;42,91;44,06;-1,15;41106;3965;0.0964;3677;288;52255;6672;0.1277;7549;-877
2017-06-26 20:00:00;41,58;43,26;-1,68;41106;1171;0.0285;1181;-10;52255;5897;0.1128;6564;-667
2017-06-26 21:00:00;40,55;39,56;0,99;41106;97;0.0023;102;-5;52255;5418;0.1037;5896;-478
2017-06-26 22:00:00;42,4;40,02;2,38;41106;0;0;0;0;52255;5414;0.1036;5502;-88
2017-06-26 23:00:00;38,46;36,11;2,35;41106;0;0;0;0;52255;4852;0.0928;5167;-315
2017-06-27 00:00:00;31,07;33,54;-2,47;41114;0;0;0;0;52279;4762;0.0911;4697;65
2017-06-27 01:00:00;30,07;30,88;-0,81;41114;0;0;0;0;52279;4582;0.0876;4383;199
2017-06-27 02:00:00;29,09;29,12;-0,03;41114;0;0;0;0;52279;4297;0.0822;4078;219
2017-06-27 03:00:00;29,04;27,99;1,05;41114;0;0;0;0;52279;3815;0.073;3742;73
2017-06-27 04:00:00;28,69;28,9;-0,21;41114;2;0;2;0;52279;3272;0.0626;3400;-128
2017-06-27 05:00:00;29,41;31,61;-2,2;41114;224;0.0054;251;-27;52279;2793;0.0534;3018;-225
2017-06-27 06:00:00;37,94;40,13;-2,19;41114;1405;0.0342;1581;-176;52279;2278;0.0436;2569;-291
2017-06-27 07:00:00;43,55;50,16;-6,61;41114;3748;0.0912;4402;-654;52279;1741;0.0333;2110;-369
2017-06-27 08:00:00;46,66;52,23;-5,57;41114;6850;0.1666;8114;-1264;52279;1277;0.0244;1753;-476
2017-06-27 09:00:00;46,3;51,95;-5,65;41114;10326;0.2512;11806;-1480;52279;1109;0.0212;1568;-459
2017-06-27 10:00:00;46,69;49,91;-3,22;41114;13120;0.3191;14942;-1822;52279;1018;0.0195;1495;-477
2017-06-27 11:00:00;48,04;45,2;2,84;41114;15406;0.3747;17217;-1811;52279;982;0.0188;1513;-531
2017-06-27 12:00:00;45,95;45,99;-0,04;41114;17017;0.4139;18419;-1402;52279;1112;0.0213;1622;-510
2017-06-27 13:00:00;44,45;45,0;-0,55;41114;17688;0.4302;18562;-874;52279;1281;0.0245;1775;-494
2017-06-27 14:00:00;44,1;42,9;1,2;41114;17364;0.4224;17892;-528;52279;1565;0.0299;2012;-447
2017-06-27 15:00:00;40,15;41,98;-1,83;41114;15874;0.3861;16221;-347;52279;1948;0.0373;2426;-478
2017-06-27 16:00:00;42,53;44,16;-1,63;41114;13100;0.3186;13422;-322;52279;2534;0.0485;3009;-475
2017-06-27 17:00:00;42,6;45,0;-2,4;41114;9742;0.2369;9862;-120;52279;3161;0.0605;3738;-577
2017-06-27 18:00:00;43,93;44,77;-0,84;41114;5803;0.1412;6044;-241;52279;3824;0.0731;4643;-819
2017-06-27 19:00:00;43,95;46,28;-2,33;41114;2697;0.0656;2837;-140;52279;4554;0.0871;5720;-1166
2017-06-27 20:00:00;40,24;45,01;-4,77;41114;824;0.0201;895;-71;52279;5523;0.1056;6950;-1427
2017-06-27 21:00:00;37,98;43,37;-5,39;41114;48;0.0011;75;-27;52279;7116;0.1361;8261;-1145
2017-06-27 22:00:00;32,62;37,87;-5,25;41114;0;0;0;0;52279;8876;0.1698;9549;-673
2017-06-27 23:00:00;27,3;32,53;-5,23;41114;0;0;0;0;52279;10419;0.1993;10463;-44
2017-06-28 00:00:00;28,77;30,16;-1,39;41137;0;0;0;0;52329;11381;0.2175;11903;-522
2017-06-28 01:00:00;27,35;28,78;-1,43;41137;0;0;0;0;52329;11848;0.2264;12282;-434
2017-06-28 02:00:00;26,38;28,93;-2,55;41137;0;0;0;0;52329;12200;0.2331;12587;-387
2017-06-28 03:00:00;26,02;28,01;-1,99;41137;0;0;0;0;52329;12372;0.2364;12701;-329
2017-06-28 04:00:00;25,96;27,65;-1,69;41137;2;0;2;0;52329;12644;0.2416;12713;-69
2017-06-28 05:00:00;27,96;30,25;-2,29;41137;222;0.0054;234;-12;52329;12913;0.2468;12523;390
2017-06-28 06:00:00;32,76;37,82;-5,06;41137;1487;0.0361;1487;0;52329;13187;0.252;12033;1154
2017-06-28 07:00:00;38,64;40,7;-2,06;41137;3659;0.0889;4149;-490;52329;11809;0.2256;11420;389
2017-06-28 08:00:00;41,51;45,96;-4,45;41137;6455;0.1569;7578;-1123;52329;11394;0.2177;10921;473
2017-06-28 09:00:00;41,99;46,4;-4,41;41137;9237;0.2246;10914;-1677;52329;11824;0.226;10715;1109
2017-06-28 10:00:00;41,95;43,03;-1,08;41137;12101;0.2941;13537;-1436;52329;12435;0.2376;10816;1619
2017-06-28 11:00:00;42,7;41,89;0,81;41137;14348;0.3488;15274;-926;52329;12890;0.2463;11010;1880
2017-06-28 12:00:00;41,45;39,43;2,02;41137;15748;0.3828;16028;-280;52329;13545;0.2589;11194;2351
2017-06-28 13:00:00;38,97;35,29;3,68;41137;16100;0.3914;15829;271;52329;13291;0.254;11376;1915
2017-06-28 14:00:00;36,57;34,75;1,82;41137;16071;0.3906;15034;1037;52329;12880;0.2461;11139;1741
2017-06-28 15:00:00;33,79;32,97;0,82;41137;15088;0.3668;13717;1371;52329;12057;0.2304;10441;1616
2017-06-28 16:00:00;34,9;35,48;-0,58;41137;12488;0.3036;11669;819;52329;11270;0.2154;9863;1407
2017-06-28 17:00:00;38,4;39,11;-0,71;41137;9214;0.224;8844;370;52329;10356;0.1979;9473;883
2017-06-28 18:00:00;38,97;41,47;-2,5;41137;5900;0.1434;5584;316;52329;9491;0.1814;9330;161
2017-06-28 19:00:00;40,0;41,65;-1,65;41137;2992;0.0727;2748;244;52329;8908;0.1702;9338;-430
2017-06-28 20:00:00;38,95;40,85;-1,9;41137;976;0.0237;877;99;52329;8168;0.1561;9347;-1179
2017-06-28 21:00:00;35,61;38,38;-2,77;41137;69;0.0017;68;1;52329;7726;0.1476;9261;-1535
2017-06-28 22:00:00;35,92;38,75;-2,83;41137;0;0;0;0;52329;7080;0.1353;9139;-2059
2017-06-28 23:00:00;31,24;35,23;-3,99;41137;0;0;0;0;52329;5969;0.1141;8737;-2768
2017-06-29 00:00:00;32,42;31,97;0,45;41155;0;0;0;0;52399;4941;0.0943;7769;-2828
2017-06-29 01:00:00;30,59;31,0;-0,41;41155;0;0;0;0;52399;4851;0.0925;7112;-2261
2017-06-29 02:00:00;29,94;27,82;2,12;41155;0;0;0;0;52399;4628;0.0883;6568;-1940
2017-06-29 03:00:00;29,03;27,28;1,75;41155;0;0;0;0;52399;4482;0.0855;6011;-1529
2017-06-29 04:00:00;29,05;27,29;1,76;41155;1;0;1;0;52399;4296;0.082;5618;-1322
2017-06-29 05:00:00;30,12;27,83;2,29;41155;142;0.0035;148;-6;52399;3968;0.0758;5376;-1408
2017-06-29 06:00:00;33,95;29,74;4,21;41155;981;0.0238;962;19;52399;4003;0.0764;5188;-1185
2017-06-29 07:00:00;41,9;39,71;2,19;41155;2404;0.0584;2438;-34;52399;4032;0.077;5019;-987
2017-06-29 08:00:00;46,96;42,28;4,68;41155;4066;0.0988;4164;-98;52399;3983;0.076;4914;-931
2017-06-29 09:00:00;47,53;42,04;5,49;41155;5869;0.1426;5872;-3;52399;4134;0.0789;4934;-800
2017-06-29 10:00:00;47,53;40,69;6,84;41155;7790;0.1893;7602;188;52399;4368;0.0834;5077;-709
2017-06-29 11:00:00;47,81;40,31;7,5;41155;10334;0.2511;9256;1078;52399;5127;0.0978;5279;-152
2017-06-29 12:00:00;45,99;38,41;7,58;41155;12138;0.2949;10459;1679;52399;6070;0.1158;5584;486
2017-06-29 13:00:00;45,2;37,16;8,04;41155;12766;0.3102;10962;1804;52399;7013;0.1338;5986;1027
2017-06-29 14:00:00;41,71;34,93;6,78;41155;12707;0.3088;11086;1621;52399;7965;0.152;6490;1475
2017-06-29 15:00:00;39,17;33,73;5,44;41155;11795;0.2866;10384;1411;52399;9380;0.179;7079;2301
2017-06-29 16:00:00;38,28;32,33;5,95;41155;9933;0.2414;8677;1256;52399;10671;0.2036;7708;2963
2017-06-29 17:00:00;38,23;32,8;5,43;41155;7425;0.1804;6534;891;52399;11964;0.2283;8196;3768
2017-06-29 18:00:00;38,94;34,23;4,71;41155;4427;0.1076;4189;238;52399;11870;0.2265;8366;3504
2017-06-29 19:00:00;39,01;35,31;3,7;41155;2122;0.0516;2081;41;52399;11703;0.2234;8500;3203
2017-06-29 20:00:00;35,52;32,6;2,92;41155;650;0.0158;658;-8;52399;11226;0.2142;8835;2391
2017-06-29 21:00:00;34,99;32,42;2,57;41155;33;0.0008;48;-15;52399;11526;0.22;9202;2324
2017-06-29 22:00:00;36,48;33,75;2,73;41155;0;0;0;0;52399;11615;0.2217;9736;1879
2017-06-29 23:00:00;33,5;31,07;2,43;41155;0;0;0;0;52399;12225;0.2333;10384;1841
2017-06-30 00:00:00;29,29;27,17;2,12;41190;0;0;0;0;52538;13248;0.2522;10389;2859
2017-06-30 01:00:00;29,01;25,21;3,8;41190;0;0;0;0;52538;14201;0.2703;11005;3196
2017-06-30 02:00:00;28,06;22,7;5,36;41190;0;0;0;0;52538;15144;0.2882;11603;3541
2017-06-30 03:00:00;27,0;21,19;5,81;41190;0;0;0;0;52538;15836;0.3014;12111;3725
2017-06-30 04:00:00;25,58;19,19;6,39;41190;0;0;0;0;52538;16190;0.3082;12644;3546
2017-06-30 05:00:00;28,0;21,1;6,9;41190;98;0.0024;151;-53;52538;16340;0.311;13117;3223
2017-06-30 06:00:00;31,96;27,58;4,38;41190;1059;0.0257;1281;-222;52538;16185;0.3081;13606;2579
2017-06-30 07:00:00;37,93;35,79;2,14;41190;3124;0.0758;3699;-575;52538;15964;0.3039;14230;1734
2017-06-30 08:00:00;38,91;37,37;1,54;41190;6584;0.1598;7034;-450;52538;16900;0.3217;14919;1981
2017-06-30 09:00:00;35,99;33,92;2,07;41190;10382;0.2521;10446;-64;52538;18348;0.3492;15618;2730
2017-06-30 10:00:00;35,51;27,21;8,3;41190;13291;0.3227;13491;-200;52538;19510;0.3714;16231;3279
2017-06-30 11:00:00;32,24;27,51;4,73;41190;15548;0.3775;15897;-349;52538;21084;0.4013;16678;4406
2017-06-30 12:00:00;29,33;24,2;5,13;41190;16797;0.4078;17446;-649;52538;21806;0.415;16919;4887
2017-06-30 13:00:00;27,29;23,04;4,25;41190;17175;0.417;18050;-875;52538;21882;0.4165;16994;4888
2017-06-30 14:00:00;25,08;22,47;2,61;41190;17103;0.4152;17712;-609;52538;21019;0.4001;16772;4247
2017-06-30 15:00:00;25,09;22,31;2,78;41190;15791;0.3834;16291;-500;52538;19750;0.3759;16143;3607
2017-06-30 16:00:00;27,29;23,83;3,46;41190;13186;0.3202;13714;-528;52538;18520;0.3525;15280;3240
2017-06-30 17:00:00;30,51;29,15;1,36;41190;9996;0.2426;10270;-274;52538;16860;0.321;14105;2755
2017-06-30 18:00:00;36,36;35,3;1,06;41190;6314;0.1533;6412;-98;52538;14826;0.2822;12691;2135
2017-06-30 19:00:00;38,92;36,57;2,35;41190;3010;0.0731;3120;-110;52538;12646;0.2407;11276;1370
2017-06-30 20:00:00;38,71;36,3;2,41;41190;876;0.0213;1022;-146;52538;10976;0.2089;10277;699
2017-06-30 21:00:00;36,61;35,52;1,09;41190;40;0.001;71;-31;52538;9854;0.1876;10092;-238
2017-06-30 22:00:00;38,95;36,98;1,97;41190;0;0;0;0;52538;9544;0.1816;10445;-901
2017-06-30 23:00:00;34,07;35,26;-1,19;41190;0;0;0;0;52538;9620;0.1831;11024;-1404
2017-01-07 00:00:00;32,17;37,54;-5,37;41191;0;0;0;0;52538;9971;0.1898;10077;-106
2017-01-07 01:00:00;29,04;34,88;-5,84;41191;0;0;0;0;52538;10535;0.2005;10577;-42
2017-01-07 02:00:00;26,96;30,36;-3,4;41191;0;0;0;0;52538;10886;0.2072;11001;-115
2017-01-07 03:00:00;26,08;29,63;-3,55;41191;0;0;0;0;52538;11317;0.2154;11226;91
2017-01-07 04:00:00;26,04;26,4;-0,36;41191;0;0;0;0;52538;11498;0.2188;11505;-7
2017-01-07 05:00:00;25,59;25,45;0,14;41191;124;0.003;143;-19;52538;12108;0.2304;11795;313
2017-01-07 06:00:00;25,56;25,77;-0,21;41191;1088;0.0264;1099;-11;52538;12442;0.2368;12039;403
2017-01-07 07:00:00;26,77;28,38;-1,61;41191;3040;0.0738;3003;37;52538;12307;0.2342;12366;-59
2017-01-07 08:00:00;28,82;33,09;-4,27;41191;5501;0.1335;5421;80;52538;12838;0.2444;12873;-35
2017-01-07 09:00:00;32,4;34,12;-1,72;41191;7813;0.1897;7677;136;52538;13790;0.2625;13410;380
2017-01-07 10:00:00;33,35;32,22;1,13;41191;9853;0.2392;9369;484;52538;14922;0.284;13918;1004
2017-01-07 11:00:00;33,15;32,06;1,09;41191;11141;0.2704;10530;611;52538;15713;0.2991;14245;1468
2017-01-07 12:00:00;29,1;27,09;2,01;41191;12213;0.2965;11222;991;52538;16293;0.3101;14466;1827
2017-01-07 13:00:00;26,07;23,65;2,42;41191;12537;0.3044;11389;1148;52538;16628;0.3165;14691;1937
2017-01-07 14:00:00;26,33;22,31;4,02;41191;11899;0.2889;11075;824;52538;16209;0.3085;14837;1372
2017-01-07 15:00:00;26,04;23,89;2,15;41191;10865;0.2638;10093;772;52538;16321;0.3107;14842;1479
2017-01-07 16:00:00;26,09;25,24;0,85;41191;9270;0.2251;8411;859;52538;16648;0.3169;14842;1806
2017-01-07 17:00:00;29,01;26,15;2,86;41191;7103;0.1724;6310;793;52538;15719;0.2992;14555;1164
2017-01-07 18:00:00;29,34;30,39;-1,05;41191;4564;0.1108;4009;555;52538;14411;0.2743;13936;475
2017-01-07 19:00:00;29,89;32,77;-2,88;41191;2245;0.0545;1932;313;52538;13035;0.2481;13199;-164
2017-01-07 20:00:00;30,12;31,76;-1,64;41191;676;0.0164;610;66;52538;12041;0.2292;12588;-547
2017-01-07 21:00:00;29,63;32,43;-2,8;41191;59;0.0014;51;8;52538;12281;0.2338;12195;86
2017-01-07 22:00:00;28,87;33,03;-4,16;41191;0;0;0;0;52538;12551;0.2389;12093;458
2017-01-07 23:00:00;26,26;28,48;-2,22;41191;0;0;0;0;52538;12486;0.2376;12093;393
2017-02-07 00:00:00;24,36;23,86;0,5;41191;0;0;0;0;52544;12043;0.2292;11792;251
2017-02-07 01:00:00;23,12;22,79;0,33;41191;0;0;0;0;52544;11938;0.2272;11514;424
2017-02-07 02:00:00;22,73;21,03;1,7;41191;0;0;0;0;52544;11884;0.2262;11310;574
2017-02-07 03:00:00;22,63;20,57;2,06;41191;0;0;0;0;52544;12408;0.2362;11138;1270
2017-02-07 04:00:00;20,27;18,15;2,12;41191;1;0;1;0;52544;13116;0.2496;11018;2098
2017-02-07 05:00:00;20,59;11,2;9,39;41191;136;0.0033;168;-32;52544;13310;0.2533;10802;2508
2017-02-07 06:00:00;21,3;10,38;10,92;41191;992;0.0241;1034;-42;52544;12804;0.2437;10543;2261
2017-02-07 07:00:00;23,07;15,21;7,86;41191;2754;0.0668;2940;-186;52544;12262;0.2334;10544;1718
2017-02-07 08:00:00;24,76;16,8;7,96;41191;5034;0.1222;5605;-571;52544;11872;0.226;10869;1003
2017-02-07 09:00:00;25,56;20,9;4,66;41191;7473;0.1814;8365;-892;52544;11700;0.2227;11385;315
2017-02-07 10:00:00;20,71;23,74;-3,03;41191;9736;0.2364;10613;-877;52544;11627;0.2213;12077;-450
2017-02-07 11:00:00;23,32;26,29;-2,97;41191;11517;0.2796;12389;-872;52544;12734;0.2424;12740;-6
2017-02-07 12:00:00;21,36;24,47;-3,11;41191;12371;0.3004;13409;-1038;52544;13114;0.2496;13340;-226
2017-02-07 13:00:00;19,08;25,52;-6,44;41191;12106;0.2939;13377;-1271;52544;13874;0.264;13919;-45
2017-02-07 14:00:00;10,47;21,51;-11,04;41191;11109;0.2697;12817;-1708;52544;14778;0.2812;14148;630
2017-02-07 15:00:00;9,96;17,59;-7,63;41191;9734;0.2363;11611;-1877;52544;15636;0.2976;14004;1632
2017-02-07 16:00:00;17,31;19,54;-2,23;41191;8467;0.2055;9664;-1197;52544;15989;0.3043;13656;2333
2017-02-07 17:00:00;19,72;16,6;3,12;41191;6812;0.1654;7299;-487;52544;15752;0.2998;13125;2627
2017-02-07 18:00:00;28,63;26,39;2,24;41191;4646;0.1128;4712;-66;52544;15320;0.2915;12407;2913
2017-02-07 19:00:00;32,9;30,85;2,05;41191;2562;0.0622;2331;231;52544;14526;0.2764;11547;2979
2017-02-07 20:00:00;35,37;32,56;2,81;41191;840;0.0204;777;63;52544;12536;0.2386;10630;1906
2017-02-07 21:00:00;37,0;32,99;4,01;41191;72;0.0017;71;1;52544;11698;0.2226;9745;1953
2017-02-07 22:00:00;38,92;34,49;4,43;41191;0;0;0;0;52544;11761;0.2238;9050;2711
2017-02-07 23:00:00;37,06;31,86;5,2;41191;0;0;0;0;52544;11699;0.2226;8512;3187
2017-03-07 00:00:00;26,04;30,7;-4,66;41193;0;0;0;0;52544;11292;0.2149;10905;387
2017-03-07 01:00:00;23,51;26,44;-2,93;41193;0;0;0;0;52544;11192;0.213;10774;418
2017-03-07 02:00:00;22,86;25,55;-2,69;41193;0;0;0;0;52544;10734;0.2043;10586;148
2017-03-07 03:00:00;22,56;23,94;-1,38;41193;0;0;0;0;52544;9894;0.1883;10277;-383
2017-03-07 04:00:00;24,86;22,96;1,9;41193;1;0;1;0;52544;9537;0.1815;9896;-359
2017-03-07 05:00:00;26,78;26,67;0,11;41193;172;0.0042;222;-50;52544;8914;0.1696;9460;-546
2017-03-07 06:00:00;34,93;34,24;0,69;41193;1524;0.037;1445;79;52544;8097;0.1541;8962;-865
2017-03-07 07:00:00;41,25;44,93;-3,68;41193;4830;0.1172;4462;368;52544;6880;0.131;8562;-1682
2017-03-07 08:00:00;41,61;44,97;-3,36;41193;9374;0.2276;8851;523;52544;7300;0.139;8684;-1384
2017-03-07 09:00:00;38,94;38,15;0,79;41193;14073;0.3416;13424;649;52544;9296;0.1769;9445;-149
2017-03-07 10:00:00;35,35;33,09;2,26;41193;18204;0.4419;17388;816;52544;10844;0.2064;10336;508
2017-03-07 11:00:00;32,92;31,23;1,69;41193;21030;0.5105;20322;708;52544;11779;0.2242;11213;566
2017-03-07 12:00:00;28,68;27,52;1,16;41193;22598;0.5486;21876;722;52544;12648;0.2407;12038;610
2017-03-07 13:00:00;28,17;26,43;1,74;41193;23080;0.5603;21983;1097;52544;13102;0.2494;12778;324
2017-03-07 14:00:00;26,91;26,09;0,82;41193;22033;0.5349;20980;1053;52544;13492;0.2568;13381;111
2017-03-07 15:00:00;28,02;26,17;1,85;41193;19701;0.4783;18894;807;52544;14134;0.269;13820;314
2017-03-07 16:00:00;28,59;28,14;0,45;41193;16051;0.3896;15643;408;52544;14766;0.281;14092;674
2017-03-07 17:00:00;32,18;30,71;1,47;41193;11980;0.2908;11579;401;52544;14924;0.284;13888;1036
2017-03-07 18:00:00;38,94;35,47;3,47;41193;7390;0.1794;7079;311;52544;14597;0.2778;13136;1461
2017-03-07 19:00:00;42,78;38,14;4,64;41193;3489;0.0847;3269;220;52544;13280;0.2527;12265;1015
2017-03-07 20:00:00;40,91;37,24;3,67;41193;1018;0.0247;1048;-30;52544;11480;0.2185;11524;-44
2017-03-07 21:00:00;39,37;37,94;1,43;41193;54;0.0013;89;-35;52544;11313;0.2153;11091;222
2017-03-07 22:00:00;39,91;36,73;3,18;41193;0;0;0;0;52544;11832;0.2252;11114;718
2017-03-07 23:00:00;32,04;33,92;-1,88;41193;0;0;0;0;52544;12263;0.2334;11247;1016
2017-04-07 00:00:00;28,83;27,79;1,04;41197;0;0;0;0;52544;11773;0.224;11803;-30
2017-04-07 01:00:00;28,63;28,45;0,18;41197;0;0;0;0;52544;11728;0.2232;11910;-182
2017-04-07 02:00:00;28,49;28,78;-0,29;41197;0;0;0;0;52544;11458;0.2181;11961;-503
2017-04-07 03:00:00;28,43;29,47;-1,04;41197;0;0;0;0;52544;10987;0.2091;11924;-937
2017-04-07 04:00:00;27,99;29,53;-1,54;41197;1;0;1;0;52544;10618;0.2021;11828;-1210
2017-04-07 05:00:00;28,44;30,62;-2,18;41197;180;0.0044;213;-33;52544;9955;0.1895;11398;-1443
2017-04-07 06:00:00;35,81;38,09;-2,28;41197;1599;0.0388;1512;87;52544;9117;0.1735;10675;-1558
2017-04-07 07:00:00;41,63;42,09;-0,46;41197;4648;0.1128;4528;120;52544;8400;0.1598;10065;-1665
2017-04-07 08:00:00;41,79;40,27;1,52;41197;8796;0.2135;8800;-4;52544;9008;0.1714;9886;-878
2017-04-07 09:00:00;36,0;37,01;-1,01;41197;13286;0.3225;13234;52;52544;9592;0.1825;9963;-371
2017-04-07 10:00:00;34,74;35,9;-1,16;41197;17455;0.4237;16792;663;52544;9844;0.1874;10153;-309
2017-04-07 11:00:00;32,97;34,44;-1,47;41197;20150;0.4891;19175;975;52544;10270;0.1954;10328;-58
2017-04-07 12:00:00;31,93;30,95;0,98;41197;21152;0.5134;20440;712;52544;10602;0.2018;10341;261
2017-04-07 13:00:00;31,93;31,38;0,55;41197;21476;0.5213;20872;604;52544;10545;0.2007;10153;392
2017-04-07 14:00:00;30,55;32,08;-1,53;41197;21082;0.5117;20442;640;52544;9913;0.1886;9840;73
2017-04-07 15:00:00;32,6;33,39;-0,79;41197;19722;0.4787;18956;766;52544;8995;0.1712;9298;-303
2017-04-07 16:00:00;32,93;33,32;-0,39;41197;17241;0.4185;16317;924;52544;7701;0.1466;8546;-845
2017-04-07 17:00:00;36,95;36,99;-0,04;41197;13345;0.3239;12489;856;52544;6316;0.1202;7572;-1256
2017-04-07 18:00:00;40,0;41,04;-1,04;41197;8478;0.2058;7753;725;52544;4909;0.0934;6357;-1448
2017-04-07 19:00:00;44,04;43,06;0,98;41197;3925;0.0953;3533;392;52544;3528;0.0671;5151;-1623
2017-04-07 20:00:00;43,1;44,06;-0,96;41197;1132;0.0275;1166;-34;52544;2424;0.0462;4227;-1803
2017-04-07 21:00:00;41,68;43,96;-2,28;41197;60;0.0014;108;-48;52544;1928;0.0367;3695;-1767
2017-04-07 22:00:00;40,54;42,78;-2,24;41197;0;0;0;0;52544;1794;0.0342;3436;-1642
2017-04-07 23:00:00;37,29;38,78;-1,49;41197;0;0;0;0;52544;1594;0.0304;3224;-1630
2017-05-07 00:00:00;34,99;37,75;-2,76;41200;0;0;0;0;52550;1357;0.0258;2329;-972
2017-05-07 01:00:00;32,51;35,86;-3,35;41200;0;0;0;0;52550;1276;0.0243;2155;-879
2017-05-07 02:00:00;31,02;33,58;-2,56;41200;0;0;0;0;52550;1205;0.0229;2031;-826
2017-05-07 03:00:00;29,07;30,96;-1,89;41200;0;0;0;0;52550;1113;0.0212;1927;-814
2017-05-07 04:00:00;29,54;31,82;-2,28;41200;0;0;0;0;52550;1208;0.023;1836;-628
2017-05-07 05:00:00;31,89;33,35;-1,46;41200;138;0.0034;192;-54;52550;1509;0.0287;1707;-198
2017-05-07 06:00:00;38,02;37,22;0,8;41200;1425;0.0346;1428;-3;52550;1634;0.0311;1556;78
2017-05-07 07:00:00;43,92;41,37;2,55;41200;4512;0.1095;4463;49;52550;1341;0.0255;1392;-51
2017-05-07 08:00:00;46,01;40,82;5,19;41200;9058;0.2198;8956;102;52550;1098;0.0209;1239;-141
2017-05-07 09:00:00;44,18;40,95;3,23;41200;13778;0.3344;13584;194;52550;1018;0.0194;1105;-87
2017-05-07 10:00:00;43,71;39,68;4,03;41200;17892;0.4342;17453;439;52550;1056;0.0201;1063;-7
2017-05-07 11:00:00;42,06;38,91;3,15;41200;21084;0.5117;20269;815;52550;1100;0.021;1093;7
2017-05-07 12:00:00;38,93;37,62;1,31;41200;22878;0.5553;21861;1017;52550;1104;0.021;1200;-96
2017-05-07 13:00:00;38,09;35,71;2,38;41200;23586;0.5725;22101;1485;52550;1169;0.0222;1345;-176
2017-05-07 14:00:00;37,44;33,81;3,63;41200;22858;0.5548;21187;1671;52550;1298;0.0247;1522;-224
2017-05-07 15:00:00;37,38;33,96;3,42;41200;20603;0.5001;19174;1429;52550;1440;0.0274;1702;-262
2017-05-07 16:00:00;38,9;37,19;1,71;41200;17239;0.4184;16118;1121;52550;1544;0.0294;1846;-302
2017-05-07 17:00:00;41,51;41,45;0,06;41200;12923;0.3137;12114;809;52550;1568;0.0298;1913;-345
2017-05-07 18:00:00;42,52;42,22;0,3;41200;8288;0.2012;7508;780;52550;1563;0.0297;1892;-329
2017-05-07 19:00:00;44,55;44,9;-0,35;41200;3938;0.0956;3542;396;52550;1522;0.0289;1887;-365
2017-05-07 20:00:00;44,15;44,58;-0,43;41200;1165;0.0283;1178;-13;52550;1575;0.03;1945;-370
2017-05-07 21:00:00;43,93;42,78;1,15;41200;75;0.0018;102;-27;52550;1770;0.0337;2078;-308
2017-05-07 22:00:00;41,66;42,44;-0,78;41200;0;0;0;0;52550;2066;0.0393;2260;-194
2017-05-07 23:00:00;36,07;36,8;-0,73;41200;0;0;0;0;52550;1896;0.0361;2288;-392
2017-06-07 00:00:00;33,03;33,09;-0,06;41204;0;0;0;0;52550;1592;0.0303;1795;-203
2017-06-07 01:00:00;32,21;32,6;-0,39;41204;0;0;0;0;52550;1474;0.0281;1573;-99
2017-06-07 02:00:00;30,62;31,8;-1,18;41204;0;0;0;0;52550;1298;0.0247;1389;-91
2017-06-07 03:00:00;30,11;31,21;-1,1;41204;0;0;0;0;52550;1142;0.0217;1279;-137
2017-06-07 04:00:00;29,19;30,06;-0,87;41204;0;0;1;-1;52550;1087;0.0207;1164;-77
2017-06-07 05:00:00;32,06;31,32;0,74;41204;188;0.0046;233;-45;52550;1052;0.02;1011;41
2017-06-07 06:00:00;36,94;37,21;-0,27;41204;1721;0.0418;1655;66;52550;913;0.0174;798;115
2017-06-07 07:00:00;42,29;42,56;-0,27;41204;5434;0.1319;5313;121;52550;591;0.0112;547;44
2017-06-07 08:00:00;48,24;42,77;5,47;41204;11034;0.2678;10762;272;52550;233;0.0044;381;-148
2017-06-07 09:00:00;43,08;40,95;2,13;41204;16662;0.4044;16350;312;52550;165;0.0031;342;-177
2017-06-07 10:00:00;41,86;41,09;0,77;41204;21171;0.5138;20776;395;52550;207;0.004;321;-114
2017-06-07 11:00:00;40,03;41,69;-1,66;41204;23874;0.5794;23802;72;52550;243;0.0046;332;-89
2017-06-07 12:00:00;35,71;38,35;-2,64;41204;25222;0.6121;25425;-203;52550;327;0.0062;380;-53
2017-06-07 13:00:00;35,75;39,11;-3,36;41204;25289;0.6138;25658;-369;52550;477;0.0091;438;39
2017-06-07 14:00:00;35,54;39,22;-3,68;41204;24184;0.5869;24579;-395;52550;608;0.0116;506;102
2017-06-07 15:00:00;39,52;40,88;-1,36;41204;21152;0.5134;22223;-1071;52550;1007;0.0192;596;411
2017-06-07 16:00:00;40,6;44,17;-3,57;41204;17094;0.4149;18637;-1543;52550;1026;0.0195;700;326
2017-06-07 17:00:00;44,31;47,44;-3,13;41204;12460;0.3024;13736;-1276;52550;1033;0.0196;802;231
2017-06-07 18:00:00;45,87;53,96;-8,09;41204;7501;0.1821;8161;-660;52550;1269;0.0242;970;299
2017-06-07 19:00:00;53,71;54,01;-0,3;41204;3352;0.0814;3514;-162;52550;1695;0.0322;1294;401
2017-06-07 20:00:00;49,56;51,87;-2,31;41204;954;0.0232;1103;-149;52550;2591;0.0493;1938;653
2017-06-07 21:00:00;46,03;46,93;-0,9;41204;54;0.0013;100;-46;52550;3556;0.0677;3020;536
2017-06-07 22:00:00;42,71;45,33;-2,62;41204;0;0;0;0;52550;5511;0.1049;4285;1226
2017-06-07 23:00:00;35,61;35,65;-0,04;41204;0;0;0;0;52550;7250;0.138;5158;2092
2017-07-07 00:00:00;34,16;31,11;3,05;41208;0;0;0;0;52560;8642;0.1644;5737;2905
2017-07-07 01:00:00;32,07;28,96;3,11;41208;0;0;0;0;52560;9265;0.1763;5788;3477
2017-07-07 02:00:00;30,8;26,88;3,92;41208;0;0;0;0;52560;8359;0.159;5772;2587
2017-07-07 03:00:00;30,69;29,69;1,0;41208;0;0;0;0;52560;7042;0.134;5631;1411
2017-07-07 04:00:00;29,64;29,81;-0,17;41208;0;0;0;0;52560;6416;0.1221;5520;896
2017-07-07 05:00:00;30,84;31,69;-0,85;41208;124;0.003;175;-51;52560;6372;0.1212;5241;1131
2017-07-07 06:00:00;35,87;34,56;1,31;41208;1207;0.0293;1363;-156;52560;5515;0.105;4703;812
2017-07-07 07:00:00;41,88;41,9;-0,02;41208;3489;0.0846;4173;-684;52560;4836;0.092;4237;599
2017-07-07 08:00:00;45,54;48,61;-3,07;41208;6934;0.1682;8157;-1223;52560;3834;0.073;3913;-79
2017-07-07 09:00:00;45,58;49,2;-3,62;41208;10944;0.2656;12291;-1347;52560;3421;0.0651;3950;-529
2017-07-07 10:00:00;44,61;48,42;-3,81;41208;14660;0.3558;15992;-1332;52560;3300;0.0628;4236;-936
2017-07-07 11:00:00;43,31;53,2;-9,89;41208;17530;0.4254;18861;-1331;52560;3718;0.0708;4716;-998
2017-07-07 12:00:00;39,65;44,86;-5,21;41208;19716;0.4785;20585;-869;52560;3888;0.074;5344;-1456
2017-07-07 13:00:00;34,43;41,47;-7,04;41208;21162;0.5136;21108;54;52560;4481;0.0852;6098;-1617
2017-07-07 14:00:00;32,05;39,21;-7,16;41208;20996;0.5095;20583;413;52560;5546;0.1055;6846;-1300
2017-07-07 15:00:00;31,84;36,97;-5,13;41208;18590;0.4511;18858;-268;52560;6580;0.1252;7386;-806
2017-07-07 16:00:00;32,4;37,75;-5,35;41208;15442;0.3747;16049;-607;52560;7241;0.1377;7825;-584
2017-07-07 17:00:00;37,87;39,89;-2,02;41208;11379;0.2762;12159;-780;52560;7441;0.1416;7873;-432
2017-07-07 18:00:00;40,58;42,31;-1,73;41208;7114;0.1726;7534;-420;52560;7104;0.1352;7292;-188
2017-07-07 19:00:00;42,74;44,64;-1,9;41208;3356;0.0814;3500;-144;52560;5813;0.1106;6471;-658
2017-07-07 20:00:00;41,8;44,0;-2,2;41208;1074;0.0261;1138;-64;52560;4738;0.0901;5668;-930
2017-07-07 21:00:00;40,46;42,09;-1,63;41208;71;0.0018;94;-23;52560;4001;0.0762;5171;-1170
2017-07-07 22:00:00;40,99;43,19;-2,2;41208;0;0;0;0;52560;3636;0.0692;4953;-1317
2017-07-07 23:00:00;35,91;37,25;-1,34;41208;0;0;0;0;52560;3489;0.0664;4874;-1385
2017-08-07 00:00:00;37,08;38,54;-1,46;41208;0;0;0;0;52560;3233;0.0615;4475;-1242
2017-08-07 01:00:00;34,64;39,39;-4,75;41208;0;0;0;0;52560;3187;0.0606;4538;-1351
2017-08-07 02:00:00;32,05;36,24;-4,19;41208;0;0;0;0;52560;3524;0.067;4699;-1175
2017-08-07 03:00:00;30,68;33,14;-2,46;41208;0;0;0;0;52560;3919;0.0745;4897;-978
2017-08-07 04:00:00;29,87;31,6;-1,73;41208;0;0;0;0;52560;3988;0.0759;5044;-1056
2017-08-07 05:00:00;29,09;31,25;-2,16;41208;141;0.0034;196;-55;52560;4126;0.0785;5058;-932
2017-08-07 06:00:00;30,0;32,05;-2,05;41208;1460;0.0354;1495;-35;52560;4444;0.0846;4986;-542
2017-08-07 07:00:00;32,02;33,16;-1,14;41208;4456;0.1081;4595;-139;52560;4658;0.0887;4948;-290
2017-08-07 08:00:00;34,58;36,44;-1,86;41208;8748;0.2123;8964;-216;52560;4463;0.0849;5150;-687
2017-08-07 09:00:00;36,71;39,02;-2,31;41208;12791;0.3104;13409;-618;52560;4834;0.092;5601;-767
2017-08-07 10:00:00;35,89;38,54;-2,65;41208;16714;0.4056;16984;-270;52560;5793;0.1102;6201;-408
2017-08-07 11:00:00;35,37;35,92;-0,55;41208;19594;0.4755;19349;245;52560;6982;0.1328;6768;214
2017-08-07 12:00:00;33,22;33,38;-0,16;41208;20767;0.504;20529;238;52560;7856;0.1494;7265;591
2017-08-07 13:00:00;31,41;28,61;2,8;41208;21217;0.5149;20575;642;52560;8337;0.1586;7673;664
2017-08-07 14:00:00;30,18;28,34;1,84;41208;20107;0.4879;19627;480;52560;8935;0.17;7914;1021
2017-08-07 15:00:00;30,05;28,97;1,08;41208;17688;0.4292;17771;-83;52560;8737;0.1662;7940;797
2017-08-07 16:00:00;31,4;30,07;1,33;41208;14715;0.3571;15134;-419;52560;8241;0.1568;7874;367
2017-08-07 17:00:00;33,18;34,7;-1,52;41208;11483;0.2786;11649;-166;52560;7755;0.1476;7421;334
2017-08-07 18:00:00;36,98;36,59;0,39;41208;7212;0.175;7403;-191;52560;6998;0.1331;6495;503
2017-08-07 19:00:00;40,04;37,21;2,83;41208;3475;0.0844;3510;-35;52560;6034;0.1148;5547;487
2017-08-07 20:00:00;39,63;35,75;3,88;41208;1040;0.0253;1160;-120;52560;4750;0.0904;4757;-7
2017-08-07 21:00:00;39,82;35,19;4,63;41208;63;0.0015;92;-29;52560;4129;0.0786;4137;-8
2017-08-07 22:00:00;42,09;38,83;3,26;41208;0;0;0;0;52560;3838;0.073;3681;157
2017-08-07 23:00:00;39,67;37,54;2,13;41208;0;0;0;0;52560;3498;0.0666;3306;192
2017-09-07 00:00:00;32,21;30,68;1,53;41208;0;0;0;0;52560;3178;0.0604;3130;48
2017-09-07 01:00:00;31,08;29,57;1,51;41208;0;0;0;0;52560;3098;0.0589;2888;210
2017-09-07 02:00:00;29,84;28,72;1,12;41208;0;0;0;0;52560;2759;0.0525;2660;99
2017-09-07 03:00:00;29,2;27,93;1,27;41208;0;0;0;0;52560;2582;0.0491;2366;216
2017-09-07 04:00:00;29,62;28,79;0,83;41208;0;0;0;0;52560;2456;0.0467;2006;450
2017-09-07 05:00:00;29,46;26,33;3,13;41208;144;0.0035;202;-58;52560;2137;0.0406;1625;512
2017-09-07 06:00:00;29,49;26,11;3,38;41208;1440;0.0349;1477;-37;52560;2030;0.0386;1262;768
2017-09-07 07:00:00;29,83;27,02;2,81;41208;4114;0.0998;4666;-552;52560;1416;0.027;930;486
2017-09-07 08:00:00;30,03;28,45;1,58;41208;7905;0.1918;9215;-1310;52560;1086;0.0206;695;391
2017-09-07 09:00:00;31,26;31,26;0,0;41208;12014;0.2915;13887;-1873;52560;1072;0.0204;598;474
2017-09-07 10:00:00;31,26;30,83;0,43;41208;15466;0.3753;17798;-2332;52560;968;0.0184;551;417
2017-09-07 11:00:00;32,4;31,37;1,03;41208;18439;0.4474;20654;-2215;52560;875;0.0167;552;323
2017-09-07 12:00:00;32,07;31,43;0,64;41208;20692;0.5022;22199;-1507;52560;875;0.0167;595;280
2017-09-07 13:00:00;31,0;28,2;2,8;41208;22243;0.5398;22273;-30;52560;870;0.0166;633;237
2017-09-07 14:00:00;29,88;26,88;3,0;41208;21753;0.5279;21064;689;52560;843;0.0161;681;162
2017-09-07 15:00:00;30,69;24,86;5,83;41208;19594;0.4755;18720;874;52560;791;0.0151;736;55
2017-09-07 16:00:00;31,28;28,0;3,28;41208;15514;0.3765;15298;216;52560;867;0.0165;791;76
2017-09-07 17:00:00;33,8;29,19;4,61;41208;10972;0.2663;10994;-22;52560;951;0.0181;868;83
2017-09-07 18:00:00;36,75;32,75;4,0;41208;6260;0.1519;6570;-310;52560;1102;0.021;1037;65
2017-09-07 19:00:00;40,53;38,22;2,31;41208;3062;0.0743;3055;7;52560;1393;0.0265;1332;61
2017-09-07 20:00:00;40,53;39,12;1,41;41208;975;0.0237;984;-9;52560;1842;0.035;1794;48
2017-09-07 21:00:00;40,59;40,6;-0,01;41208;64;0.0015;80;-16;52560;2867;0.0546;2469;398
2017-09-07 22:00:00;42,28;41,79;0,49;41208;0;0;0;0;52560;4128;0.0786;3256;872
2017-09-07 23:00:00;40,08;38,55;1,53;41208;0;0;0;0;52560;5006;0.0952;3731;1275
2017-10-07 00:00:00;32,76;29,35;3,41;41212;0;0;0;0;52570;5160;0.0982;3706;1454
2017-10-07 01:00:00;29,92;28,21;1,71;41212;0;0;0;0;52570;5008;0.0952;3622;1386
2017-10-07 02:00:00;29,44;27,77;1,67;41212;0;0;0;0;52570;4774;0.0908;3508;1266
2017-10-07 03:00:00;29,59;27,18;2,41;41212;0;0;0;0;52570;4414;0.084;3406;1008
2017-10-07 04:00:00;29,31;27,09;2,22;41212;0;0;0;0;52570;3807;0.0724;3386;421
2017-10-07 05:00:00;30,6;28,04;2,56;41212;109;0.0026;145;-36;52570;3597;0.0684;3311;286
2017-10-07 06:00:00;38,03;37,16;0,87;41212;950;0.0231;1082;-132;52570;3420;0.065;3075;345
2017-10-07 07:00:00;44,03;44,2;-0,17;41212;2690;0.0653;3142;-452;52570;2674;0.0508;2754;-80
2017-10-07 08:00:00;50,07;51,16;-1,09;41212;4638;0.1126;5748;-1110;52570;2058;0.0392;2462;-404
2017-10-07 09:00:00;50,0;57,11;-7,11;41212;6656;0.1615;8402;-1746;52570;1813;0.0345;2321;-508
2017-10-07 10:00:00;48,73;56,81;-8,08;41212;8990;0.2181;10825;-1835;52570;1920;0.0365;2396;-476
2017-10-07 11:00:00;48,72;55,74;-7,02;41212;11725;0.2845;12832;-1107;52570;2232;0.0424;2646;-414
2017-10-07 12:00:00;47,69;51,95;-4,26;41212;14612;0.3546;14297;315;52570;2640;0.0502;3026;-386
2017-10-07 13:00:00;46,65;48,81;-2,16;41212;16020;0.3887;14990;1030;52570;3115;0.0593;3460;-345
2017-10-07 14:00:00;44,18;46,04;-1,86;41212;16038;0.3892;14998;1040;52570;3613;0.0687;3798;-185
2017-10-07 15:00:00;42,93;43,18;-0,25;41212;14766;0.3583;13933;833;52570;4129;0.0786;4023;106
2017-10-07 16:00:00;40,65;42,95;-2,3;41212;12146;0.2947;11755;391;52570;4552;0.0866;4182;370
2017-10-07 17:00:00;40,95;43,35;-2,4;41212;8782;0.2131;8905;-123;52570;4506;0.0857;4244;262
2017-10-07 18:00:00;41,62;45,08;-3,46;41212;5362;0.1301;5580;-218;52570;4196;0.0798;4155;41
2017-10-07 19:00:00;42,97;48,13;-5,16;41212;2653;0.0644;2617;36;52570;3944;0.075;4198;-254
2017-10-07 20:00:00;40,21;44,78;-4,57;41212;831;0.0202;794;37;52570;3613;0.0687;4482;-869
2017-10-07 21:00:00;38,86;42,42;-3,56;41212;39;0.001;55;-16;52570;3546;0.0674;5047;-1501
2017-10-07 22:00:00;39,92;43,49;-3,57;41212;0;0;0;0;52570;3596;0.0684;5814;-2218
2017-10-07 23:00:00;33,45;41,05;-7,6;41212;0;0;0;0;52570;3879;0.0738;6493;-2614
2017-11-07 00:00:00;30,93;34,32;-3,39;41216;0;0;0;0;52584;4732;0.09;4506;226
2017-11-07 01:00:00;30,28;32,14;-1,86;41216;0;0;0;0;52584;5112;0.0972;4703;409
2017-11-07 02:00:00;29,63;30,62;-0,99;41216;0;0;0;0;52584;5612;0.1067;4903;709
2017-11-07 03:00:00;28,96;26,4;2,56;41216;0;0;0;0;52584;6166;0.1172;5039;1127
2017-11-07 04:00:00;28,95;28,69;0,26;41216;0;0;0;0;52584;6172;0.1174;5214;958
2017-11-07 05:00:00;30,08;30,54;-0,46;41216;94;0.0023;130;-36;52584;5962;0.1134;5404;558
2017-11-07 06:00:00;34,51;36,45;-1,94;41216;990;0.024;1086;-96;52584;5876;0.1117;5523;353
2017-11-07 07:00:00;41,44;39,4;2,04;41216;3186;0.0773;3235;-49;52584;5414;0.1029;5725;-311
2017-11-07 08:00:00;44,22;41,77;2,45;41216;6253;0.1517;6227;26;52584;5399;0.1027;6138;-739
2017-11-07 09:00:00;43,43;40,95;2,48;41216;9866;0.2394;9513;353;52584;6156;0.1171;6719;-563
2017-11-07 10:00:00;42,03;41,08;0,95;41216;13228;0.3209;12725;503;52584;7450;0.1417;7447;3
2017-11-07 11:00:00;41,45;40,47;0,98;41216;16098;0.3906;15634;464;52584;9074;0.1726;8309;765
2017-11-07 12:00:00;39,42;37,24;2,18;41216;18198;0.4415;17545;653;52584;9902;0.1883;9189;713
2017-11-07 13:00:00;36,01;32,22;3,79;41216;18735;0.4546;17934;801;52584;10750;0.2044;10078;672
2017-11-07 14:00:00;34,21;29,82;4,39;41216;17682;0.429;17249;433;52584;11359;0.216;10740;619
2017-11-07 15:00:00;34,42;30,09;4,33;41216;15644;0.3796;15488;156;52584;11698;0.2224;10934;764
2017-11-07 16:00:00;35,39;32,09;3,3;41216;12572;0.305;12694;-122;52584;11685;0.2222;10854;831
2017-11-07 17:00:00;37,62;35,82;1,8;41216;9680;0.2348;9421;259;52584;10749;0.2044;10288;461
2017-11-07 18:00:00;39,99;38,99;1,0;41216;6219;0.1509;5931;288;52584;8961;0.1704;9176;-215
2017-11-07 19:00:00;41,58;40,53;1,05;41216;3170;0.0769;2899;271;52584;6953;0.1322;7868;-915
2017-11-07 20:00:00;40,7;41,67;-0,97;41216;938;0.0227;884;54;52584;5350;0.1018;6819;-1469
2017-11-07 21:00:00;38,94;41,56;-2,62;41216;37;0.0009;60;-23;52584;4910;0.0934;6229;-1319
2017-11-07 22:00:00;39,36;41,55;-2,19;41216;0;0;0;0;52584;4814;0.0915;6092;-1278
2017-11-07 23:00:00;34,25;36,89;-2,64;41216;0;0;0;0;52584;4253;0.0808;6148;-1895
2017-12-07 00:00:00;32,29;30,63;1,66;41220;0;0;0;0;52608;4032;0.0766;4642;-610
2017-12-07 01:00:00;30,14;29,98;0,16;41220;0;0;0;0;52608;4122;0.0783;4694;-572
2017-12-07 02:00:00;29,1;28,32;0,78;41220;0;0;0;0;52608;4046;0.0769;4649;-603
2017-12-07 03:00:00;28,52;27,81;0,71;41220;0;0;0;0;52608;4142;0.0787;4560;-418
2017-12-07 04:00:00;28,43;29,05;-0,62;41220;0;0;0;0;52608;4884;0.0929;4541;343
2017-12-07 05:00:00;29,3;28,09;1,21;41220;101;0.0024;124;-23;52608;5864;0.1115;4633;1231
2017-12-07 06:00:00;34,77;31,73;3,04;41220;980;0.0238;965;15;52608;6450;0.1226;4923;1527
2017-12-07 07:00:00;39,94;41,38;-1,44;41220;2693;0.0653;2696;-3;52608;6733;0.128;5416;1317
2017-12-07 08:00:00;44,01;44,13;-0,12;41220;4470;0.1084;4861;-391;52608;7109;0.1352;6025;1084
2017-12-07 09:00:00;44,31;44,65;-0,34;41220;6368;0.1545;7019;-651;52608;8551;0.1626;6980;1571
2017-12-07 10:00:00;44,16;43,3;0,86;41220;7688;0.1865;8697;-1009;52608;9715;0.1847;8222;1493
2017-12-07 11:00:00;43,9;43,13;0,77;41220;8200;0.199;9735;-1535;52608;10717;0.2037;9534;1183
2017-12-07 12:00:00;41,07;42,71;-1,64;41220;8674;0.2104;10139;-1465;52608;12678;0.241;11048;1630
2017-12-07 13:00:00;39,9;40,76;-0,86;41220;9011;0.2186;9937;-926;52608;14388;0.2735;12709;1679
2017-12-07 14:00:00;37,27;39,55;-2,28;41220;8716;0.2115;9284;-568;52608;16346;0.3107;14241;2105
2017-12-07 15:00:00;33,93;36,89;-2,96;41220;8675;0.2105;8481;194;52608;18321;0.3483;15696;2625
2017-12-07 16:00:00;32,19;33,21;-1,02;41220;8818;0.2139;7533;1285;52608;20409;0.3879;17369;3040
2017-12-07 17:00:00;33,29;30,74;2,55;41220;7519;0.1824;6234;1285;52608;21493;0.4086;18686;2807
2017-12-07 18:00:00;32,95;29,96;2,99;41220;5345;0.1297;4397;948;52608;22470;0.4271;19865;2605
2017-12-07 19:00:00;32,91;31,22;1,69;41220;2610;0.0633;2272;338;52608;23288;0.4426;21100;2188
2017-12-07 20:00:00;30,5;30,46;0,04;41220;745;0.0181;712;33;52608;24000;0.4562;21727;2273
2017-12-07 21:00:00;30,6;30,85;-0,25;41220;45;0.0011;51;-6;52608;23825;0.4529;21739;2086
2017-12-07 22:00:00;30,09;29,25;0,84;41220;0;0;0;0;52608;22930;0.4359;21604;1326
2017-12-07 23:00:00;27,82;27,71;0,11;41220;0;0;0;0;52608;22811;0.4336;21338;1473
2017-07-13 00:00:00;26,02;26,18;-0,16;41224;0;0;0;0;52621;22048;0.419;20305;1743
2017-07-13 01:00:00;24,37;22,91;1,46;41224;0;0;0;0;52621;20455;0.3887;19374;1081
2017-07-13 02:00:00;23,04;22,06;0,98;41224;0;0;0;0;52621;18320;0.3482;18377;-57
2017-07-13 03:00:00;24,76;20,92;3,84;41224;0;0;0;0;52621;16644;0.3163;17227;-583
2017-07-13 04:00:00;26,45;22,36;4,09;41224;0;0;0;0;52621;14974;0.2846;16104;-1130
2017-07-13 05:00:00;28,09;27,17;0,92;41224;117;0.0028;156;-39;52621;13550;0.2575;15081;-1531
2017-07-13 06:00:00;31,06;34,16;-3,1;41224;1429;0.0347;1361;68;52621;12485;0.2372;14148;-1663
2017-07-13 07:00:00;38,12;42,47;-4,35;41224;4629;0.1123;4386;243;52621;10920;0.2075;13319;-2399
2017-07-13 08:00:00;36,73;42,43;-5,7;41224;9370;0.2273;8806;564;52621;10398;0.1976;12707;-2309
2017-07-13 09:00:00;36,07;39,38;-3,31;41224;13661;0.3314;13493;168;52621;10501;0.1996;12125;-1624
2017-07-13 10:00:00;35,52;37,19;-1,67;41224;16834;0.4084;17742;-908;52621;10148;0.1928;11301;-1153
2017-07-13 11:00:00;34,96;39,22;-4,26;41224;19410;0.4709;21087;-1677;52621;9134;0.1736;10380;-1246
2017-07-13 12:00:00;30,26;37,06;-6,8;41224;21436;0.52;23214;-1778;52621;8388;0.1594;9515;-1127
2017-07-13 13:00:00;30,04;36,07;-6,03;41224;22562;0.5473;24095;-1533;52621;7933;0.1508;8777;-844
2017-07-13 14:00:00;29,07;32,78;-3,71;41224;22656;0.5496;23799;-1143;52621;7355;0.1397;8149;-794
2017-07-13 15:00:00;30,27;32,87;-2,6;41224;21476;0.5209;22074;-598;52621;6561;0.1247;7488;-927
2017-07-13 16:00:00;33,46;33,53;-0,07;41224;18521;0.4492;18747;-226;52621;5776;0.1097;6793;-1017
2017-07-13 17:00:00;38,08;39,74;-1,66;41224;14233;0.3453;14055;178;52621;4853;0.0922;5953;-1100
2017-07-13 18:00:00;41,35;42,16;-0,81;41224;8890;0.2157;8478;412;52621;3844;0.073;5003;-1159
2017-07-13 19:00:00;46,82;43,58;3,24;41224;3984;0.0966;3644;340;52621;2606;0.0495;4073;-1467
2017-07-13 20:00:00;45,09;42,91;2,18;41224;1148;0.0278;1084;64;52621;1794;0.0341;3389;-1595
2017-07-13 21:00:00;42,93;42,89;0,04;41224;52;0.0012;74;-22;52621;1530;0.0291;3034;-1504
2017-07-13 22:00:00;42,13;43,18;-1,05;41224;0;0;0;0;52621;1512;0.0287;2887;-1375
2017-07-13 23:00:00;38,12;40,31;-2,19;41224;0;0;0;0;52621;1538;0.0292;2791;-1253
2017-07-14 00:00:00;34,4;33,94;0,46;41229;0;0;0;0;52643;1508;0.0286;2236;-728
2017-07-14 01:00:00;32,34;32,01;0,33;41229;0;0;0;0;52643;1535;0.0292;2112;-577
2017-07-14 02:00:00;30,36;30,63;-0,27;41229;0;0;0;0;52643;1495;0.0284;2134;-639
2017-07-14 03:00:00;29,08;30,72;-1,64;41229;0;0;0;0;52643;1518;0.0288;2292;-774
2017-07-14 04:00:00;29,55;30,87;-1,32;41229;0;0;0;0;52643;1773;0.0337;2522;-749
2017-07-14 05:00:00;30,41;31,19;-0,78;41229;129;0.0031;150;-21;52643;2192;0.0417;2741;-549
2017-07-14 06:00:00;39,94;36,62;3,32;41229;1192;0.0289;1196;-4;52643;2478;0.0471;2905;-427
2017-07-14 07:00:00;44,99;41,05;3,94;41229;3718;0.0902;3737;-19;52643;2509;0.0477;2974;-465
2017-07-14 08:00:00;46,0;41,54;4,46;41229;7482;0.1815;7438;44;52643;2182;0.0414;2999;-817
2017-07-14 09:00:00;43,32;40,05;3,27;41229;12067;0.2927;11471;596;52643;1934;0.0367;3119;-1185
2017-07-14 10:00:00;41,62;38,54;3,08;41229;16169;0.3922;14884;1285;52643;2046;0.0388;3436;-1390
2017-07-14 11:00:00;38,94;37,06;1,88;41229;17791;0.4316;17304;487;52643;2030;0.0386;3900;-1870
2017-07-14 12:00:00;37,1;38,59;-1,49;41229;17316;0.42;18565;-1249;52643;2606;0.0495;4355;-1749
2017-07-14 13:00:00;35,97;37,24;-1,27;41229;16548;0.4014;18581;-2033;52643;3246;0.0617;4868;-1622
2017-07-14 14:00:00;31,91;33,66;-1,75;41229;15098;0.3662;17572;-2474;52643;3892;0.0739;5417;-1525
2017-07-14 15:00:00;30,34;34,62;-4,28;41229;13292;0.3224;15719;-2427;52643;4188;0.0796;6033;-1845
2017-07-14 16:00:00;31,29;36,21;-4,92;41229;11531;0.2797;13247;-1716;52643;4783;0.0908;6709;-1926
2017-07-14 17:00:00;36,92;39,03;-2,11;41229;8530;0.2068;10126;-1596;52643;5673;0.1078;7181;-1508
2017-07-14 18:00:00;40,93;41,34;-0,41;41229;5234;0.127;6387;-1153;52643;5591;0.1062;7492;-1901
2017-07-14 19:00:00;42,96;41,83;1,13;41229;2545;0.0617;3005;-460;52643;4664;0.0886;7958;-3294
2017-07-14 20:00:00;39,69;41,07;-1,38;41229;798;0.0194;911;-113;52643;4322;0.0821;8398;-4076
2017-07-14 21:00:00;39,1;39,94;-0,84;41229;38;0.0009;56;-18;52643;4304;0.0818;8546;-4242
2017-07-14 22:00:00;39,71;40,26;-0,55;41229;0;0;0;0;52643;5172;0.0982;8838;-3666
2017-07-14 23:00:00;36,65;38,06;-1,41;41229;0;0;0;0;52643;5726;0.1088;9225;-3499
2017-07-15 00:00:00;34,57;32,3;2,27;41230;0;0;0;0;52646;5835;0.1108;5541;294
2017-07-15 01:00:00;31,08;29,75;1,33;41230;0;0;0;0;52646;5570;0.1058;5718;-148
2017-07-15 02:00:00;30,82;27,82;3,0;41230;0;0;0;0;52646;5461;0.1037;5892;-431
2017-07-15 03:00:00;30,01;26,11;3,9;41230;0;0;0;0;52646;5616;0.1067;5881;-265
2017-07-15 04:00:00;29,4;25,44;3,96;41230;0;0;0;0;52646;5418;0.1029;5899;-481
2017-07-15 05:00:00;29,17;24,27;4,9;41230;94;0.0023;124;-30;52646;5116;0.0972;5807;-691
2017-07-15 06:00:00;30,46;28,0;2,46;41230;1154;0.028;1112;42;52646;4532;0.0861;5541;-1009
2017-07-15 07:00:00;30,82;28,52;2,3;41230;3858;0.0936;3635;223;52646;3666;0.0696;5153;-1487
2017-07-15 08:00:00;31,94;29,0;2,94;41230;7793;0.189;7285;508;52646;3067;0.0582;4634;-1567
2017-07-15 09:00:00;33,81;36,57;-2,76;41230;11669;0.283;11237;432;52646;2738;0.052;4067;-1329
2017-07-15 10:00:00;33,43;35,39;-1,96;41230;14644;0.3552;14634;10;52646;2480;0.0471;3548;-1068
2017-07-15 11:00:00;33,06;35,45;-2,39;41230;16244;0.394;17209;-965;52646;2317;0.044;3239;-922
2017-07-15 12:00:00;32,22;36,46;-4,24;41230;16786;0.4071;18729;-1943;52646;2428;0.0461;3163;-735
2017-07-15 13:00:00;30,76;34,5;-3,74;41230;16762;0.4066;18995;-2233;52646;2750;0.0523;3237;-487
2017-07-15 14:00:00;29,07;31,05;-1,98;41230;16672;0.4044;18251;-1579;52646;3216;0.0611;3447;-231
2017-07-15 15:00:00;28,64;29,86;-1,22;41230;15363;0.3726;16458;-1095;52646;3564;0.0677;3626;-62
2017-07-15 16:00:00;29,04;27,56;1,48;41230;12900;0.3129;13728;-828;52646;3678;0.0699;3761;-83
2017-07-15 17:00:00;30,98;30,26;0,72;41230;9983;0.2421;10253;-270;52646;3454;0.0656;3654;-200
2017-07-15 18:00:00;35,21;35,08;0,13;41230;6619;0.1606;6380;239;52646;2896;0.055;3225;-329
2017-07-15 19:00:00;37,54;36,2;1,34;41230;3245;0.0787;2990;255;52646;2286;0.0434;2741;-455
2017-07-15 20:00:00;37,0;35,54;1,46;41230;907;0.022;885;22;52646;1985;0.0377;2371;-386
2017-07-15 21:00:00;36,9;36,12;0,78;41230;39;0.001;54;-15;52646;1824;0.0346;2252;-428
2017-07-15 22:00:00;37,98;35,95;2,03;41230;0;0;0;0;52646;2130;0.0405;2348;-218
2017-07-15 23:00:00;36,01;32,99;3,02;41230;0;0;0;0;52646;2856;0.0542;2633;223
2017-07-16 00:00:00;34,65;30,08;4,57;41230;0;0;0;0;52655;3655;0.0694;2825;830
2017-07-16 01:00:00;30,05;27,48;2,57;41230;0;0;0;0;52655;4621;0.0878;3722;899
2017-07-16 02:00:00;28,68;25,85;2,83;41230;0;0;0;0;52655;5496;0.1044;4693;803
2017-07-16 03:00:00;27,78;23,65;4,13;41230;0;0;0;0;52655;6330;0.1202;5413;917
2017-07-16 04:00:00;27,72;22,68;5,04;41230;0;0;0;0;52655;6825;0.1296;5947;878
2017-07-16 05:00:00;27,4;19,82;7,58;41230;104;0.0025;141;-37;52655;6876;0.1306;6306;570
2017-07-16 06:00:00;27,53;20,09;7,44;41230;1253;0.0304;1198;55;52655;7228;0.1373;6505;723
2017-07-16 07:00:00;27,6;19,37;8,23;41230;4120;0.0999;3542;578;52655;7270;0.1381;6681;589
2017-07-16 08:00:00;27,4;20,79;6,61;41230;8192;0.1987;6597;1595;52655;7274;0.1381;6812;462
2017-07-16 09:00:00;28,49;22,77;5,72;41230;12143;0.2945;9595;2548;52655;7384;0.1402;6940;444
2017-07-16 10:00:00;28,99;21,91;7,08;41230;14968;0.3631;11889;3079;52655;7623;0.1448;7178;445
2017-07-16 11:00:00;28,99;21,16;7,83;41230;16460;0.3992;13399;3061;52655;7987;0.1517;7479;508
2017-07-16 12:00:00;29,76;19,41;10,35;41230;17220;0.4177;14143;3077;52655;8347;0.1585;7718;629
2017-07-16 13:00:00;26,95;17,19;9,76;41230;17339;0.4206;14146;3193;52655;8681;0.1648;7903;778
2017-07-16 14:00:00;25,99;14,99;11,0;41230;16473;0.3996;13518;2955;52655;8368;0.1589;7943;425
2017-07-16 15:00:00;25,22;16,15;9,07;41230;14589;0.3539;12227;2362;52655;8294;0.1575;7732;562
2017-07-16 16:00:00;27,55;22,13;5,42;41230;11992;0.2908;10249;1743;52655;8463;0.1607;7469;994
2017-07-16 17:00:00;28,57;26,85;1,72;41230;8916;0.2162;7727;1189;52655;7634;0.145;7069;565
2017-07-16 18:00:00;31,79;32,31;-0,52;41230;5479;0.1329;4846;633;52655;6602;0.1254;6577;25
2017-07-16 19:00:00;35,41;35,6;-0,19;41230;2540;0.0616;2256;284;52655;5873;0.1116;6139;-266
2017-07-16 20:00:00;36,65;36,73;-0,08;41230;672;0.0163;640;32;52655;5112;0.0971;5799;-687
2017-07-16 21:00:00;37,14;38,05;-0,91;41230;20;0.0005;36;-16;52655;4592;0.0872;5556;-964
2017-07-16 22:00:00;41,02;40,58;0,44;41230;0;0;0;0;52655;4586;0.0871;5414;-828
2017-07-16 23:00:00;38,79;38,25;0,54;41230;0;0;0;0;52655;4794;0.091;5295;-501
2017-07-17 00:00:00;31,47;36,1;-4,63;41234;0;0;0;0;52658;4608;0.0875;5589;-981
2017-07-17 01:00:00;30,11;35,28;-5,17;41234;0;0;0;0;52658;4666;0.0886;5457;-791
2017-07-17 02:00:00;29,32;32,86;-3,54;41234;0;0;0;0;52658;4625;0.0878;5420;-795
2017-07-17 03:00:00;27,57;32,41;-4,84;41234;0;0;0;0;52658;4826;0.0916;5310;-484
2017-07-17 04:00:00;27,92;32,36;-4,44;41234;0;0;0;0;52658;4656;0.0884;5141;-485
2017-07-17 05:00:00;29,21;34,14;-4,93;41234;73;0.0017;101;-28;52658;4377;0.0831;4858;-481
2017-07-17 06:00:00;36,89;41,53;-4,64;41234;1076;0.0261;1019;57;52658;3996;0.0759;4455;-459
2017-07-17 07:00:00;42,83;45,8;-2,97;41234;3743;0.0908;3456;287;52658;3150;0.0598;4062;-912
2017-07-17 08:00:00;42,97;46,84;-3,87;41234;7887;0.1913;7082;805;52658;2748;0.0522;3897;-1149
2017-07-17 09:00:00;42,3;42,99;-0,69;41234;12407;0.3009;11103;1304;52658;3178;0.0604;4010;-832
2017-07-17 10:00:00;42,4;41,58;0,82;41234;16143;0.3915;14669;1474;52658;3357;0.0638;4310;-953
2017-07-17 11:00:00;42,74;40,95;1,79;41234;18537;0.4496;17457;1080;52658;3632;0.069;4635;-1003
2017-07-17 12:00:00;40,85;38,83;2,02;41234;19848;0.4814;19314;534;52658;4233;0.0804;4905;-672
2017-07-17 13:00:00;36,95;37,39;-0,44;41234;20179;0.4894;19967;212;52658;4790;0.091;5144;-354
2017-07-17 14:00:00;35,98;35,0;0,98;41234;19452;0.4718;19405;47;52658;5177;0.0983;5352;-175
2017-07-17 15:00:00;35,3;33,57;1,73;41234;17913;0.4344;17732;181;52658;5488;0.1042;5433;55
2017-07-17 16:00:00;35,94;34,6;1,34;41234;15596;0.3782;15044;552;52658;5657;0.1074;5445;212
2017-07-17 17:00:00;39,94;41,55;-1,61;41234;12135;0.2943;11368;767;52658;5221;0.0992;5304;-83
2017-07-17 18:00:00;42,05;45,5;-3,45;41234;7808;0.1894;7016;792;52658;4398;0.0835;4962;-564
2017-07-17 19:00:00;44,95;46,93;-1,98;41234;3723;0.0903;3190;533;52658;3890;0.0738;4511;-621
2017-07-17 20:00:00;43,79;46,83;-3,04;41234;993;0.0241;941;52;52658;3202;0.0608;4089;-887
2017-07-17 21:00:00;40,98;45,88;-4,9;41234;38;0.001;55;-17;52658;3148;0.0598;3879;-731
2017-07-17 22:00:00;40,95;45,27;-4,32;41234;0;0;0;0;52658;3652;0.0694;3847;-195
2017-07-17 23:00:00;35,4;38,93;-3,53;41234;0;0;0;0;52658;3817;0.0725;3768;49
2017-07-18 00:00:00;33,69;35,77;-2,08;41240;0;0;0;0;52664;3712;0.0705;3417;295
2017-07-18 01:00:00;31,18;32,92;-1,74;41240;0;0;0;0;52664;3610;0.0686;3360;250
2017-07-18 02:00:00;29,85;30,56;-0,71;41240;0;0;0;0;52664;3481;0.0661;3380;101
2017-07-18 03:00:00;29,56;29,54;0,02;41240;0;0;0;0;52664;3297;0.0626;3312;-15
2017-07-18 04:00:00;30,28;30,01;0,27;41240;0;0;0;0;52664;2924;0.0555;3137;-213
2017-07-18 05:00:00;32,01;30,96;1,05;41240;93;0.0022;141;-48;52664;2667;0.0506;2841;-174
2017-07-18 06:00:00;37,72;39,68;-1,96;41240;1362;0.033;1363;-1;52664;2465;0.0468;2403;62
2017-07-18 07:00:00;40,91;43,77;-2,86;41240;4914;0.1192;4985;-71;52664;1903;0.0361;1818;85
2017-07-18 08:00:00;42,88;42,85;0,03;41240;10228;0.248;10493;-265;52664;1031;0.0196;1321;-290
2017-07-18 09:00:00;42,43;41,35;1,08;41240;15769;0.3824;16188;-419;52664;771;0.0146;1149;-378
2017-07-18 10:00:00;41,75;41,34;0,41;41240;20214;0.4902;20783;-569;52664;842;0.016;1156;-314
2017-07-18 11:00:00;38,92;41,1;-2,18;41240;23242;0.5636;23842;-600;52664;1050;0.02;1239;-189
2017-07-18 12:00:00;34,17;34,69;-0,52;41240;24722;0.5995;25459;-737;52664;1052;0.02;1345;-293
2017-07-18 13:00:00;34,12;34,22;-0,1;41240;24876;0.6032;25645;-769;52664;1032;0.0196;1402;-370
2017-07-18 14:00:00;33,69;34,33;-0,64;41240;23836;0.578;24381;-545;52664;1107;0.021;1483;-376
2017-07-18 15:00:00;34,62;35,64;-1,02;41240;21750;0.5274;21860;-110;52664;1212;0.023;1577;-365
2017-07-18 16:00:00;38,57;38,67;-0,1;41240;18402;0.4462;18243;159;52664;1346;0.0256;1708;-362
2017-07-18 17:00:00;42,97;41,15;1,82;41240;13696;0.3321;13403;293;52664;1617;0.0307;1985;-368
2017-07-18 18:00:00;45,79;43,46;2,33;41240;8416;0.2041;7939;477;52664;2034;0.0386;2449;-415
2017-07-18 19:00:00;46,89;46,17;0,72;41240;3762;0.0912;3433;329;52664;2516;0.0478;3091;-575
2017-07-18 20:00:00;43,97;44,94;-0,97;41240;993;0.0241;1003;-10;52664;3329;0.0632;3983;-654
2017-07-18 21:00:00;42,99;44,85;-1,86;41240;38;0.0009;58;-20;52664;5682;0.1079;5294;388
2017-07-18 22:00:00;40,83;41,94;-1,11;41240;0;0;0;0;52664;8196;0.1556;6617;1579
2017-07-18 23:00:00;33,95;30,26;3,69;41240;0;0;0;0;52664;9700;0.1842;7376;2324
2017-07-19 00:00:00;30,93;30,26;0,67;41244;0;0;0;0;52679;10107;0.1918;7508;2599
2017-07-19 01:00:00;29,59;27,99;1,6;41244;0;0;0;0;52679;10028;0.1904;7600;2428
2017-07-19 02:00:00;28,62;27,94;0,68;41244;0;0;0;0;52679;10132;0.1923;7639;2493
2017-07-19 03:00:00;27,3;28,07;-0,77;41244;0;0;0;0;52679;10023;0.1902;7672;2351
2017-07-19 04:00:00;27,63;28,17;-0,54;41244;0;0;0;0;52679;9684;0.1838;7630;2054
2017-07-19 05:00:00;29,03;29,66;-0,63;41244;83;0.002;126;-43;52679;9534;0.181;7512;2022
2017-07-19 06:00:00;37,96;38,82;-0,86;41244;1308;0.0317;1277;31;52679;8897;0.1689;7222;1675
2017-07-19 07:00:00;42,16;43,15;-0,99;41244;4840;0.1174;4919;-79;52679;7351;0.1396;6588;763
2017-07-19 08:00:00;42,91;44,65;-1,74;41244;10227;0.248;10563;-336;52679;5944;0.1128;5936;8
2017-07-19 09:00:00;40,08;44,28;-4,2;41244;15876;0.3849;16325;-449;52679;5760;0.1094;5736;24
2017-07-19 10:00:00;37,93;42,05;-4,12;41244;20695;0.5018;21057;-362;52679;6197;0.1176;5817;380
2017-07-19 11:00:00;34,55;41,25;-6,7;41244;24065;0.5835;24269;-204;52679;7409;0.1406;6086;1323
2017-07-19 12:00:00;31,7;33,09;-1,39;41244;25677;0.6226;25667;10;52679;8904;0.169;6707;2197
2017-07-19 13:00:00;31,71;30,59;1,12;41244;25576;0.6201;25419;157;52679;9026;0.1713;7342;1684
2017-07-19 14:00:00;32,9;28,23;4,67;41244;23953;0.5808;23824;129;52679;9241;0.1754;7691;1550
2017-07-19 15:00:00;36,54;30,69;5,85;41244;20922;0.5072;21036;-114;52679;9401;0.1785;7653;1748
2017-07-19 16:00:00;38,03;32,54;5,49;41244;16790;0.4071;17419;-629;52679;9596;0.1822;7558;2038
2017-07-19 17:00:00;40,52;39,89;0,63;41244;11854;0.2874;12709;-855;52679;9712;0.1844;7741;1971
2017-07-19 18:00:00;42,97;43,68;-0,71;41244;6699;0.1624;7432;-733;52679;10148;0.1926;8374;1774
2017-07-19 19:00:00;44,0;44,35;-0,35;41244;2882;0.0699;3189;-307;52679;10854;0.206;9354;1500
2017-07-19 20:00:00;42,16;41,82;0,34;41244;760;0.0184;897;-137;52679;12163;0.2309;10279;1884
2017-07-19 21:00:00;40,58;39,8;0,78;41244;31;0.0007;47;-16;52679;13788;0.2617;11029;2759
2017-07-19 22:00:00;39,09;38,86;0,23;41244;0;0;0;0;52679;14425;0.2738;11480;2945
2017-07-19 23:00:00;32,97;32,98;-0,01;41244;0;0;0;0;52679;13675;0.2596;11155;2520
2017-07-20 00:00:00;30,54;30,29;0,25;41254;0;0;0;0;52703;12077;0.2292;11118;959
2017-07-20 01:00:00;31,46;31,62;-0,16;41254;0;0;0;0;52703;10066;0.191;10191;-125
2017-07-20 02:00:00;29,6;31,43;-1,83;41254;0;0;0;0;52703;8801;0.167;9259;-458
2017-07-20 03:00:00;28,1;29,6;-1,5;41254;0;0;0;0;52703;8180;0.1552;8499;-319
2017-07-20 04:00:00;28,52;29,35;-0,83;41254;0;0;0;0;52703;8095;0.1536;7884;211
2017-07-20 05:00:00;30,32;29,52;0,8;41254;60;0.0014;91;-31;52703;7303;0.1386;7329;-26
2017-07-20 06:00:00;38,27;34,75;3,52;41254;920;0.0223;975;-55;52703;6468;0.1227;6826;-358
2017-07-20 07:00:00;47,26;41,67;5,59;41254;3013;0.073;3294;-281;52703;5643;0.1071;6302;-659
2017-07-20 08:00:00;43,26;43,03;0,23;41254;6482;0.1571;6444;38;52703;5405;0.1026;5850;-445
2017-07-20 09:00:00;43,25;43,58;-0,33;41254;10187;0.247;9629;558;52703;4709;0.0894;5642;-933
2017-07-20 10:00:00;41,73;42,55;-0,82;41254;12593;0.3052;12305;288;52703;4498;0.0854;5655;-1157
2017-07-20 11:00:00;41,93;42,41;-0,48;41254;14338;0.3475;14337;1;52703;5020;0.0952;5900;-880
2017-07-20 12:00:00;40,0;40,33;-0,33;41254;15342;0.3719;15602;-260;52703;5374;0.102;6211;-837
2017-07-20 13:00:00;38,36;40,36;-2,0;41254;14808;0.359;16099;-1291;52703;5539;0.1051;6535;-996
2017-07-20 14:00:00;36,9;41,76;-4,86;41254;13855;0.3358;15930;-2075;52703;6014;0.1141;6808;-794
2017-07-20 15:00:00;35,74;39,5;-3,76;41254;12783;0.3099;14795;-2012;52703;6310;0.1198;6910;-600
2017-07-20 16:00:00;34,48;37,2;-2,72;41254;11084;0.2687;12623;-1539;52703;6644;0.1261;6739;-95
2017-07-20 17:00:00;36,97;38,82;-1,85;41254;8915;0.2161;9637;-722;52703;7154;0.1358;6347;807
2017-07-20 18:00:00;39,77;38,64;1,13;41254;5855;0.1419;6077;-222;52703;7408;0.1406;5754;1654
2017-07-20 19:00:00;41,93;38,23;3,7;41254;2931;0.071;2858;73;52703;7120;0.1351;5156;1964
2017-07-20 20:00:00;41,05;38,29;2,76;41254;767;0.0186;808;-41;52703;5930;0.1125;5007;923
2017-07-20 21:00:00;40,11;36,58;3,53;41254;21;0.0005;39;-18;52703;6192;0.1175;5307;885
2017-07-20 22:00:00;39,74;35,98;3,76;41254;0;0;0;0;52703;7444;0.1412;6073;1371
2017-07-20 23:00:00;34,29;28,26;6,03;41254;0;0;0;0;52703;9176;0.1741;6684;2492
2017-07-21 00:00:00;29,65;28,29;1,36;41261;0;0;0;0;52731;9623;0.1825;9575;48
2017-07-21 01:00:00;29,1;27,97;1,13;41261;0;0;0;0;52731;9648;0.183;10015;-367
2017-07-21 02:00:00;28,42;27,02;1,4;41261;0;0;0;0;52731;8877;0.1684;10028;-1151
2017-07-21 03:00:00;27,07;26,18;0,89;41261;0;0;0;0;52731;8125;0.1541;9307;-1182
2017-07-21 04:00:00;27,32;26,03;1,29;41261;0;0;0;0;52731;7585;0.1438;8106;-521
2017-07-21 05:00:00;29,99;28,67;1,32;41261;66;0.0016;100;-34;52731;6438;0.1221;6760;-322
2017-07-21 06:00:00;36,8;35,03;1,77;41261;1213;0.0294;1162;51;52731;5308;0.1006;5345;-37
2017-07-21 07:00:00;40,06;37,54;2,52;41261;4497;0.109;4203;294;52731;3948;0.0748;4160;-212
2017-07-21 08:00:00;41,83;37,92;3,91;41261;9394;0.2277;8906;488;52731;3014;0.0572;3274;-260
2017-07-21 09:00:00;40,87;33,4;7,47;41261;14592;0.3536;13917;675;52731;2400;0.0455;2758;-358
2017-07-21 10:00:00;38,44;35,57;2,87;41261;19340;0.4687;18094;1246;52731;1989;0.0377;2461;-472
2017-07-21 11:00:00;39,04;35,98;3,06;41261;22382;0.5424;21021;1361;52731;1772;0.0336;2153;-381
2017-07-21 12:00:00;35,98;33,44;2,54;41261;23805;0.577;22689;1116;52731;1520;0.0288;1914;-394
2017-07-21 13:00:00;32,94;32,2;0,74;41261;23836;0.5777;23064;772;52731;1366;0.0259;1672;-306
2017-07-21 14:00:00;32,87;32,29;0,58;41261;22708;0.5503;22155;553;52731;1226;0.0232;1453;-227
2017-07-21 15:00:00;32,9;32,32;0,58;41261;20360;0.4934;19980;380;52731;1150;0.0218;1278;-128
2017-07-21 16:00:00;35,11;34,25;0,86;41261;17037;0.4129;16594;443;52731;1201;0.0228;1148;53
2017-07-21 17:00:00;39,01;35,36;3,65;41261;12828;0.3109;12135;693;52731;1396;0.0265;1153;243
2017-07-21 18:00:00;41,42;36,99;4,43;41261;7928;0.1922;7241;687;52731;1682;0.0319;1368;314
2017-07-21 19:00:00;42,63;38,12;4,51;41261;3452;0.0836;3169;283;52731;2195;0.0416;1840;355
2017-07-21 20:00:00;42,01;38,08;3,93;41261;804;0.0194;879;-75;52731;3130;0.0594;2757;373
2017-07-21 21:00:00;40,57;36,55;4,02;41261;22;0.0005;42;-20;52731;4932;0.0935;4269;663
2017-07-21 22:00:00;41,38;36,5;4,88;41261;0;0;0;0;52731;7274;0.138;5881;1393
2017-07-21 23:00:00;36,79;31,99;4,8;41261;0;0;0;0;52731;10176;0.193;7073;3103
2017-07-22 00:00:00;32,2;27,54;4,66;41261;0;0;0;0;52734;11865;0.225;7276;4589
2017-07-22 01:00:00;31,57;24,6;6,97;41261;0;0;0;0;52734;12030;0.2281;7535;4495
2017-07-22 02:00:00;29,92;24,65;5,27;41261;0;0;0;0;52734;10780;0.2044;7654;3126
2017-07-22 03:00:00;28,74;25,33;3,41;41261;0;0;0;0;52734;10182;0.1931;7508;2674
2017-07-22 04:00:00;28,75;26,17;2,58;41261;0;0;0;0;52734;9659;0.1832;7284;2375
2017-07-22 05:00:00;28,54;24,96;3,58;41261;60;0.0014;82;-22;52734;9201;0.1745;7035;2166
2017-07-22 06:00:00;29,7;27,44;2,26;41261;921;0.0223;953;-32;52734;8080;0.1532;6625;1455
2017-07-22 07:00:00;30,92;28,41;2,51;41261;3073;0.0745;3451;-378;52734;6350;0.1204;5941;409
2017-07-22 08:00:00;34,96;34,68;0,28;41261;6135;0.1487;7122;-987;52734;5132;0.0973;5318;-186
2017-07-22 09:00:00;36,47;36,41;0,06;41261;10361;0.2511;11101;-740;52734;4408;0.0836;5050;-642
2017-07-22 10:00:00;35,69;35,54;0,15;41261;14397;0.3489;14673;-276;52734;4281;0.0812;4896;-615
2017-07-22 11:00:00;34,66;35,82;-1,16;41261;17566;0.4257;17541;25;52734;4226;0.0802;4905;-679
2017-07-22 12:00:00;32,25;34,85;-2,6;41261;19150;0.4641;19247;-97;52734;4502;0.0854;4992;-490
2017-07-22 13:00:00;30,02;30,86;-0,84;41261;19547;0.4737;19518;29;52734;4882;0.0926;5102;-220
2017-07-22 14:00:00;29,48;31,57;-2,09;41261;18844;0.4567;18803;41;52734;5666;0.1074;5132;534
2017-07-22 15:00:00;29,9;29,92;-0,02;41261;16886;0.4092;17079;-193;52734;6376;0.1209;5003;1373
2017-07-22 16:00:00;30,55;27,91;2,64;41261;13818;0.3349;14424;-606;52734;6419;0.1217;4931;1488
2017-07-22 17:00:00;33,25;30,86;2,39;41261;10314;0.25;10806;-492;52734;6408;0.1215;4971;1437
2017-07-22 18:00:00;38,52;35,8;2,72;41261;6458;0.1565;6601;-143;52734;6518;0.1236;5157;1361
2017-07-22 19:00:00;39,89;36,48;3,41;41261;2970;0.072;2954;16;52734;6621;0.1256;5540;1081
2017-07-22 20:00:00;39,0;35,32;3,68;41261;726;0.0176;802;-76;52734;6595;0.125;5995;600
2017-07-22 21:00:00;38,09;35,73;2,36;41261;16;0.0004;35;-19;52734;6394;0.1212;6573;-179
2017-07-22 22:00:00;40,0;35,77;4,23;41261;0;0;0;0;52734;7365;0.1396;7123;242
2017-07-22 23:00:00;36,67;34,61;2,06;41261;0;0;0;0;52734;8401;0.1593;7400;1001
2017-07-23 00:00:00;32,99;26,99;6,0;41261;0;0;0;0;52734;8806;0.167;5768;3038
2017-07-23 01:00:00;28,78;23,49;5,29;41261;0;0;0;0;52734;8764;0.1662;6012;2752
2017-07-23 02:00:00;26,69;20,43;6,26;41261;0;0;0;0;52734;8453;0.1603;6271;2182
2017-07-23 03:00:00;24,68;16,95;7,73;41261;0;0;0;0;52734;8328;0.158;6430;1898
2017-07-23 04:00:00;23,07;16,78;6,29;41261;0;0;0;0;52734;8004;0.1518;6659;1345
2017-07-23 05:00:00;23,96;17,47;6,49;41261;42;0.001;65;-23;52734;7790;0.1477;6675;1115
2017-07-23 06:00:00;23,9;15,23;8,67;41261;684;0.0166;857;-173;52734;7578;0.1437;6559;1019
2017-07-23 07:00:00;25,17;15,12;10,05;41261;2581;0.0625;3116;-535;52734;7389;0.1401;6735;654
2017-07-23 08:00:00;25,78;19,87;5,91;41261;5374;0.1302;6364;-990;52734;8680;0.1646;7240;1440
2017-07-23 09:00:00;26,67;18,8;7,87;41261;8487;0.2056;9782;-1295;52734;10104;0.1916;7868;2236
2017-07-23 10:00:00;26,87;16,83;10,04;41261;11800;0.286;12853;-1053;52734;12042;0.2283;8694;3348
2017-07-23 11:00:00;27,18;16,37;10,81;41261;14144;0.3428;15441;-1297;52734;13445;0.255;9598;3847
2017-07-23 12:00:00;27,89;13,91;13,98;41261;15838;0.3838;17211;-1373;52734;14514;0.2752;10470;4044
2017-07-23 13:00:00;26,3;13,47;12,83;41261;16602;0.4024;17904;-1302;52734;15189;0.288;11325;3864
2017-07-23 14:00:00;22,76;11,34;11,42;41261;16254;0.3939;17665;-1411;52734;14800;0.2807;11846;2954
2017-07-23 15:00:00;20,34;12,32;8,02;41261;15428;0.3739;16411;-983;52734;14153;0.2684;11744;2409
2017-07-23 16:00:00;23,07;12,76;10,31;41261;13659;0.331;13941;-282;52734;12699;0.2408;11260;1439
2017-07-23 17:00:00;27,05;19,11;7,94;41261;10461;0.2535;10478;-17;52734;11235;0.2131;10149;1086
2017-07-23 18:00:00;29,62;21,3;8,32;41261;6378;0.1546;6435;-57;52734;8914;0.169;8430;484
2017-07-23 19:00:00;37,05;32,22;4,83;41261;2928;0.071;2895;33;52734;6180;0.1172;6670;-490
2017-07-23 20:00:00;38,51;35,61;2,9;41261;666;0.0162;788;-122;52734;3970;0.0753;5320;-1350
2017-07-23 21:00:00;39,42;37,52;1,9;41261;13;0.0003;30;-17;52734;3086;0.0585;4651;-1565
2017-07-23 22:00:00;42,85;45,11;-2,26;41261;0;0;0;0;52734;3104;0.0589;4472;-1368
2017-07-23 23:00:00;39,82;38,76;1,06;41261;0;0;0;0;52734;2981;0.0565;4439;-1458
2017-07-24 00:00:00;39,65;33,88;5,77;41264;0;0;0;0;52748;2749;0.0521;3422;-673
2017-07-24 01:00:00;35,62;29,82;5,8;41264;0;0;0;0;52748;2415;0.0458;3324;-909
2017-07-24 02:00:00;32,7;28,52;4,18;41264;0;0;0;0;52748;2120;0.0402;3228;-1108
2017-07-24 03:00:00;31,28;27,81;3,47;41264;0;0;0;0;52748;1502;0.0285;2891;-1389
2017-07-24 04:00:00;30,46;27,78;2,68;41264;0;0;0;0;52748;996;0.0189;2497;-1501
2017-07-24 05:00:00;33,24;29,01;4,23;41264;47;0.0012;70;-23;52748;1097;0.0208;2186;-1089
2017-07-24 06:00:00;41,9;37,64;4,26;41264;765;0.0186;805;-40;52748;1203;0.0228;1987;-784
2017-07-24 07:00:00;44,18;42,94;1,24;41264;2671;0.0647;2756;-85;52748;1360;0.0258;1831;-471
2017-07-24 08:00:00;44,12;51,61;-7,49;41264;5109;0.1238;5408;-299;52748;1406;0.0267;1756;-350
2017-07-24 09:00:00;48,23;53,99;-5,76;41264;7363;0.1784;7999;-636;52748;1664;0.0316;1873;-209
2017-07-24 10:00:00;48,45;54,45;-6,0;41264;9271;0.2246;9871;-600;52748;1909;0.0362;2162;-253
2017-07-24 11:00:00;47,77;53,52;-5,75;41264;10358;0.251;10958;-600;52748;2256;0.0428;2418;-162
2017-07-24 12:00:00;46,47;49,33;-2,86;41264;10652;0.2582;11405;-753;52748;2874;0.0545;2570;304
2017-07-24 13:00:00;44,91;45,51;-0,6;41264;10204;0.2473;11197;-993;52748;3544;0.0672;2673;871
2017-07-24 14:00:00;42,29;42,92;-0,63;41264;9948;0.2411;10524;-576;52748;3959;0.075;2742;1217
2017-07-24 15:00:00;40,94;39,3;1,64;41264;8988;0.2178;9321;-333;52748;4198;0.0796;2956;1242
2017-07-24 16:00:00;39,2;37,05;2,15;41264;7737;0.1875;7583;154;52748;4285;0.0812;3286;999
2017-07-24 17:00:00;39,7;36,34;3,36;41264;6118;0.1483;5577;541;52748;4468;0.0847;3686;782
2017-07-24 18:00:00;38,18;37,43;0,75;41264;4062;0.0984;3487;575;52748;4730;0.0897;4123;607
2017-07-24 19:00:00;38,66;37,0;1,66;41264;1908;0.0462;1636;272;52748;4982;0.0944;4490;492
2017-07-24 20:00:00;36,43;36,09;0,34;41264;481;0.0116;442;39;52748;5202;0.0986;4813;389
2017-07-24 21:00:00;34,73;35,87;-1,14;41264;12;0.0003;15;-3;52748;5776;0.1095;5068;708
2017-07-24 22:00:00;34,59;35,28;-0,69;41264;0;0;0;0;52748;6124;0.1161;5246;878
2017-07-24 23:00:00;30,39;28,8;1,59;41264;0;0;0;0;52748;6377;0.1209;5337;1040
2017-07-25 00:00:00;31,01;28,98;2,03;41269;0;0;0;0;52773;6687;0.1267;5697;990
2017-07-25 01:00:00;28,96;25,05;3,91;41269;0;0;0;0;52773;7101;0.1346;5814;1287
2017-07-25 02:00:00;27,09;23,64;3,45;41269;0;0;0;0;52773;7436;0.1409;6102;1334
2017-07-25 03:00:00;27,47;22,61;4,86;41269;0;0;0;0;52773;7808;0.148;6357;1451
2017-07-25 04:00:00;26,04;22,26;3,78;41269;0;0;0;0;52773;8171;0.1548;6682;1489
2017-07-25 05:00:00;26,21;24,6;1,61;41269;15;0.0004;29;-14;52773;8733;0.1655;7082;1651
2017-07-25 06:00:00;31,63;28,74;2,89;41269;374;0.009;448;-74;52773;9335;0.1769;7452;1883
2017-07-25 07:00:00;37,96;34,03;3,93;41269;1414;0.0342;1731;-317;52773;9948;0.1885;7750;2198
2017-07-25 08:00:00;39,48;35,1;4,38;41269;2856;0.0692;3543;-687;52773;10246;0.1942;8067;2179
2017-07-25 09:00:00;40,06;35,93;4,13;41269;4663;0.113;5456;-793;52773;10157;0.1925;8354;1803
2017-07-25 10:00:00;40,37;36,83;3,54;41269;6290;0.1524;7123;-833;52773;10455;0.1981;8628;1827
2017-07-25 11:00:00;40,8;37,96;2,84;41269;8207;0.1989;8346;-139;52773;10632;0.2014;8817;1815
2017-07-25 12:00:00;39,75;34,69;5,06;41269;9192;0.2227;9091;101;52773;11589;0.2196;8961;2628
2017-07-25 13:00:00;38,94;31,7;7,24;41269;9202;0.223;9077;125;52773;12550;0.2378;9017;3533
2017-07-25 14:00:00;36,98;30,18;6,8;41269;8444;0.2046;8575;-131;52773;12888;0.2442;9203;3685
2017-07-25 15:00:00;36,43;29,77;6,66;41269;7212;0.1748;7661;-449;52773;14009;0.2655;9388;4621
2017-07-25 16:00:00;34,97;29,61;5,36;41269;6004;0.1455;6128;-124;52773;14390;0.2727;9656;4734
2017-07-25 17:00:00;34,99;28,8;6,19;41269;4333;0.105;4409;-76;52773;15074;0.2856;9763;5311
2017-07-25 18:00:00;36,95;29,15;7,8;41269;2562;0.0621;2690;-128;52773;15243;0.2888;9617;5626
2017-07-25 19:00:00;35,4;31,04;4,36;41269;1070;0.026;1183;-113;52773;15251;0.289;9450;5801
2017-07-25 20:00:00;33,78;28,96;4,82;41269;201;0.0049;283;-82;52773;15102;0.2862;9415;5687
2017-07-25 21:00:00;32,96;26,58;6,38;41269;2;0;9;-7;52773;14755;0.2796;9502;5253
2017-07-25 22:00:00;32,21;26,99;5,22;41269;0;0;0;0;52773;14387;0.2726;9676;4711
2017-07-25 23:00:00;29,01;25,44;3,57;41269;0;0;0;0;52773;14117;0.2675;9810;4307
2017-07-26 00:00:00;25,74;28,41;-2,67;41275;0;0;0;0;52814;13836;0.262;14306;-470
2017-07-26 01:00:00;25,24;28,37;-3,13;41275;0;0;0;0;52814;13508;0.2558;14494;-986
2017-07-26 02:00:00;22,64;26,72;-4,08;41275;0;0;0;0;52814;13307;0.252;14682;-1375
2017-07-26 03:00:00;21,12;27,42;-6,3;41275;0;0;0;0;52814;13295;0.2517;14582;-1287
2017-07-26 04:00:00;21,23;28,28;-7,05;41275;0;0;0;0;52814;12940;0.245;14440;-1500
2017-07-26 05:00:00;26,16;29,85;-3,69;41275;11;0.0002;20;-9;52814;12713;0.2407;14168;-1455
2017-07-26 06:00:00;29,08;33,52;-4,44;41275;260;0.0063;284;-24;52814;13109;0.2482;13705;-596
2017-07-26 07:00:00;34,49;39,55;-5,06;41275;1178;0.0285;1118;60;52814;13048;0.2471;13173;-125
2017-07-26 08:00:00;37,78;41,89;-4,11;41275;2708;0.0656;2619;89;52814;12152;0.2301;12688;-536
2017-07-26 09:00:00;37,92;42,02;-4,1;41275;4631;0.1122;4593;38;52814;11452;0.2169;12375;-923
2017-07-26 10:00:00;37,96;42,36;-4,4;41275;6624;0.1605;6451;173;52814;11073;0.2097;12106;-1033
2017-07-26 11:00:00;38,08;42,05;-3,97;41275;8051;0.195;8087;-36;52814;11074;0.2097;11770;-696
2017-07-26 12:00:00;37,96;40,42;-2,46;41275;9063;0.2196;9044;19;52814;11179;0.2117;11464;-285
2017-07-26 13:00:00;37,73;38,69;-0,96;41275;9541;0.2312;9340;201;52814;11366;0.2152;11087;279
2017-07-26 14:00:00;36,08;38,68;-2,6;41275;9554;0.2315;9295;259;52814;11111;0.2104;10748;363
2017-07-26 15:00:00;35,23;37,42;-2,19;41275;9152;0.2217;8673;479;52814;10584;0.2004;10366;218
2017-07-26 16:00:00;34,38;36,32;-1,94;41275;8372;0.2028;7455;917;52814;10200;0.1931;9932;268
2017-07-26 17:00:00;35,27;35,54;-0,27;41275;6756;0.1637;5856;900;52814;9549;0.1808;9334;215
2017-07-26 18:00:00;36,39;35,78;0,61;41275;4452;0.1078;3839;613;52814;8231;0.1558;8505;-274
2017-07-26 19:00:00;37,94;38,08;-0,14;41275;2134;0.0517;1773;361;52814;6838;0.1295;7676;-838
2017-07-26 20:00:00;36,93;37,41;-0,48;41275;530;0.0128;492;38;52814;5974;0.1131;7103;-1129
2017-07-26 21:00:00;35,93;38,47;-2,54;41275;16;0.0004;20;-4;52814;6299;0.1192;6938;-639
2017-07-26 22:00:00;35,75;37,38;-1,63;41275;0;0;0;0;52814;6715;0.1272;7026;-311
2017-07-26 23:00:00;30,07;33,8;-3,73;41275;0;0;0;0;52814;7865;0.149;7204;661
2017-07-27 00:00:00;28,75;29,25;-0,5;41286;0;0;0;0;52876;8892;0.1682;7456;1436
2017-07-27 01:00:00;26,7;26,47;0,23;41286;0;0;0;0;52876;9727;0.184;8320;1407
2017-07-27 02:00:00;24,85;24,07;0,78;41286;0;0;0;0;52876;10047;0.19;9058;989
2017-07-27 03:00:00;23,69;23,93;-0,24;41286;0;0;0;0;52876;10335;0.1955;9375;960
2017-07-27 04:00:00;24,48;21,62;2,86;41286;0;0;0;0;52876;10340;0.1956;9384;956
2017-07-27 05:00:00;27,02;22,66;4,36;41286;28;0.0007;46;-18;52876;10228;0.1934;9055;1173
2017-07-27 06:00:00;29,19;28,19;1,0;41286;726;0.0176;647;79;52876;9420;0.1781;8493;927
2017-07-27 07:00:00;35,31;35,36;-0,05;41286;2780;0.0673;2297;483;52876;7868;0.1488;7883;-15
2017-07-27 08:00:00;37,91;36,63;1,28;41286;5550;0.1344;4607;943;52876;6968;0.1318;7388;-420
2017-07-27 09:00:00;37,89;36,07;1,82;41286;7716;0.1869;7056;660;52876;7208;0.1363;7260;-52
2017-07-27 10:00:00;38,05;37,01;1,04;41286;9370;0.227;9046;324;52876;7491;0.1416;8048;-557
2017-07-27 11:00:00;38,48;38,33;0,15;41286;10406;0.252;10552;-146;52876;8046;0.1522;8689;-643
2017-07-27 12:00:00;38,5;39,49;-0,99;41286;11016;0.2668;11348;-332;52876;8251;0.156;9044;-793
2017-07-27 13:00:00;38,03;39,63;-1,6;41286;11490;0.2783;11325;165;52876;8514;0.161;9311;-797
2017-07-27 14:00:00;36,0;37,86;-1,86;41286;11355;0.275;10931;424;52876;8519;0.1611;9442;-923
2017-07-27 15:00:00;34,52;36,27;-1,75;41286;10646;0.2579;10001;645;52876;8172;0.1546;9239;-1067
2017-07-27 16:00:00;35,29;35,51;-0,22;41286;9386;0.2273;8363;1023;52876;7449;0.1409;8907;-1458
2017-07-27 17:00:00;35,74;37,3;-1,56;41286;7239;0.1753;6246;993;52876;6283;0.1188;8518;-2235
2017-07-27 18:00:00;37,32;38,82;-1,5;41286;4638;0.1124;3954;684;52876;5438;0.1028;7797;-2359
2017-07-27 19:00:00;38,98;38,63;0,35;41286;2000;0.0484;1848;152;52876;4669;0.0883;6653;-1984
2017-07-27 20:00:00;38,06;37,63;0,43;41286;389;0.0094;467;-78;52876;4089;0.0774;5769;-1680
2017-07-27 21:00:00;36,87;38,52;-1,65;41286;7;0.0002;14;-7;52876;4516;0.0854;5564;-1048
2017-07-27 22:00:00;36,55;37,13;-0,58;41286;0;0;0;0;52876;4794;0.0906;5853;-1059
2017-07-27 23:00:00;31,62;35,12;-3,5;41286;0;0;0;0;52876;5378;0.1017;6165;-787
2017-07-28 00:00:00;33,86;33,31;0,55;41299;0;0;0;0;52957;5895;0.1113;6316;-421
2017-07-28 01:00:00;29,04;27,93;1,11;41299;0;0;0;0;52957;6132;0.1158;6595;-463
2017-07-28 02:00:00;28,1;26,7;1,4;41299;0;0;0;0;52957;6426;0.1214;6987;-561
2017-07-28 03:00:00;26,8;27,03;-0,23;41299;0;0;0;0;52957;7124;0.1345;7265;-141
2017-07-28 04:00:00;26,46;25,86;0,6;41299;0;0;0;0;52957;7706;0.1455;7478;228
2017-07-28 05:00:00;27,48;25,77;1,71;41299;32;0.0008;45;-13;52957;8238;0.1556;7618;620
2017-07-28 06:00:00;32,13;32,63;-0,5;41299;847;0.0205;778;69;52957;8770;0.1656;7857;913
2017-07-28 07:00:00;38,0;35,62;2,38;41299;3626;0.0878;3102;524;52957;7666;0.1448;8147;-481
2017-07-28 08:00:00;38,8;37,5;1,3;41299;7730;0.1872;6718;1012;52957;7787;0.1471;8873;-1086
2017-07-28 09:00:00;37,05;37,83;-0,78;41299;12081;0.2925;10751;1330;52957;9678;0.1828;10567;-889
2017-07-28 10:00:00;35,5;35,28;0,22;41299;15664;0.3793;14244;1420;52957;12199;0.2304;12741;-542
2017-07-28 11:00:00;31,0;31,57;-0,57;41299;17680;0.4281;16746;934;52957;15526;0.2932;14724;802
2017-07-28 12:00:00;27,51;29,62;-2,11;41299;17918;0.4338;18104;-186;52957;18518;0.3497;16239;2279
2017-07-28 13:00:00;25,17;25,76;-0,59;41299;17336;0.4198;18322;-986;52957;19652;0.3711;17298;2354
2017-07-28 14:00:00;23,69;21,77;1,92;41299;16858;0.4082;17578;-720;52957;19869;0.3752;17927;1942
2017-07-28 15:00:00;24,34;21,4;2,94;41299;15937;0.3859;15762;175;52957;19443;0.3671;18065;1378
2017-07-28 16:00:00;26,31;22,58;3,73;41299;13968;0.3382;13249;719;52957;18874;0.3564;17698;1176
2017-07-28 17:00:00;28,87;23,22;5,65;41299;10594;0.2565;9951;643;52957;17543;0.3312;16457;1086
2017-07-28 18:00:00;34,15;28,33;5,82;41299;6542;0.1584;5934;608;52957;14870;0.2808;14362;508
2017-07-28 19:00:00;36,96;34,25;2,71;41299;2754;0.0667;2487;267;52957;11969;0.226;12168;-199
2017-07-28 20:00:00;36,94;34,89;2,05;41299;526;0.0128;583;-57;52957;9278;0.1752;10598;-1320
2017-07-28 21:00:00;36,3;35,09;1,21;41299;4;0.0001;14;-10;52957;8495;0.1604;9862;-1367
2017-07-28 22:00:00;35,95;35,57;0,38;41299;0;0;0;0;52957;8289;0.1565;9730;-1441
2017-07-28 23:00:00;32,24;34,23;-1,99;41299;0;0;0;0;52957;9070;0.1713;9931;-861
2017-07-29 00:00:00;27,77;27,94;-0,17;41303;0;0;0;0;52970;9737;0.1839;10367;-630
2017-07-29 01:00:00;23,35;18,3;5,05;41303;0;0;0;0;52970;10584;0.1998;11073;-489
2017-07-29 02:00:00;18,99;15,71;3,28;41303;0;0;0;0;52970;11908;0.2248;11877;31
2017-07-29 03:00:00;14,17;9,98;4,19;41303;0;0;0;0;52970;12720;0.2402;12641;79
2017-07-29 04:00:00;10,04;9,04;1,0;41303;0;0;0;0;52970;13263;0.2504;13422;-159
2017-07-29 05:00:00;11,89;10,12;1,77;41303;23;0.0006;41;-18;52970;14114;0.2664;14283;-169
2017-07-29 06:00:00;14,41;11,05;3,36;41303;690;0.0167;783;-93;52970;15690;0.2962;15135;555
2017-07-29 07:00:00;17,11;11,28;5,83;41303;3166;0.0766;3305;-139;52970;16750;0.3162;15953;797
2017-07-29 08:00:00;19,78;12,78;7,0;41303;7312;0.177;7294;18;52970;17080;0.3225;16697;383
2017-07-29 09:00:00;18,05;14,88;3,17;41303;11930;0.2888;11611;319;52970;18080;0.3413;17376;704
2017-07-29 10:00:00;9,93;15,06;-5,13;41303;15639;0.3787;15218;421;52970;19724;0.3723;18369;1355
2017-07-29 11:00:00;15,78;5,95;9,83;41303;17654;0.4274;17677;-23;52970;20280;0.3828;19239;1041
2017-07-29 12:00:00;10,17;5,36;4,81;41303;18969;0.4592;18792;177;52970;19795;0.3737;19668;127
2017-07-29 13:00:00;9,92;2,21;7,71;41303;19650;0.4758;18649;1001;52970;18932;0.3574;19531;-599
2017-07-29 14:00:00;9,27;6,15;3,12;41303;19563;0.4736;17536;2027;52970;17116;0.3231;18604;-1488
2017-07-29 15:00:00;14,05;4,41;9,64;41303;17666;0.4277;15597;2069;52970;14272;0.2694;16848;-2576
2017-07-29 16:00:00;19,26;12,02;7,24;41303;14752;0.3572;13031;1721;52970;11396;0.2152;14481;-3085
2017-07-29 17:00:00;25,47;25,06;0,41;41303;11184;0.2708;9650;1534;52970;8885;0.1677;11948;-3063
2017-07-29 18:00:00;30,13;30,56;-0,43;41303;6800;0.1646;5787;1013;52970;6653;0.1256;9457;-2804
2017-07-29 19:00:00;34,45;31,19;3,26;41303;2858;0.0692;2482;376;52970;4456;0.0841;7192;-2736
2017-07-29 20:00:00;35,43;32,8;2,63;41303;532;0.0129;583;-51;52970;3031;0.0572;5607;-2576
2017-07-29 21:00:00;35,65;33,18;2,47;41303;2;0;12;-10;52970;3154;0.0595;4787;-1633
2017-07-29 22:00:00;34,76;31,74;3,02;41303;0;0;0;0;52970;4312;0.0814;4481;-169
2017-07-29 23:00:00;30,6;27,41;3,19;41303;0;0;0;0;52970;5782;0.1091;4685;1097
2017-07-30 00:00:00;26,92;19,57;7,35;41304;0;0;0;0;52985;7402;0.1397;5694;1708
2017-07-30 01:00:00;21,16;9,58;11,58;41304;0;0;0;0;52985;8828;0.1666;6994;1834
2017-07-30 02:00:00;16,22;7,49;8,73;41304;0;0;0;0;52985;10003;0.1888;8545;1458
2017-07-30 03:00:00;12,79;8,65;4,14;41304;0;0;0;0;52985;10523;0.1986;10118;405
2017-07-30 04:00:00;10,73;9,43;1,3;41304;0;0;0;0;52985;10438;0.197;11802;-1364
2017-07-30 05:00:00;10,03;11,77;-1,74;41304;26;0.0006;42;-16;52985;11907;0.2247;13298;-1391
2017-07-30 06:00:00;8,44;6,6;1,84;41304;897;0.0217;883;14;52985;13524;0.2552;14435;-911
2017-07-30 07:00:00;7,67;5,31;2,36;41304;3792;0.0918;3817;-25;52985;14080;0.2658;15143;-1063
2017-07-30 08:00:00;2,05;4,51;-2,46;41304;8204;0.1986;8529;-325;52985;13372;0.2524;15419;-2047
2017-07-30 09:00:00;1,94;7,64;-5,7;41304;13163;0.3187;13782;-619;52985;14230;0.2686;16165;-1935
2017-07-30 10:00:00;-5,15;3,58;-8,73;41304;17251;0.4176;18255;-1004;52985;17327;0.327;17307;20
2017-07-30 11:00:00;-0,02;-12,55;12,53;41304;20846;0.5047;21373;-527;52985;19857;0.3748;18482;1375
2017-07-30 12:00:00;-45,42;-57,71;12,29;41304;22454;0.5436;22836;-382;52985;20680;0.3903;19394;1286
2017-07-30 13:00:00;-67,05;-86,12;19,07;41304;22988;0.5566;22380;608;52985;17971;0.3392;20046;-2075
2017-07-30 14:00:00;-64,9;-86,41;21,51;41304;21289;0.5154;20506;783;52985;17374;0.3279;19953;-2579
2017-07-30 15:00:00;-14,23;-71,65;57,42;41304;18268;0.4423;17654;614;52985;19100;0.3605;18712;388
2017-07-30 16:00:00;-0,91;-56,41;55,5;41304;14131;0.3421;14223;-92;52985;21250;0.401;16823;4427
2017-07-30 17:00:00;5,01;-25,62;30,63;41304;10414;0.2521;10127;287;52985;20671;0.3901;14543;6128
2017-07-30 18:00:00;22,54;14,56;7,98;41304;6280;0.1521;5941;339;52985;18255;0.3446;12016;6239
2017-07-30 19:00:00;31,77;27,3;4,47;41304;2643;0.0639;2557;86;52985;13686;0.2583;9681;4005
2017-07-30 20:00:00;34,52;33,38;1,14;41304;568;0.0138;578;-10;52985;9974;0.1882;7901;2073
2017-07-30 21:00:00;35,93;35,74;0,19;41304;8;0.0002;10;-2;52985;8409;0.1587;7150;1259
2017-07-30 22:00:00;37,67;38,68;-1,01;41304;0;0;0;0;52985;7145;0.1348;6960;185
2017-07-30 23:00:00;35,87;35,39;0,48;41304;0;0;0;0;52985;6260;0.1182;6886;-626
2017-07-31 00:00:00;32,0;35,13;-3,13;41329;0;0;0;0;53043;5745;0.1083;6759;-1014
2017-07-31 01:00:00;26,55;30,76;-4,21;41329;0;0;0;0;53043;5314;0.1002;6597;-1283
2017-07-31 02:00:00;26,11;29,78;-3,67;41329;0;0;0;0;53043;5366;0.1011;6689;-1323
2017-07-31 03:00:00;24,65;28,1;-3,45;41329;0;0;0;0;53043;5624;0.106;6825;-1201
2017-07-31 04:00:00;24,64;24,81;-0,17;41329;0;0;0;0;53043;6027;0.1136;7077;-1050
2017-07-31 05:00:00;26,57;26,47;0,1;41329;20;0.0005;36;-16;53043;6215;0.1172;7210;-995
2017-07-31 06:00:00;32,15;31,34;0,81;41329;784;0.019;845;-61;53043;6392;0.1205;7173;-781
2017-07-31 07:00:00;36,92;35,31;1,61;41329;3715;0.0899;3825;-110;53043;6097;0.115;6885;-788
2017-07-31 08:00:00;36,92;38,49;-1,57;41329;8888;0.215;8723;165;53043;5376;0.1014;6498;-1122
2017-07-31 09:00:00;35,45;35,92;-0,47;41329;14588;0.353;13968;620;53043;5490;0.1035;6529;-1039
2017-07-31 10:00:00;33,29;33,86;-0,57;41329;19272;0.4663;18179;1093;53043;5894;0.1111;7209;-1315
2017-07-31 11:00:00;33,89;33,89;0,0;41329;21664;0.5242;20985;679;53043;6772;0.1277;7800;-1028
2017-07-31 12:00:00;29,03;28,74;0,29;41329;22138;0.5356;22264;-126;53043;7304;0.1377;8492;-1188
2017-07-31 13:00:00;28,07;29,4;-1,33;41329;21680;0.5246;22260;-580;53043;7640;0.144;8994;-1354
2017-07-31 14:00:00;28,02;32,68;-4,66;41329;20250;0.49;21105;-855;53043;7564;0.1426;8879;-1315
2017-07-31 15:00:00;28,71;35,26;-6,55;41329;17419;0.4215;18798;-1379;53043;6922;0.1305;7952;-1030
2017-07-31 16:00:00;30,05;34,69;-4,64;41329;14014;0.3391;15581;-1567;53043;5982;0.1128;6556;-574
2017-07-31 17:00:00;35,51;37,41;-1,9;41329;9814;0.2374;11355;-1541;53043;4742;0.0894;4943;-201
2017-07-31 18:00:00;37,91;45,66;-7,75;41329;5889;0.1425;6630;-741;53043;3551;0.067;3538;13
2017-07-31 19:00:00;38,9;52,22;-13,32;41329;2660;0.0644;2712;-52;53043;2683;0.0506;2640;43
2017-07-31 20:00:00;38,9;46,04;-7,14;41329;508;0.0123;594;-86;53043;2430;0.0458;2307;123
2017-07-31 21:00:00;38,07;44,63;-6,56;41329;4;0.0001;10;-6;53043;2705;0.051;2549;156
2017-07-31 22:00:00;37,84;44,18;-6,34;41329;0;0;0;0;53043;3080;0.0581;3074;6
2017-07-31 23:00:00;32,91;37,95;-5,04;41329;0;0;0;0;53043;3556;0.067;3557;-1
2017-01-08 00:00:00;30,57;30,04;0,53;41338;0;0;0;0;53073;3809;0.0718;3090;719
2017-01-08 01:00:00;28,01;28,2;-0,19;41338;0;0;0;0;53073;3975;0.0749;3226;749
2017-01-08 02:00:00;27,3;25,92;1,38;41338;0;0;0;0;53073;4049;0.0763;3317;732
2017-01-08 03:00:00;26,79;24,54;2,25;41338;0;0;0;0;53073;4174;0.0786;3280;894
2017-01-08 04:00:00;26,81;24,47;2,34;41338;0;0;0;0;53073;4616;0.087;3289;1327
2017-01-08 05:00:00;27,54;26,27;1,27;41338;17;0.0004;28;-11;53073;4750;0.0895;3187;1563
2017-01-08 06:00:00;32,66;29,16;3,5;41338;674;0.0163;710;-36;53073;5829;0.1098;2999;2830
2017-01-08 07:00:00;37,0;32,3;4,7;41338;3040;0.0735;3297;-257;53073;6538;0.1232;2725;3813
2017-01-08 08:00:00;38,94;32,34;6,6;41338;6904;0.167;7444;-540;53073;5894;0.111;2172;3722
2017-01-08 09:00:00;38,09;34,78;3,31;41338;11650;0.2818;11905;-255;53073;3639;0.0686;1673;1966
2017-01-08 10:00:00;37,9;36,53;1,37;41338;15994;0.3869;15742;252;53073;2841;0.0535;1429;1412
2017-01-08 11:00:00;37,08;35,22;1,86;41338;18945;0.4583;18533;412;53073;2689;0.0507;1332;1357
2017-01-08 12:00:00;36,45;35,91;0,54;41338;20349;0.4922;20149;200;53073;2878;0.0542;1405;1473
2017-01-08 13:00:00;35,93;35,03;0,9;41338;20410;0.4937;20515;-105;53073;3484;0.0656;1575;1909
2017-01-08 14:00:00;35,91;34,46;1,45;41338;18673;0.4517;19639;-966;53073;3364;0.0634;1709;1655
2017-01-08 15:00:00;36,0;34,38;1,62;41338;15952;0.3859;17364;-1412;53073;3581;0.0675;1817;1764
2017-01-08 16:00:00;36,61;35,5;1,11;41338;12468;0.3016;13962;-1494;53073;4040;0.0762;2010;2030
2017-01-08 17:00:00;38,47;36,61;1,86;41338;8355;0.2021;9702;-1347;53073;4300;0.0811;2157;2143
2017-01-08 18:00:00;40,94;37,95;2,99;41338;4451;0.1077;5319;-868;53073;4587;0.0864;2337;2250
2017-01-08 19:00:00;41,06;38,42;2,64;41338;1682;0.0407;2056;-374;53073;5155;0.0971;2629;2526
2017-01-08 20:00:00;38,96;36,32;2,64;41338;320;0.0078;408;-88;53073;5146;0.097;3053;2093
2017-01-08 21:00:00;37,04;35,38;1,66;41338;5;0.0001;5;0;53073;4443;0.0837;3734;709
2017-01-08 22:00:00;35,94;37,62;-1,68;41338;0;0;0;0;53073;3871;0.0729;4459;-588
2017-01-08 23:00:00;31,69;36,57;-4,88;41338;0;0;0;0;53073;3760;0.0708;4976;-1216
2017-02-08 00:00:00;27,62;32,04;-4,42;41344;0;0;0;0;53073;3364;0.0634;5130;-1766
2017-02-08 01:00:00;26,59;31,88;-5,29;41344;0;0;0;0;53073;3088;0.0582;5176;-2088
2017-02-08 02:00:00;26,2;31,33;-5,13;41344;0;0;0;0;53073;3548;0.0668;5427;-1879
2017-02-08 03:00:00;25,09;30,82;-5,73;41344;0;0;0;0;53073;4129;0.0778;5688;-1559
2017-02-08 04:00:00;25,78;29,95;-4,17;41344;0;0;0;0;53073;4654;0.0877;5889;-1235
2017-02-08 05:00:00;27,25;31,98;-4,73;41344;16;0.0004;25;-9;53073;4815;0.0907;5935;-1120
2017-02-08 06:00:00;30,26;36,09;-5,83;41344;619;0.015;696;-77;53073;5070;0.0955;5726;-656
2017-02-08 07:00:00;35,05;40,21;-5,16;41344;3113;0.0753;3183;-70;53073;4301;0.081;5330;-1029
2017-02-08 08:00:00;36,57;41,2;-4,63;41344;7078;0.1712;7157;-79;53073;3088;0.0582;4783;-1695
2017-02-08 09:00:00;36,47;41,22;-4,75;41344;11370;0.275;11590;-220;53073;2406;0.0453;4442;-2036
2017-02-08 10:00:00;35,96;38,72;-2,76;41344;15335;0.3709;15542;-207;53073;2593;0.0489;4536;-1943
2017-02-08 11:00:00;35,14;38,79;-3,65;41344;18250;0.4414;18572;-322;53073;3318;0.0625;4844;-1526
2017-02-08 12:00:00;33,07;36,94;-3,87;41344;19419;0.4697;20277;-858;53073;4446;0.0838;5204;-758
2017-02-08 13:00:00;29,9;33,29;-3,39;41344;19805;0.479;20429;-624;53073;5758;0.1085;5474;284
2017-02-08 14:00:00;30,07;32,92;-2,85;41344;19553;0.473;19498;55;53073;6108;0.115;5532;576
2017-02-08 15:00:00;31,69;31,49;0,2;41344;18005;0.4355;17480;525;53073;6504;0.1226;5156;1348
2017-02-08 16:00:00;34,9;30,01;4,89;41344;14652;0.3544;14383;269;53073;6078;0.1145;4460;1618
2017-02-08 17:00:00;35,99;33,75;2,24;41344;10302;0.2492;10363;-61;53073;4957;0.0934;3529;1428
2017-02-08 18:00:00;39,23;36,86;2,37;41344;5604;0.1355;5957;-353;53073;3599;0.0678;2561;1038
2017-02-08 19:00:00;40,94;38,14;2,8;41344;2149;0.052;2385;-236;53073;2339;0.0441;1851;488
2017-02-08 20:00:00;39,27;39,26;0,01;41344;321;0.0078;473;-152;53073;2148;0.0404;1611;537
2017-02-08 21:00:00;38,15;39,53;-1,38;41344;0;0;6;-6;53073;2485;0.0468;1924;561
2017-02-08 22:00:00;37,53;37,6;-0,07;41344;0;0;0;0;53073;3740;0.0704;2651;1089
2017-02-08 23:00:00;34,46;34,29;0,17;41344;0;0;0;0;53073;5057;0.0953;3669;1388
2017-03-08 00:00:00;28,1;32,24;-4,14;41349;0;0;0;0;53079;5912;0.1114;5922;-10
2017-03-08 01:00:00;26,47;31,37;-4,9;41349;0;0;0;0;53079;6438;0.1213;7123;-685
2017-03-08 02:00:00;24,76;30,23;-5,47;41349;0;0;0;0;53079;7304;0.1376;8108;-804
2017-03-08 03:00:00;23,36;27,15;-3,79;41349;0;0;0;0;53079;8170;0.1539;8657;-487
2017-03-08 04:00:00;23,39;26,76;-3,37;41349;0;0;0;0;53079;8900;0.1677;9220;-320
2017-03-08 05:00:00;25,08;27,86;-2,78;41349;10;0.0002;15;-5;53079;9709;0.1829;10051;-342
2017-03-08 06:00:00;28,58;34,77;-6,19;41349;478;0.0116;510;-32;53079;11003;0.2073;10953;50
2017-03-08 07:00:00;34,94;37,19;-2,25;41349;2130;0.0515;2376;-246;53079;11784;0.222;11828;-44
2017-03-08 08:00:00;35,98;37,55;-1,57;41349;4308;0.1042;5229;-921;53079;11991;0.2259;12565;-574
2017-03-08 09:00:00;35,98;40,5;-4,52;41349;6993;0.1692;8298;-1305;53079;12280;0.2313;13287;-1007
2017-03-08 10:00:00;35,89;41,13;-5,24;41349;9427;0.228;10956;-1529;53079;13570;0.2556;14355;-785
2017-03-08 11:00:00;34,72;39,71;-4,99;41349;10431;0.2523;12954;-2523;53079;15728;0.2963;15834;-106
2017-03-08 12:00:00;30,57;32,93;-2,36;41349;12079;0.2921;14273;-2194;53079;18012;0.3394;17622;390
2017-03-08 13:00:00;27,13;33,26;-6,13;41349;13552;0.3278;14906;-1354;53079;21134;0.3982;19557;1577
2017-03-08 14:00:00;22,03;25,56;-3,53;41349;14570;0.3524;15067;-497;53079;24152;0.455;21286;2866
2017-03-08 15:00:00;20,28;21,5;-1,22;41349;14271;0.3451;14434;-163;53079;26184;0.4933;22599;3585
2017-03-08 16:00:00;18,09;14,71;3,38;41349;12745;0.3082;12900;-155;53079;27223;0.5129;23649;3574
2017-03-08 17:00:00;23,99;18,61;5,38;41349;9987;0.2416;10206;-219;53079;26843;0.5057;23703;3140
2017-03-08 18:00:00;26,82;30,03;-3,21;41349;6205;0.15;6315;-110;53079;25318;0.477;22447;2871
2017-03-08 19:00:00;29,76;33,92;-4,16;41349;2549;0.0616;2557;-8;53079;21853;0.4117;20363;1490
2017-03-08 20:00:00;30,76;33,76;-3,0;41349;430;0.0104;521;-91;53079;19335;0.3642;18303;1032
2017-03-08 21:00:00;31,85;35,02;-3,17;41349;2;0;6;-4;53079;18034;0.3398;17102;932
2017-03-08 22:00:00;29,69;35,11;-5,42;41349;0;0;0;0;53079;17044;0.3211;16493;551
2017-03-08 23:00:00;25,52;33,79;-8,27;41349;0;0;0;0;53079;16270;0.3065;16010;260
2017-04-08 00:00:00;25,16;34,9;-9,74;41360;0;0;0;0;53079;15563;0.2932;15737;-174
2017-04-08 01:00:00;22,7;29,61;-6,91;41360;0;0;0;0;53079;14957;0.2818;15501;-544
2017-04-08 02:00:00;21,3;28,0;-6,7;41360;0;0;0;0;53079;14869;0.2801;15399;-530
2017-04-08 03:00:00;19,03;24,2;-5,17;41360;0;0;0;0;53079;14686;0.2767;15364;-678
2017-04-08 04:00:00;18,95;23,47;-4,52;41360;0;0;0;0;53079;14901;0.2807;15399;-498
2017-04-08 05:00:00;21,48;23,75;-2,27;41360;15;0.0004;19;-4;53079;15169;0.2858;15419;-250
2017-04-08 06:00:00;30,5;34,69;-4,19;41360;564;0.0136;628;-64;53079;15237;0.2871;15593;-356
2017-04-08 07:00:00;34,99;37,24;-2,25;41360;2646;0.064;2852;-206;53079;15171;0.2858;16070;-899
2017-04-08 08:00:00;35,02;39,03;-4,01;41360;5768;0.1395;6223;-455;53079;15672;0.2953;17236;-1564
2017-04-08 09:00:00;33,59;39,04;-5,45;41360;9485;0.2294;10092;-607;53079;18075;0.3405;19626;-1551
2017-04-08 10:00:00;28,42;36,19;-7,77;41360;13236;0.32;13447;-211;53079;21619;0.4073;22664;-1045
2017-04-08 11:00:00;21,62;25,83;-4,21;41360;15869;0.3837;15825;44;53079;24339;0.4586;25137;-798
2017-04-08 12:00:00;17,05;20,53;-3,48;41360;17233;0.4167;17317;-84;53079;26528;0.4998;26713;-185
2017-04-08 13:00:00;10,35;9,16;1,19;41360;17371;0.42;17933;-562;53079;27185;0.5122;27488;-303
2017-04-08 14:00:00;9,58;14,09;-4,51;41360;16818;0.4066;17532;-714;53079;26907;0.5069;27718;-811
2017-04-08 15:00:00;10,36;18,93;-8,57;41360;15249;0.3687;16091;-842;53079;26513;0.4995;27188;-675
2017-04-08 16:00:00;10,32;19,52;-9,2;41360;12965;0.3135;13625;-660;53079;25972;0.4893;26241;-269
2017-04-08 17:00:00;20,04;24,42;-4,38;41360;9733;0.2353;10026;-293;53079;24853;0.4682;24606;247
2017-04-08 18:00:00;28,46;33,05;-4,59;41360;5895;0.1425;5857;38;53079;22880;0.4311;22076;804
2017-04-08 19:00:00;35,01;37,96;-2,95;41360;2400;0.058;2302;98;53079;19779;0.3726;19244;535
2017-04-08 20:00:00;34,48;37,1;-2,62;41360;382;0.0092;441;-59;53079;16199;0.3052;16900;-701
2017-04-08 21:00:00;34,93;38,23;-3,3;41360;2;0;6;-4;53079;14655;0.2761;15214;-559
2017-04-08 22:00:00;34,96;39,13;-4,17;41360;0;0;0;0;53079;14073;0.2651;14244;-171
2017-04-08 23:00:00;31,06;36,75;-5,69;41360;0;0;0;0;53079;14026;0.2642;13713;313
2017-05-08 00:00:00;24,97;35,18;-10,21;41360;0;0;0;0;53079;13299;0.2506;14070;-771
2017-05-08 01:00:00;24,97;33,18;-8,21;41360;0;0;0;0;53079;12772;0.2406;13410;-638
2017-05-08 02:00:00;25,05;32,59;-7,54;41360;0;0;0;0;53079;12253;0.2308;12823;-570
2017-05-08 03:00:00;24,02;30,78;-6,76;41360;0;0;0;0;53079;11756;0.2215;12024;-268
2017-05-08 04:00:00;23,1;29,77;-6,67;41360;0;0;0;0;53079;10968;0.2066;11126;-158
2017-05-08 05:00:00;24,74;31,12;-6,38;41360;14;0.0003;18;-4;53079;10373;0.1954;10113;260
2017-05-08 06:00:00;24,17;30,44;-6,27;41360;638;0.0155;607;31;53079;9672;0.1822;8982;690
2017-05-08 07:00:00;27,68;31,2;-3,52;41360;3358;0.0812;2913;445;53079;8362;0.1575;7852;510
2017-05-08 08:00:00;31,0;33,09;-2,09;41360;7733;0.187;6587;1146;53079;7086;0.1335;7072;14
2017-05-08 09:00:00;32,82;32,25;0,57;41360;12310;0.2976;10568;1742;53079;7123;0.1342;6956;167
2017-05-08 10:00:00;31,88;29,49;2,39;41360;15476;0.3742;13715;1761;53079;8030;0.1513;7263;767
2017-05-08 11:00:00;27,21;25,37;1,84;41360;17145;0.4145;15821;1324;53079;8674;0.1634;7659;1015
2017-05-08 12:00:00;25,06;25,28;-0,22;41360;17562;0.4246;16865;697;53079;9344;0.176;8087;1257
2017-05-08 13:00:00;23,37;24,54;-1,17;41360;17211;0.4161;16853;358;53079;9846;0.1855;8299;1547
2017-05-08 14:00:00;23,43;23,9;-0,47;41360;16019;0.3873;15979;40;53079;10876;0.2049;8329;2547
2017-05-08 15:00:00;24,55;20,16;4,39;41360;14012;0.3388;14255;-243;53079;11843;0.2231;8123;3720
2017-05-08 16:00:00;25,33;20,67;4,66;41360;11173;0.2702;11907;-734;53079;11694;0.2203;7941;3753
2017-05-08 17:00:00;27,98;26,28;1,7;41360;8298;0.2006;8834;-536;53079;11328;0.2134;7596;3732
2017-05-08 18:00:00;32,09;30,29;1,8;41360;5158;0.1247;5251;-93;53079;10414;0.1962;7006;3408
2017-05-08 19:00:00;33,96;29,44;4,52;41360;2165;0.0524;2114;51;53079;8934;0.1683;6498;2436
2017-05-08 20:00:00;33,63;31,0;2,63;41360;338;0.0082;392;-54;53079;8098;0.1526;6254;1844
2017-05-08 21:00:00;33,8;32,79;1,01;41360;1;0;3;-2;53079;8100;0.1526;6327;1773
2017-05-08 22:00:00;34,3;31,85;2,45;41360;0;0;0;0;53079;8644;0.1629;6567;2077
2017-05-08 23:00:00;32,74;28,82;3,92;41360;0;0;0;0;53079;9018;0.1699;6974;2044
2017-06-08 00:00:00;25,73;20,62;5,11;41360;0;0;0;0;53079;9872;0.186;9335;537
2017-06-08 01:00:00;20,57;14,12;6,45;41360;0;0;0;0;53079;10573;0.1992;9670;903
2017-06-08 02:00:00;18,03;8,61;9,42;41360;0;0;0;0;53079;11359;0.214;9916;1443
2017-06-08 03:00:00;16,59;3,56;13,03;41360;0;0;0;0;53079;11297;0.2128;9813;1484
2017-06-08 04:00:00;13,69;2,75;10,94;41360;0;0;0;0;53079;11086;0.2089;9534;1552
2017-06-08 05:00:00;10,87;4,84;6,03;41360;12;0.0003;16;-4;53079;10152;0.1912;8995;1157
2017-06-08 06:00:00;10,75;6,58;4,17;41360;588;0.0142;592;-4;53079;9507;0.1791;8182;1325
2017-06-08 07:00:00;12,6;5,18;7,42;41360;3249;0.0786;3140;109;53079;8260;0.1556;7329;931
2017-06-08 08:00:00;16,32;9,45;6,87;41360;7736;0.187;7403;333;53079;7208;0.1358;6790;418
2017-06-08 09:00:00;18,0;10,6;7,4;41360;13133;0.3176;12025;1108;53079;7896;0.1488;6828;1068
2017-06-08 10:00:00;10,46;6,51;3,95;41360;16913;0.4089;15570;1343;53079;8822;0.1662;7203;1619
2017-06-08 11:00:00;13,33;4,37;8,96;41360;18732;0.4529;17840;892;53079;9539;0.1797;7633;1906
2017-06-08 12:00:00;14,13;9,33;4,8;41360;19124;0.4624;18877;247;53079;9405;0.1772;7917;1488
2017-06-08 13:00:00;10,83;11,81;-0,98;41360;18368;0.4441;18796;-428;53079;9497;0.1789;8006;1491
2017-06-08 14:00:00;10,41;11,15;-0,74;41360;17738;0.4289;17756;-18;53079;9203;0.1734;7908;1295
2017-06-08 15:00:00;10,32;11,16;-0,84;41360;15954;0.3857;15805;149;53079;8931;0.1683;7580;1351
2017-06-08 16:00:00;13,01;10,17;2,84;41360;13479;0.3259;13133;346;53079;7774;0.1465;7099;675
2017-06-08 17:00:00;19,57;17,17;2,4;41360;10061;0.2433;9647;414;53079;6628;0.1249;6324;304
2017-06-08 18:00:00;28,66;29,5;-0,84;41360;6357;0.1537;5664;693;53079;5347;0.1007;5257;90
2017-06-08 19:00:00;32,94;32,41;0,53;41360;2609;0.0631;2233;376;53079;3956;0.0745;4156;-200
2017-06-08 20:00:00;34,95;32,73;2,22;41360;404;0.0098;408;-4;53079;2541;0.0479;3285;-744
2017-06-08 21:00:00;36,05;35,19;0,86;41360;1;0;3;-2;53079;2006;0.0378;2872;-866
2017-06-08 22:00:00;36,07;35,86;0,21;41360;0;0;0;0;53079;1820;0.0343;2706;-886
2017-06-08 23:00:00;34,94;35,21;-0,27;41360;0;0;0;0;53079;1825;0.0344;2634;-809
2017-07-08 00:00:00;31,1;26,85;4,25;41362;0;0;0;0;53079;1962;0.037;2469;-507
2017-07-08 01:00:00;28,0;23,7;4,3;41362;0;0;0;0;53079;2399;0.0452;2568;-169
2017-07-08 02:00:00;26,11;22,99;3,12;41362;0;0;0;0;53079;2932;0.0552;2843;89
2017-07-08 03:00:00;24,8;20,69;4,11;41362;0;0;0;0;53079;3509;0.0661;3208;301
2017-07-08 04:00:00;25,47;19,61;5,86;41362;0;0;0;0;53079;4292;0.0809;3743;549
2017-07-08 05:00:00;28,28;20,38;7,9;41362;11;0.0002;15;-4;53079;5159;0.0972;4251;908
2017-07-08 06:00:00;35,18;26,64;8,54;41362;668;0.0161;655;13;53079;6239;0.1176;4646;1593
2017-07-08 07:00:00;37,93;28,92;9,01;41362;4030;0.0974;3919;111;53079;6537;0.1232;4870;1667
2017-07-08 08:00:00;37,85;29,24;8,61;41362;9645;0.2332;9656;-11;53079;5225;0.0984;4653;572
2017-07-08 09:00:00;36,42;30,41;6,01;41362;16068;0.3885;15902;166;53079;4295;0.0809;4344;-49
2017-07-08 10:00:00;34,08;31,42;2,66;41362;21215;0.5129;20823;392;53079;5009;0.0943;4465;544
2017-07-08 11:00:00;33,14;30,13;3,01;41362;24165;0.5842;23995;170;53079;5890;0.111;4697;1193
2017-07-08 12:00:00;29,03;28,36;0,67;41362;24884;0.6016;25566;-682;53079;6499;0.1224;4834;1665
2017-07-08 13:00:00;26,87;28,13;-1,26;41362;25183;0.6088;25855;-672;53079;6202;0.1169;4794;1408
2017-07-08 14:00:00;27,47;27,13;0,34;41362;24532;0.5931;24779;-247;53079;5354;0.1009;4435;919
2017-07-08 15:00:00;29,04;26,83;2,21;41362;22394;0.5414;22298;96;53079;4602;0.0867;3767;835
2017-07-08 16:00:00;32,65;30,01;2,64;41362;18945;0.458;18594;351;53079;3802;0.0716;3051;751
2017-07-08 17:00:00;36,95;31,09;5,86;41362;13763;0.3327;13442;321;53079;2951;0.0556;2499;452
2017-07-08 18:00:00;42,16;38,03;4,13;41362;7616;0.1841;7343;273;53079;2318;0.0437;2329;-11
2017-07-08 19:00:00;45,11;41,65;3,46;41362;2651;0.0641;2487;164;53079;2007;0.0378;2632;-625
2017-07-08 20:00:00;44,9;40,07;4,83;41362;347;0.0084;439;-92;53079;2707;0.051;3543;-836
2017-07-08 21:00:00;39,94;38,87;1,07;41362;0;0;3;-3;53079;4846;0.0913;5175;-329
2017-07-08 22:00:00;35,92;38,61;-2,69;41362;0;0;0;0;53079;7271;0.137;6948;323
2017-07-08 23:00:00;29,94;31,65;-1,71;41362;0;0;0;0;53079;8652;0.163;8301;351
2017-08-08 00:00:00;28,09;26,72;1,37;41366;0;0;0;0;53091;8964;0.1689;7706;1258
2017-08-08 01:00:00;26,86;24,18;2,68;41366;0;0;0;0;53091;8581;0.1616;7876;705
2017-08-08 02:00:00;25,34;23,5;1,84;41366;0;0;0;0;53091;8083;0.1522;7999;84
2017-08-08 03:00:00;24,59;26,3;-1,71;41366;0;0;0;0;53091;7870;0.1482;8109;-239
2017-08-08 04:00:00;24,64;26,2;-1,56;41366;0;0;0;0;53091;7899;0.1488;8303;-404
2017-08-08 05:00:00;26,96;28,47;-1,51;41366;8;0.0002;13;-5;53091;8204;0.1545;8447;-243
2017-08-08 06:00:00;31,0;37,05;-6,05;41366;657;0.0159;617;40;53091;9314;0.1754;8425;889
2017-08-08 07:00:00;35,0;38,79;-3,79;41366;3697;0.0894;3460;237;53091;8904;0.1677;7930;974
2017-08-08 08:00:00;36,51;39,65;-3,14;41366;8175;0.1976;8176;-1;53091;6987;0.1316;7078;-91
2017-08-08 09:00:00;37,06;39,52;-2,46;41366;12451;0.301;13166;-715;53091;6073;0.1144;6614;-541
2017-08-08 10:00:00;36,2;39,47;-3,27;41366;15981;0.3863;17063;-1082;53091;7514;0.1415;6793;721
2017-08-08 11:00:00;36,38;37,91;-1,53;41366;17590;0.4252;19443;-1853;53091;9388;0.1768;7644;1744
2017-08-08 12:00:00;34,74;37,82;-3,08;41366;17732;0.4286;20326;-2594;53091;10880;0.2049;8952;1928
2017-08-08 13:00:00;31,51;34,99;-3,48;41366;17442;0.4216;19781;-2339;53091;11724;0.2208;10248;1476
2017-08-08 14:00:00;29,56;34,77;-5,21;41366;15417;0.3727;18057;-2640;53091;11521;0.217;11172;349
2017-08-08 15:00:00;30,95;36,79;-5,84;41366;12675;0.3064;15397;-2722;53091;12403;0.2336;11874;529
2017-08-08 16:00:00;31,33;34,54;-3,21;41366;9837;0.2378;11950;-2113;53091;13629;0.2567;12311;1318
2017-08-08 17:00:00;32,36;34,28;-1,92;41366;6654;0.1608;7959;-1305;53091;14024;0.2642;12307;1717
2017-08-08 18:00:00;33,9;34,89;-0,99;41366;3706;0.0896;4221;-515;53091;13697;0.258;12150;1547
2017-08-08 19:00:00;33,91;34,51;-0,6;41366;1514;0.0366;1518;-4;53091;10832;0.204;12345;-1513
2017-08-08 20:00:00;33,03;36,05;-3,02;41366;206;0.005;246;-40;53091;9412;0.1773;12934;-3522
2017-08-08 21:00:00;32,07;37,0;-4,93;41366;0;0;1;-1;53091;10639;0.2004;13764;-3125
2017-08-08 22:00:00;31,06;33,87;-2,81;41366;0;0;0;0;53091;11690;0.2202;14271;-2581
2017-08-08 23:00:00;27,97;28,91;-0,94;41366;0;0;0;0;53091;12045;0.2269;14160;-2115
2017-09-08 00:00:00;25,0;27,95;-2,95;41369;0;0;0;0;53101;12304;0.2317;11515;789
2017-09-08 01:00:00;23,63;23,65;-0,02;41369;0;0;0;0;53101;12432;0.2341;11410;1022
2017-09-08 02:00:00;21,13;21,84;-0,71;41369;0;0;0;0;53101;13224;0.249;11595;1629
2017-09-08 03:00:00;19,08;21,36;-2,28;41369;0;0;0;0;53101;12938;0.2436;11693;1245
2017-09-08 04:00:00;19,09;20,63;-1,54;41369;0;0;0;0;53101;12436;0.2342;11872;564
2017-09-08 05:00:00;24,57;26,47;-1,9;41369;4;0.0001;6;-2;53101;11960;0.2252;11941;19
2017-09-08 06:00:00;27,8;35,66;-7,86;41369;378;0.0091;460;-82;53101;12003;0.226;11777;226
2017-09-08 07:00:00;31,57;38,04;-6,47;41369;2608;0.0631;2720;-112;53101;10839;0.2041;11624;-785
2017-09-08 08:00:00;34,85;40,43;-5,58;41369;6555;0.1584;6634;-79;53101;10121;0.1906;11781;-1660
2017-09-08 09:00:00;33,15;39,99;-6,84;41369;11485;0.2776;11184;301;53101;10586;0.1993;12314;-1728
2017-09-08 10:00:00;31,49;36,48;-4,99;41369;16154;0.3905;15436;718;53101;11100;0.209;12750;-1650
2017-09-08 11:00:00;31,34;34,96;-3,62;41369;19702;0.4762;18744;958;53101;11490;0.2164;12793;-1303
2017-09-08 12:00:00;27,74;32,62;-4,88;41369;21611;0.5224;20791;820;53101;11008;0.2073;12492;-1484
2017-09-08 13:00:00;26,56;32,73;-6,17;41369;21581;0.5217;21013;568;53101;10309;0.1942;12099;-1790
2017-09-08 14:00:00;27,75;32,5;-4,75;41369;19829;0.4793;19901;-72;53101;9274;0.1746;11593;-2319
2017-09-08 15:00:00;29,96;34,42;-4,46;41369;17418;0.421;17570;-152;53101;8444;0.159;10869;-2425
2017-09-08 16:00:00;31,25;34,68;-3,43;41369;14148;0.342;14227;-79;53101;7780;0.1465;9965;-2185
2017-09-08 17:00:00;34,92;37,62;-2,7;41369;10015;0.2421;10003;12;53101;6894;0.1298;8828;-1934
2017-09-08 18:00:00;35,96;43,54;-7,58;41369;5391;0.1303;5450;-59;53101;5636;0.1061;7535;-1899
2017-09-08 19:00:00;40,1;46,68;-6,58;41369;1897;0.0458;1908;-11;53101;4389;0.0826;6385;-1996
2017-09-08 20:00:00;38,33;50,64;-12,31;41369;258;0.0062;315;-57;53101;3673;0.0692;5767;-2094
2017-09-08 21:00:00;39,42;50,25;-10,83;41369;0;0;1;-1;53101;3919;0.0738;5716;-1797
2017-09-08 22:00:00;37,35;44,73;-7,38;41369;0;0;0;0;53101;4622;0.087;5808;-1186
2017-09-08 23:00:00;34,51;35,05;-0,54;41369;0;0;0;0;53101;5348;0.1007;5693;-345
2017-10-08 00:00:00;29,91;29,27;0,64;41374;0;0;0;0;53113;5399;0.1016;4105;1294
2017-10-08 01:00:00;28,24;29,06;-0,82;41374;0;0;0;0;53113;5432;0.1023;3985;1447
2017-10-08 02:00:00;27,79;26,78;1,01;41374;0;0;0;0;53113;5050;0.0951;3960;1090
2017-10-08 03:00:00;26,6;25,4;1,2;41374;0;0;0;0;53113;4861;0.0915;3811;1050
2017-10-08 04:00:00;26,02;24,71;1,31;41374;0;0;0;0;53113;4331;0.0816;3669;662
2017-10-08 05:00:00;28,44;26,17;2,27;41374;2;0;4;-2;53113;3959;0.0746;3480;479
2017-10-08 06:00:00;33,81;30,31;3,5;41374;253;0.0061;265;-12;53113;3609;0.068;3284;325
2017-10-08 07:00:00;36,81;36,23;0,58;41374;1540;0.0372;1430;110;53113;2988;0.0562;3032;-44
2017-10-08 08:00:00;40,88;39,42;1,46;41374;3428;0.0829;3319;109;53113;2653;0.0499;2737;-84
2017-10-08 09:00:00;41,95;41,76;0,19;41374;4954;0.1197;5317;-363;53113;2352;0.0443;2573;-221
2017-10-08 10:00:00;41,95;43,2;-1,25;41374;6706;0.1621;7002;-296;53113;2255;0.0425;2559;-304
2017-10-08 11:00:00;41,93;45,68;-3,75;41374;8126;0.1965;8242;-116;53113;2125;0.04;2703;-578
2017-10-08 12:00:00;41,63;47,87;-6,24;41374;8930;0.2158;8974;-44;53113;2088;0.0393;2966;-878
2017-10-08 13:00:00;40,95;48,35;-7,4;41374;9054;0.2188;9048;6;53113;2416;0.0455;3286;-870
2017-10-08 14:00:00;39,2;45,35;-6,15;41374;8527;0.2061;8606;-79;53113;2812;0.053;3606;-794
2017-10-08 15:00:00;37,88;43,96;-6,08;41374;7234;0.1749;7625;-391;53113;3436;0.0647;3887;-451
2017-10-08 16:00:00;36,24;42,79;-6,55;41374;5584;0.135;6093;-509;53113;4198;0.079;4163;35
2017-10-08 17:00:00;37,05;42,49;-5,44;41374;3811;0.0921;4285;-474;53113;4712;0.0887;4412;300
2017-10-08 18:00:00;38,0;41,55;-3,55;41374;2165;0.0523;2428;-263;53113;5042;0.0949;4633;409
2017-10-08 19:00:00;39,61;39,94;-0,33;41374;748;0.0181;911;-163;53113;5110;0.0962;4815;295
2017-10-08 20:00:00;35,99;36,42;-0,43;41374;98;0.0024;149;-51;53113;5136;0.0967;4955;181
2017-10-08 21:00:00;35,56;36,63;-1,07;41374;0;0;1;-1;53113;5822;0.1096;5105;717
2017-10-08 22:00:00;34,78;34,97;-0,19;41374;0;0;0;0;53113;6525;0.1228;5219;1306
2017-10-08 23:00:00;30,97;30,43;0,54;41374;0;0;0;0;53113;6615;0.1246;5214;1401
2017-11-08 00:00:00;28,99;28,88;0,11;41382;0;0;0;0;53124;6080;0.1144;5226;854
2017-11-08 01:00:00;28,13;28,69;-0,56;41382;0;0;0;0;53124;6099;0.1148;5185;914
2017-11-08 02:00:00;27,03;26,86;0,17;41382;0;0;0;0;53124;5974;0.1125;5196;778
2017-11-08 03:00:00;26,29;25,07;1,22;41382;0;0;0;0;53124;5266;0.0991;5017;249
2017-11-08 04:00:00;26,12;26,42;-0,3;41382;0;0;0;0;53124;4945;0.0931;4898;47
2017-11-08 05:00:00;28,11;28,43;-0,32;41382;2;0;2;0;53124;4922;0.0927;4805;117
2017-11-08 06:00:00;31,79;32,22;-0,43;41382;167;0.004;161;6;53124;4842;0.0911;4577;265
2017-11-08 07:00:00;40,75;36,84;3,91;41382;935;0.0226;848;87;53124;4445;0.0837;4296;149
2017-11-08 08:00:00;46,98;42,7;4,28;41382;1966;0.0475;1911;55;53124;3745;0.0705;3998;-253
2017-11-08 09:00:00;49,68;42,76;6,92;41382;3324;0.0803;3011;313;53124;3215;0.0605;3789;-574
2017-11-08 10:00:00;51,18;44,57;6,61;41382;4508;0.109;3875;633;53124;2890;0.0544;3703;-813
2017-11-08 11:00:00;61,36;50,37;10,99;41382;4730;0.1143;4485;245;53124;2547;0.0479;3759;-1212
2017-11-08 12:00:00;52,65;44,85;7,8;41382;5275;0.1275;4901;374;53124;2704;0.0509;3944;-1240
2017-11-08 13:00:00;46,8;41,92;4,88;41382;5273;0.1274;4978;295;53124;3140;0.0591;4196;-1056
2017-11-08 14:00:00;39,09;37,83;1,26;41382;4790;0.1158;4845;-55;53124;3432;0.0646;4425;-993
2017-11-08 15:00:00;39,01;35,72;3,29;41382;3568;0.0862;4500;-932;53124;3597;0.0677;4622;-1025
2017-11-08 16:00:00;36,88;33,6;3,28;41382;2933;0.0709;3778;-845;53124;3727;0.0701;4878;-1151
2017-11-08 17:00:00;37,42;36,09;1,33;41382;2362;0.0571;2806;-444;53124;4026;0.0758;5124;-1098
2017-11-08 18:00:00;38,08;33,45;4,63;41382;1707;0.0412;1688;19;53124;4584;0.0863;5183;-599
2017-11-08 19:00:00;36,21;33,39;2,82;41382;608;0.0147;634;-26;53124;5065;0.0953;5214;-149
2017-11-08 20:00:00;34,32;32,38;1,94;41382;50;0.0012;87;-37;53124;5186;0.0976;5326;-140
2017-11-08 21:00:00;34,61;32,83;1,78;41382;0;0;0;0;53124;5110;0.0962;5682;-572
2017-11-08 22:00:00;33,36;32,1;1,26;41382;0;0;0;0;53124;5351;0.1008;6039;-688
2017-11-08 23:00:00;30,71;28,26;2,45;41382;0;0;0;0;53124;5909;0.1112;6459;-550
2017-12-08 00:00:00;25,63;27,48;-1,85;41383;0;0;0;0;53139;6394;0.1203;8150;-1756
2017-12-08 01:00:00;23,05;25,39;-2,34;41383;0;0;0;0;53139;7561;0.1423;8936;-1375
2017-12-08 02:00:00;20,72;22,22;-1,5;41383;0;0;0;0;53139;8624;0.1623;9720;-1096
2017-12-08 03:00:00;20,06;18,19;1,87;41383;0;0;0;0;53139;9098;0.1712;10217;-1119
2017-12-08 04:00:00;18,85;16,18;2,67;41383;0;0;0;0;53139;9669;0.182;10574;-905
2017-12-08 05:00:00;17,03;15,64;1,39;41383;2;0;1;1;53139;9962;0.1874;10739;-777
2017-12-08 06:00:00;19,59;17,17;2,42;41383;230;0.0056;193;37;53139;10070;0.1895;10812;-742
2017-12-08 07:00:00;20,91;19,26;1,65;41383;1379;0.0333;1106;273;53139;9732;0.1831;10815;-1083
2017-12-08 08:00:00;24,37;24,21;0,16;41383;3088;0.0746;2590;498;53139;9555;0.1798;10975;-1420
2017-12-08 09:00:00;25,84;27,04;-1,2;41383;4870;0.1177;4208;662;53139;10026;0.1886;11497;-1471
2017-12-08 10:00:00;25,36;26,58;-1,22;41383;6672;0.1612;5710;962;53139;10997;0.2069;12255;-1258
2017-12-08 11:00:00;25,5;24,25;1,25;41383;8498;0.2054;6996;1502;53139;12260;0.2307;13064;-804
2017-12-08 12:00:00;24,49;20,14;4,35;41383;9904;0.2393;7829;2075;53139;13852;0.2607;13903;-51
2017-12-08 13:00:00;19,01;10,22;8,79;41383;10163;0.2456;7974;2189;53139;14668;0.276;14589;79
2017-12-08 14:00:00;15,23;3,85;11,38;41383;9827;0.2374;7627;2200;53139;15497;0.2916;14849;648
2017-12-08 15:00:00;16,41;4,56;11,85;41383;9164;0.2214;6824;2340;53139;16220;0.3052;14782;1438
2017-12-08 16:00:00;15,99;2,09;13,9;41383;7460;0.1802;5499;1961;53139;16142;0.3038;14689;1453
2017-12-08 17:00:00;18,77;7,92;10,85;41383;5232;0.1264;3972;1260;53139;16270;0.3062;14423;1847
2017-12-08 18:00:00;24,81;18,13;6,68;41383;3129;0.0756;2315;814;53139;15079;0.2838;14014;1065
2017-12-08 19:00:00;25,44;20,63;4,81;41383;1174;0.0284;872;302;53139;14330;0.2697;13701;629
2017-12-08 20:00:00;25,67;20,98;4,69;41383;114;0.0028;121;-7;53139;14235;0.2679;13623;612
2017-12-08 21:00:00;25,54;21,8;3,74;41383;0;0;0;0;53139;14696;0.2765;13764;932
2017-12-08 22:00:00;24,02;18,11;5,91;41383;0;0;0;0;53139;14805;0.2786;13953;852
2017-12-08 23:00:00;17,93;14,31;3,62;41383;0;0;0;0;53139;14458;0.2721;14005;453
2017-08-13 00:00:00;15,74;10,89;4,85;41383;0;0;0;0;53139;13482;0.2537;12721;761
2017-08-13 01:00:00;15,42;8,99;6,43;41383;0;0;0;0;53139;12181;0.2292;11878;303
2017-08-13 02:00:00;12,93;8,8;4,13;41383;0;0;0;0;53139;11012;0.2072;11043;-31
2017-08-13 03:00:00;11,64;7,8;3,84;41383;0;0;0;0;53139;9708;0.1827;9931;-223
2017-08-13 04:00:00;13,34;9,18;4,16;41383;0;0;0;0;53139;8451;0.159;8966;-515
2017-08-13 05:00:00;11,95;8,94;3,01;41383;2;0;3;-1;53139;7612;0.1432;7986;-374
2017-08-13 06:00:00;11,77;10,47;1,3;41383;275;0.0067;295;-20;53139;6423;0.1209;7005;-582
2017-08-13 07:00:00;16,07;13,39;2,68;41383;1888;0.0456;1797;91;53139;5303;0.0998;6084;-781
2017-08-13 08:00:00;19,0;17,86;1,14;41383;4776;0.1154;4457;319;53139;4236;0.0797;5348;-1112
2017-08-13 09:00:00;21,02;21,34;-0,32;41383;8640;0.2088;7640;1000;53139;3837;0.0722;4947;-1110
2017-08-13 10:00:00;19,69;16,79;2,9;41383;12446;0.3007;10705;1741;53139;3788;0.0713;4709;-921
2017-08-13 11:00:00;21,09;13,84;7,25;41383;15154;0.3662;13309;1845;53139;3935;0.074;4603;-668
2017-08-13 12:00:00;19,33;9,55;9,78;41383;16415;0.3967;15214;1201;53139;4217;0.0793;4587;-370
2017-08-13 13:00:00;16,07;7,5;8,57;41383;16810;0.4062;16023;787;53139;4518;0.085;4620;-102
2017-08-13 14:00:00;13,24;9,0;4,24;41383;16777;0.4054;15944;833;53139;4609;0.0867;4589;20
2017-08-13 15:00:00;11,8;8,45;3,35;41383;15708;0.3796;14730;978;53139;4344;0.0818;4393;-49
2017-08-13 16:00:00;10,8;7,37;3,43;41383;13682;0.3306;12459;1223;53139;3813;0.0718;4091;-278
2017-08-13 17:00:00;21,89;15,87;6,02;41383;10248;0.2477;9254;994;53139;3247;0.0611;3539;-292
2017-08-13 18:00:00;28,39;27,95;0,44;41383;6064;0.1465;5288;776;53139;2419;0.0455;2808;-389
2017-08-13 19:00:00;33,0;34,13;-1,13;41383;2089;0.0505;1815;274;53139;1696;0.0319;2107;-411
2017-08-13 20:00:00;34,98;37,52;-2,54;41383;183;0.0044;232;-49;53139;1231;0.0232;1664;-433
2017-08-13 21:00:00;36,47;37,74;-1,27;41383;0;0;0;0;53139;1210;0.0228;1560;-350
2017-08-13 22:00:00;35,8;37,79;-1,99;41383;0;0;0;0;53139;1312;0.0247;1573;-261
2017-08-13 23:00:00;32,0;34,36;-2,36;41383;0;0;0;0;53139;1364;0.0256;1600;-236
2017-08-14 00:00:00;28,69;30,94;-2,25;41386;0;0;0;0;53143;1450;0.0273;1464;-14
2017-08-14 01:00:00;26,37;25,45;0,92;41386;0;0;0;0;53143;1531;0.0288;1498;33
2017-08-14 02:00:00;25,24;24,07;1,17;41386;0;0;0;0;53143;1660;0.0312;1728;-68
2017-08-14 03:00:00;25,17;23,7;1,47;41386;0;0;0;0;53143;1973;0.0371;1882;91
2017-08-14 04:00:00;25,28;23,99;1,29;41386;0;0;0;0;53143;2316;0.0436;2128;188
2017-08-14 05:00:00;27,64;24,95;2,69;41386;2;0;2;0;53143;2928;0.0551;2411;517
2017-08-14 06:00:00;32,9;32,27;0,63;41386;448;0.0108;454;-6;53143;3862;0.0727;2596;1266
2017-08-14 07:00:00;37,9;36,88;1,02;41386;3419;0.0826;3192;227;53143;4380;0.0824;2654;1726
2017-08-14 08:00:00;38,44;35,03;3,41;41386;8784;0.2122;8212;572;53143;3488;0.0656;2406;1082
2017-08-14 09:00:00;36,64;34,03;2,61;41386;15068;0.3641;13844;1224;53143;2903;0.0546;2081;822
2017-08-14 10:00:00;35,04;31,72;3,32;41386;20216;0.4885;18505;1711;53143;3034;0.0571;2038;996
2017-08-14 11:00:00;34,96;29,88;5,08;41386;23553;0.5691;21643;1910;53143;2981;0.0561;2156;825
2017-08-14 12:00:00;33,4;29,2;4,2;41386;24704;0.5969;23157;1547;53143;2850;0.0536;2419;431
2017-08-14 13:00:00;31,93;28,26;3,67;41386;24450;0.5908;23039;1411;53143;2917;0.0549;2565;352
2017-08-14 14:00:00;31,87;28,39;3,48;41386;22778;0.5504;21492;1286;53143;3164;0.0596;2616;548
2017-08-14 15:00:00;33,0;29,31;3,69;41386;20188;0.4878;18764;1424;53143;3763;0.0708;2688;1075
2017-08-14 16:00:00;34,87;29,35;5,52;41386;16630;0.4018;15283;1347;53143;4423;0.0832;2914;1509
2017-08-14 17:00:00;37,07;30,91;6,16;41386;11940;0.2885;10740;1200;53143;5024;0.0946;3380;1644
2017-08-14 18:00:00;39,64;33,22;6,42;41386;6538;0.158;5736;802;53143;5512;0.1037;4218;1294
2017-08-14 19:00:00;41,96;37,46;4,5;41386;2131;0.0514;1854;277;53143;5849;0.1101;5487;362
2017-08-14 20:00:00;38,39;36,15;2,24;41386;178;0.0043;223;-45;53143;7542;0.1419;7212;330
2017-08-14 21:00:00;37,76;37,61;0,15;41386;0;0;0;0;53143;11071;0.2084;9235;1836
2017-08-14 22:00:00;32,96;33,8;-0,84;41386;0;0;0;0;53143;13396;0.252;10920;2476
2017-08-14 23:00:00;26,82;25,98;0,84;41386;0;0;0;0;53143;14250;0.2682;11845;2405
2017-08-15 00:00:00;23,9;22,92;0,98;41391;0;0;0;0;53152;14020;0.2638;13053;967
2017-08-15 01:00:00;23,05;21,4;1,65;41391;0;0;0;0;53152;13110;0.2466;12849;261
2017-08-15 02:00:00;22,07;22,72;-0,65;41391;0;0;0;0;53152;12302;0.2314;12563;-261
2017-08-15 03:00:00;19,3;22,02;-2,72;41391;0;0;0;0;53152;11381;0.2141;11952;-571
2017-08-15 04:00:00;19,25;22,08;-2,83;41391;0;0;0;0;53152;10324;0.1943;11331;-1007
2017-08-15 05:00:00;21,47;25,45;-3,98;41391;2;0;2;0;53152;9588;0.1804;10838;-1250
2017-08-15 06:00:00;26,23;30,56;-4,33;41391;415;0.01;435;-20;53152;9535;0.1794;10426;-891
2017-08-15 07:00:00;26,96;30,42;-3,46;41391;3369;0.0814;3225;144;53152;8658;0.1629;9658;-1000
2017-08-15 08:00:00;27,96;33,02;-5,06;41391;8685;0.2098;8400;285;53152;6445;0.1212;8305;-1860
2017-08-15 09:00:00;26,84;33,48;-6,64;41391;14312;0.3458;14093;219;53152;5008;0.0942;6788;-1780
2017-08-15 10:00:00;26,08;32,04;-5,96;41391;18420;0.445;18818;-398;53152;4960;0.0933;5772;-812
2017-08-15 11:00:00;26,69;30,76;-4,07;41391;20720;0.5006;22099;-1379;53152;5683;0.1069;5511;172
2017-08-15 12:00:00;25,38;30,24;-4,86;41391;21897;0.529;23603;-1706;53152;6113;0.115;5874;239
2017-08-15 13:00:00;23,07;27,22;-4,15;41391;22263;0.5379;23430;-1167;53152;6424;0.1209;6465;-41
2017-08-15 14:00:00;21,26;27,97;-6,71;41391;20596;0.4976;21922;-1326;53152;6160;0.1159;6951;-791
2017-08-15 15:00:00;25,18;31,14;-5,96;41391;17085;0.4128;19124;-2039;53152;5798;0.109;7165;-1367
2017-08-15 16:00:00;26,08;32,87;-6,79;41391;12235;0.2956;15041;-2806;53152;6336;0.1192;7275;-939
2017-08-15 17:00:00;31,34;38,0;-6,66;41391;7459;0.1802;9922;-2463;53152;5970;0.1124;7182;-1212
2017-08-15 18:00:00;35,24;42,21;-6,97;41391;3638;0.0879;4909;-1271;53152;6446;0.1213;6963;-517
2017-08-15 19:00:00;35,3;48,19;-12,89;41391;1029;0.0249;1462;-433;53152;7171;0.1349;7183;-12
2017-08-15 20:00:00;35,36;45,05;-9,69;41391;80;0.0019;159;-79;53152;8431;0.1586;7572;859
2017-08-15 21:00:00;34,95;41,95;-7,0;41391;0;0;0;0;53152;8968;0.1687;7905;1063
2017-08-15 22:00:00;29,04;37,75;-8,71;41391;0;0;0;0;53152;8558;0.161;8295;263
2017-08-15 23:00:00;27,1;35,23;-8,13;41391;0;0;0;0;53152;7885;0.1484;8460;-575
2017-08-16 00:00:00;28,93;34,84;-5,91;41396;0;0;0;0;53164;7450;0.1401;8919;-1469
2017-08-16 01:00:00;27,99;34,14;-6,15;41396;0;0;0;0;53164;6470;0.1217;8907;-2437
2017-08-16 02:00:00;27,11;33,08;-5,97;41396;0;0;0;0;53164;5896;0.1109;9031;-3135
2017-08-16 03:00:00;26,79;30,63;-3,84;41396;0;0;0;0;53164;5626;0.1058;8671;-3045
2017-08-16 04:00:00;27,64;28,97;-1,33;41396;0;0;0;0;53164;4993;0.0939;8161;-3168
2017-08-16 05:00:00;28,72;29,81;-1,09;41396;0;0;0;0;53164;4192;0.0788;7400;-3208
2017-08-16 06:00:00;34,98;35,73;-0,75;41396;162;0.0039;246;-84;53164;3941;0.0741;6474;-2533
2017-08-16 07:00:00;37,61;39,58;-1,97;41396;1447;0.035;1871;-424;53164;3666;0.0689;5473;-1807
2017-08-16 08:00:00;42,0;42,61;-0,61;41396;3931;0.095;5019;-1088;53164;2414;0.0454;4635;-2221
2017-08-16 09:00:00;41,91;45,04;-3,13;41396;7991;0.193;8944;-953;53164;2109;0.0396;4077;-1968
2017-08-16 10:00:00;40,92;43,52;-2,6;41396;12616;0.3047;12988;-372;53164;1664;0.0313;3718;-2054
2017-08-16 11:00:00;40,91;41,46;-0,55;41396;16915;0.4086;16512;403;53164;1323;0.0249;3407;-2084
2017-08-16 12:00:00;38,44;38,09;0,35;41396;19314;0.4666;18940;374;53164;1109;0.0208;3093;-1984
2017-08-16 13:00:00;36,07;35,32;0,75;41396;19999;0.4831;19955;44;53164;1064;0.02;2753;-1689
2017-08-16 14:00:00;35,56;35,92;-0,36;41396;19361;0.4677;19757;-396;53164;861;0.0162;2423;-1562
2017-08-16 15:00:00;34,31;34,28;0,03;41396;17676;0.427;18071;-395;53164;752;0.0142;2070;-1318
2017-08-16 16:00:00;36,27;35,87;0,4;41396;14370;0.3472;14749;-379;53164;625;0.0118;1708;-1083
2017-08-16 17:00:00;39,94;40,14;-0,2;41396;9819;0.2372;10238;-419;53164;560;0.0106;1334;-774
2017-08-16 18:00:00;41,93;40,82;1,11;41396;5216;0.126;5434;-218;53164;586;0.011;1058;-472
2017-08-16 19:00:00;43,15;42,1;1,05;41396;1708;0.0412;1741;-33;53164;986;0.0185;947;39
2017-08-16 20:00:00;41,95;40,32;1,63;41396;152;0.0037;185;-33;53164;1632;0.0307;1119;513
2017-08-16 21:00:00;40,1;39,6;0,5;41396;0;0;0;0;53164;2628;0.0494;1661;967
2017-08-16 22:00:00;36,02;36,3;-0,28;41396;0;0;0;0;53164;3991;0.075;2447;1544
2017-08-16 23:00:00;32,0;30,19;1,81;41396;0;0;0;0;53164;5386;0.1013;3344;2042
2017-08-17 00:00:00;29,82;27,94;1,88;41419;0;0;0;0;53192;6114;0.115;3730;2384
2017-08-17 01:00:00;28,44;26,55;1,89;41419;0;0;0;0;53192;6474;0.1217;4301;2173
2017-08-17 02:00:00;26,96;26,12;0,84;41419;0;0;0;0;53192;6574;0.1236;4919;1655
2017-08-17 03:00:00;26,83;25,93;0,9;41419;0;0;0;0;53192;7068;0.1329;5214;1854
2017-08-17 04:00:00;26,96;23,94;3,02;41419;0;0;0;0;53192;7097;0.1334;5458;1639
2017-08-17 05:00:00;28,57;27,3;1,27;41419;0;0;1;-1;53192;7061;0.1327;5814;1247
2017-08-17 06:00:00;33,94;32,32;1,62;41419;362;0.0087;368;-6;53192;7611;0.1431;6212;1399
2017-08-17 07:00:00;36,9;34,59;2,31;41419;3044;0.0735;2804;240;53192;7520;0.1414;6404;1116
2017-08-17 08:00:00;40,14;34,7;5,44;41419;7446;0.1798;7180;266;53192;6208;0.1167;6040;168
2017-08-17 09:00:00;39,24;33,57;5,67;41419;12222;0.295;11952;270;53192;5124;0.0964;5615;-491
2017-08-17 10:00:00;36,47;33,27;3,2;41419;16029;0.387;15742;287;53192;5870;0.1104;6106;-236
2017-08-17 11:00:00;36,02;33,62;2,4;41419;18259;0.4408;18191;68;53192;7436;0.1398;6990;446
2017-08-17 12:00:00;33,39;34,67;-1,28;41419;18805;0.454;19156;-351;53192;9384;0.1764;7998;1386
2017-08-17 13:00:00;31,64;32,23;-0,59;41419;17892;0.432;18470;-578;53192;10551;0.1984;8993;1558
2017-08-17 14:00:00;30,0;33,46;-3,46;41419;15383;0.3714;16664;-1281;53192;11184;0.2103;9604;1580
2017-08-17 15:00:00;30,19;33,71;-3,52;41419;12714;0.307;14104;-1390;53192;11890;0.2235;9781;2109
2017-08-17 16:00:00;31,68;35,29;-3,61;41419;9831;0.2374;11075;-1244;53192;12020;0.226;9795;2225
2017-08-17 17:00:00;35,32;38,4;-3,08;41419;6542;0.158;7528;-986;53192;12178;0.229;9522;2656
2017-08-17 18:00:00;37,42;39,06;-1,64;41419;3520;0.085;3953;-433;53192;11073;0.2082;9022;2051
2017-08-17 19:00:00;38,97;40,92;-1,95;41419;1056;0.0255;1220;-164;53192;10078;0.1894;8653;1425
2017-08-17 20:00:00;38,35;39,66;-1,31;41419;88;0.0021;114;-26;53192;9281;0.1745;8425;856
2017-08-17 21:00:00;37,62;39,03;-1,41;41419;0;0;0;0;53192;8842;0.1662;8175;667
2017-08-17 22:00:00;36,87;37,13;-0,26;41419;0;0;0;0;53192;8847;0.1663;7924;923
2017-08-17 23:00:00;31,7;33,26;-1,56;41419;0;0;0;0;53192;8689;0.1634;7672;1017
2017-08-18 00:00:00;29,21;28,5;0,71;41425;0;0;0;0;53220;8210;0.1542;7740;470
2017-08-18 01:00:00;28,29;30,26;-1,97;41425;0;0;0;0;53220;7964;0.1496;7202;762
2017-08-18 02:00:00;27,28;28,58;-1,3;41425;0;0;0;0;53220;7336;0.1378;7007;329
2017-08-18 03:00:00;26,35;26,39;-0,04;41425;0;0;0;0;53220;7126;0.1339;6769;357
2017-08-18 04:00:00;27,7;29,3;-1,6;41425;0;0;0;0;53220;6914;0.1299;6598;316
2017-08-18 05:00:00;28,61;31,72;-3,11;41425;0;0;0;0;53220;6952;0.1306;6638;314
2017-08-18 06:00:00;33,63;34,39;-0,76;41425;292;0.007;303;-11;53220;7714;0.1449;6851;863
2017-08-18 07:00:00;38,48;38,58;-0,1;41425;2448;0.0591;2253;195;53220;8247;0.155;7198;1049
2017-08-18 08:00:00;42,25;39,4;2,85;41425;6080;0.1468;5713;367;53220;7684;0.1444;7629;55
2017-08-18 09:00:00;38,88;39,55;-0,67;41425;9864;0.2381;9476;388;53220;7115;0.1337;8216;-1101
2017-08-18 10:00:00;36,1;41,6;-5,5;41425;12902;0.3115;12425;477;53220;6948;0.1305;9105;-2157
2017-08-18 11:00:00;36,85;44,06;-7,21;41425;14840;0.3582;14406;434;53220;7206;0.1354;9934;-2728
2017-08-18 12:00:00;36,29;43,18;-6,89;41425;15940;0.3848;15356;584;53220;7339;0.1379;10537;-3198
2017-08-18 13:00:00;33,17;38,76;-5,59;41425;16364;0.395;15135;1229;53220;7551;0.1419;10923;-3372
2017-08-18 14:00:00;31,1;36,5;-5,4;41425;15065;0.3637;14079;986;53220;7868;0.1478;10969;-3101
2017-08-18 15:00:00;31,56;36,8;-5,24;41425;12797;0.3089;12261;536;53220;7814;0.1468;10661;-2847
2017-08-18 16:00:00;32,4;38,16;-5,76;41425;9870;0.2383;9575;295;53220;7610;0.143;10336;-2726
2017-08-18 17:00:00;35,71;40,25;-4,54;41425;6004;0.145;6390;-386;53220;7076;0.1329;9898;-2822
2017-08-18 18:00:00;37,43;44,35;-6,92;41425;2467;0.0596;3240;-773;53220;7865;0.1478;9284;-1419
2017-08-18 19:00:00;38,7;44,42;-5,72;41425;648;0.0156;953;-305;53220;8338;0.1567;8586;-248
2017-08-18 20:00:00;36,99;40,3;-3,31;41425;58;0.0014;82;-24;53220;8096;0.1522;7913;183
2017-08-18 21:00:00;37,02;36,19;0,83;41425;0;0;0;0;53220;8143;0.153;7453;690
2017-08-18 22:00:00;34,95;33,86;1,09;41425;0;0;0;0;53220;8476;0.1592;7367;1109
2017-08-18 23:00:00;29,45;29,59;-0,14;41425;0;0;0;0;53220;9550;0.1794;7658;1892
2017-08-19 00:00:00;22,22;29,88;-7,66;41426;0;0;0;0;53226;9923;0.1864;11321;-1398
2017-08-19 01:00:00;22,01;25,2;-3,19;41426;0;0;0;0;53226;11901;0.2236;12254;-353
2017-08-19 02:00:00;13,11;13,16;-0,05;41426;0;0;0;0;53226;13204;0.2481;13106;98
2017-08-19 03:00:00;10,93;9,87;1,06;41426;0;0;0;0;53226;13887;0.2609;13475;412
2017-08-19 04:00:00;10,47;7,51;2,96;41426;0;0;0;0;53226;14738;0.2769;13597;1141
2017-08-19 05:00:00;10,93;6,28;4,65;41426;0;0;0;0;53226;14677;0.2758;13608;1069
2017-08-19 06:00:00;11,0;8,88;2,12;41426;208;0.005;255;-47;53226;14592;0.2742;13762;830
2017-08-19 07:00:00;15,93;11,26;4,67;41426;1960;0.0473;2104;-144;53226;14335;0.2693;14242;93
2017-08-19 08:00:00;20,74;18,52;2,22;41426;5010;0.121;5687;-677;53226;15127;0.2842;15196;-69
2017-08-19 09:00:00;18,96;18,56;0,4;41426;8456;0.2041;9808;-1352;53226;16125;0.303;16693;-568
2017-08-19 10:00:00;14,62;18,0;-3,38;41426;12034;0.2905;13428;-1394;53226;18105;0.3402;18180;-75
2017-08-19 11:00:00;12,42;16,18;-3,76;41426;14998;0.362;16207;-1209;53226;18976;0.3565;19225;-249
2017-08-19 12:00:00;7,13;14,19;-7,06;41426;17070;0.412;17924;-854;53226;19400;0.3645;19585;-185
2017-08-19 13:00:00;-0,07;9,53;-9,6;41426;18188;0.4391;18412;-224;53226;19199;0.3607;19677;-478
2017-08-19 14:00:00;-4,0;6,14;-10,14;41426;17659;0.4263;17876;-217;53226;18925;0.3556;19532;-607
2017-08-19 15:00:00;-0,22;2,8;-3,02;41426;15986;0.3859;16234;-248;53226;18216;0.3423;19174;-958
2017-08-19 16:00:00;8,16;5,09;3,07;41426;13089;0.316;13539;-450;53226;17893;0.3362;18639;-746
2017-08-19 17:00:00;11,33;7,15;4,18;41426;9270;0.2238;9673;-403;53226;16000;0.3006;17536;-1536
2017-08-19 18:00:00;22,03;21,62;0,41;41426;4940;0.1192;5114;-174;53226;14258;0.2679;15820;-1562
2017-08-19 19:00:00;26,63;25,52;1,11;41426;1417;0.0342;1478;-61;53226;11897;0.2235;13818;-1921
2017-08-19 20:00:00;26,63;26,75;-0,12;41426;83;0.002;131;-48;53226;11062;0.2078;12436;-1374
2017-08-19 21:00:00;27,0;22,88;4,12;41426;0;0;0;0;53226;10836;0.2036;11978;-1142
2017-08-19 22:00:00;25,33;22,21;3,12;41426;0;0;0;0;53226;12062;0.2266;12011;51
2017-08-19 23:00:00;20,05;15,09;4,96;41426;0;0;0;0;53226;12772;0.24;12234;538
2017-08-20 00:00:00;10,84;6,87;3,97;41426;0;0;0;0;53226;12948;0.2432;11644;1304
2017-08-20 01:00:00;10,1;3,04;7,06;41426;0;0;0;0;53226;12799;0.2405;11889;910
2017-08-20 02:00:00;9,77;1,08;8,69;41426;0;0;0;0;53226;12928;0.2429;12095;833
2017-08-20 03:00:00;9,01;0,01;9,0;41426;0;0;0;0;53226;13161;0.2473;12123;1038
2017-08-20 04:00:00;5,18;-1,1;6,28;41426;0;0;0;0;53226;13214;0.2482;12169;1045
2017-08-20 05:00:00;8,51;-1,85;10,36;41426;0;0;0;0;53226;13186;0.2477;11985;1201
2017-08-20 06:00:00;8,17;-0,99;9,16;41426;269;0.0065;272;-3;53226;13444;0.2526;11663;1781
2017-08-20 07:00:00;5,06;-1,94;7,0;41426;2772;0.0669;2659;113;53226;12326;0.2316;11228;1098
2017-08-20 08:00:00;9,65;-1,1;10,75;41426;7757;0.1872;7519;238;53226;10974;0.2062;10766;208
2017-08-20 09:00:00;5,59;1,72;3,87;41426;13660;0.3298;13018;642;53226;10999;0.2066;10609;390
2017-08-20 10:00:00;2,66;-2,02;4,68;41426;17780;0.4292;17254;526;53226;12367;0.2324;11439;928
2017-08-20 11:00:00;2,1;-2,94;5,04;41426;19367;0.4675;19630;-263;53226;14274;0.2682;12622;1652
2017-08-20 12:00:00;-0,01;0,41;-0,42;41426;19030;0.4594;20482;-1452;53226;15021;0.2822;13361;1660
2017-08-20 13:00:00;-14,35;-1,95;-12,4;41426;17771;0.429;20096;-2325;53226;15306;0.2875;13766;1540
2017-08-20 14:00:00;-12,93;-0,56;-12,37;41426;16509;0.3985;18820;-2311;53226;15976;0.3002;14078;1898
2017-08-20 15:00:00;-6,37;-0,01;-6,36;41426;14881;0.3592;16530;-1649;53226;16025;0.3011;14282;1743
2017-08-20 16:00:00;-3,57;0,48;-4,05;41426;12370;0.2986;13378;-1008;53226;15704;0.2951;14230;1474
2017-08-20 17:00:00;7,53;5,02;2,51;41426;8714;0.2103;9314;-600;53226;14886;0.2797;13727;1159
2017-08-20 18:00:00;14,13;15,0;-0,87;41426;4590;0.1108;4854;-264;53226;13665;0.2568;12640;1025
2017-08-20 19:00:00;26,5;27,01;-0,51;41426;1324;0.032;1365;-41;53226;12382;0.2326;11273;1109
2017-08-20 20:00:00;28,5;30,55;-2,05;41426;74;0.0017;104;-30;53226;11368;0.2136;10330;1038
2017-08-20 21:00:00;30,57;31,51;-0,94;41426;0;0;0;0;53226;11692;0.2197;9952;1740
2017-08-20 22:00:00;29,06;28,77;0,29;41426;0;0;0;0;53226;11622;0.2184;9692;1930
2017-08-20 23:00:00;23,18;18,04;5,14;41426;0;0;0;0;53226;11332;0.2129;9492;1840
2017-08-21 00:00:00;19,55;15,93;3,62;41429;0;0;0;0;53232;11191;0.2103;11021;170
2017-08-21 01:00:00;12,34;11,69;0,65;41429;0;0;0;0;53232;11015;0.2069;11092;-77
2017-08-21 02:00:00;10,96;8,97;1,99;41429;0;0;0;0;53232;11059;0.2078;11192;-133
2017-08-21 03:00:00;9,74;7,25;2,49;41429;0;0;0;0;53232;11211;0.2106;11068;143
2017-08-21 04:00:00;9,96;10,12;-0,16;41429;0;0;0;0;53232;11178;0.21;10990;188
2017-08-21 05:00:00;20,34;20,92;-0,58;41429;0;0;0;0;53232;10944;0.2056;10864;80
2017-08-21 06:00:00;29,93;33,22;-3,29;41429;248;0.006;242;6;53232;10722;0.2014;10657;65
2017-08-21 07:00:00;35,17;45,71;-10,54;41429;2393;0.0578;2287;106;53232;10143;0.1906;10406;-263
2017-08-21 08:00:00;36,8;43,84;-7,04;41429;6615;0.1597;6324;291;53232;9306;0.1748;9939;-633
2017-08-21 09:00:00;35,54;39,85;-4,31;41429;11669;0.2817;10901;768;53232;9455;0.1776;9560;-105
2017-08-21 10:00:00;33,77;36,55;-2,78;41429;15789;0.3811;14709;1080;53232;10366;0.1947;9958;408
2017-08-21 11:00:00;31,16;34,16;-3,0;41429;18085;0.4366;17245;840;53232;10696;0.2009;10388;308
2017-08-21 12:00:00;30,96;32,56;-1,6;41429;18746;0.4525;18364;382;53232;10562;0.1984;10551;11
2017-08-21 13:00:00;29,62;31,79;-2,17;41429;19279;0.4654;18521;758;53232;10448;0.1963;10597;-149
2017-08-21 14:00:00;27,93;29,66;-1,73;41429;18774;0.4532;17733;1041;53232;10544;0.198;10551;-7
2017-08-21 15:00:00;29,87;28,77;1,1;41429;16912;0.4082;15898;1014;53232;10325;0.194;10328;-3
2017-08-21 16:00:00;32,06;32,42;-0,36;41429;13795;0.333;13103;692;53232;10079;0.1893;9826;253
2017-08-21 17:00:00;34,71;35,57;-0,86;41429;9654;0.233;9203;451;53232;9762;0.1834;8988;774
2017-08-21 18:00:00;39,8;42,17;-2,37;41429;4958;0.1197;4773;185;53232;8644;0.1624;7798;846
2017-08-21 19:00:00;41,86;43,92;-2,06;41429;1372;0.0331;1281;91;53232;6822;0.1282;6366;456
2017-08-21 20:00:00;41,01;43,1;-2,09;41429;68;0.0016;93;-25;53232;5458;0.1025;5449;9
2017-08-21 21:00:00;40,31;42,16;-1,85;41429;0;0;0;0;53232;5235;0.0984;4929;306
2017-08-21 22:00:00;37,71;39,21;-1,5;41429;0;0;0;0;53232;4946;0.0929;4669;277
2017-08-21 23:00:00;32,0;32,61;-0,61;41429;0;0;0;0;53232;4796;0.0901;4506;290
2017-08-22 00:00:00;32,77;34,83;-2,06;41434;0;0;0;0;53243;4611;0.0866;4255;356
2017-08-22 01:00:00;30,0;30,92;-0,92;41434;0;0;0;0;53243;4559;0.0856;4159;400
2017-08-22 02:00:00;29,53;30,75;-1,22;41434;0;0;0;0;53243;4734;0.0889;4187;547
2017-08-22 03:00:00;27,9;28,13;-0,23;41434;0;0;0;0;53243;4754;0.0893;4098;656
2017-08-22 04:00:00;27,78;25,71;2,07;41434;0;0;0;0;53243;4666;0.0876;4001;665
2017-08-22 05:00:00;31,78;28,43;3,35;41434;0;0;0;0;53243;4392;0.0825;3872;520
2017-08-22 06:00:00;37,71;33,83;3,88;41434;249;0.006;252;-3;53243;3940;0.074;3652;288
2017-08-22 07:00:00;42,24;42,47;-0,23;41434;2580;0.0623;2534;46;53243;3607;0.0678;3367;240
2017-08-22 08:00:00;42,42;41,28;1,14;41434;7124;0.172;7209;-85;53243;3130;0.0588;3003;127
2017-08-22 09:00:00;39,99;40,74;-0,75;41434;12545;0.3028;12448;97;53243;2780;0.0522;2860;-80
2017-08-22 10:00:00;37,76;38,48;-0,72;41434;17219;0.4156;16751;468;53243;3397;0.0638;3318;79
2017-08-22 11:00:00;36,91;36,65;0,26;41434;20443;0.4934;19647;796;53243;3871;0.0727;3779;92
2017-08-22 12:00:00;35,57;35,46;0,11;41434;21532;0.5196;21003;529;53243;4417;0.083;4060;357
2017-08-22 13:00:00;35,36;35,68;-0,32;41434;20974;0.5062;21096;-122;53243;4628;0.0869;4197;431
2017-08-22 14:00:00;35,08;36,18;-1,1;41434;20316;0.4903;20034;282;53243;4604;0.0865;4176;428
2017-08-22 15:00:00;36,06;36,38;-0,32;41434;18240;0.4402;17774;466;53243;4634;0.087;3932;702
2017-08-22 16:00:00;37,39;35,33;2,06;41434;14974;0.3614;14455;519;53243;4356;0.0818;3557;799
2017-08-22 17:00:00;42,02;38,79;3,23;41434;10478;0.2529;9991;487;53243;3728;0.07;3108;620
2017-08-22 18:00:00;44,71;45,3;-0,59;41434;5311;0.1282;5079;232;53243;2814;0.0529;2655;159
2017-08-22 19:00:00;48,17;48,02;0,15;41434;1336;0.0322;1351;-15;53243;2074;0.039;2308;-234
2017-08-22 20:00:00;45,07;47,62;-2,55;41434;54;0.0013;97;-43;53243;2175;0.0409;2304;-129
2017-08-22 21:00:00;43,38;45,59;-2,21;41434;0;0;0;0;53243;2595;0.0487;2591;4
2017-08-22 22:00:00;38,81;39,24;-0,43;41434;0;0;0;0;53243;2913;0.0547;2906;7
2017-08-22 23:00:00;34,85;34,47;0,38;41434;0;0;0;0;53243;3060;0.0575;3041;19
2017-08-23 00:00:00;30,97;30,5;0,47;41438;0;0;0;0;53262;3026;0.0568;3152;-126
2017-08-23 01:00:00;30,93;30,75;0,18;41438;0;0;0;0;53262;2849;0.0535;2949;-100
2017-08-23 02:00:00;29,63;29,06;0,57;41438;0;0;0;0;53262;2665;0.05;2874;-209
2017-08-23 03:00:00;28,4;27,23;1,17;41438;0;0;0;0;53262;2426;0.0456;2619;-193
2017-08-23 04:00:00;28,06;26,63;1,43;41438;0;0;0;0;53262;2159;0.0406;2458;-299
2017-08-23 05:00:00;29,76;30,73;-0,97;41438;0;0;0;0;53262;2140;0.0402;2414;-274
2017-08-23 06:00:00;36,93;35,89;1,04;41438;263;0.0063;263;0;53262;2340;0.0439;2365;-25
2017-08-23 07:00:00;40,92;39,41;1,51;41438;2852;0.0688;2729;123;53262;2330;0.0438;2244;86
2017-08-23 08:00:00;43,36;39,92;3,44;41438;8046;0.1942;7874;172;53262;1810;0.034;1780;30
2017-08-23 09:00:00;40,72;40,37;0,35;41438;14141;0.3412;13816;325;53262;880;0.0165;1219;-339
2017-08-23 10:00:00;38,24;41,3;-3,06;41438;19503;0.4706;18826;677;53262;836;0.0157;1052;-216
2017-08-23 11:00:00;37,5;39,3;-1,8;41438;23200;0.5599;22268;932;53262;1151;0.0216;1051;100
2017-08-23 12:00:00;36,25;36,15;0,1;41438;24913;0.6012;24016;897;53262;1234;0.0232;1150;84
2017-08-23 13:00:00;34,0;34,22;-0,22;41438;25365;0.6121;24455;910;53262;1315;0.0247;1275;40
2017-08-23 14:00:00;32,5;33,5;-1,0;41438;24362;0.5879;23575;787;53262;1521;0.0286;1367;154
2017-08-23 15:00:00;34,1;34,13;-0,03;41438;21662;0.5228;21156;506;53262;1886;0.0354;1419;467
2017-08-23 16:00:00;37,06;37,16;-0,1;41438;17237;0.416;17237;0;53262;2217;0.0416;1519;698
2017-08-23 17:00:00;40,24;41,96;-1,72;41438;11338;0.2736;11691;-353;53262;2457;0.0461;1757;700
2017-08-23 18:00:00;45,94;48,48;-2,54;41438;5115;0.1234;5604;-489;53262;2623;0.0493;2261;362
2017-08-23 19:00:00;48,05;49,41;-1,36;41438;1162;0.028;1344;-182;53262;3132;0.0588;3084;48
2017-08-23 20:00:00;44,9;46,18;-1,28;41438;34;0.0008;93;-59;53262;4847;0.091;4445;402
2017-08-23 21:00:00;41,92;42,64;-0,72;41438;0;0;0;0;53262;6883;0.1292;6248;635
2017-08-23 22:00:00;35,96;38,53;-2,57;41438;0;0;0;0;53262;8342;0.1566;7842;500
2017-08-23 23:00:00;31,29;34,41;-3,12;41438;0;0;0;0;53262;9127;0.1714;8881;246
2017-08-24 00:00:00;29,99;33,2;-3,21;41442;0;0;0;0;53289;9516;0.1786;8538;978
2017-08-24 01:00:00;29,48;31,31;-1,83;41442;0;0;0;0;53289;9594;0.18;8661;933
2017-08-24 02:00:00;28,1;30,75;-2,65;41442;0;0;0;0;53289;9070;0.1702;8756;314
2017-08-24 03:00:00;27,73;29,56;-1,83;41442;0;0;0;0;53289;8674;0.1628;8371;303
2017-08-24 04:00:00;28,0;29,35;-1,35;41442;0;0;0;0;53289;8241;0.1546;7955;286
2017-08-24 05:00:00;30,27;33,73;-3,46;41442;0;0;0;0;53289;8341;0.1565;7676;665
2017-08-24 06:00:00;36,45;38,43;-1,98;41442;186;0.0044;195;-9;53289;8734;0.1639;7629;1105
2017-08-24 07:00:00;39,42;44,2;-4,78;41442;2158;0.052;2081;77;53289;8811;0.1654;7489;1322
2017-08-24 08:00:00;42,14;46,35;-4,21;41442;5857;0.1413;5829;28;53289;7892;0.1481;6890;1002
2017-08-24 09:00:00;42,09;45,13;-3,04;41442;9790;0.2362;10127;-337;53289;6869;0.1289;6345;524
2017-08-24 10:00:00;40,7;44,86;-4,16;41442;13326;0.3216;13936;-610;53289;6855;0.1286;6821;34
2017-08-24 11:00:00;39,94;45,29;-5,35;41442;16257;0.3923;16759;-502;53289;7746;0.1454;7605;141
2017-08-24 12:00:00;32,38;38,67;-6,29;41442;17998;0.4343;18387;-389;53289;8485;0.1592;8386;99
2017-08-24 13:00:00;29,63;34,21;-4,58;41442;18735;0.4521;18808;-73;53289;8656;0.1624;9386;-730
2017-08-24 14:00:00;29,69;34,44;-4,75;41442;18431;0.4448;18119;312;53289;8945;0.1679;10135;-1190
2017-08-24 15:00:00;29,8;36,96;-7,16;41442;16748;0.4041;16137;611;53289;9430;0.177;10453;-1023
2017-08-24 16:00:00;31,76;37,09;-5,33;41442;13356;0.3223;13042;314;53289;9400;0.1764;10387;-987
2017-08-24 17:00:00;39,7;43,17;-3,47;41442;8577;0.207;8941;-364;53289;9195;0.1726;9831;-636
2017-08-24 18:00:00;42,75;45,42;-2,67;41442;3978;0.096;4473;-495;53289;8498;0.1594;8761;-263
2017-08-24 19:00:00;44,89;47,56;-2,67;41442;919;0.0222;1122;-203;53289;7162;0.1344;7613;-451
2017-08-24 20:00:00;44,55;48,9;-4,35;41442;25;0.0006;65;-40;53289;6594;0.1238;6882;-288
2017-08-24 21:00:00;42,91;45,26;-2,35;41442;0;0;0;0;53289;6572;0.1233;6490;82
2017-08-24 22:00:00;39,22;40,79;-1,57;41442;0;0;0;0;53289;6618;0.1242;6236;382
2017-08-24 23:00:00;33,96;33,83;0,13;41442;0;0;0;0;53289;6304;0.1183;6032;272
2017-08-25 00:00:00;33,43;36,59;-3,16;41446;0;0;0;0;53302;5881;0.1103;5308;573
2017-08-25 01:00:00;31,31;34,75;-3,44;41446;0;0;0;0;53302;5662;0.1062;5032;630
2017-08-25 02:00:00;30,13;32,86;-2,73;41446;0;0;0;0;53302;5124;0.0961;4935;189
2017-08-25 03:00:00;29,51;31,61;-2,1;41446;0;0;0;0;53302;4868;0.0913;4703;165
2017-08-25 04:00:00;29,94;32,17;-2,23;41446;0;0;0;0;53302;4778;0.0896;4530;248
2017-08-25 05:00:00;32,28;34,62;-2,34;41446;0;0;0;0;53302;4806;0.0901;4330;476
2017-08-25 06:00:00;38,05;39,81;-1,76;41446;194;0.0047;202;-8;53302;4951;0.0929;4061;890
2017-08-25 07:00:00;42,97;43,22;-0,25;41446;2345;0.0566;2315;30;53302;4721;0.0886;3772;949
2017-08-25 08:00:00;44,9;43,06;1,84;41446;6474;0.1562;6777;-303;53302;3932;0.0738;3407;525
2017-08-25 09:00:00;44,67;45,35;-0,68;41446;11964;0.2886;12016;-52;53302;3376;0.0634;3177;199
2017-08-25 10:00:00;41,77;43,54;-1,77;41446;17047;0.4113;16616;431;53302;3956;0.0742;3393;563
2017-08-25 11:00:00;39,87;38,78;1,09;41446;20864;0.5034;19791;1073;53302;4826;0.0905;3653;1173
2017-08-25 12:00:00;37,92;33,24;4,68;41446;22536;0.5437;21338;1198;53302;5111;0.0959;3815;1296
2017-08-25 13:00:00;34,98;30,14;4,84;41446;22852;0.5514;21380;1472;53302;5086;0.0954;3806;1280
2017-08-25 14:00:00;33,09;30,7;2,39;41446;21422;0.5169;20072;1350;53302;4588;0.0861;3652;936
2017-08-25 15:00:00;33,99;33,03;0,96;41446;18454;0.4453;17577;877;53302;3770;0.0707;3342;428
2017-08-25 16:00:00;36,04;35,43;0,61;41446;14133;0.341;14090;43;53302;3039;0.057;2915;124
2017-08-25 17:00:00;40,41;44,62;-4,21;41446;8845;0.2134;9535;-690;53302;2464;0.0462;2440;24
2017-08-25 18:00:00;43,98;47,95;-3,97;41446;3946;0.0952;4645;-699;53302;2012;0.0377;2015;-3
2017-08-25 19:00:00;45,7;49,58;-3,88;41446;811;0.0195;1096;-285;53302;1373;0.0258;1780;-407
2017-08-25 20:00:00;45,4;48,45;-3,05;41446;18;0.0004;56;-38;53302;1528;0.0287;1877;-349
2017-08-25 21:00:00;42,91;45,01;-2,1;41446;0;0;0;0;53302;1789;0.0336;2231;-442
2017-08-25 22:00:00;39,7;43,02;-3,32;41446;0;0;0;0;53302;2058;0.0386;2621;-563
2017-08-25 23:00:00;35,43;38,57;-3,14;41446;0;0;0;0;53302;2118;0.0397;2910;-792
2017-08-26 00:00:00;34,75;37,82;-3,07;41447;0;0;0;0;53305;2075;0.0389;2499;-424
2017-08-26 01:00:00;32,21;37,97;-5,76;41447;0;0;0;0;53305;2232;0.0419;2531;-299
2017-08-26 02:00:00;31,38;35,93;-4,55;41447;0;0;0;0;53305;2580;0.0484;2642;-62
2017-08-26 03:00:00;30,89;35,6;-4,71;41447;0;0;0;0;53305;2707;0.0508;2661;46
2017-08-26 04:00:00;30,61;35,44;-4,83;41447;0;0;0;0;53305;2711;0.0509;2702;9
2017-08-26 05:00:00;30,29;36,04;-5,75;41447;0;0;0;0;53305;2761;0.0518;2732;29
2017-08-26 06:00:00;30,47;35,82;-5,35;41447;142;0.0034;165;-23;53305;3020;0.0567;2704;316
2017-08-26 07:00:00;31,04;36,77;-5,73;41447;2016;0.0486;2074;-58;53305;3216;0.0603;2556;660
2017-08-26 08:00:00;34,82;39,99;-5,17;41447;5791;0.1397;6250;-459;53305;2850;0.0535;2078;772
2017-08-26 09:00:00;35,96;40,05;-4,09;41447;10272;0.2478;11021;-749;53305;1558;0.0292;1410;148
2017-08-26 10:00:00;35,65;39,53;-3,88;41447;14342;0.3461;15145;-803;53305;1009;0.0189;1124;-115
2017-08-26 11:00:00;34,99;40,33;-5,34;41447;17322;0.4179;18108;-786;53305;906;0.017;1248;-342
2017-08-26 12:00:00;31,52;35,67;-4,15;41447;19524;0.471;19703;-179;53305;926;0.0174;1450;-524
2017-08-26 13:00:00;30,78;33,13;-2,35;41447;20352;0.491;19711;641;53305;1075;0.0202;1635;-560
2017-08-26 14:00:00;30,23;31,14;-0,91;41447;19435;0.4689;18541;894;53305;1242;0.0233;1790;-548
2017-08-26 15:00:00;31,92;31,48;0,44;41447;16767;0.4046;16279;488;53305;1416;0.0266;1918;-502
2017-08-26 16:00:00;32,17;32,54;-0,37;41447;12924;0.3118;12983;-59;53305;1454;0.0273;1984;-530
2017-08-26 17:00:00;36,82;36,69;0,13;41447;8404;0.2028;8667;-263;53305;1478;0.0278;1879;-401
2017-08-26 18:00:00;39,67;42,75;-3,08;41447;3914;0.0944;4140;-226;53305;1366;0.0256;1717;-351
2017-08-26 19:00:00;42,0;44,1;-2,1;41447;797;0.0192;925;-128;53305;1577;0.0296;1705;-128
2017-08-26 20:00:00;42,38;43,34;-0,96;41447;18;0.0004;45;-27;53305;1942;0.0365;1800;142
2017-08-26 21:00:00;39,97;40,91;-0,94;41447;0;0;0;0;53305;1939;0.0364;1965;-26
2017-08-26 22:00:00;38,44;40,53;-2,09;41447;0;0;0;0;53305;2212;0.0415;2188;24
2017-08-26 23:00:00;34,9;37,48;-2,58;41447;0;0;0;0;53305;2706;0.0508;2481;225
2017-08-27 00:00:00;34,95;32,92;2,03;41447;0;0;0;0;53311;3634;0.0682;2751;883
2017-08-27 01:00:00;31,88;29,76;2,12;41447;0;0;0;0;53311;4992;0.0937;3333;1659
2017-08-27 02:00:00;30,01;24,04;5,97;41447;0;0;0;0;53311;6595;0.1237;4104;2491
2017-08-27 03:00:00;28,71;20,21;8,5;41447;0;0;0;0;53311;7304;0.137;4533;2771
2017-08-27 04:00:00;29,32;19,92;9,4;41447;0;0;0;0;53311;7824;0.1468;4683;3141
2017-08-27 05:00:00;28,82;20,68;8,14;41447;0;0;0;0;53311;7935;0.1488;4670;3265
2017-08-27 06:00:00;29,67;21,65;8,02;41447;150;0.0036;153;-3;53311;7579;0.1422;4471;3108
2017-08-27 07:00:00;28,46;22,67;5,79;41447;2046;0.0494;1936;110;53311;6565;0.1232;4152;2413
2017-08-27 08:00:00;29,44;26,55;2,89;41447;5714;0.1378;5732;-18;53311;5326;0.0999;3741;1585
2017-08-27 09:00:00;26,04;22,63;3,41;41447;10513;0.2536;9992;521;53311;5330;0.1;3408;1922
2017-08-27 10:00:00;22,18;15,93;6,25;41447;14941;0.3605;13569;1372;53311;6152;0.1154;3663;2489
2017-08-27 11:00:00;22,06;8,27;13,79;41447;17904;0.432;16009;1895;53311;6292;0.118;4233;2059
2017-08-27 12:00:00;20,74;7,61;13,13;41447;18935;0.4568;17437;1498;53311;6597;0.1237;4790;1807
2017-08-27 13:00:00;25,42;9,22;16,2;41447;18954;0.4573;17774;1180;53311;7231;0.1356;5343;1888
2017-08-27 14:00:00;23,89;12,03;11,86;41447;17510;0.4224;16951;559;53311;7486;0.1404;5726;1760
2017-08-27 15:00:00;27,0;18,9;8,1;41447;15148;0.3655;14820;328;53311;7277;0.1365;5868;1409
2017-08-27 16:00:00;28,74;25,08;3,66;41447;12597;0.3039;11875;722;53311;6688;0.1255;5698;990
2017-08-27 17:00:00;30,63;29,44;1,19;41447;8493;0.2049;8096;397;53311;5876;0.1102;5195;681
2017-08-27 18:00:00;35,2;35,06;0,14;41447;4062;0.098;3949;113;53311;4534;0.085;4318;216
2017-08-27 19:00:00;38,96;42,3;-3,34;41447;861;0.0207;878;-17;53311;3029;0.0568;3385;-356
2017-08-27 20:00:00;42,21;41,89;0,32;41447;17;0.0004;37;-20;53311;2692;0.0505;2889;-197
2017-08-27 21:00:00;42,43;41,93;0,5;41447;0;0;0;0;53311;2561;0.048;2678;-117
2017-08-27 22:00:00;38,0;39,9;-1,9;41447;0;0;0;0;53311;2432;0.0456;2564;-132
2017-08-27 23:00:00;35,98;35,56;0,42;41447;0;0;0;0;53311;2370;0.0445;2446;-76
2017-08-28 00:00:00;33,54;33,61;-0,07;41452;0;0;0;0;53317;2225;0.0417;2341;-116
2017-08-28 01:00:00;30,94;31,71;-0,77;41452;0;0;0;0;53317;2155;0.0404;2221;-66
2017-08-28 02:00:00;30,64;30,66;-0,02;41452;0;0;0;0;53317;2168;0.0407;2180;-12
2017-08-28 03:00:00;30,4;29,57;0,83;41452;0;0;0;0;53317;2045;0.0383;1939;106
2017-08-28 04:00:00;30,42;29,39;1,03;41452;0;0;0;0;53317;1917;0.036;1768;149
2017-08-28 05:00:00;31,99;30,55;1,44;41452;0;0;0;0;53317;1741;0.0326;1621;120
2017-08-28 06:00:00;41,99;37,66;4,33;41452;148;0.0036;156;-8;53317;1619;0.0304;1505;114
2017-08-28 07:00:00;43,98;42,89;1,09;41452;2279;0.055;2147;132;53317;1552;0.0291;1416;136
2017-08-28 08:00:00;45,56;43,17;2,39;41452;6911;0.1667;6707;204;53317;1324;0.0248;1090;234
2017-08-28 09:00:00;44,97;41,12;3,85;41452;12737;0.3073;12154;583;53317;762;0.0143;602;160
2017-08-28 10:00:00;43,5;38,21;5,29;41452;17716;0.4274;16852;864;53317;606;0.0114;402;204
2017-08-28 11:00:00;40,06;33,92;6,14;41452;21011;0.5069;20150;861;53317;598;0.0112;397;201
2017-08-28 12:00:00;35,63;33,75;1,88;41452;22546;0.5439;21740;806;53317;559;0.0105;440;119
2017-08-28 13:00:00;32,4;36,36;-3,96;41452;22866;0.5516;21789;1077;53317;509;0.0096;467;42
2017-08-28 14:00:00;31,5;34,61;-3,11;41452;21850;0.5271;20600;1250;53317;546;0.0102;487;59
2017-08-28 15:00:00;36,95;36,26;0,69;41452;19333;0.4664;18185;1148;53317;571;0.0107;487;84
2017-08-28 16:00:00;39,51;38,37;1,14;41452;15510;0.3742;14696;814;53317;583;0.0109;513;70
2017-08-28 17:00:00;44,53;45,9;-1,37;41452;10252;0.2473;9891;361;53317;500;0.0094;575;-75
2017-08-28 18:00:00;46,6;49,53;-2,93;41452;4616;0.1114;4626;-10;53317;364;0.0068;720;-356
2017-08-28 19:00:00;50,0;52,88;-2,88;41452;842;0.0203;940;-98;53317;542;0.0102;1078;-536
2017-08-28 20:00:00;47,59;52,45;-4,86;41452;14;0.0004;39;-25;53317;1366;0.0256;1757;-391
2017-08-28 21:00:00;44,26;48,07;-3,81;41452;0;0;0;0;53317;2723;0.0511;2796;-73
2017-08-28 22:00:00;38,99;42,24;-3,25;41452;0;0;0;0;53317;4330;0.0812;3838;492
2017-08-28 23:00:00;32,0;32,88;-0,88;41452;0;0;0;0;53317;5520;0.1035;4597;923
2017-08-29 00:00:00;30,86;34,06;-3,2;41458;0;0;0;0;53336;6291;0.118;5398;893
2017-08-29 01:00:00;30,2;33,08;-2,88;41458;0;0;0;0;53336;6488;0.1216;5854;634
2017-08-29 02:00:00;29,96;31,9;-1,94;41458;0;0;0;0;53336;6748;0.1265;6138;610
2017-08-29 03:00:00;29,31;30,11;-0,8;41458;0;0;0;0;53336;6756;0.1267;6110;646
2017-08-29 04:00:00;29,38;30,86;-1,48;41458;0;0;0;0;53336;6291;0.1179;6028;263
2017-08-29 05:00:00;30,77;32,91;-2,14;41458;0;0;0;0;53336;5929;0.1112;5954;-25
2017-08-29 06:00:00;35,0;37,45;-2,45;41458;124;0.003;146;-22;53336;5896;0.1106;5816;80
2017-08-29 07:00:00;42,07;44,21;-2,14;41458;2441;0.0589;2279;162;53336;5602;0.105;5468;134
2017-08-29 08:00:00;45,54;45,7;-0,16;41458;7685;0.1854;7647;38;53336;4386;0.0822;4475;-89
2017-08-29 09:00:00;42,99;43,05;-0,06;41458;13949;0.3365;13986;-37;53336;2172;0.0407;3076;-904
2017-08-29 10:00:00;38,97;40,19;-1,22;41458;19354;0.4668;19375;-21;53336;1640;0.0308;2427;-787
2017-08-29 11:00:00;35,58;36,77;-1,19;41458;23062;0.5563;23088;-26;53336;2158;0.0404;2482;-324
2017-08-29 12:00:00;31,32;33,38;-2,06;41458;24866;0.5998;25019;-153;53336;2850;0.0534;2774;76
2017-08-29 13:00:00;32,1;35,0;-2,9;41458;25087;0.6051;25327;-240;53336;3523;0.066;3083;440
2017-08-29 14:00:00;32,49;35,43;-2,94;41458;23750;0.5728;24136;-386;53336;3864;0.0724;3149;715
2017-08-29 15:00:00;33,0;36,01;-3,01;41458;20920;0.5046;21305;-385;53336;3784;0.071;3030;754
2017-08-29 16:00:00;37,68;39,1;-1,42;41458;16464;0.3971;16983;-519;53336;3155;0.0592;2812;343
2017-08-29 17:00:00;45,47;45,65;-0,18;41458;10620;0.2562;11163;-543;53336;2612;0.049;2546;66
2017-08-29 18:00:00;49,01;48,93;0,08;41458;4548;0.1097;4993;-445;53336;2064;0.0387;2391;-327
2017-08-29 19:00:00;52,47;52,65;-0,18;41458;712;0.0172;946;-234;53336;1740;0.0326;2561;-821
2017-08-29 20:00:00;49,98;51,25;-1,27;41458;3;0.0001;33;-30;53336;2294;0.043;3112;-818
2017-08-29 21:00:00;45,87;46,16;-0,29;41458;0;0;0;0;53336;3331;0.0624;3959;-628
2017-08-29 22:00:00;40,04;41,48;-1,44;41458;0;0;0;0;53336;4315;0.0809;4947;-632
2017-08-29 23:00:00;32,82;33,16;-0,34;41458;0;0;0;0;53336;5157;0.0967;5828;-671
2017-08-30 00:00:00;32,98;34,97;-1,99;41466;0;0;0;0;53396;5672;0.1062;5247;425
2017-08-30 01:00:00;30,26;31,38;-1,12;41466;0;0;0;0;53396;6222;0.1165;5545;677
2017-08-30 02:00:00;29,83;29,23;0,6;41466;0;0;0;0;53396;6504;0.1218;5767;737
2017-08-30 03:00:00;29,56;28,64;0,92;41466;0;0;0;0;53396;6580;0.1232;5649;931
2017-08-30 04:00:00;29,6;28,12;1,48;41466;0;0;0;0;53396;6192;0.116;5557;635
2017-08-30 05:00:00;30,82;29,8;1,02;41466;0;0;0;0;53396;5730;0.1073;5611;119
2017-08-30 06:00:00;36,51;37,74;-1,23;41466;134;0.0032;144;-10;53396;5834;0.1093;5713;121
2017-08-30 07:00:00;42,0;44,63;-2,63;41466;2354;0.0568;2209;145;53396;6182;0.1158;5729;453
2017-08-30 08:00:00;44,43;45,56;-1,13;41466;6992;0.1686;7053;-61;53396;5714;0.107;5234;480
2017-08-30 09:00:00;43,97;45,3;-1,33;41466;12239;0.2951;12752;-513;53396;4168;0.078;4321;-153
2017-08-30 10:00:00;43,39;45,64;-2,25;41466;16237;0.3916;17552;-1315;53396;3467;0.065;3995;-528
2017-08-30 11:00:00;39,91;54,76;-14,85;41466;18703;0.4511;20739;-2036;53396;4260;0.0798;4320;-60
2017-08-30 12:00:00;33,0;44,77;-11,77;41466;20162;0.4862;22207;-2045;53396;5538;0.1037;4927;611
2017-08-30 13:00:00;32,75;37,58;-4,83;41466;19999;0.4823;22007;-2008;53396;6872;0.1287;5724;1148
2017-08-30 14:00:00;32,83;36,39;-3,56;41466;18296;0.4412;20413;-2117;53396;7788;0.1458;6539;1249
2017-08-30 15:00:00;32,14;39,52;-7,38;41466;15521;0.3743;17459;-1938;53396;7898;0.1479;7234;664
2017-08-30 16:00:00;37,4;45,6;-8,2;41466;11546;0.2784;13477;-1931;53396;7864;0.1473;7990;-126
2017-08-30 17:00:00;40,56;46,62;-6,06;41466;6751;0.1628;8475;-1724;53396;8236;0.1543;8774;-538
2017-08-30 18:00:00;42,39;46,52;-4,13;41466;2772;0.0669;3580;-808;53396;8953;0.1677;9620;-667
2017-08-30 19:00:00;42,4;45,27;-2,87;41466;415;0.01;643;-228;53396;9816;0.1838;10590;-774
2017-08-30 20:00:00;41,39;44,7;-3,31;41466;3;0;16;-13;53396;11477;0.2149;11296;181
2017-08-30 21:00:00;37,04;41,38;-4,34;41466;0;0;0;0;53396;12199;0.2285;11859;340
2017-08-30 22:00:00;32,48;32,32;0,16;41466;0;0;0;0;53396;12341;0.2311;12061;280
2017-08-30 23:00:00;30,89;31,24;-0,35;41466;0;0;0;0;53396;12128;0.2271;11824;304
2017-08-31 00:00:00;31,0;27,36;3,64;41480;0;0;0;0;53444;12310;0.2304;8406;3904
2017-08-31 01:00:00;29,97;23,33;6,64;41480;0;0;0;0;53444;12384;0.2317;7757;4627
2017-08-31 02:00:00;29,75;22,76;6,99;41480;0;0;0;0;53444;12420;0.2324;7563;4857
2017-08-31 03:00:00;28,83;21,92;6,91;41480;0;0;0;0;53444;12775;0.239;7499;5276
2017-08-31 04:00:00;28,89;19,95;8,94;41480;0;0;0;0;53444;12302;0.2302;7553;4749
2017-08-31 05:00:00;30,06;21,25;8,81;41480;0;0;0;0;53444;10884;0.2036;7658;3226
2017-08-31 06:00:00;34,15;27,84;6,31;41480;78;0.0019;89;-11;53444;9992;0.187;7757;2235
2017-08-31 07:00:00;39,92;36,01;3,91;41480;1274;0.0307;1172;102;53444;9640;0.1803;7921;1719
2017-08-31 08:00:00;43,28;40,36;2,92;41480;3802;0.0917;3503;299;53444;9112;0.1705;8209;903
2017-08-31 09:00:00;44,92;42,52;2,4;41480;6587;0.1588;6105;482;53444;9222;0.1726;8774;448
2017-08-31 10:00:00;44,08;40,11;3,97;41480;8517;0.2054;8144;373;53444;10530;0.197;9809;721
2017-08-31 11:00:00;44,8;40,02;4,78;41480;9024;0.2176;9574;-550;53444;10893;0.2038;10624;269
2017-08-31 12:00:00;42,98;40,38;2,6;41480;9348;0.2254;10284;-936;53444;10632;0.1989;11219;-587
2017-08-31 13:00:00;41,97;40,11;1,86;41480;8827;0.2128;10182;-1355;53444;10612;0.1986;12007;-1395
2017-08-31 14:00:00;40,06;38,74;1,32;41480;7156;0.1725;9444;-2288;53444;10815;0.2023;12164;-1349
2017-08-31 15:00:00;41,97;40,22;1,75;41480;5958;0.1436;8089;-2131;53444;10790;0.2019;11531;-741
2017-08-31 16:00:00;41,94;39,89;2,05;41480;4774;0.1151;6142;-1368;53444;10451;0.1956;10845;-394
2017-08-31 17:00:00;42,05;38,36;3,69;41480;3260;0.0786;3880;-620;53444;9483;0.1774;9884;-401
2017-08-31 18:00:00;43,6;39,87;3,73;41480;1754;0.0422;1766;-12;53444;7918;0.1482;8610;-692
2017-08-31 19:00:00;43,8;40,51;3,29;41480;430;0.0103;370;60;53444;6251;0.117;7359;-1108
2017-08-31 20:00:00;44,09;41,1;2,99;41480;5;0.0001;9;-4;53444;5126;0.0959;6421;-1295
2017-08-31 21:00:00;41,92;39,45;2,47;41480;0;0;0;0;53444;4252;0.0796;5922;-1670
2017-08-31 22:00:00;35,59;35,86;-0,27;41480;0;0;0;0;53444;3976;0.0744;5511;-1535
2017-08-31 23:00:00;33,41;30,49;2,92;41480;0;0;0;0;53444;3743;0.07;5132;-1389
2017-01-09 00:00:00;33,09;29,26;3,83;41486;0;0;0;0;53458;3489;0.0653;3559;-70
2017-01-09 01:00:00;31,07;28,56;2,51;41486;0;0;0;0;53458;3189;0.0596;3263;-74
2017-01-09 02:00:00;29,89;27,84;2,05;41486;0;0;0;0;53458;3106;0.0581;3040;66
2017-01-09 03:00:00;29,64;27,32;2,32;41486;0;0;0;0;53458;2847;0.0533;2679;168
2017-01-09 04:00:00;29,65;26,21;3,44;41486;0;0;0;0;53458;2565;0.048;2329;236
2017-01-09 05:00:00;31,71;28,43;3,28;41486;0;0;0;0;53458;2204;0.0412;2027;177
2017-01-09 06:00:00;36,04;31,28;4,76;41486;42;0.001;54;-12;53458;1950;0.0365;1730;220
2017-01-09 07:00:00;43,46;38,2;5,26;41486;929;0.0224;855;74;53458;1616;0.0302;1414;202
2017-01-09 08:00:00;45,83;40,29;5,54;41486;3090;0.0744;3056;34;53458;1259;0.0236;1068;191
2017-01-09 09:00:00;45,12;40,74;4,38;41486;5769;0.139;5710;59;53458;794;0.0149;792;2
2017-01-09 10:00:00;44,9;38,68;6,22;41486;8650;0.2085;8199;451;53458;638;0.0119;696;-58
2017-01-09 11:00:00;45,02;38,88;6,14;41486;9962;0.2401;10068;-106;53458;634;0.0118;693;-59
2017-01-09 12:00:00;44,87;38,88;5,99;41486;10298;0.2483;11120;-822;53458;665;0.0124;743;-78
2017-01-09 13:00:00;43,09;38,55;4,54;41486;10258;0.2472;11212;-954;53458;744;0.0139;796;-52
2017-01-09 14:00:00;39,91;37,63;2,28;41486;9967;0.2402;10609;-642;53458;856;0.016;844;12
2017-01-09 15:00:00;38,93;35,44;3,49;41486;8847;0.2133;9337;-490;53458;1066;0.0199;907;159
2017-01-09 16:00:00;38,56;33,8;4,76;41486;7583;0.1827;7445;138;53458;1227;0.0229;1017;210
2017-01-09 17:00:00;40,36;33,78;6,58;41486;5262;0.1268;5010;252;53458;1290;0.0241;1113;177
2017-01-09 18:00:00;42,2;35,13;7,07;41486;2350;0.0566;2367;-17;53458;1360;0.0254;1176;184
2017-01-09 19:00:00;43,74;37,27;6,47;41486;398;0.0096;469;-71;53458;1326;0.0248;1288;38
2017-01-09 20:00:00;43,95;36,94;7,01;41486;2;0;10;-8;53458;1515;0.0283;1424;91
2017-01-09 21:00:00;39,4;34,93;4,47;41486;0;0;0;0;53458;1529;0.0286;1554;-25
2017-01-09 22:00:00;36,21;34,31;1,9;41486;0;0;0;0;53458;1394;0.026;1606;-212
2017-01-09 23:00:00;34,51;32,98;1,53;41486;0;0;0;0;53458;1237;0.0232;1612;-375
2017-02-09 00:00:00;32,22;34,62;-2,4;41486;0;0;0;0;53466;1191;0.0223;1526;-335
2017-02-09 01:00:00;31,73;33,75;-2,02;41486;0;0;0;0;53466;1220;0.0228;1528;-308
2017-02-09 02:00:00;30,06;30,98;-0,92;41486;0;0;0;0;53466;1257;0.0235;1689;-432
2017-02-09 03:00:00;29,64;30,55;-0,91;41486;0;0;0;0;53466;1271;0.0238;1745;-474
2017-02-09 04:00:00;29,48;30,2;-0,72;41486;0;0;0;0;53466;1252;0.0234;1801;-549
2017-02-09 05:00:00;29,99;31,53;-1,54;41486;0;0;0;0;53466;1219;0.0228;1841;-622
2017-02-09 06:00:00;31,1;32,88;-1,78;41486;56;0.0013;65;-9;53466;1255;0.0235;1803;-548
2017-02-09 07:00:00;32,39;32,64;-0,25;41486;1307;0.0315;1288;19;53466;1300;0.0243;1669;-369
2017-02-09 08:00:00;35,1;32,19;2,91;41486;4280;0.1032;4475;-195;53466;1121;0.021;1430;-309
2017-02-09 09:00:00;38,0;36,02;1,98;41486;8176;0.1971;8353;-177;53466;642;0.012;1203;-561
2017-02-09 10:00:00;38,15;37,04;1,11;41486;11566;0.2788;11740;-174;53466;646;0.0121;1225;-579
2017-02-09 11:00:00;38,03;35,11;2,92;41486;13440;0.324;14081;-641;53466;1020;0.0191;1385;-365
2017-02-09 12:00:00;35,37;34,22;1,15;41486;13562;0.3269;15297;-1735;53466;1536;0.0287;1578;-42
2017-02-09 13:00:00;33,0;32,48;0,52;41486;12914;0.3113;15373;-2459;53466;1882;0.0352;1791;91
2017-02-09 14:00:00;31,78;32,21;-0,43;41486;12370;0.2982;14385;-2015;53466;2271;0.0424;2053;218
2017-02-09 15:00:00;30,97;31,43;-0,46;41486;10702;0.258;12370;-1668;53466;2449;0.0458;2355;94
2017-02-09 16:00:00;31,5;32,86;-1,36;41486;8655;0.2086;9745;-1090;53466;2378;0.0445;2647;-269
2017-02-09 17:00:00;32,99;32,07;0,92;41486;5895;0.1421;6463;-568;53466;2533;0.0474;2727;-194
2017-02-09 18:00:00;37,25;33,58;3,67;41486;2794;0.0674;2965;-171;53466;2246;0.042;2583;-337
2017-02-09 19:00:00;40,32;37,25;3,07;41486;468;0.0113;544;-76;53466;1822;0.034;2427;-605
2017-02-09 20:00:00;40,52;38,61;1,91;41486;4;0.0001;10;-6;53466;1742;0.0326;2288;-546
2017-02-09 21:00:00;38,02;36,19;1,83;41486;0;0;0;0;53466;1789;0.0335;2233;-444
2017-02-09 22:00:00;35,65;34,32;1,33;41486;0;0;0;0;53466;1677;0.0314;2154;-477
2017-02-09 23:00:00;31,02;31,18;-0,16;41486;0;0;0;0;53466;1448;0.0271;2050;-602
2017-03-09 00:00:00;32,85;28,03;4,82;41486;0;0;0;0;53466;1303;0.0244;1822;-519
2017-03-09 01:00:00;27,84;29,03;-1,19;41486;0;0;0;0;53466;1314;0.0246;1620;-306
2017-03-09 02:00:00;29,8;27,41;2,39;41486;0;0;0;0;53466;1468;0.0274;1583;-115
2017-03-09 03:00:00;28,12;25,99;2,13;41486;0;0;0;0;53466;1503;0.0281;1495;8
2017-03-09 04:00:00;27,6;24,58;3,02;41486;0;0;0;0;53466;1413;0.0264;1419;-6
2017-03-09 05:00:00;27,64;24,29;3,35;41486;0;0;0;0;53466;1273;0.0238;1342;-69
2017-03-09 06:00:00;28,08;26,12;1,96;41486;61;0.0015;83;-22;53466;1288;0.0241;1263;25
2017-03-09 07:00:00;27,63;23,15;4,48;41486;1499;0.0361;1687;-188;53466;1224;0.0229;1179;45
2017-03-09 08:00:00;29,45;27,77;1,68;41486;4956;0.1194;5914;-958;53466;866;0.0162;994;-128
2017-03-09 09:00:00;30,25;30,16;0,09;41486;9722;0.2343;11068;-1346;53466;420;0.0079;793;-373
2017-03-09 10:00:00;29,32;30,28;-0,96;41486;14326;0.3453;15405;-1079;53466;344;0.0064;756;-412
2017-03-09 11:00:00;30,09;27,96;2,13;41486;17315;0.4174;18237;-922;53466;435;0.0081;848;-413
2017-03-09 12:00:00;30,7;28,98;1,72;41486;18107;0.4364;19642;-1535;53466;564;0.0106;973;-409
2017-03-09 13:00:00;26,26;24,54;1,72;41486;18145;0.4374;19693;-1548;53466;749;0.014;1080;-331
2017-03-09 14:00:00;25,95;23,99;1,96;41486;17195;0.4145;18350;-1155;53466;973;0.0182;1170;-197
2017-03-09 15:00:00;25,0;21,29;3,71;41486;15200;0.3664;15803;-603;53466;1171;0.0219;1210;-39
2017-03-09 16:00:00;26,46;23,82;2,64;41486;11979;0.2887;12472;-493;53466;1214;0.0227;1292;-78
2017-03-09 17:00:00;29,73;28,0;1,73;41486;7785;0.1876;8173;-388;53466;1026;0.0192;1322;-296
2017-03-09 18:00:00;34,15;35,19;-1,04;41486;3426;0.0826;3606;-180;53466;798;0.0149;1216;-418
2017-03-09 19:00:00;38,88;38,55;0,33;41486;477;0.0115;606;-129;53466;576;0.0107;1125;-549
2017-03-09 20:00:00;42,27;40,27;2,0;41486;1;0;9;-8;53466;743;0.0139;1147;-404
2017-03-09 21:00:00;39,91;38,23;1,68;41486;0;0;0;0;53466;1106;0.0207;1292;-186
2017-03-09 22:00:00;38,42;37,14;1,28;41486;0;0;0;0;53466;1392;0.026;1428;-36
2017-03-09 23:00:00;33,43;30,39;3,04;41486;0;0;0;0;53466;1684;0.0315;1515;169
2017-04-09 00:00:00;31,03;27,84;3,19;41490;0;0;0;0;53482;1918;0.0359;1783;135
2017-04-09 01:00:00;29,72;27,28;2,44;41490;0;0;0;0;53482;2031;0.038;1868;163
2017-04-09 02:00:00;29,41;26,69;2,72;41490;0;0;0;0;53482;2228;0.0417;2027;201
2017-04-09 03:00:00;27,77;24,35;3,42;41490;0;0;0;0;53482;2396;0.0448;2079;317
2017-04-09 04:00:00;28,09;25,95;2,14;41490;0;0;0;0;53482;2596;0.0485;2166;430
2017-04-09 05:00:00;30,4;27,59;2,81;41490;0;0;0;0;53482;2673;0.05;2293;380
2017-04-09 06:00:00;39,67;35,82;3,85;41490;69;0.0016;84;-15;53482;2836;0.053;2367;469
2017-04-09 07:00:00;43,92;40,54;3,38;41490;1930;0.0465;1845;85;53482;3092;0.0578;2339;753
2017-04-09 08:00:00;42,95;43,29;-0,34;41490;6778;0.1634;7002;-224;53482;2630;0.0492;2188;442
2017-04-09 09:00:00;42,04;40,83;1,21;41490;12743;0.3071;13293;-550;53482;1840;0.0344;2070;-230
2017-04-09 10:00:00;38,85;39,65;-0,8;41490;18062;0.4353;18368;-306;53482;2087;0.039;2237;-150
2017-04-09 11:00:00;35,17;38,53;-3,36;41490;21832;0.5262;21500;332;53482;2851;0.0533;2599;252
2017-04-09 12:00:00;32,36;34,65;-2,29;41490;23142;0.5577;22814;328;53482;3534;0.066;2979;555
2017-04-09 13:00:00;32,95;33,71;-0,76;41490;22297;0.5374;22278;19;53482;4125;0.0772;3360;765
2017-04-09 14:00:00;33,23;33,37;-0,14;41490;20313;0.4896;20274;39;53482;4542;0.085;3639;903
2017-04-09 15:00:00;35,26;35,72;-0,46;41490;16968;0.409;17247;-279;53482;4822;0.0902;3777;1045
2017-04-09 16:00:00;36,6;37,56;-0,96;41490;12853;0.3098;13522;-669;53482;4934;0.0922;3764;1170
2017-04-09 17:00:00;39,23;41,69;-2,46;41490;7793;0.1879;8606;-813;53482;4605;0.0861;3585;1020
2017-04-09 18:00:00;42,91;44,9;-1,99;41490;2983;0.0719;3599;-616;53482;3975;0.0743;3314;661
2017-04-09 19:00:00;45,48;44,76;0,72;41490;360;0.0086;559;-199;53482;3248;0.0607;3117;131
2017-04-09 20:00:00;45,71;46,13;-0,42;41490;0;0;7;-7;53482;3372;0.063;3176;196
2017-04-09 21:00:00;42,3;44,92;-2,62;41490;0;0;0;0;53482;3458;0.0647;3472;-14
2017-04-09 22:00:00;38,93;39,8;-0,87;41490;0;0;0;0;53482;3532;0.066;3770;-238
2017-04-09 23:00:00;33,22;34,65;-1,43;41490;0;0;0;0;53482;3774;0.0706;4011;-237
2017-05-09 00:00:00;31,92;29,97;1,95;41494;0;0;0;0;53506;3950;0.0738;3456;494
2017-05-09 01:00:00;29,93;29,59;0,34;41494;0;0;0;0;53506;3942;0.0737;3549;393
2017-05-09 02:00:00;29,7;29,91;-0,21;41494;0;0;0;0;53506;3930;0.0735;3780;150
2017-05-09 03:00:00;29,62;30,43;-0,81;41494;0;0;0;0;53506;4304;0.0804;3753;551
2017-05-09 04:00:00;29,68;28,8;0,88;41494;0;0;0;0;53506;4842;0.0905;3711;1131
2017-05-09 05:00:00;31,02;29,99;1,03;41494;0;0;0;0;53506;4930;0.0922;3764;1166
2017-05-09 06:00:00;36,37;33,94;2,43;41494;56;0.0013;70;-14;53506;4992;0.0933;3890;1102
2017-05-09 07:00:00;42,39;41,38;1,01;41494;1551;0.0374;1578;-27;53506;5087;0.0951;3985;1102
2017-05-09 08:00:00;44,05;42,97;1,08;41494;5143;0.124;5533;-390;53506;4476;0.0836;3898;578
2017-05-09 09:00:00;42,93;41,62;1,31;41494;9974;0.2404;10235;-261;53506;3448;0.0644;3519;-71
2017-05-09 10:00:00;41,26;39,13;2,13;41494;14637;0.3528;14311;326;53506;2911;0.0544;3247;-336
2017-05-09 11:00:00;41,76;38,52;3,24;41494;18120;0.4367;17145;975;53506;3348;0.0626;3372;-24
2017-05-09 12:00:00;38,49;34,85;3,64;41494;19696;0.4747;18575;1121;53506;3883;0.0726;3742;141
2017-05-09 13:00:00;37,25;33,4;3,85;41494;18800;0.453;18464;336;53506;4203;0.0785;4050;153
2017-05-09 14:00:00;36,67;32,53;4,14;41494;16546;0.3988;16962;-416;53506;4232;0.0791;4178;54
2017-05-09 15:00:00;38,43;34,86;3,57;41494;13266;0.3197;14219;-953;53506;4220;0.0788;4141;79
2017-05-09 16:00:00;39,05;37,01;2,04;41494;9712;0.234;10619;-907;53506;4022;0.0752;3973;49
2017-05-09 17:00:00;40,56;37,83;2,73;41494;5654;0.1362;6418;-764;53506;3937;0.0736;3671;266
2017-05-09 18:00:00;43,04;40,1;2,94;41494;2156;0.052;2547;-391;53506;3936;0.0736;3517;419
2017-05-09 19:00:00;44,22;40,76;3,46;41494;230;0.0056;381;-151;53506;4046;0.0756;3625;421
2017-05-09 20:00:00;44,97;40,67;4,3;41494;0;0;2;-2;53506;4858;0.0908;4031;827
2017-05-09 21:00:00;40,4;36,71;3,69;41494;0;0;0;0;53506;5506;0.1029;4532;974
2017-05-09 22:00:00;37,25;33,0;4,25;41494;0;0;0;0;53506;5760;0.1076;4960;800
2017-05-09 23:00:00;32,97;30,28;2,69;41494;0;0;0;0;53506;5819;0.1088;5309;510
2017-06-09 00:00:00;29,47;27,92;1,55;41497;0;0;0;0;53523;5633;0.1052;5404;229
2017-06-09 01:00:00;29,06;30,35;-1,29;41497;0;0;0;0;53523;5281;0.0987;5543;-262
2017-06-09 02:00:00;27,83;29,19;-1,36;41497;0;0;0;0;53523;5365;0.1002;5840;-475
2017-06-09 03:00:00;26,19;28,09;-1,9;41497;0;0;0;0;53523;5510;0.1029;6107;-597
2017-06-09 04:00:00;26,42;27,29;-0,87;41497;0;0;0;0;53523;5839;0.1091;6444;-605
2017-06-09 05:00:00;29,19;30,54;-1,35;41497;0;0;0;0;53523;6484;0.1212;6809;-325
2017-06-09 06:00:00;36,32;38,97;-2,65;41497;24;0.0006;31;-7;53523;7022;0.1312;7211;-189
2017-06-09 07:00:00;42,02;44,05;-2,03;41497;678;0.0163;704;-26;53523;8000;0.1495;7790;210
2017-06-09 08:00:00;43,73;45,74;-2,01;41497;2564;0.0618;2667;-103;53523;9651;0.1803;8511;1140
2017-06-09 09:00:00;43,0;41,88;1,12;41497;5122;0.1234;5233;-111;53523;11274;0.2106;9543;1731
2017-06-09 10:00:00;41,0;38,26;2,74;41497;7903;0.1904;7806;97;53523;14275;0.2667;10847;3428
2017-06-09 11:00:00;40,07;34,21;5,86;41497;9960;0.24;9940;20;53523;18035;0.337;12201;5834
2017-06-09 12:00:00;35,92;26,85;9,07;41497;11692;0.2818;11498;194;53523;20491;0.3828;13707;6784
2017-06-09 13:00:00;29,88;23,25;6,63;41497;13175;0.3175;12235;940;53523;21870;0.4086;15592;6278
2017-06-09 14:00:00;27,9;19,88;8,02;41497;12941;0.3118;12144;797;53523;24064;0.4496;17381;6683
2017-06-09 15:00:00;23,81;18,0;5,81;41497;11581;0.279;10986;595;53523;25405;0.4746;18918;6487
2017-06-09 16:00:00;22,06;13,75;8,31;41497;8639;0.2082;8695;-56;53523;26496;0.495;20530;5966
2017-06-09 17:00:00;26,81;19,09;7,72;41497;5398;0.1301;5651;-253;53523;25628;0.4788;21331;4297
2017-06-09 18:00:00;29,65;26,29;3,36;41497;2117;0.051;2398;-281;53523;24713;0.4617;21077;3636
2017-06-09 19:00:00;35,92;34,69;1,23;41497;208;0.005;361;-153;53523;23523;0.4395;20216;3307
2017-06-09 20:00:00;35,96;35,8;0,16;41497;0;0;2;-2;53523;22996;0.4296;19198;3798
2017-06-09 21:00:00;30,96;30,58;0,38;41497;0;0;0;0;53523;21919;0.4095;18510;3409
2017-06-09 22:00:00;29,67;29,3;0,37;41497;0;0;0;0;53523;20598;0.3848;18049;2549
2017-06-09 23:00:00;22,07;20,72;1,35;41497;0;0;0;0;53523;20312;0.3795;17784;2528
2017-07-09 00:00:00;21,54;16,03;5,51;41501;0;0;0;0;53534;20638;0.3855;18809;1829
2017-07-09 01:00:00;14,96;10,79;4,17;41501;0;0;0;0;53534;19801;0.3699;18509;1292
2017-07-09 02:00:00;13,12;13,1;0,02;41501;0;0;0;0;53534;18880;0.3526;18291;589
2017-07-09 03:00:00;11,76;13,5;-1,74;41501;0;0;0;0;53534;17835;0.3332;17874;-39
2017-07-09 04:00:00;13,82;17,09;-3,27;41501;0;0;0;0;53534;17136;0.3201;17372;-236
2017-07-09 05:00:00;22,01;23,89;-1,88;41501;0;0;0;0;53534;16559;0.3093;16851;-292
2017-07-09 06:00:00;34,63;38,88;-4,25;41501;27;0.0006;34;-7;53534;16302;0.3045;16337;-35
2017-07-09 07:00:00;40,68;43,38;-2,7;41501;900;0.0217;941;-41;53534;16054;0.2999;15853;201
2017-07-09 08:00:00;39,94;43,79;-3,85;41501;3584;0.0864;3707;-123;53534;14638;0.2734;15568;-930
2017-07-09 09:00:00;39,95;43,87;-3,92;41501;7020;0.1692;7229;-209;53534;14644;0.2735;15528;-884
2017-07-09 10:00:00;37,48;41,61;-4,13;41501;10404;0.2507;10362;42;53534;14806;0.2766;15636;-830
2017-07-09 11:00:00;38,98;40,64;-1,66;41501;12462;0.3003;12336;126;53534;15306;0.286;15556;-250
2017-07-09 12:00:00;37,41;38,81;-1,4;41501;13048;0.3144;13192;-144;53534;15290;0.2856;15273;17
2017-07-09 13:00:00;36,8;38,28;-1,48;41501;12566;0.3028;13012;-446;53534;14764;0.2758;14560;204
2017-07-09 14:00:00;36,11;36,68;-0,57;41501;12094;0.2914;12086;8;53534;13984;0.2612;13807;177
2017-07-09 15:00:00;36,73;36,97;-0,24;41501;10815;0.2606;10426;389;53534;13430;0.2508;12970;460
2017-07-09 16:00:00;37,71;34,66;3,05;41501;8878;0.2139;8100;778;53534;12871;0.2404;12011;860
2017-07-09 17:00:00;40,37;39,19;1,18;41501;5973;0.1439;5188;785;53534;11418;0.2133;10701;717
2017-07-09 18:00:00;42,67;45,73;-3,06;41501;2461;0.0593;2137;324;53534;9342;0.1745;9136;206
2017-07-09 19:00:00;45,22;49,54;-4,32;41501;265;0.0064;302;-37;53534;8518;0.1591;7918;600
2017-07-09 20:00:00;45,99;50,02;-4,03;41501;0;0;1;-1;53534;9141;0.1707;7454;1687
2017-07-09 21:00:00;41,02;40,01;1,01;41501;0;0;0;0;53534;9852;0.184;7649;2203
2017-07-09 22:00:00;38,78;36,3;2,48;41501;0;0;0;0;53534;10278;0.192;8287;1991
2017-07-09 23:00:00;33,99;33,02;0,97;41501;0;0;0;0;53534;11223;0.2096;9278;1945
2017-08-09 00:00:00;29,92;29,17;0,75;41505;0;0;0;0;53566;12403;0.2316;10605;1798
2017-08-09 01:00:00;27,01;27,91;-0,9;41505;0;0;0;0;53566;13654;0.2549;11891;1763
2017-08-09 02:00:00;23,95;23,47;0,48;41505;0;0;0;0;53566;14542;0.2715;13306;1236
2017-08-09 03:00:00;19,0;18,65;0,35;41505;0;0;0;0;53566;15096;0.2818;14480;616
2017-08-09 04:00:00;14,09;14,96;-0,87;41505;0;0;0;0;53566;16018;0.299;15557;461
2017-08-09 05:00:00;22,24;23,45;-1,21;41505;0;0;0;0;53566;17650;0.3295;16617;1033
2017-08-09 06:00:00;32,96;30,0;2,96;41505;24;0.0006;30;-6;53566;19748;0.3687;17872;1876
2017-08-09 07:00:00;35,93;34,03;1,9;41505;975;0.0235;958;17;53566;21232;0.3964;19324;1908
2017-08-09 08:00:00;35,14;33,04;2,1;41505;3370;0.0812;3573;-203;53566;22538;0.4208;20860;1678
2017-08-09 09:00:00;31,02;33,85;-2,83;41505;6494;0.1564;6641;-147;53566;23515;0.439;22345;1170
2017-08-09 10:00:00;29,91;28,46;1,45;41505;9375;0.2258;9213;162;53566;25417;0.4745;23942;1475
2017-08-09 11:00:00;22,88;19,32;3,56;41505;10808;0.2604;10812;-4;53566;27758;0.5182;25409;2349
2017-08-09 12:00:00;19,04;15,42;3,62;41505;10558;0.2544;11464;-906;53566;29417;0.5492;26418;2999
2017-08-09 13:00:00;17,99;16,43;1,56;41505;10226;0.2464;11157;-931;53566;29948;0.5591;26991;2957
2017-08-09 14:00:00;15,03;16,89;-1,86;41505;9749;0.2349;10130;-381;53566;29698;0.5544;26620;3078
2017-08-09 15:00:00;22,05;19,47;2,58;41505;8559;0.2062;8491;68;53566;27166;0.5072;25125;2041
2017-08-09 16:00:00;24,3;22,14;2,16;41505;6594;0.1588;6496;98;53566;24432;0.4561;22876;1556
2017-08-09 17:00:00;30,36;28,41;1,95;41505;4061;0.0978;4107;-46;53566;21750;0.406;20528;1222
2017-08-09 18:00:00;33,98;35,08;-1,1;41505;1483;0.0357;1641;-158;53566;19844;0.3704;18598;1246
2017-08-09 19:00:00;35,97;36,42;-0,45;41505;117;0.0028;214;-97;53566;19288;0.3601;16947;2341
2017-08-09 20:00:00;37,31;36,4;0,91;41505;0;0;1;-1;53566;18863;0.3521;15785;3078
2017-08-09 21:00:00;34,0;30,32;3,68;41505;0;0;0;0;53566;18707;0.3492;15313;3394
2017-08-09 22:00:00;30,86;24,51;6,35;41505;0;0;0;0;53566;18641;0.348;15160;3481
2017-08-09 23:00:00;28,87;21,27;7,6;41505;0;0;0;0;53566;18589;0.347;15219;3370
2017-09-09 00:00:00;27,95;29,33;-1,38;41506;0;0;0;0;53568;18716;0.3494;16202;2514
2017-09-09 01:00:00;21,85;25,7;-3,85;41506;0;0;0;0;53568;18097;0.3378;15689;2408
2017-09-09 02:00:00;21,09;24,12;-3,03;41506;0;0;0;0;53568;16842;0.3144;15170;1672
2017-09-09 03:00:00;21,03;23,02;-1,99;41506;0;0;0;0;53568;15053;0.281;14421;632
2017-09-09 04:00:00;21,08;23,81;-2,73;41506;0;0;0;0;53568;13919;0.2598;13775;144
2017-09-09 05:00:00;25,23;27,92;-2,69;41506;0;0;0;0;53568;12755;0.2381;13230;-475
2017-09-09 06:00:00;27,45;29,23;-1,78;41506;20;0.0005;25;-5;53568;12488;0.2331;12658;-170
2017-09-09 07:00:00;29,93;31,71;-1,78;41506;775;0.0187;802;-27;53568;12402;0.2315;12156;246
2017-09-09 08:00:00;34,1;34,27;-0,17;41506;2570;0.0619;2898;-328;53568;12472;0.2328;11674;798
2017-09-09 09:00:00;37,08;36,25;0,83;41506;4451;0.1072;5322;-871;53568;12608;0.2354;11207;1401
2017-09-09 10:00:00;37,17;35,9;1,27;41506;5680;0.1368;7262;-1582;53568;12854;0.24;10944;1910
2017-09-09 11:00:00;38,68;35,55;3,13;41506;6915;0.1666;8416;-1501;53568;14058;0.2624;10779;3279
2017-09-09 12:00:00;36,26;32,16;4,1;41506;8059;0.1942;8996;-937;53568;15166;0.2831;10613;4553
2017-09-09 13:00:00;33,1;22,67;10,43;41506;8442;0.2034;8991;-549;53568;16065;0.2999;10606;5459
2017-09-09 14:00:00;29,88;17,81;12,07;41506;8416;0.2028;8512;-96;53568;15456;0.2885;10403;5053
2017-09-09 15:00:00;30,85;20,5;10,35;41506;7700;0.1855;7474;226;53568;13878;0.2591;9749;4129
2017-09-09 16:00:00;32,87;30,76;2,11;41506;5604;0.135;5789;-185;53568;11926;0.2226;8902;3024
2017-09-09 17:00:00;34,54;36,37;-1,83;41506;3242;0.0781;3617;-375;53568;9897;0.1848;7976;1921
2017-09-09 18:00:00;36,21;38,35;-2,14;41506;1223;0.0295;1410;-187;53568;7986;0.1491;6970;1016
2017-09-09 19:00:00;39,08;40,39;-1,31;41506;162;0.0039;178;-16;53568;6870;0.1282;6183;687
2017-09-09 20:00:00;41,53;43,84;-2,31;41506;0;0;1;-1;53568;6998;0.1307;5835;1163
2017-09-09 21:00:00;38,99;38,65;0,34;41506;0;0;0;0;53568;7519;0.1404;5621;1898
2017-09-09 22:00:00;38,94;36,18;2,76;41506;0;0;0;0;53568;7914;0.1477;5434;2480
2017-09-09 23:00:00;36,81;32,43;4,38;41506;0;0;0;0;53568;7384;0.1378;5147;2237
2017-10-09 00:00:00;31,06;25,21;5,85;41506;0;0;0;0;53568;6992;0.1306;4866;2126
2017-10-09 01:00:00;29,56;22,87;6,69;41506;0;0;0;0;53568;6552;0.1223;4558;1994
2017-10-09 02:00:00;28,23;22,71;5,52;41506;0;0;0;0;53568;6702;0.1251;4460;2242
2017-10-09 03:00:00;25,9;20,68;5,22;41506;0;0;0;0;53568;6402;0.1195;4349;2053
2017-10-09 04:00:00;23,73;19,84;3,89;41506;0;0;0;0;53568;5936;0.1108;4324;1612
2017-10-09 05:00:00;23,17;20,2;2,97;41506;0;0;0;0;53568;6346;0.1185;4366;1980
2017-10-09 06:00:00;25,92;21,64;4,28;41506;14;0.0003;16;-2;53568;7082;0.1322;4478;2604
2017-10-09 07:00:00;26,08;20,66;5,42;41506;714;0.0172;696;18;53568;7340;0.137;4678;2662
2017-10-09 08:00:00;29,89;20,86;9,03;41506;3119;0.0752;3139;-20;53568;6327;0.1181;4819;1508
2017-10-09 09:00:00;30,28;25,76;4,52;41506;6672;0.1608;6506;166;53568;5658;0.1056;4978;680
2017-10-09 10:00:00;29,8;25,11;4,69;41506;10632;0.2562;9927;705;53568;6424;0.1199;5537;887
2017-10-09 11:00:00;29,42;20,64;8,78;41506;13808;0.3326;12680;1128;53568;8357;0.156;6740;1617
2017-10-09 12:00:00;24,8;15,08;9,72;41506;15456;0.3724;14399;1057;53568;10658;0.199;8368;2290
2017-10-09 13:00:00;17,24;9,96;7,28;41506;16010;0.3857;14785;1225;53568;12228;0.2282;9985;2243
2017-10-09 14:00:00;8,93;5,72;3,21;41506;14610;0.352;14116;494;53568;13609;0.254;11306;2303
2017-10-09 15:00:00;9,85;4,04;5,81;41506;12935;0.3116;12392;543;53568;14906;0.2782;12139;2767
2017-10-09 16:00:00;10,51;-0,39;10,9;41506;10192;0.2456;9696;496;53568;16103;0.3006;12783;3320
2017-10-09 17:00:00;13,21;5,13;8,08;41506;6483;0.1562;6126;357;53568;16205;0.3025;12985;3220
2017-10-09 18:00:00;23,28;11,4;11,88;41506;2477;0.0597;2409;68;53568;14953;0.2791;12794;2159
2017-10-09 19:00:00;30,63;24,47;6,16;41506;208;0.005;273;-65;53568;14300;0.2669;12891;1409
2017-10-09 20:00:00;29,7;27,63;2,07;41506;0;0;0;0;53568;16263;0.3036;13877;2386
2017-10-09 21:00:00;22,56;13,65;8,91;41506;0;0;0;0;53568;18845;0.3518;15873;2972
2017-10-09 22:00:00;18,05;4,99;13,06;41506;0;0;0;0;53568;20976;0.3916;17975;3001
2017-10-09 23:00:00;9,4;-0,79;10,19;41506;0;0;0;0;53568;23162;0.4324;19736;3426
2017-11-09 00:00:00;0,43;-0,71;1,14;41511;0;0;0;0;53576;24025;0.4484;21285;2740
2017-11-09 01:00:00;0,0;-2,87;2,87;41511;0;0;0;0;53576;24967;0.466;22356;2611
2017-11-09 02:00:00;-0,07;-4,05;3,98;41511;0;0;0;0;53576;25576;0.4774;23344;2232
2017-11-09 03:00:00;-2,32;-7,34;5,02;41511;0;0;0;0;53576;26112;0.4874;23660;2452
2017-11-09 04:00:00;-2,77;-7,61;4,84;41511;0;0;0;0;53576;26299;0.4908;23988;2311
2017-11-09 05:00:00;4,23;-4,21;8,44;41511;0;0;0;0;53576;25932;0.484;23994;1938
2017-11-09 06:00:00;23,29;17,63;5,66;41511;19;0.0004;22;-3;53576;25832;0.4822;23737;2095
2017-11-09 07:00:00;32,9;33,72;-0,82;41511;1042;0.0251;944;98;53576;25124;0.469;23206;1918
2017-11-09 08:00:00;36,33;36,5;-0,17;41511;4063;0.0979;3675;388;53576;23780;0.4438;22341;1439
2017-11-09 09:00:00;36,02;35,19;0,83;41511;7660;0.1846;6954;706;53576;22579;0.4214;21535;1044
2017-11-09 10:00:00;31,49;28,23;3,26;41511;10336;0.249;9738;598;53576;22411;0.4183;21371;1040
2017-11-09 11:00:00;33,0;27,34;5,66;41511;12052;0.2903;11650;402;53576;22403;0.4182;21613;790
2017-11-09 12:00:00;30,07;29,01;1,06;41511;12887;0.3105;12550;337;53576;23089;0.431;21960;1129
2017-11-09 13:00:00;23,78;26,5;-2,72;41511;13257;0.3194;12435;822;53576;23478;0.4382;22342;1136
2017-11-09 14:00:00;23,06;20,72;2,34;41511;12862;0.3098;11662;1200;53576;24070;0.4493;22713;1357
2017-11-09 15:00:00;21,98;15,92;6,06;41511;11370;0.2739;10012;1358;53576;24033;0.4486;22768;1265
2017-11-09 16:00:00;27,52;17,69;9,83;41511;8912;0.2147;7654;1258;53576;23612;0.4407;22344;1268
2017-11-09 17:00:00;30,63;23,92;6,71;41511;5564;0.134;4837;727;53576;23064;0.4305;21782;1282
2017-11-09 18:00:00;33,94;28,59;5,35;41511;2252;0.0542;1861;391;53576;21535;0.402;21154;381
2017-11-09 19:00:00;37,75;34,81;2,94;41511;186;0.0045;201;-15;53576;21748;0.4059;21064;684
2017-11-09 20:00:00;34,69;35,16;-0,47;41511;0;0;0;0;53576;22510;0.4202;21619;891
2017-11-09 21:00:00;30,04;29,83;0,21;41511;0;0;0;0;53576;24411;0.4556;22531;1880
2017-11-09 22:00:00;19,93;22,6;-2,67;41511;0;0;0;0;53576;25201;0.4704;23432;1769
2017-11-09 23:00:00;9,36;10,68;-1,32;41511;0;0;0;0;53576;25213;0.4706;23977;1236
2017-12-09 00:00:00;10,75;9,91;0,84;41514;0;0;0;0;53587;24594;0.459;26601;-2007
2017-12-09 01:00:00;9,03;12,65;-3,62;41514;0;0;0;0;53587;23654;0.4414;25908;-2254
2017-12-09 02:00:00;6,49;12,11;-5,62;41514;0;0;0;0;53587;22092;0.4122;24904;-2812
2017-12-09 03:00:00;5,33;10,67;-5,34;41514;0;0;0;0;53587;20438;0.3814;23406;-2968
2017-12-09 04:00:00;8,71;12,05;-3,34;41514;0;0;0;0;53587;19074;0.356;22064;-2990
2017-12-09 05:00:00;14,9;14,43;0,47;41514;0;0;0;0;53587;18073;0.3372;21087;-3014
2017-12-09 06:00:00;34,91;38,74;-3,83;41514;12;0.0003;17;-5;53587;17809;0.3323;20292;-2483
2017-12-09 07:00:00;40,0;40,49;-0,49;41514;882;0.0212;862;20;53587;18462;0.3446;19808;-1346
2017-12-09 08:00:00;42,46;41,74;0,72;41514;3272;0.0788;3560;-288;53587;17779;0.3318;19756;-1977
2017-12-09 09:00:00;39,98;39,53;0,45;41514;6256;0.1507;6820;-564;53587;17965;0.3352;20021;-2056
2017-12-09 10:00:00;37,05;37,44;-0,39;41514;9672;0.233;9825;-153;53587;19464;0.3632;20751;-1287
2017-12-09 11:00:00;36,65;37,12;-0,47;41514;11927;0.2873;12059;-132;53587;21486;0.401;21335;151
2017-12-09 12:00:00;33,45;32,52;0,93;41514;12986;0.3128;13275;-289;53587;21375;0.3989;21274;101
2017-12-09 13:00:00;30,49;28,54;1,95;41514;13406;0.3229;13843;-437;53587;20966;0.3913;20896;70
2017-12-09 14:00:00;28,58;28,12;0,46;41514;12969;0.3124;13684;-715;53587;20485;0.3822;20661;-176
2017-12-09 15:00:00;29,62;23,87;5,75;41514;12277;0.2957;12222;55;53587;19184;0.358;20541;-1357
2017-12-09 16:00:00;30,69;23,86;6,83;41514;10248;0.2468;9507;741;53587;18971;0.354;20298;-1327
2017-12-09 17:00:00;35,25;27,09;8,16;41514;6529;0.1573;5926;603;53587;18779;0.3505;19425;-646
2017-12-09 18:00:00;41,49;35,41;6,08;41514;2412;0.0581;2214;198;53587;17296;0.3228;17866;-570
2017-12-09 19:00:00;45,89;39,23;6,66;41514;183;0.0044;222;-39;53587;16761;0.3128;16597;164
2017-12-09 20:00:00;45,52;39,63;5,89;41514;0;0;0;0;53587;17094;0.319;16041;1053
2017-12-09 21:00:00;36,94;32,85;4,09;41514;0;0;0;0;53587;17797;0.3321;16378;1419
2017-12-09 22:00:00;34,11;32,93;1,18;41514;0;0;0;0;53587;18097;0.3377;16866;1231
2017-12-09 23:00:00;28,1;24,37;3,73;41514;0;0;0;0;53587;19350;0.3611;17504;1846
2017-09-13 00:00:00;19,02;4,87;14,15;41517;0;0;0;0;53605;20356;0.3797;18080;2276
2017-09-13 01:00:00;12,08;-1,6;13,68;41517;0;0;0;0;53605;21655;0.404;19047;2608
2017-09-13 02:00:00;10,71;-10,23;20,94;41517;0;0;0;0;53605;22678;0.423;20697;1981
2017-09-13 03:00:00;5,48;-1,79;7,27;41517;0;0;0;0;53605;23824;0.4444;22404;1420
2017-09-13 04:00:00;8,33;-4,91;13,24;41517;0;0;0;0;53605;25756;0.4804;24446;1310
2017-09-13 05:00:00;14,01;1,61;12,4;41517;0;0;0;0;53605;27973;0.5218;27184;789
2017-09-13 06:00:00;23,01;14,29;8,72;41517;6;0.0001;12;-6;53605;31118;0.5805;29998;1120
2017-09-13 07:00:00;28,72;9,1;19,62;41517;683;0.0164;560;123;53605;33643;0.6276;32408;1235
2017-09-13 08:00:00;23,07;9,24;13,83;41517;2438;0.0587;2157;281;53605;34628;0.646;34071;557
2017-09-13 09:00:00;15,92;9,93;5,99;41517;3856;0.0929;3929;-73;53605;35332;0.6591;35298;34
2017-09-13 10:00:00;13,41;12,06;1,35;41517;5808;0.1399;5769;39;53605;36526;0.6814;36549;-23
2017-09-13 11:00:00;12,73;11,3;1,43;41517;8064;0.1942;7542;522;53605;37809;0.7053;37353;456
2017-09-13 12:00:00;10,74;6,13;4,61;41517;10052;0.2421;8965;1087;53605;37384;0.6974;37834;-450
2017-09-13 13:00:00;12,06;2,08;9,98;41517;11986;0.2887;9532;2454;53605;36932;0.689;37902;-970
2017-09-13 14:00:00;10,1;-5,82;15,92;41517;11818;0.2847;9301;2517;53605;36106;0.6736;37848;-1742
2017-09-13 15:00:00;9,18;-6,3;15,48;41517;9504;0.2289;8277;1227;53605;35714;0.6662;37534;-1820
2017-09-13 16:00:00;9,16;0,67;8,49;41517;6850;0.165;6355;495;53605;35466;0.6616;37124;-1658
2017-09-13 17:00:00;9,12;11,66;-2,54;41517;4198;0.1011;3785;413;53605;35019;0.6532;36218;-1199
2017-09-13 18:00:00;16,24;22,1;-5,86;41517;1461;0.0352;1346;115;53605;34264;0.6392;35061;-797
2017-09-13 19:00:00;16,03;27,91;-11,88;41517;97;0.0023;132;-35;53605;33071;0.617;33998;-927
2017-09-13 20:00:00;16,07;30,01;-13,94;41517;0;0;0;0;53605;30926;0.5769;33219;-2293
2017-09-13 21:00:00;12,06;26,92;-14,86;41517;0;0;0;0;53605;29674;0.5536;32355;-2681
2017-09-13 22:00:00;10,67;27,62;-16,95;41517;0;0;0;0;53605;27666;0.5161;31969;-4303
2017-09-13 23:00:00;8,6;26,41;-17,81;41517;0;0;0;0;53605;27127;0.506;31385;-4258
2017-09-14 00:00:00;-11,04;19,4;-30,44;41521;0;0;0;0;53617;26686;0.4977;32458;-5772
2017-09-14 01:00:00;-4,92;18,93;-23,85;41521;0;0;0;0;53617;26429;0.4929;31741;-5312
2017-09-14 02:00:00;-7,91;16,01;-23,92;41521;0;0;0;0;53617;25953;0.484;31138;-5185
2017-09-14 03:00:00;-7,1;12,35;-19,45;41521;0;0;0;0;53617;25175;0.4695;30136;-4961
2017-09-14 04:00:00;-1,7;11,57;-13,27;41521;0;0;0;0;53617;24508;0.4571;29044;-4536
2017-09-14 05:00:00;9,42;16,37;-6,95;41521;0;0;0;0;53617;23798;0.4439;27769;-3971
2017-09-14 06:00:00;31,08;39,59;-8,51;41521;4;0.0001;11;-7;53617;24038;0.4483;26465;-2427
2017-09-14 07:00:00;35,47;43,14;-7,67;41521;591;0.0142;668;-77;53617;23257;0.4338;25471;-2214
2017-09-14 08:00:00;36,98;44,36;-7,38;41521;2730;0.0658;2854;-124;53617;23650;0.4411;24932;-1282
2017-09-14 09:00:00;35,03;40,82;-5,79;41521;4989;0.1202;5456;-467;53617;24042;0.4484;25131;-1089
2017-09-14 10:00:00;34,46;40,22;-5,76;41521;6290;0.1515;7489;-1199;53617;25342;0.4726;26121;-779
2017-09-14 11:00:00;34,37;41,47;-7,1;41521;7180;0.173;8819;-1639;53617;26914;0.502;27079;-165
2017-09-14 12:00:00;30,55;39,17;-8,62;41521;8258;0.1989;9453;-1195;53617;28459;0.5308;27470;989
2017-09-14 13:00:00;29,73;34,63;-4,9;41521;8185;0.1972;9247;-1062;53617;29483;0.5499;27544;1939
2017-09-14 14:00:00;25,86;29,02;-3,16;41521;8010;0.1929;8551;-541;53617;29776;0.5554;27421;2355
2017-09-14 15:00:00;27,27;29,25;-1,98;41521;7476;0.1801;7364;112;53617;30410;0.5672;27224;3186
2017-09-14 16:00:00;27,94;24,02;3,92;41521;5913;0.1424;5570;343;53617;30580;0.5703;26997;3583
2017-09-14 17:00:00;32,14;27,33;4,81;41521;3522;0.0848;3397;125;53617;29199;0.5446;26412;2787
2017-09-14 18:00:00;34,91;30,08;4,83;41521;1266;0.0304;1200;66;53617;27497;0.5128;25590;1907
2017-09-14 19:00:00;35,88;35,33;0,55;41521;66;0.0016;111;-45;53617;26648;0.497;25118;1530
2017-09-14 20:00:00;36,09;34,91;1,18;41521;0;0;0;0;53617;26752;0.4989;24918;1834
2017-09-14 21:00:00;34,45;27,12;7,33;41521;0;0;0;0;53617;27426;0.5115;24767;2659
2017-09-14 22:00:00;26,66;22,32;4,34;41521;0;0;0;0;53617;26720;0.4984;24702;2018
2017-09-14 23:00:00;19,03;15,47;3,56;41521;0;0;0;0;53617;25751;0.4803;24271;1480
2017-09-15 00:00:00;20,53;12,17;8,36;41536;0;0;0;0;53662;24381;0.4543;24410;-29
2017-09-15 01:00:00;12,28;18,55;-6,27;41536;0;0;0;0;53662;23599;0.4398;23268;331
2017-09-15 02:00:00;14,0;16,24;-2,24;41536;0;0;0;0;53662;22577;0.4207;22337;240
2017-09-15 03:00:00;16,69;15,9;0,79;41536;0;0;0;0;53662;21228;0.3956;21109;119
2017-09-15 04:00:00;22,07;16,6;5,47;41536;0;0;0;0;53662;20198;0.3764;19818;380
2017-09-15 05:00:00;29,6;29,58;0,02;41536;0;0;0;0;53662;18589;0.3464;18448;141
2017-09-15 06:00:00;40,24;39,25;0,99;41536;6;0.0001;12;-6;53662;17628;0.3285;17083;545
2017-09-15 07:00:00;44,3;45,83;-1,53;41536;955;0.023;991;-36;53662;16006;0.2983;15907;99
2017-09-15 08:00:00;44,8;46,99;-2,19;41536;4718;0.1136;4566;152;53662;14574;0.2716;15040;-466
2017-09-15 09:00:00;40,96;44,83;-3,87;41536;9622;0.2316;9032;590;53662;13413;0.25;14537;-1124
2017-09-15 10:00:00;39,98;42,81;-2,83;41536;13597;0.3273;12875;722;53662;13770;0.2566;14430;-660
2017-09-15 11:00:00;38,96;40,49;-1,53;41536;16038;0.3861;15200;838;53662;14667;0.2733;14243;424
2017-09-15 12:00:00;36,69;36,38;0,31;41536;16291;0.3922;16262;29;53662;15030;0.2801;13952;1078
2017-09-15 13:00:00;33,05;33,52;-0,47;41536;15204;0.366;16210;-1006;53662;14200;0.2646;13513;687
2017-09-15 14:00:00;36,4;34,49;1,91;41536;13895;0.3346;15027;-1132;53662;13037;0.2429;12818;219
2017-09-15 15:00:00;36,13;35,19;0,94;41536;12456;0.2999;12771;-315;53662;12761;0.2378;11842;919
2017-09-15 16:00:00;38,65;34,67;3,98;41536;9925;0.239;9539;386;53662;11667;0.2174;10731;936
2017-09-15 17:00:00;42,51;37,08;5,43;41536;5963;0.1436;5657;306;53662;9623;0.1793;9348;275
2017-09-15 18:00:00;45,47;42,88;2,59;41536;2137;0.0514;1901;236;53662;7962;0.1483;7947;15
2017-09-15 19:00:00;48,0;43,62;4,38;41536;133;0.0032;154;-21;53662;7651;0.1426;7133;518
2017-09-15 20:00:00;47,95;43,44;4,51;41536;0;0;0;0;53662;8214;0.1531;6951;1263
2017-09-15 21:00:00;42,05;40,24;1,81;41536;0;0;0;0;53662;9250;0.1724;7033;2217
2017-09-15 22:00:00;37,91;36,44;1,47;41536;0;0;0;0;53662;9054;0.1687;7322;1732
2017-09-15 23:00:00;31,4;29,9;1,5;41536;0;0;0;0;53662;8892;0.1657;7570;1322
2017-09-16 00:00:00;33,95;31,33;2,62;41537;0;0;0;0;53671;8472;0.1578;7804;668
2017-09-16 01:00:00;32,0;32,08;-0,08;41537;0;0;0;0;53671;7882;0.1468;7451;431
2017-09-16 02:00:00;31,57;31,29;0,28;41537;0;0;0;0;53671;7273;0.1356;7155;118
2017-09-16 03:00:00;31,01;30,46;0,55;41537;0;0;0;0;53671;6360;0.1185;6732;-372
2017-09-16 04:00:00;30,82;28,75;2,07;41537;0;0;0;0;53671;5806;0.1082;6319;-513
2017-09-16 05:00:00;31,44;30,74;0,7;41537;0;0;0;0;53671;5497;0.1024;5929;-432
2017-09-16 06:00:00;31,94;34,22;-2,28;41537;6;0.0001;10;-4;53671;5037;0.0938;5616;-579
2017-09-16 07:00:00;34,7;36,84;-2,14;41537;735;0.0177;871;-136;53671;4336;0.0808;5239;-903
2017-09-16 08:00:00;40,38;40,77;-0,39;41537;3573;0.086;4073;-500;53671;3384;0.063;4673;-1289
2017-09-16 09:00:00;40,92;43,18;-2,26;41537;7284;0.1753;8098;-814;53671;2200;0.041;4113;-1913
2017-09-16 10:00:00;40,63;44,1;-3,47;41537;10803;0.2601;11558;-755;53671;2021;0.0377;3888;-1867
2017-09-16 11:00:00;35,45;40,12;-4,67;41537;12550;0.3021;13765;-1215;53671;2324;0.0433;3917;-1593
2017-09-16 12:00:00;37,93;38,59;-0,66;41537;13273;0.3196;14635;-1362;53671;2616;0.0487;3953;-1337
2017-09-16 13:00:00;35,29;34,06;1,23;41537;13439;0.3236;14298;-859;53671;2564;0.0478;3912;-1348
2017-09-16 14:00:00;32,99;32,54;0,45;41537;12341;0.2971;13020;-679;53671;2175;0.0405;3623;-1448
2017-09-16 15:00:00;33,9;33,03;0,87;41537;10524;0.2534;10928;-404;53671;1885;0.0351;3075;-1190
2017-09-16 16:00:00;35,5;35,62;-0,12;41537;8166;0.1966;8172;-6;53671;1750;0.0326;2532;-782
2017-09-16 17:00:00;40,03;40,44;-0,41;41537;5062;0.1218;4845;217;53671;1613;0.03;2017;-404
2017-09-16 18:00:00;44,64;43,98;0,66;41537;1616;0.0389;1602;14;53671;1529;0.0285;1634;-105
2017-09-16 19:00:00;48,01;47,07;0,94;41537;76;0.0018;125;-49;53671;1592;0.0297;1394;198
2017-09-16 20:00:00;46,7;49,85;-3,15;41537;0;0;0;0;53671;1631;0.0304;1366;265
2017-09-16 21:00:00;43,54;46,49;-2,95;41537;0;0;0;0;53671;1585;0.0296;1528;57
2017-09-16 22:00:00;40,33;43,3;-2,97;41537;0;0;0;0;53671;1438;0.0268;1711;-273
2017-09-16 23:00:00;35,01;41,24;-6,23;41537;0;0;0;0;53671;1392;0.0259;1840;-448
2017-09-17 00:00:00;32,27;37,52;-5,25;41537;0;0;0;0;53675;1431;0.0267;1511;-80
2017-09-17 01:00:00;30,4;34,88;-4,48;41537;0;0;0;0;53675;1470;0.0274;1412;58
2017-09-17 02:00:00;30,06;33,04;-2,98;41537;0;0;0;0;53675;1296;0.0241;1488;-192
2017-09-17 03:00:00;29,43;33,66;-4,23;41537;0;0;0;0;53675;983;0.0183;1403;-420
2017-09-17 04:00:00;29,18;31,84;-2,66;41537;0;0;0;0;53675;816;0.0152;1217;-401
2017-09-17 05:00:00;29,38;32,93;-3,55;41537;0;0;0;0;53675;704;0.0131;1118;-414
2017-09-17 06:00:00;29,98;32,79;-2,81;41537;5;0.0001;7;-2;53675;720;0.0134;1107;-387
2017-09-17 07:00:00;30,09;32,4;-2,31;41537;770;0.0185;806;-36;53675;772;0.0144;1102;-330
2017-09-17 08:00:00;32,04;36,54;-4,5;41537;3684;0.0887;3991;-307;53675;776;0.0145;957;-181
2017-09-17 09:00:00;32,59;37,31;-4,72;41537;7588;0.1826;8241;-653;53675;707;0.0132;738;-31
2017-09-17 10:00:00;32,16;33,62;-1,46;41537;12277;0.2955;12172;105;53675;422;0.0079;643;-221
2017-09-17 11:00:00;32,65;32,67;-0,02;41537;16708;0.4022;15005;1703;53675;328;0.0061;692;-364
2017-09-17 12:00:00;32,05;26,5;5,55;41537;18605;0.4479;16268;2337;53675;460;0.0086;809;-349
2017-09-17 13:00:00;30,31;24,26;6,05;41537;17688;0.4258;15981;1707;53675;637;0.0119;832;-195
2017-09-17 14:00:00;30,01;24,5;5,51;41537;15149;0.3647;14659;490;53675;720;0.0134;779;-59
2017-09-17 15:00:00;29,72;28,8;0,92;41537;12062;0.2904;12438;-376;53675;791;0.0148;727;64
2017-09-17 16:00:00;30,05;30,49;-0,44;41537;8536;0.2055;9200;-664;53675;810;0.015;788;22
2017-09-17 17:00:00;32,15;35,55;-3,4;41537;5152;0.124;5261;-109;53675;871;0.0162;873;-2
2017-09-17 18:00:00;41,0;45,61;-4,61;41537;1633;0.0393;1614;19;53675;988;0.0184;957;31
2017-09-17 19:00:00;45,09;49,3;-4,21;41537;70;0.0016;109;-39;53675;1150;0.0214;1071;79
2017-09-17 20:00:00;46,95;49,78;-2,83;41537;0;0;0;0;53675;1280;0.0238;1226;54
2017-09-17 21:00:00;42,38;45,84;-3,46;41537;0;0;0;0;53675;1353;0.0252;1407;-54
2017-09-17 22:00:00;38,27;42,91;-4,64;41537;0;0;0;0;53675;1824;0.034;1544;280
2017-09-17 23:00:00;33,09;37,75;-4,66;41537;0;0;0;0;53675;2353;0.0439;1645;708
2017-09-18 00:00:00;32,77;32,57;0,2;41541;0;0;0;0;53677;2252;0.042;1496;756
2017-09-18 01:00:00;32,08;30,86;1,22;41541;0;0;0;0;53677;2417;0.045;1709;708
2017-09-18 02:00:00;32,1;30,74;1,36;41541;0;0;0;0;53677;2389;0.0445;2016;373
2017-09-18 03:00:00;31,42;30,73;0,69;41541;0;0;0;0;53677;2451;0.0456;2112;339
2017-09-18 04:00:00;32,0;30,6;1,4;41541;0;0;0;0;53677;2416;0.045;2196;220
2017-09-18 05:00:00;32,6;33,32;-0,72;41541;0;0;0;0;53677;2355;0.0439;2302;53
2017-09-18 06:00:00;43,89;45,38;-1,49;41541;4;0.0001;5;-1;53677;2432;0.0453;2413;19
2017-09-18 07:00:00;51,06;53,16;-2,1;41541;664;0.016;626;38;53677;2553;0.0476;2504;49
2017-09-18 08:00:00;53,23;51,73;1,5;41541;3420;0.0823;3468;-48;53677;2295;0.0428;2379;-84
2017-09-18 09:00:00;51,71;49,4;2,31;41541;7148;0.1721;7246;-98;53677;1671;0.0312;2037;-366
2017-09-18 10:00:00;51,59;48,88;2,71;41541;10552;0.254;10800;-248;53677;1498;0.0279;1829;-331
2017-09-18 11:00:00;45,04;40,3;4,74;41541;13057;0.3143;13568;-511;53677;1714;0.032;1858;-144
2017-09-18 12:00:00;41,09;39,37;1,72;41541;14513;0.3494;15241;-728;53677;1830;0.0341;2039;-209
2017-09-18 13:00:00;37,91;40,57;-2,66;41541;14907;0.3588;15564;-657;53677;2194;0.0408;2268;-74
2017-09-18 14:00:00;36,09;38,66;-2,57;41541;14032;0.3378;14741;-709;53677;2510;0.0468;2352;158
2017-09-18 15:00:00;41,88;40,61;1,27;41541;12539;0.3018;12554;-15;53677;2552;0.0475;2284;268
2017-09-18 16:00:00;43,92;40,99;2,93;41541;9108;0.2192;9298;-190;53677;2317;0.0432;2204;113
2017-09-18 17:00:00;45,61;46,72;-1,11;41541;5352;0.1288;5309;43;53677;2016;0.0376;2074;-58
2017-09-18 18:00:00;49,41;50,14;-0,73;41541;1639;0.0394;1576;63;53677;1782;0.0332;1953;-171
2017-09-18 19:00:00;52,89;51,51;1,38;41541;56;0.0013;94;-38;53677;2031;0.0378;1942;89
2017-09-18 20:00:00;53,14;51,46;1,68;41541;0;0;0;0;53677;2464;0.0459;2104;360
2017-09-18 21:00:00;44,58;45,58;-1,0;41541;0;0;0;0;53677;2666;0.0497;2415;251
2017-09-18 22:00:00;40,55;40,54;0,01;41541;0;0;0;0;53677;2712;0.0505;2651;61
2017-09-18 23:00:00;33,2;35,61;-2,41;41541;0;0;0;0;53677;2860;0.0532;2816;44
2017-09-19 00:00:00;33,1;32,02;1,08;41546;0;0;0;0;53726;2901;0.054;2308;593
2017-09-19 01:00:00;32,13;31,8;0,33;41546;0;0;0;0;53726;2767;0.0515;2322;445
2017-09-19 02:00:00;31,28;29,35;1,93;41546;0;0;0;0;53726;2667;0.0497;2370;297
2017-09-19 03:00:00;30,8;29,13;1,67;41546;0;0;0;0;53726;2442;0.0455;2205;237
2017-09-19 04:00:00;31,07;29,35;1,72;41546;0;0;0;0;53726;2255;0.042;2046;209
2017-09-19 05:00:00;33,22;31,61;1,61;41546;0;0;0;0;53726;2232;0.0415;1928;304
2017-09-19 06:00:00;40,0;40,17;-0,17;41546;2;0;4;-2;53726;2180;0.0406;1837;343
2017-09-19 07:00:00;50,02;50,65;-0,63;41546;560;0.0135;575;-15;53726;2182;0.0406;1696;486
2017-09-19 08:00:00;53,76;53,61;0,15;41546;3040;0.0732;3208;-168;53726;1988;0.037;1447;541
2017-09-19 09:00:00;51,1;52,19;-1,09;41546;6337;0.1525;6811;-474;53726;1229;0.0229;1085;144
2017-09-19 10:00:00;49,99;49,48;0,51;41546;9603;0.2311;10136;-533;53726;1049;0.0195;851;198
2017-09-19 11:00:00;49,37;49,73;-0,36;41546;12018;0.2892;12520;-502;53726;1236;0.023;920;316
2017-09-19 12:00:00;44,9;43,95;0,95;41546;13297;0.32;13805;-508;53726;1546;0.0288;1094;452
2017-09-19 13:00:00;43,9;41,13;2,77;41546;12828;0.3088;13794;-966;53726;2052;0.0382;1326;726
2017-09-19 14:00:00;39,8;37,91;1,89;41546;12032;0.2896;12679;-647;53726;2554;0.0475;1624;930
2017-09-19 15:00:00;38,36;36,91;1,45;41546;10441;0.2513;10677;-236;53726;3016;0.0562;1960;1056
2017-09-19 16:00:00;38,94;35,99;2,95;41546;7763;0.1868;7898;-135;53726;3259;0.0607;2321;938
2017-09-19 17:00:00;42,98;38,63;4,35;41546;4609;0.111;4505;104;53726;3213;0.0598;2617;596
2017-09-19 18:00:00;46,26;42,66;3,6;41546;1417;0.0341;1298;119;53726;3662;0.0682;2801;861
2017-09-19 19:00:00;50,01;44,78;5,23;41546;42;0.001;66;-24;53726;4681;0.0871;3027;1654
2017-09-19 20:00:00;47,96;45,21;2,75;41546;0;0;0;0;53726;5756;0.1071;3289;2467
2017-09-19 21:00:00;40,0;37,28;2,72;41546;0;0;0;0;53726;6549;0.1219;3540;3009
2017-09-19 22:00:00;37,34;35,17;2,17;41546;0;0;0;0;53726;6974;0.1298;3800;3174
2017-09-19 23:00:00;35,74;31,78;3,96;41546;0;0;0;0;53726;7110;0.1324;4165;2945
2017-09-20 00:00:00;29,97;31,26;-1,29;41551;0;0;0;0;53781;7836;0.1457;6824;1012
2017-09-20 01:00:00;29,49;31,55;-2,06;41551;0;0;0;0;53781;8610;0.1601;7186;1424
2017-09-20 02:00:00;28,47;30,4;-1,93;41551;0;0;0;0;53781;8836;0.1643;7629;1207
2017-09-20 03:00:00;25,99;28,71;-2,72;41551;0;0;0;0;53781;9056;0.1684;7828;1228
2017-09-20 04:00:00;26,56;27,61;-1,05;41551;0;0;0;0;53781;8730;0.1624;7895;835
2017-09-20 05:00:00;31,05;29,73;1,32;41551;0;0;0;0;53781;8329;0.1549;7724;605
2017-09-20 06:00:00;39,49;42,19;-2,7;41551;2;0;2;0;53781;7870;0.1463;7340;530
2017-09-20 07:00:00;46,99;46,66;0,33;41551;390;0.0094;572;-182;53781;7522;0.1399;6887;635
2017-09-20 08:00:00;47,93;53,81;-5,88;41551;2210;0.0532;3079;-869;53781;6472;0.1204;6201;271
2017-09-20 09:00:00;44,99;52,34;-7,35;41551;5018;0.1208;6367;-1349;53781;4895;0.091;5366;-471
2017-09-20 10:00:00;46,84;49,58;-2,74;41551;8041;0.1935;9468;-1427;53781;4423;0.0822;4869;-446
2017-09-20 11:00:00;43,88;45,87;-1,99;41551;10758;0.2589;11943;-1185;53781;5015;0.0933;4827;188
2017-09-20 12:00:00;37,0;40,11;-3,11;41551;12528;0.3015;13286;-758;53781;5733;0.1066;5057;676
2017-09-20 13:00:00;35,47;36,64;-1,17;41551;13114;0.3156;13240;-126;53781;6502;0.1209;5296;1206
2017-09-20 14:00:00;37,51;35,68;1,83;41551;11822;0.2845;12196;-374;53781;6106;0.1135;5380;726
2017-09-20 15:00:00;34,07;37,6;-3,53;41551;9570;0.2303;10318;-748;53781;5630;0.1047;5103;527
2017-09-20 16:00:00;40,0;38,5;1,5;41551;6764;0.1628;7615;-851;53781;5265;0.0979;4654;611
2017-09-20 17:00:00;43,94;43,77;0,17;41551;3794;0.0914;4337;-543;53781;4647;0.0864;4052;595
2017-09-20 18:00:00;48,93;47,69;1,24;41551;1162;0.028;1198;-36;53781;3726;0.0693;3403;323
2017-09-20 19:00:00;52,02;49,97;2,05;41551;34;0.0008;61;-27;53781;3120;0.058;2966;154
2017-09-20 20:00:00;51,03;46,95;4,08;41551;0;0;0;0;53781;3478;0.0647;2798;680
2017-09-20 21:00:00;43,91;38,02;5,89;41551;0;0;0;0;53781;3800;0.0706;2833;967
2017-09-20 22:00:00;39,44;37,52;1,92;41551;0;0;0;0;53781;4062;0.0756;2966;1096
2017-09-20 23:00:00;34,61;31,66;2,95;41551;0;0;0;0;53781;4482;0.0833;3111;1371
2017-09-21 00:00:00;32,61;32,2;0,41;41555;0;0;0;0;53800;4991;0.0928;3409;1582
2017-09-21 01:00:00;30,8;29,05;1,75;41555;0;0;0;0;53800;4876;0.0906;3571;1305
2017-09-21 02:00:00;29,66;27,25;2,41;41555;0;0;0;0;53800;4486;0.0834;3703;783
2017-09-21 03:00:00;29,49;26,56;2,93;41555;0;0;0;0;53800;4058;0.0754;3564;494
2017-09-21 04:00:00;29,98;28,68;1,3;41555;0;0;0;0;53800;3665;0.0681;3321;344
2017-09-21 05:00:00;32,11;34,07;-1,96;41555;0;0;0;0;53800;3338;0.062;3072;266
2017-09-21 06:00:00;40,0;42,83;-2,83;41555;2;0;2;0;53800;3006;0.0559;2902;104
2017-09-21 07:00:00;47,97;46,75;1,22;41555;699;0.0168;648;51;53800;2796;0.052;2753;43
2017-09-21 08:00:00;50,97;47,26;3,71;41555;3663;0.0881;3977;-314;53800;2402;0.0446;2410;-8
2017-09-21 09:00:00;47,03;44,9;2,13;41555;7834;0.1885;8700;-866;53800;1528;0.0284;1896;-368
2017-09-21 10:00:00;43,47;44,47;-1,0;41555;12394;0.2982;13135;-741;53800;1014;0.0188;1474;-460
2017-09-21 11:00:00;39,48;38,96;0,52;41555;16214;0.3902;16413;-199;53800;1016;0.0189;1238;-222
2017-09-21 12:00:00;35,9;36,61;-0,71;41555;18452;0.444;18184;268;53800;1125;0.0209;1151;-26
2017-09-21 13:00:00;35,27;35,3;-0,03;41555;18274;0.4398;17954;320;53800;1288;0.0239;1081;207
2017-09-21 14:00:00;34,55;34,67;-0,12;41555;16212;0.3901;16159;53;53800;1158;0.0216;969;189
2017-09-21 15:00:00;34,4;34,55;-0,15;41555;13441;0.3234;13416;25;53800;961;0.0178;849;112
2017-09-21 16:00:00;37,52;36,61;0,91;41555;9750;0.2346;9882;-132;53800;848;0.0158;812;36
2017-09-21 17:00:00;43,48;40,69;2,79;41555;5361;0.129;5533;-172;53800;791;0.0147;875;-84
2017-09-21 18:00:00;48,73;45,41;3,32;41555;1450;0.0349;1498;-48;53800;851;0.0158;1087;-236
2017-09-21 19:00:00;52,77;46,97;5,8;41555;29;0.0007;67;-38;53800;1119;0.0208;1453;-334
2017-09-21 20:00:00;50,75;46,78;3,97;41555;0;0;0;0;53800;1604;0.0298;1887;-283
2017-09-21 21:00:00;42,2;42,03;0,17;41555;0;0;0;0;53800;1748;0.0325;2299;-551
2017-09-21 22:00:00;38,33;37,95;0,38;41555;0;0;0;0;53800;1866;0.0347;2627;-761
2017-09-21 23:00:00;34,73;34,55;0,18;41555;0;0;0;0;53800;1717;0.0319;2787;-1070
2017-09-22 00:00:00;32,24;31,88;0,36;41561;0;0;0;0;53834;1502;0.0279;2612;-1110
2017-09-22 01:00:00;31,67;31,85;-0,18;41561;0;0;0;0;53834;1323;0.0246;2564;-1241
2017-09-22 02:00:00;30,4;29,81;0,59;41561;0;0;0;0;53834;1222;0.0227;2607;-1385
2017-09-22 03:00:00;30,02;29,49;0,53;41561;0;0;0;0;53834;1122;0.0208;2444;-1322
2017-09-22 04:00:00;30,3;31,64;-1,34;41561;0;0;0;0;53834;1052;0.0195;2282;-1230
2017-09-22 05:00:00;31,9;34,33;-2,43;41561;0;0;0;0;53834;1095;0.0203;2132;-1037
2017-09-22 06:00:00;40,06;38,69;1,37;41561;1;0;1;0;53834;1052;0.0195;1997;-945
2017-09-22 07:00:00;48,18;48,24;-0,06;41561;595;0.0143;593;2;53834;929;0.0173;1861;-932
2017-09-22 08:00:00;49,8;50,17;-0,37;41561;3423;0.0824;3937;-514;53834;800;0.0149;1616;-816
2017-09-22 09:00:00;49,71;49,19;0,52;41561;7224;0.1738;8560;-1336;53834;583;0.0108;1238;-655
2017-09-22 10:00:00;47,17;47,64;-0,47;41561;10773;0.2592;12728;-1955;53834;414;0.0077;939;-525
2017-09-22 11:00:00;45,34;46,15;-0,81;41561;13683;0.3292;15790;-2107;53834;421;0.0078;785;-364
2017-09-22 12:00:00;40,34;41,41;-1,07;41561;15940;0.3835;17426;-1486;53834;432;0.008;731;-299
2017-09-22 13:00:00;38,07;38,06;0,01;41561;17078;0.4109;17512;-434;53834;470;0.0088;693;-223
2017-09-22 14:00:00;36,58;36,47;0,11;41561;16225;0.3904;16223;2;53834;451;0.0084;648;-197
2017-09-22 15:00:00;36,57;36,03;0,54;41561;13286;0.3197;13630;-344;53834;384;0.0071;626;-242
2017-09-22 16:00:00;37,31;37,06;0,25;41561;9486;0.2282;9882;-396;53834;316;0.0059;647;-331
2017-09-22 17:00:00;43,27;44,14;-0,87;41561;4956;0.1192;5398;-442;53834;319;0.0059;720;-401
2017-09-22 18:00:00;45,92;47,67;-1,75;41561;1203;0.0289;1372;-169;53834;440;0.0082;875;-435
2017-09-22 19:00:00;48,92;50,98;-2,06;41561;18;0.0004;47;-29;53834;590;0.011;1124;-534
2017-09-22 20:00:00;47,21;49,65;-2,44;41561;0;0;0;0;53834;732;0.0136;1371;-639
2017-09-22 21:00:00;43,3;46,13;-2,83;41561;0;0;0;0;53834;782;0.0145;1508;-726
2017-09-22 22:00:00;39,51;42,87;-3,36;41561;0;0;0;0;53834;772;0.0144;1558;-786
2017-09-22 23:00:00;37,95;35,86;2,09;41561;0;0;0;0;53834;704;0.0131;1556;-852
2017-09-23 00:00:00;34,67;34,35;0,32;41561;0;0;0;0;53846;688;0.0128;936;-248
2017-09-23 01:00:00;31,99;34,47;-2,48;41561;0;0;0;0;53846;708;0.0131;953;-245
2017-09-23 02:00:00;31,94;33,65;-1,71;41561;0;0;0;0;53846;606;0.0112;1111;-505
2017-09-23 03:00:00;31,91;34,12;-2,21;41561;0;0;0;0;53846;584;0.0108;1076;-492
2017-09-23 04:00:00;31,43;33,5;-2,07;41561;0;0;0;0;53846;626;0.0116;1049;-423
2017-09-23 05:00:00;31,81;33,67;-1,86;41561;0;0;0;0;53846;719;0.0134;1027;-308
2017-09-23 06:00:00;33,4;36,06;-2,66;41561;1;0;2;-1;53846;793;0.0147;991;-198
2017-09-23 07:00:00;39,03;39,79;-0,76;41561;599;0.0144;644;-45;53846;720;0.0134;970;-250
2017-09-23 08:00:00;41,54;41,96;-0,42;41561;3363;0.0809;4137;-774;53846;729;0.0135;840;-111
2017-09-23 09:00:00;42,93;44,41;-1,48;41561;7457;0.1794;8840;-1383;53846;629;0.0117;613;16
2017-09-23 10:00:00;41,91;44,69;-2,78;41561;11984;0.2883;13205;-1221;53846;458;0.0085;455;3
2017-09-23 11:00:00;39,9;42,22;-2,32;41561;15692;0.3776;16494;-802;53846;419;0.0078;447;-28
2017-09-23 12:00:00;31,91;33,56;-1,65;41561;17858;0.4297;18073;-215;53846;446;0.0083;559;-113
2017-09-23 13:00:00;32,17;32,44;-0,27;41561;17681;0.4254;17634;47;53846;616;0.0114;683;-67
2017-09-23 14:00:00;32,12;33,09;-0,97;41561;15528;0.3736;15825;-297;53846;784;0.0146;794;-10
2017-09-23 15:00:00;32,0;34,51;-2,51;41561;12400;0.2984;13110;-710;53846;866;0.0161;913;-47
2017-09-23 16:00:00;32,77;36,5;-3,73;41561;8704;0.2095;9558;-854;53846;980;0.0182;1077;-97
2017-09-23 17:00:00;37,22;41,68;-4,46;41561;4686;0.1128;5283;-597;53846;1104;0.0205;1295;-191
2017-09-23 18:00:00;42,44;47,93;-5,49;41561;1213;0.0292;1315;-102;53846;1330;0.0247;1630;-300
2017-09-23 19:00:00;45,2;51,06;-5,86;41561;20;0.0005;39;-19;53846;1980;0.0368;2099;-119
2017-09-23 20:00:00;44,93;48,29;-3,36;41561;0;0;0;0;53846;2478;0.046;2516;-38
2017-09-23 21:00:00;39,08;42,64;-3,56;41561;0;0;0;0;53846;2663;0.0495;2696;-33
2017-09-23 22:00:00;35,79;38,22;-2,43;41561;0;0;0;0;53846;2649;0.0492;2727;-78
2017-09-23 23:00:00;31,72;34,07;-2,35;41561;0;0;0;0;53846;2422;0.045;2574;-152
2017-09-24 00:00:00;31,76;34,82;-3,06;41561;0;0;0;0;53846;2314;0.043;2460;-146
2017-09-24 01:00:00;30,51;32,46;-1,95;41561;0;0;0;0;53846;1963;0.0365;2261;-298
2017-09-24 02:00:00;31,03;31,98;-0,95;41561;0;0;0;0;53846;1579;0.0294;2195;-616
2017-09-24 03:00:00;30,77;31,83;-1,06;41561;0;0;0;0;53846;1500;0.0279;2061;-561
2017-09-24 04:00:00;30,55;32,55;-2,0;41561;0;0;0;0;53846;1436;0.0267;1971;-535
2017-09-24 05:00:00;31,06;32,52;-1,46;41561;0;0;0;0;53846;1442;0.0268;1929;-487
2017-09-24 06:00:00;31,82;33,26;-1,44;41561;0;0;0;0;53846;1465;0.0272;1914;-449
2017-09-24 07:00:00;32,09;36,52;-4,43;41561;312;0.0075;340;-28;53846;1548;0.0288;1904;-356
2017-09-24 08:00:00;34,9;38,58;-3,68;41561;2207;0.0531;2351;-144;53846;1638;0.0304;1796;-158
2017-09-24 09:00:00;35,57;39,42;-3,85;41561;5460;0.1314;5323;137;53846;1426;0.0265;1610;-184
2017-09-24 10:00:00;35,25;37,16;-1,91;41561;9304;0.2239;8237;1067;53846;1052;0.0195;1463;-411
2017-09-24 11:00:00;35,61;36,22;-0,61;41561;12593;0.303;10446;2147;53846;996;0.0185;1419;-423
2017-09-24 12:00:00;35,21;34,38;0,83;41561;14120;0.3398;11595;2525;53846;1260;0.0234;1478;-218
2017-09-24 13:00:00;32,71;31,49;1,22;41561;13471;0.3242;11448;2023;53846;1258;0.0234;1559;-301
2017-09-24 14:00:00;31,52;32,05;-0,53;41561;11747;0.2826;10392;1355;53846;1344;0.025;1650;-306
2017-09-24 15:00:00;31,37;33,58;-2,21;41561;9490;0.2284;8612;878;53846;1499;0.0278;1754;-255
2017-09-24 16:00:00;31,62;34,55;-2,93;41561;6238;0.1501;6150;88;53846;1653;0.0307;1918;-265
2017-09-24 17:00:00;35,34;39,31;-3,97;41561;3102;0.0746;3280;-178;53846;1677;0.0312;2138;-461
2017-09-24 18:00:00;42,39;45,7;-3,31;41561;805;0.0194;775;30;53846;2102;0.039;2460;-358
2017-09-24 19:00:00;46,94;47,16;-0,22;41561;12;0.0003;22;-10;53846;2739;0.0509;2957;-218
2017-09-24 20:00:00;44,99;47,82;-2,83;41561;0;0;0;0;53846;3748;0.0696;3518;230
2017-09-24 21:00:00;42,2;46,16;-3,96;41561;0;0;0;0;53846;4450;0.0826;3946;504
2017-09-24 22:00:00;41,08;42,39;-1,31;41561;0;0;0;0;53846;4690;0.0871;4241;449
2017-09-24 23:00:00;32,45;39,2;-6,75;41561;0;0;0;0;53846;4642;0.0862;4413;229
2017-09-25 00:00:00;32,97;36,35;-3,38;41565;0;0;0;0;53901;4257;0.079;4072;185
2017-09-25 01:00:00;31,69;33,86;-2,17;41565;0;0;0;0;53901;4073;0.0755;3986;87
2017-09-25 02:00:00;31,1;33,12;-2,02;41565;0;0;0;0;53901;3551;0.0659;4007;-456
2017-09-25 03:00:00;31,02;33,09;-2,07;41565;0;0;0;0;53901;3164;0.0587;3946;-782
2017-09-25 04:00:00;30,5;33,86;-3,36;41565;0;0;0;0;53901;2824;0.0524;3925;-1101
2017-09-25 05:00:00;32,49;35,14;-2,65;41565;0;0;0;0;53901;2860;0.053;3960;-1100
2017-09-25 06:00:00;44,42;46,87;-2,45;41565;0;0;0;0;53901;2805;0.052;4083;-1278
2017-09-25 07:00:00;52,44;53,23;-0,79;41565;318;0.0076;382;-64;53901;3123;0.058;4308;-1185
2017-09-25 08:00:00;53,77;53,9;-0,13;41565;2329;0.056;2664;-335;53901;3337;0.0619;4453;-1116
2017-09-25 09:00:00;52,4;54,15;-1,75;41565;5426;0.1305;6092;-666;53901;3545;0.0658;4505;-960
2017-09-25 10:00:00;51,1;52,87;-1,77;41565;9030;0.2172;9462;-432;53901;3864;0.0717;4692;-828
2017-09-25 11:00:00;48,95;50,16;-1,21;41565;11878;0.2858;12122;-244;53901;4029;0.0748;4934;-905
2017-09-25 12:00:00;44,93;44,69;0,24;41565;13682;0.3292;13643;39;53901;4468;0.0829;5196;-728
2017-09-25 13:00:00;42,4;43,65;-1,25;41565;13709;0.3298;13667;42;53901;4488;0.0832;5422;-934
2017-09-25 14:00:00;40,51;42,67;-2,16;41565;12202;0.2936;12588;-386;53901;4226;0.0784;5534;-1308
2017-09-25 15:00:00;42,01;46,5;-4,49;41565;10274;0.2472;10598;-324;53901;4382;0.0813;5542;-1160
2017-09-25 16:00:00;43,93;47,27;-3,34;41565;7493;0.1802;7757;-264;53901;4528;0.084;5748;-1220
2017-09-25 17:00:00;46,13;47,96;-1,83;41565;4088;0.0984;4202;-114;53901;4336;0.0804;6126;-1790
2017-09-25 18:00:00;49,81;50,45;-0,64;41565;1016;0.0244;956;60;53901;4425;0.0821;6689;-2264
2017-09-25 19:00:00;52,0;53,16;-1,16;41565;8;0.0002;23;-15;53901;5016;0.093;7409;-2393
2017-09-25 20:00:00;50,44;53,27;-2,83;41565;0;0;0;0;53901;6000;0.1113;8029;-2029
2017-09-25 21:00:00;41,96;46,0;-4,04;41565;0;0;0;0;53901;6383;0.1184;8189;-1806
2017-09-25 22:00:00;34,9;40,61;-5,71;41565;0;0;0;0;53901;6398;0.1187;8049;-1651
2017-09-25 23:00:00;34,85;36,16;-1,31;41565;0;0;0;0;53901;6026;0.1118;7762;-1736
2017-09-26 00:00:00;35,37;36,81;-1,44;41570;0;0;0;0;53954;5622;0.1042;6199;-577
2017-09-26 01:00:00;32,42;35,11;-2,69;41570;0;0;0;0;53954;5191;0.0962;5747;-556
2017-09-26 02:00:00;31,36;33,47;-2,11;41570;0;0;0;0;53954;4778;0.0886;5455;-677
2017-09-26 03:00:00;31,33;32,2;-0,87;41570;0;0;0;0;53954;4495;0.0833;5271;-776
2017-09-26 04:00:00;31,88;33,15;-1,27;41570;0;0;0;0;53954;4307;0.0798;5151;-844
2017-09-26 05:00:00;33,61;37,03;-3,42;41570;0;0;0;0;53954;3956;0.0733;5126;-1170
2017-09-26 06:00:00;42,52;44,47;-1,95;41570;0;0;0;0;53954;3836;0.0711;5263;-1427
2017-09-26 07:00:00;51,78;56,24;-4,46;41570;321;0.0078;418;-97;53954;4112;0.0762;5388;-1276
2017-09-26 08:00:00;55,2;64,08;-8,88;41570;2430;0.0584;3006;-576;53954;4310;0.0799;5392;-1082
2017-09-26 09:00:00;50,81;57,63;-6,82;41570;5958;0.1433;7025;-1067;53954;4306;0.0798;5332;-1026
2017-09-26 10:00:00;46,03;49,15;-3,12;41570;9884;0.2378;11070;-1186;53954;4467;0.0828;5433;-966
2017-09-26 11:00:00;41,1;48,85;-7,75;41570;13212;0.3178;14229;-1017;53954;4782;0.0886;5654;-872
2017-09-26 12:00:00;36,09;44,25;-8,16;41570;15376;0.3699;15928;-552;53954;5248;0.0973;5819;-571
2017-09-26 13:00:00;35,13;39,06;-3,93;41570;15572;0.3746;16008;-436;53954;5303;0.0983;5961;-658
2017-09-26 14:00:00;34,83;38,66;-3,83;41570;14168;0.3409;14776;-608;53954;5292;0.0981;6031;-739
2017-09-26 15:00:00;35,9;42,41;-6,51;41570;11907;0.2864;12375;-468;53954;5518;0.1023;5983;-465
2017-09-26 16:00:00;39,53;46,57;-7,04;41570;8368;0.2013;8866;-498;53954;5824;0.1079;5952;-128
2017-09-26 17:00:00;46,05;49,55;-3,5;41570;4176;0.1005;4645;-469;53954;6188;0.1147;6157;31
2017-09-26 18:00:00;49,93;54,36;-4,43;41570;857;0.0206;1000;-143;53954;6871;0.1274;6784;87
2017-09-26 19:00:00;54,66;57,85;-3,19;41570;9;0.0002;19;-10;53954;7626;0.1414;7683;-57
2017-09-26 20:00:00;49,42;52,84;-3,42;41570;0;0;0;0;53954;8508;0.1577;8444;64
2017-09-26 21:00:00;36,34;39,34;-3,0;41570;0;0;0;0;53954;8945;0.1658;8727;218
2017-09-26 22:00:00;33,93;35,47;-1,54;41570;0;0;0;0;53954;8605;0.1595;8645;-40
2017-09-26 23:00:00;35,43;35,75;-0,32;41570;0;0;0;0;53954;8332;0.1544;8237;95
2017-09-27 00:00:00;33,41;32,96;0,45;41574;0;0;0;0;54010;7270;0.1346;7683;-413
2017-09-27 01:00:00;32,12;36,02;-3,9;41574;0;0;0;0;54010;6222;0.1152;7284;-1062
2017-09-27 02:00:00;32,03;34,69;-2,66;41574;0;0;0;0;54010;5644;0.1045;7010;-1366
2017-09-27 03:00:00;31,56;35,27;-3,71;41574;0;0;0;0;54010;5365;0.0993;6704;-1339
2017-09-27 04:00:00;32,14;35,41;-3,27;41574;0;0;0;0;54010;5156;0.0955;6450;-1294
2017-09-27 05:00:00;33,7;40,64;-6,94;41574;0;0;0;0;54010;5138;0.0952;6410;-1272
2017-09-27 06:00:00;45,07;50,48;-5,41;41574;0;0;0;0;54010;5155;0.0955;6520;-1365
2017-09-27 07:00:00;54,4;58,33;-3,93;41574;293;0.0071;444;-151;54010;5264;0.0975;6620;-1356
2017-09-27 08:00:00;57,0;59,68;-2,68;41574;2276;0.0547;3259;-983;54010;5740;0.1063;6531;-791
2017-09-27 09:00:00;51,59;56,65;-5,06;41574;5574;0.1341;7831;-2257;54010;5750;0.1065;6229;-479
2017-09-27 10:00:00;46,1;50,74;-4,64;41574;9575;0.2303;12437;-2862;54010;5535;0.1025;5959;-424
2017-09-27 11:00:00;41,16;46,57;-5,41;41574;13356;0.3213;16035;-2679;54010;5321;0.0985;5902;-581
2017-09-27 12:00:00;34,43;41,04;-6,61;41574;16124;0.3878;18097;-1973;54010;5008;0.0927;6003;-995
2017-09-27 13:00:00;34,9;39,85;-4,95;41574;16994;0.4088;18412;-1418;54010;5114;0.0947;6069;-955
2017-09-27 14:00:00;34,42;38,13;-3,71;41574;15805;0.3802;17110;-1305;54010;4948;0.0916;6047;-1099
2017-09-27 15:00:00;35,96;38,64;-2,68;41574;13210;0.3178;14313;-1103;54010;5085;0.0942;5960;-875
2017-09-27 16:00:00;38,94;40,63;-1,69;41574;9272;0.223;10170;-898;54010;5285;0.0979;5970;-685
2017-09-27 17:00:00;45,08;42,08;3,0;41574;4631;0.1114;5252;-621;54010;5378;0.0996;6324;-946
2017-09-27 18:00:00;49,99;51,87;-1,88;41574;920;0.0221;1076;-156;54010;5829;0.1079;7201;-1372
2017-09-27 19:00:00;54,86;54,55;0,31;41574;4;0.0001;17;-13;54010;7086;0.1312;8318;-1232
2017-09-27 20:00:00;47,99;49,86;-1,87;41574;1;0;0;1;54010;8144;0.1508;9278;-1134
2017-09-27 21:00:00;42,95;43,37;-0,42;41574;1;0;0;1;54010;8168;0.1512;9699;-1531
2017-09-27 22:00:00;38,43;41,6;-3,17;41574;1;0;0;1;54010;7760;0.1437;9785;-2025
2017-09-27 23:00:00;32,94;38,43;-5,49;41574;0;0;0;0;54010;7694;0.1425;9646;-1952
2017-09-28 00:00:00;32,08;35,53;-3,45;41581;0;0;0;0;54131;7618;0.1408;8032;-414
2017-09-28 01:00:00;31,77;33,71;-1,94;41581;0;0;0;0;54131;7362;0.136;7741;-379
2017-09-28 02:00:00;31,58;30,1;1,48;41581;0;0;0;0;54131;6944;0.1283;7526;-582
2017-09-28 03:00:00;31,01;28,24;2,77;41581;0;0;0;0;54131;6477;0.1197;7292;-815
2017-09-28 04:00:00;31,05;29,87;1,18;41581;0;0;0;0;54131;5885;0.1087;7102;-1217
2017-09-28 05:00:00;33,4;33,93;-0,53;41581;0;0;0;0;54131;5866;0.1084;7042;-1176
2017-09-28 06:00:00;40,2;45,0;-4,8;41581;0;0;0;0;54131;6070;0.1122;7108;-1038
2017-09-28 07:00:00;49,21;48,18;1,03;41581;322;0.0078;350;-28;54131;6319;0.1168;7116;-797
2017-09-28 08:00:00;49,43;48,91;0,52;41581;2433;0.0585;2624;-191;54131;6334;0.117;6839;-505
2017-09-28 09:00:00;47,08;45,49;1,59;41581;5723;0.1376;6162;-439;54131;5730;0.1059;6282;-552
2017-09-28 10:00:00;45,27;41,28;3,99;41581;8630;0.2076;9476;-846;54131;4920;0.0908;5756;-836
2017-09-28 11:00:00;44,35;39,73;4,62;41581;11078;0.2664;12022;-944;54131;4350;0.0804;5402;-1052
2017-09-28 12:00:00;39,2;42,77;-3,57;41581;12303;0.2959;13394;-1091;54131;4088;0.0755;5196;-1108
2017-09-28 13:00:00;39,2;43,53;-4,33;41581;12649;0.3042;13255;-606;54131;4282;0.0791;5010;-728
2017-09-28 14:00:00;38,45;42,15;-3,7;41581;11629;0.2797;11910;-281;54131;4483;0.0828;4765;-282
2017-09-28 15:00:00;41,67;41,98;-0,31;41581;9331;0.2244;9640;-309;54131;4617;0.0853;4457;160
2017-09-28 16:00:00;44,12;44,11;0,01;41581;6591;0.1585;6684;-93;54131;4577;0.0845;4295;282
2017-09-28 17:00:00;46,93;50,44;-3,51;41581;3293;0.0792;3355;-62;54131;4605;0.0851;4431;174
2017-09-28 18:00:00;47,51;52,67;-5,16;41581;612;0.0147;638;-26;54131;4870;0.09;5004;-134
2017-09-28 19:00:00;49,78;56,38;-6,6;41581;1;0;10;-9;54131;5564;0.1028;5796;-232
2017-09-28 20:00:00;47,49;55,67;-8,18;41581;0;0;0;0;54131;6006;0.111;6297;-291
2017-09-28 21:00:00;38,5;44,96;-6,46;41581;0;0;0;0;54131;6287;0.1162;6458;-171
2017-09-28 22:00:00;34,96;40,97;-6,01;41581;0;0;0;0;54131;6385;0.1179;6412;-27
2017-09-28 23:00:00;32,96;38,65;-5,69;41581;0;0;0;0;54131;6245;0.1154;6227;18
2017-09-29 00:00:00;33,85;36,72;-2,87;41591;0;0;0;0;54302;5994;0.1104;6041;-47
2017-09-29 01:00:00;32,88;33,91;-1,03;41591;0;0;0;0;54302;5609;0.1033;5737;-128
2017-09-29 02:00:00;31,5;34,05;-2,55;41591;0;0;0;0;54302;4993;0.092;5543;-550
2017-09-29 03:00:00;31,1;34,12;-3,02;41591;0;0;0;0;54302;4763;0.0877;5390;-627
2017-09-29 04:00:00;30,97;35,15;-4,18;41591;0;0;0;0;54302;4731;0.0871;5274;-543
2017-09-29 05:00:00;31,91;37,48;-5,57;41591;0;0;0;0;54302;4891;0.0901;5262;-371
2017-09-29 06:00:00;40,67;44,68;-4,01;41591;0;0;0;0;54302;4812;0.0886;5378;-566
2017-09-29 07:00:00;49,91;53,76;-3,85;41591;352;0.0084;337;15;54302;4842;0.0892;5506;-664
2017-09-29 08:00:00;51,2;54,93;-3,73;41591;2678;0.0644;2691;-13;54302;4755;0.0876;5363;-608
2017-09-29 09:00:00;49,99;52,88;-2,89;41591;6255;0.1504;6451;-196;54302;4070;0.075;4884;-814
2017-09-29 10:00:00;47,99;51,59;-3,6;41591;10083;0.2424;10271;-188;54302;3232;0.0595;4468;-1236
2017-09-29 11:00:00;47,08;51,13;-4,05;41591;13022;0.3131;13346;-324;54302;3315;0.061;4381;-1066
2017-09-29 12:00:00;38,65;41,15;-2,5;41591;14948;0.3594;15072;-124;54302;3785;0.0697;4572;-787
2017-09-29 13:00:00;39,13;38,11;1,02;41591;15216;0.3659;15164;52;54302;4387;0.0808;4921;-534
2017-09-29 14:00:00;36,86;36,42;0,44;41591;13933;0.335;13893;40;54302;4933;0.0908;5197;-264
2017-09-29 15:00:00;38,45;35,7;2,75;41591;11441;0.2751;11371;70;54302;5381;0.0991;5421;-40
2017-09-29 16:00:00;41,23;40,96;0,27;41591;7744;0.1862;7789;-45;54302;6014;0.1108;5770;244
2017-09-29 17:00:00;45,17;45,54;-0,37;41591;3643;0.0876;3813;-170;54302;6925;0.1275;6504;421
2017-09-29 18:00:00;47,93;47,49;0,44;41591;640;0.0154;661;-21;54302;8470;0.156;7894;576
2017-09-29 19:00:00;47,99;47,77;0,22;41591;3;0.0001;7;-4;54302;11391;0.2098;9559;1832
2017-09-29 20:00:00;39,1;40,19;-1,09;41591;0;0;0;0;54302;14213;0.2618;10858;3355
2017-09-29 21:00:00;32,21;30,7;1,51;41591;0;0;0;0;54302;15517;0.2857;11640;3877
2017-09-29 22:00:00;36,94;31,98;4,96;41591;0;0;0;0;54302;15638;0.288;11987;3651
2017-09-29 23:00:00;30,6;24,69;5,91;41591;0;0;0;0;54302;13994;0.2577;11845;2149
2017-09-30 00:00:00;23,88;25,18;-1,3;41592;0;0;0;0;54344;11898;0.219;11264;634
2017-09-30 01:00:00;26,09;25,63;0,46;41592;0;0;0;0;54344;10439;0.1921;10295;144
2017-09-30 02:00:00;26,65;26,09;0,56;41592;0;0;0;0;54344;9079;0.167;9307;-228
2017-09-30 03:00:00;28,73;25,81;2,92;41592;0;0;0;0;54344;7870;0.1448;8324;-454
2017-09-30 04:00:00;29,03;26,72;2,31;41592;0;0;0;0;54344;7246;0.1333;7458;-212
2017-09-30 05:00:00;30,02;24,97;5,05;41592;0;0;0;0;54344;6514;0.1199;6780;-266
2017-09-30 06:00:00;31,96;28,2;3,76;41592;0;0;0;0;54344;6069;0.1117;6303;-234
2017-09-30 07:00:00;38,6;32,07;6,53;41592;400;0.0096;355;45;54344;5541;0.102;5783;-242
2017-09-30 08:00:00;39,0;38,94;0,06;41592;3078;0.074;2643;435;54344;5370;0.0988;5131;239
2017-09-30 09:00:00;42,49;37,82;4,67;41592;6697;0.161;6096;601;54344;4620;0.085;4277;343
2017-09-30 10:00:00;42,57;37,62;4,95;41592;10299;0.2476;9439;860;54344;3654;0.0672;3578;76
2017-09-30 11:00:00;43,2;35,1;8,1;41592;13131;0.3157;11951;1180;54344;3507;0.0646;3316;191
2017-09-30 12:00:00;38,75;28,98;9,77;41592;14324;0.3444;13231;1093;54344;3764;0.0693;3374;390
2017-09-30 13:00:00;32,82;26,81;6,01;41592;13656;0.3283;12967;689;54344;4825;0.0888;3616;1209
2017-09-30 14:00:00;31,84;25,85;5,99;41592;11998;0.2885;11518;480;54344;6269;0.1154;4004;2265
2017-09-30 15:00:00;33,0;26,04;6,96;41592;9186;0.2209;9095;91;54344;7712;0.1419;4558;3154
2017-09-30 16:00:00;37,52;30,24;7,28;41592;5646;0.1358;6007;-361;54344;9048;0.1665;5286;3762
2017-09-30 17:00:00;41,77;33,38;8,39;41592;2331;0.056;2771;-440;54344;11624;0.2139;6012;5612
2017-09-30 18:00:00;45,06;34,54;10,52;41592;317;0.0076;438;-121;54344;13435;0.2472;6844;6591
2017-09-30 19:00:00;48,25;35,03;13,22;41592;3;0.0001;4;-1;54344;14717;0.2708;7913;6804
2017-09-30 20:00:00;45,01;27,8;17,21;41592;0;0;0;0;54344;14643;0.2695;8710;5933
2017-09-30 21:00:00;37,49;26,0;11,49;41592;0;0;0;0;54344;13456;0.2476;9095;4361
2017-09-30 22:00:00;32,18;28,47;3,71;41592;0;0;0;0;54344;11528;0.2122;9175;2353
2017-09-30 23:00:00;29,06;30,11;-1,05;41592;0;0;0;0;54344;10362;0.1907;8978;1384
2017-01-10 00:00:00;12,95;26,05;-13,1;41592;0;0;0;0;54344;9114;0.1677;10598;-1484
2017-01-10 01:00:00;14,84;23,64;-8,8;41592;0;0;0;0;54344;8341;0.1535;9783;-1442
2017-01-10 02:00:00;19,05;22,57;-3,52;41592;0;0;0;0;54344;7883;0.1451;9042;-1159
2017-01-10 03:00:00;22,15;21,61;0,54;41592;0;0;0;0;54344;7270;0.1338;8191;-921
2017-01-10 04:00:00;22,9;20,31;2,59;41592;0;0;0;0;54344;6748;0.1242;7402;-654
2017-01-10 05:00:00;23,1;21,1;2,0;41592;0;0;0;0;54344;6348;0.1168;6812;-464
2017-01-10 06:00:00;25,66;21,28;4,38;41592;0;0;0;0;54344;6037;0.1111;6385;-348
2017-01-10 07:00:00;27,4;23,59;3,81;41592;140;0.0034;166;-26;54344;5466;0.1006;6077;-611
2017-01-10 08:00:00;32,71;28,34;4,37;41592;1679;0.0404;1679;0;54344;4898;0.0902;5559;-661
2017-01-10 09:00:00;38,11;33,7;4,41;41592;4714;0.1134;4374;340;54344;4082;0.0751;4890;-808
2017-01-10 10:00:00;38,39;34,19;4,2;41592;8178;0.1966;7279;899;54344;3545;0.0652;4424;-879
2017-01-10 11:00:00;38,58;33,12;5,46;41592;11220;0.2698;9893;1327;54344;3715;0.0683;4353;-638
2017-01-10 12:00:00;38,29;31,87;6,42;41592;13229;0.3181;11570;1659;54344;4532;0.0834;4736;-204
2017-01-10 13:00:00;29,68;22,3;7,38;41592;13793;0.3316;11975;1818;54344;5597;0.103;5247;350
2017-01-10 14:00:00;26,09;20,97;5,12;41592;12816;0.3081;11285;1531;54344;6685;0.123;5807;878
2017-01-10 15:00:00;26,64;17,94;8,7;41592;10487;0.2521;9554;933;54344;7738;0.1424;6282;1456
2017-01-10 16:00:00;27,84;19,5;8,34;41592;6974;0.1677;6763;211;54344;8087;0.1488;6755;1332
2017-01-10 17:00:00;37,0;31,57;5,43;41592;3434;0.0826;3384;50;54344;7997;0.1472;7383;614
2017-01-10 18:00:00;46,13;43,92;2,21;41592;530;0.0128;630;-100;54344;9025;0.1661;8482;543
2017-01-10 19:00:00;49,9;52,0;-2,1;41592;0;0;7;-7;54344;11626;0.2139;10074;1552
2017-01-10 20:00:00;45,98;45,45;0,53;41592;0;0;0;0;54344;13921;0.2562;11821;2100
2017-01-10 21:00:00;31,95;34,87;-2,92;41592;0;0;0;0;54344;15205;0.2798;13596;1609
2017-01-10 22:00:00;26,08;30,04;-3,96;41592;0;0;0;0;54344;16348;0.3008;15298;1050
2017-01-10 23:00:00;13,94;17,58;-3,64;41592;0;0;0;0;54344;17729;0.3263;16844;885
2017-02-10 00:00:00;18,64;16,06;2,58;41595;0;0;0;0;54344;18422;0.339;16826;1596
2017-02-10 01:00:00;12,9;14,68;-1,78;41595;0;0;0;0;54344;19336;0.3558;18134;1202
2017-02-10 02:00:00;5,72;14,35;-8,63;41595;0;0;0;0;54344;20534;0.3778;19371;1163
2017-02-10 03:00:00;0,34;5,94;-5,6;41595;0;0;0;0;54344;21622;0.3979;20479;1143
2017-02-10 04:00:00;2,9;3,17;-0,27;41595;0;0;0;0;54344;22016;0.4051;21674;342
2017-02-10 05:00:00;9,37;11,8;-2,43;41595;0;0;0;0;54344;23570;0.4337;22925;645
2017-02-10 06:00:00;13,98;18,69;-4,71;41595;0;0;0;0;54344;25674;0.4724;24159;1515
2017-02-10 07:00:00;21,32;23,24;-1,92;41595;207;0.005;239;-32;54344;26727;0.4918;25178;1549
2017-02-10 08:00:00;21,38;24,59;-3,21;41595;1987;0.0478;1781;206;54344;26992;0.4967;25538;1454
2017-02-10 09:00:00;21,38;25,91;-4,53;41595;4269;0.1026;3834;435;54344;26646;0.4903;25312;1334
2017-02-10 10:00:00;20,29;26,75;-6,46;41595;6584;0.1583;5455;1129;54344;26817;0.4935;25166;1651
2017-02-10 11:00:00;25,29;24,69;0,6;41595;8077;0.1942;6515;1562;54344;26859;0.4942;25230;1629
2017-02-10 12:00:00;22,1;22,82;-0,72;41595;8766;0.2107;7067;1699;54344;26471;0.4871;25591;880
2017-02-10 13:00:00;14,82;18,41;-3,59;41595;8383;0.2015;6741;1642;54344;26819;0.4935;25950;869
2017-02-10 14:00:00;14,6;21,48;-6,88;41595;6982;0.1679;5734;1248;54344;26346;0.4848;26210;136
2017-02-10 15:00:00;19,3;25,74;-6,44;41595;5055;0.1215;4359;696;54344;25275;0.4651;26080;-805
2017-02-10 16:00:00;19,9;31,26;-11,36;41595;3328;0.08;2793;535;54344;24399;0.449;25643;-1244
2017-02-10 17:00:00;31,29;42,93;-11,64;41595;1500;0.0361;1255;245;54344;23356;0.4298;24956;-1600
2017-02-10 18:00:00;31,23;46,11;-14,88;41595;206;0.005;214;-8;54344;23404;0.4306;24137;-733
2017-02-10 19:00:00;36,04;48,9;-12,86;41595;0;0;1;-1;54344;23389;0.4304;23562;-173
2017-02-10 20:00:00;29,28;38,88;-9,6;41595;0;0;0;0;54344;22908;0.4216;23170;-262
2017-02-10 21:00:00;22,68;33,74;-11,06;41595;0;0;0;0;54344;22074;0.4062;23034;-960
2017-02-10 22:00:00;15,18;29,53;-14,35;41595;0;0;0;0;54344;21055;0.3874;22810;-1755
2017-02-10 23:00:00;9,39;17,4;-8,01;41595;0;0;0;0;54344;21000;0.3864;22430;-1430
2017-03-10 00:00:00;13,26;20,88;-7,62;41595;0;0;0;0;54344;20814;0.383;20607;207
2017-03-10 01:00:00;13,95;17,81;-3,86;41595;0;0;0;0;54344;19992;0.3679;19751;241
2017-03-10 02:00:00;12,31;16,51;-4,2;41595;0;0;0;0;54344;18333;0.3374;18916;-583
2017-03-10 03:00:00;15,09;18,73;-3,64;41595;0;0;0;0;54344;17048;0.3137;18032;-984
2017-03-10 04:00:00;19,51;21,97;-2,46;41595;0;0;0;0;54344;15782;0.2904;17389;-1607
2017-03-10 05:00:00;21,58;30,38;-8,8;41595;0;0;0;0;54344;15466;0.2846;16916;-1450
2017-03-10 06:00:00;28,28;46,51;-18,23;41595;0;0;0;0;54344;15900;0.2926;16609;-709
2017-03-10 07:00:00;31,41;45,22;-13,81;41595;61;0.0015;114;-53;54344;15994;0.2943;16608;-614
2017-03-10 08:00:00;35,95;43,07;-7,12;41595;1104;0.0265;1288;-184;54344;15581;0.2867;16988;-1407
2017-03-10 09:00:00;34,9;43,13;-8,23;41595;3284;0.079;3457;-173;54344;16480;0.3032;17535;-1055
2017-03-10 10:00:00;32,03;41,12;-9,09;41595;6135;0.1475;6047;88;54344;17330;0.3189;18418;-1088
2017-03-10 11:00:00;32,69;40,76;-8,07;41595;8886;0.2136;8745;141;54344;19275;0.3547;19363;-88
2017-03-10 12:00:00;24,87;28,91;-4,04;41595;11391;0.2739;10729;662;54344;21006;0.3866;20272;734
2017-03-10 13:00:00;17,91;15,99;1,92;41595;12700;0.3053;11386;1314;54344;22446;0.413;21018;1428
2017-03-10 14:00:00;11,09;5,49;5,6;41595;12558;0.3019;11084;1474;54344;23290;0.4286;21672;1618
2017-03-10 15:00:00;12,47;9,38;3,09;41595;11048;0.2656;9649;1399;54344;23187;0.4267;21865;1322
2017-03-10 16:00:00;16,63;13,05;3,58;41595;7938;0.1908;6890;1048;54344;22219;0.4088;21480;739
2017-03-10 17:00:00;27,62;22,0;5,62;41595;3880;0.0933;3364;516;54344;21180;0.3897;20488;692
2017-03-10 18:00:00;33,06;30,21;2,85;41595;568;0.0137;523;45;54344;19983;0.3677;19290;693
2017-03-10 19:00:00;39,54;37,57;1,97;41595;0;0;4;-4;54344;20138;0.3706;18494;1644
2017-03-10 20:00:00;30,63;32,68;-2,05;41595;0;0;0;0;54344;20331;0.3741;18259;2072
2017-03-10 21:00:00;30,66;32,96;-2,3;41595;0;0;0;0;54344;20128;0.3704;18481;1647
2017-03-10 22:00:00;30,09;37,0;-6,91;41595;0;0;0;0;54344;19929;0.3667;18634;1295
2017-03-10 23:00:00;22,08;28,22;-6,14;41595;0;0;0;0;54344;19850;0.3652;18574;1276
2017-04-10 00:00:00;18,09;29,06;-10,97;41599;0;0;0;0;54344;19096;0.3514;18804;292
2017-04-10 01:00:00;18,65;26,8;-8,15;41599;0;0;0;0;54344;19163;0.3526;18738;425
2017-04-10 02:00:00;20,88;27,1;-6,22;41599;0;0;0;0;54344;19162;0.3526;18859;303
2017-04-10 03:00:00;18,06;24,24;-6,18;41599;0;0;0;0;54344;19020;0.35;18885;135
2017-04-10 04:00:00;22,63;27,66;-5,03;41599;0;0;0;0;54344;19456;0.358;18948;508
2017-04-10 05:00:00;30,0;35,97;-5,97;41599;0;0;0;0;54344;19792;0.3642;19099;693
2017-04-10 06:00:00;45,22;42,98;2,24;41599;0;0;0;0;54344;20898;0.3846;19537;1361
2017-04-10 07:00:00;54,61;52,21;2,4;41599;172;0.0042;199;-27;54344;21838;0.4018;20194;1644
2017-04-10 08:00:00;55,93;46,43;9,5;41599;2295;0.0552;2006;289;54344;22400;0.4122;20854;1546
2017-04-10 09:00:00;44,2;37,92;6,28;41599;5490;0.132;5131;359;54344;22718;0.418;21724;994
2017-04-10 10:00:00;35,34;30,84;4,5;41599;7960;0.1914;8167;-207;54344;23920;0.4402;23263;657
2017-04-10 11:00:00;31,17;29,71;1,46;41599;10481;0.252;10576;-95;54344;25790;0.4746;25358;432
2017-04-10 12:00:00;22,8;23,66;-0,86;41599;11624;0.2794;11919;-295;54344;28236;0.5196;27343;893
2017-04-10 13:00:00;19,96;14,49;5,47;41599;10924;0.2626;11953;-1029;54344;29702;0.5466;28857;845
2017-04-10 14:00:00;22,77;12,87;9,9;41599;9464;0.2275;10871;-1407;54344;30602;0.5631;29749;853
2017-04-10 15:00:00;25,0;17,89;7,11;41599;7831;0.1882;8781;-950;54344;30432;0.56;29799;633
2017-04-10 16:00:00;25,06;16,63;8,43;41599;5429;0.1305;5840;-411;54344;30708;0.5651;29316;1392
2017-04-10 17:00:00;33,06;18,39;14,67;41599;2314;0.0556;2571;-257;54344;30240;0.5564;28577;1663
2017-04-10 18:00:00;33,8;21,8;12,0;41599;282;0.0068;365;-83;54344;30160;0.555;27998;2162
2017-04-10 19:00:00;35,93;23,79;12,14;41599;0;0;2;-2;54344;30486;0.561;27946;2540
2017-04-10 20:00:00;30,26;22,38;7,88;41599;0;0;0;0;54344;31917;0.5873;28203;3714
2017-04-10 21:00:00;22,1;13,1;9,0;41599;0;0;0;0;54344;32700;0.6017;28643;4057
2017-04-10 22:00:00;20,62;12,02;8,6;41599;0;0;0;0;54344;32130;0.5912;29213;2917
2017-04-10 23:00:00;0,49;-1,65;2,14;41599;0;0;0;0;54344;31486;0.5794;29609;1877
2017-05-10 00:00:00;4,09;-1,26;5,35;41611;0;0;0;0;54344;30056;0.5531;28122;1934
2017-05-10 01:00:00;2,09;-3,73;5,82;41611;0;0;0;0;54344;28904;0.5318;27824;1080
2017-05-10 02:00:00;1,8;2,22;-0,42;41611;0;0;0;0;54344;28945;0.5327;27703;1242
2017-05-10 03:00:00;8,91;8,75;0,16;41611;0;0;0;0;54344;27851;0.5125;27444;407
2017-05-10 04:00:00;12,46;10,7;1,76;41611;0;0;0;0;54344;26979;0.4964;27273;-294
2017-05-10 05:00:00;16,98;12,76;4,22;41611;0;0;0;0;54344;26693;0.4912;27403;-710
2017-05-10 06:00:00;31,31;29,35;1,96;41611;0;0;0;0;54344;26768;0.4926;28097;-1329
2017-05-10 07:00:00;35,84;41,4;-5,56;41611;90;0.0022;136;-46;54344;27176;0.5001;29360;-2184
2017-05-10 08:00:00;41,92;47,03;-5,11;41611;1519;0.0365;1601;-82;54344;28835;0.5306;30647;-1812
2017-05-10 09:00:00;31,04;35,83;-4,79;41611;4382;0.1053;4199;183;54344;30859;0.5679;31800;-941
2017-05-10 10:00:00;24,98;25,73;-0,75;41611;7210;0.1733;6739;471;54344;33749;0.621;33225;524
2017-05-10 11:00:00;20,44;7,9;12,54;41611;9593;0.2306;8616;977;54344;36166;0.6655;34299;1867
2017-05-10 12:00:00;9,71;-8,51;18,22;41611;11075;0.2662;9554;1521;54344;37283;0.6861;35209;2074
2017-05-10 13:00:00;12,18;-20,18;32,36;41611;10804;0.2596;9425;1379;54344;37724;0.6942;36409;1315
2017-05-10 14:00:00;10,81;-15,91;26,72;41611;9650;0.2319;8445;1205;54344;36855;0.6782;37057;-202
2017-05-10 15:00:00;10,84;-3,83;14,67;41611;8434;0.2027;6749;1685;54344;34646;0.6375;37169;-2523
2017-05-10 16:00:00;10,89;6,39;4,5;41611;5264;0.1265;4369;895;54344;33264;0.6121;36473;-3209
2017-05-10 17:00:00;14,68;15,18;-0,5;41611;2010;0.0483;1858;152;54344;32429;0.5967;35102;-2673
2017-05-10 18:00:00;25,0;29,8;-4,8;41611;254;0.0061;265;-11;54344;31782;0.5848;33452;-1670
2017-05-10 19:00:00;29,96;30,24;-0,28;41611;0;0;0;0;54344;30672;0.5644;31879;-1207
2017-05-10 20:00:00;26,08;27,98;-1,9;41611;0;0;0;0;54344;30086;0.5536;30628;-542
2017-05-10 21:00:00;27,96;20,73;7,23;41611;0;0;0;0;54344;30020;0.5524;29576;444
2017-05-10 22:00:00;10,84;11,52;-0,68;41611;0;0;0;0;54344;29500;0.5428;28882;618
2017-05-10 23:00:00;11,81;13,04;-1,23;41611;0;0;0;0;54344;28815;0.5302;28374;441
2017-06-10 00:00:00;0,95;11,74;-10,79;41616;0;0;0;0;54350;27970;0.5147;27878;92
2017-06-10 01:00:00;9,88;13,95;-4,07;41616;0;0;0;0;54350;27179;0.5001;27468;-289
2017-06-10 02:00:00;3,23;12,41;-9,18;41616;0;0;0;0;54350;26788;0.4929;27342;-554
2017-06-10 03:00:00;0,43;10,41;-9,98;41616;0;0;0;0;54350;26475;0.4871;27153;-678
2017-06-10 04:00:00;4,46;12,56;-8,1;41616;0;0;0;0;54350;25977;0.478;27037;-1060
2017-06-10 05:00:00;10,78;19,74;-8,96;41616;0;0;0;0;54350;26062;0.4795;26924;-862
2017-06-10 06:00:00;31,08;38,09;-7,01;41616;0;0;0;0;54350;26616;0.4897;26779;-163
2017-06-10 07:00:00;37,87;39,43;-1,56;41616;115;0.0028;135;-20;54350;26432;0.4863;26504;-72
2017-06-10 08:00:00;34,94;35,59;-0,65;41616;1790;0.043;1571;219;54350;25706;0.473;26227;-521
2017-06-10 09:00:00;33,98;35,62;-1,64;41616;4682;0.1125;4255;427;54350;25377;0.4669;26134;-757
2017-06-10 10:00:00;32,95;35,93;-2,98;41616;7191;0.1728;6751;440;54350;25107;0.462;26227;-1120
2017-06-10 11:00:00;32,95;34,98;-2,03;41616;8764;0.2106;8627;137;54350;25812;0.4749;26121;-309
2017-06-10 12:00:00;32,13;34,89;-2,76;41616;9606;0.2308;9568;38;54350;26285;0.4836;25744;541
2017-06-10 13:00:00;30,35;32,96;-2,61;41616;9988;0.24;9687;301;54350;26937;0.4956;25299;1638
2017-06-10 14:00:00;29,45;31,38;-1,93;41616;9574;0.2301;9039;535;54350;26617;0.4897;24966;1651
2017-06-10 15:00:00;29,28;30,74;-1,46;41616;8197;0.197;7594;603;54350;25709;0.473;24623;1086
2017-06-10 16:00:00;32,41;31,49;0,92;41616;5698;0.1369;5255;443;54350;24792;0.4562;24019;773
2017-06-10 17:00:00;36,9;33,88;3,02;41616;2460;0.0591;2361;99;54350;23724;0.4365;22895;829
2017-06-10 18:00:00;46,92;39,03;7,89;41616;301;0.0072;324;-23;54350;22280;0.4099;21684;596
2017-06-10 19:00:00;48,52;45,55;2,97;41616;0;0;1;-1;54350;21984;0.4045;20891;1093
2017-06-10 20:00:00;42,04;36,51;5,53;41616;0;0;0;0;54350;21764;0.4004;20313;1451
2017-06-10 21:00:00;35,1;32,0;3,1;41616;0;0;0;0;54350;21500;0.3956;19722;1778
2017-06-10 22:00:00;30,6;29,28;1,32;41616;0;0;0;0;54350;20276;0.373;19248;1028
2017-06-10 23:00:00;26,87;29,52;-2,65;41616;0;0;0;0;54350;19739;0.3632;18958;781
2017-07-10 00:00:00;13,85;16,22;-2,37;41616;0;0;0;0;54350;19756;0.3635;18444;1312
2017-07-10 01:00:00;11,85;10,51;1,34;41616;0;0;0;0;54350;19148;0.3523;18278;870
2017-07-10 02:00:00;10,72;10,73;-0,01;41616;0;0;0;0;54350;18142;0.3338;18376;-234
2017-07-10 03:00:00;11,04;12,41;-1,37;41616;0;0;0;0;54350;18527;0.3408;18401;126
2017-07-10 04:00:00;9,0;14,89;-5,89;41616;0;0;0;0;54350;19313;0.3554;18455;858
2017-07-10 05:00:00;8,94;11,85;-2,91;41616;0;0;0;0;54350;18932;0.3484;18458;474
2017-07-10 06:00:00;10,94;13,17;-2,23;41616;0;0;0;0;54350;19764;0.3636;18410;1354
2017-07-10 07:00:00;12,21;9,49;2,72;41616;71;0.0017;84;-13;54350;20431;0.3759;18489;1942
2017-07-10 08:00:00;24,92;14,02;10,9;41616;1422;0.0342;1117;305;54350;21532;0.3962;18981;2551
2017-07-10 09:00:00;17,39;2,43;14,96;41616;3946;0.0948;3269;677;54350;22510;0.4141;19958;2552
2017-07-10 10:00:00;10,77;-0,06;10,83;41616;6366;0.153;5514;852;54350;24387;0.4487;21535;2852
2017-07-10 11:00:00;11,21;-0,16;11,37;41616;8417;0.2022;7198;1219;54350;27091;0.4984;23511;3580
2017-07-10 12:00:00;3,57;-6,85;10,42;41616;8704;0.2091;7916;788;54350;29310;0.5393;25577;3733
2017-07-10 13:00:00;0,0;-8,06;8,06;41616;7864;0.189;7457;407;54350;30920;0.5689;27403;3517
2017-07-10 14:00:00;-0,95;-5,9;4,95;41616;6727;0.1617;6273;454;54350;31825;0.5856;28804;3021
2017-07-10 15:00:00;-1,35;-3,39;2,04;41616;5063;0.1216;4634;429;54350;32521;0.5983;29528;2993
2017-07-10 16:00:00;-0,94;0,54;-1,48;41616;2778;0.0668;2788;-10;54350;33658;0.6193;30168;3490
2017-07-10 17:00:00;0,89;7,24;-6,35;41616;914;0.022;1073;-159;54350;33936;0.6244;30577;3359
2017-07-10 18:00:00;8,3;10,41;-2,11;41616;56;0.0013;124;-68;54350;33952;0.6247;30810;3142
2017-07-10 19:00:00;10,12;10,82;-0,7;41616;0;0;0;0;54350;34044;0.6264;31207;2837
2017-07-10 20:00:00;2,53;5,96;-3,43;41616;0;0;0;0;54350;33526;0.6168;31365;2161
2017-07-10 21:00:00;3,08;3,91;-0,83;41616;0;0;0;0;54350;32071;0.5901;31013;1058
2017-07-10 22:00:00;2,59;5,82;-3,23;41616;0;0;0;0;54350;30179;0.5553;30149;30
2017-07-10 23:00:00;0,47;5,4;-4,93;41616;0;0;0;0;54350;28891;0.5316;28866;25
2017-08-10 00:00:00;-0,96;5,75;-6,71;41616;0;0;0;0;54350;26740;0.492;26522;218
2017-08-10 01:00:00;-2,37;4,23;-6,6;41616;0;0;0;0;54350;24434;0.4496;25071;-637
2017-08-10 02:00:00;-0,03;4,22;-4,25;41616;0;0;0;0;54350;22786;0.4192;23757;-971
2017-08-10 03:00:00;-0,96;1,77;-2,73;41616;0;0;0;0;54350;21941;0.4037;22426;-485
2017-08-10 04:00:00;-0,08;1,62;-1,7;41616;0;0;0;0;54350;20619;0.3794;21211;-592
2017-08-10 05:00:00;8,76;4,33;4,43;41616;0;0;0;0;54350;19144;0.3522;19733;-589
2017-08-10 06:00:00;2,52;7,34;-4,82;41616;0;0;0;0;54350;18137;0.3337;17841;296
2017-08-10 07:00:00;12,19;8,64;3,55;41616;35;0.0008;50;-15;54350;16754;0.3082;15926;828
2017-08-10 08:00:00;27,97;21,46;6,51;41616;913;0.0219;829;84;54350;14985;0.2757;14174;811
2017-08-10 09:00:00;29,67;25,81;3,86;41616;3093;0.0743;2504;589;54350;12688;0.2334;12659;29
2017-08-10 10:00:00;32,48;28,24;4,24;41616;5674;0.1364;4574;1100;54350;11533;0.2122;11589;-56
2017-08-10 11:00:00;38,28;32,77;5,51;41616;7754;0.1863;6592;1162;54350;11326;0.2084;11229;97
2017-08-10 12:00:00;30,21;28,87;1,34;41616;9153;0.2199;8096;1057;54350;12088;0.2224;11354;734
2017-08-10 13:00:00;28,03;26,65;1,38;41616;9558;0.2297;8730;828;54350;12490;0.2298;11621;869
2017-08-10 14:00:00;26,26;24,45;1,81;41616;9146;0.2198;8540;606;54350;12850;0.2364;11848;1002
2017-08-10 15:00:00;21,85;22,8;-0,95;41616;7826;0.1881;7308;518;54350;12928;0.2379;11660;1268
2017-08-10 16:00:00;27,44;27,78;-0,34;41616;5413;0.1301;4868;545;54350;12453;0.2291;11028;1425
2017-08-10 17:00:00;32,46;31,89;0,57;41616;2251;0.0541;2008;243;54350;10499;0.1932;10011;488
2017-08-10 18:00:00;40,05;43,48;-3,43;41616;188;0.0045;224;-36;54350;8848;0.1628;9094;-246
2017-08-10 19:00:00;47,97;49,21;-1,24;41616;0;0;0;0;54350;8339;0.1534;8555;-216
2017-08-10 20:00:00;43,92;46,12;-2,2;41616;0;0;0;0;54350;8006;0.1473;8160;-154
2017-08-10 21:00:00;40,94;40,36;0,58;41616;0;0;0;0;54350;7658;0.1409;7786;-128
2017-08-10 22:00:00;40,95;38,49;2,46;41616;0;0;0;0;54350;7122;0.131;7410;-288
2017-08-10 23:00:00;35,25;32,55;2,7;41616;0;0;0;0;54350;6631;0.122;7055;-424
2017-09-10 00:00:00;32,06;29,64;2,42;41619;0;0;0;0;54353;6466;0.119;5270;1196
2017-09-10 01:00:00;30,64;28,31;2,33;41619;0;0;0;0;54353;6564;0.1208;5142;1422
2017-09-10 02:00:00;30,02;25,91;4,11;41619;0;0;0;0;54353;6431;0.1183;5196;1235
2017-09-10 03:00:00;30,09;26,28;3,81;41619;0;0;0;0;54353;6658;0.1225;5318;1340
2017-09-10 04:00:00;30,01;28,77;1,24;41619;0;0;0;0;54353;6820;0.1255;5455;1365
2017-09-10 05:00:00;32,0;31,22;0,78;41619;0;0;0;0;54353;6824;0.1256;5564;1260
2017-09-10 06:00:00;42,98;41,79;1,19;41619;0;0;0;0;54353;6892;0.1268;5580;1312
2017-09-10 07:00:00;51,48;52,64;-1,16;41619;91;0.0022;102;-11;54353;7034;0.1294;5469;1565
2017-09-10 08:00:00;54,75;55,44;-0,69;41619;1686;0.0405;1593;93;54353;6726;0.1238;5121;1605
2017-09-10 09:00:00;51,14;47,05;4,09;41619;4762;0.1144;4352;410;54353;5604;0.1031;4547;1057
2017-09-10 10:00:00;51,14;44,37;6,77;41619;7895;0.1897;6945;950;54353;4742;0.0873;4174;568
2017-09-10 11:00:00;47,12;42,06;5,06;41619;10376;0.2493;8839;1537;54353;5463;0.1005;4446;1017
2017-09-10 12:00:00;41,21;35,34;5,87;41619;11399;0.2739;9737;1662;54353;6813;0.1254;5123;1690
2017-09-10 13:00:00;39,94;34,82;5,12;41619;10730;0.2579;9425;1305;54353;7970;0.1466;5822;2148
2017-09-10 14:00:00;40,06;35,2;4,86;41619;9262;0.2225;8269;993;54353;8062;0.1484;6169;1893
2017-09-10 15:00:00;41,41;37,74;3,67;41619;6884;0.1654;6407;477;54353;7416;0.1364;6058;1358
2017-09-10 16:00:00;43,79;40,16;3,63;41619;4035;0.097;4006;29;54353;6547;0.1204;5623;924
2017-09-10 17:00:00;50,52;47,47;3,05;41619;1489;0.0358;1516;-27;54353;5755;0.1059;5233;522
2017-09-10 18:00:00;59,83;57,11;2,72;41619;102;0.0024;158;-56;54353;5592;0.1029;5090;502
2017-09-10 19:00:00;62,01;60,12;1,89;41619;0;0;0;0;54353;6035;0.111;5191;844
2017-09-10 20:00:00;46,36;47,5;-1,14;41619;0;0;0;0;54353;6902;0.127;5390;1512
2017-09-10 21:00:00;38,58;39,11;-0,53;41619;0;0;0;0;54353;7568;0.1392;5680;1888
2017-09-10 22:00:00;37,22;36,97;0,25;41619;0;0;0;0;54353;8205;0.151;6018;2187
2017-09-10 23:00:00;32,93;31,77;1,16;41619;0;0;0;0;54353;8244;0.1516;6345;1899
2017-10-10 00:00:00;30,22;32,19;-1,97;41624;0;0;0;0;54353;8251;0.1518;7600;651
2017-10-10 01:00:00;29,96;31,63;-1,67;41624;0;0;0;0;54353;8224;0.1513;7871;353
2017-10-10 02:00:00;30,19;32,69;-2,5;41624;0;0;0;0;54353;8089;0.1488;8221;-132
2017-10-10 03:00:00;30,0;32,31;-2,31;41624;0;0;0;0;54353;7664;0.141;8443;-779
2017-10-10 04:00:00;30,74;32,05;-1,31;41624;0;0;0;0;54353;7840;0.1442;8702;-862
2017-10-10 05:00:00;31,79;33,08;-1,29;41624;0;0;0;0;54353;7779;0.1431;8792;-1013
2017-10-10 06:00:00;37,78;42,82;-5,04;41624;0;0;0;0;54353;7993;0.1471;8830;-837
2017-10-10 07:00:00;48,85;56,98;-8,13;41624;23;0.0006;42;-19;54353;7966;0.1466;9058;-1092
2017-10-10 08:00:00;56,94;66,27;-9,33;41624;680;0.0164;700;-20;54353;8183;0.1506;9701;-1518
2017-10-10 09:00:00;55,61;70,79;-15,18;41624;2330;0.056;2213;117;54353;8755;0.1611;10862;-2107
2017-10-10 10:00:00;43,07;59,76;-16,69;41624;4182;0.1005;3780;402;54353;9832;0.1809;12284;-2452
2017-10-10 11:00:00;42,36;49,32;-6,96;41624;5502;0.1322;4973;529;54353;11198;0.206;13973;-2775
2017-10-10 12:00:00;40,0;44,43;-4,43;41624;6406;0.1539;5553;853;54353;13254;0.2438;15729;-2475
2017-10-10 13:00:00;38,3;41,56;-3,26;41624;6462;0.1552;5328;1134;54353;14684;0.2702;17171;-2487
2017-10-10 14:00:00;37,24;40,04;-2,8;41624;4958;0.1191;4566;392;54353;14997;0.2759;18062;-3065
2017-10-10 15:00:00;35,89;50,78;-14,89;41624;3352;0.0805;3390;-38;54353;15378;0.2829;18133;-2755
2017-10-10 16:00:00;35,37;43,99;-8,62;41624;1912;0.046;1988;-76;54353;16206;0.2982;18051;-1845
2017-10-10 17:00:00;36,82;42,56;-5,74;41624;763;0.0183;728;35;54353;16470;0.303;17958;-1488
2017-10-10 18:00:00;39,9;48,6;-8,7;41624;64;0.0015;82;-18;54353;17475;0.3215;17893;-418
2017-10-10 19:00:00;42,92;45,63;-2,71;41624;0;0;0;0;54353;18323;0.3371;18160;163
2017-10-10 20:00:00;35,46;37,81;-2,35;41624;0;0;0;0;54353;19501;0.3588;18492;1009
2017-10-10 21:00:00;33,03;33,75;-0,72;41624;0;0;0;0;54353;20502;0.3772;18693;1809
2017-10-10 22:00:00;30,51;28,6;1,91;41624;0;0;0;0;54353;20312;0.3737;18526;1786
2017-10-10 23:00:00;22,76;23,21;-0,45;41624;0;0;0;0;54353;20370;0.3748;18118;2252
2017-11-10 00:00:00;22,04;16,32;5,72;41627;0;0;0;0;54358;19706;0.3625;17596;2110
2017-11-10 01:00:00;21,31;14,9;6,41;41627;0;0;0;0;54358;19009;0.3497;16665;2344
2017-11-10 02:00:00;22,79;17,26;5,53;41627;0;0;0;0;54358;19055;0.3506;16195;2860
2017-11-10 03:00:00;23,09;16,1;6,99;41627;0;0;0;0;54358;19071;0.3508;16047;3024
2017-11-10 04:00:00;27,05;19,06;7,99;41627;0;0;0;0;54358;19620;0.3609;16108;3512
2017-11-10 05:00:00;29,83;19,82;10,01;41627;0;0;0;0;54358;20218;0.372;16451;3767
2017-11-10 06:00:00;38,93;27,5;11,43;41627;0;0;0;0;54358;21137;0.3889;17128;4009
2017-11-10 07:00:00;47,0;31,88;15,12;41627;45;0.0011;50;-5;54358;20949;0.3854;18056;2893
2017-11-10 08:00:00;49,93;41,29;8,64;41627;1165;0.028;1019;146;54358;21346;0.3927;18892;2454
2017-11-10 09:00:00;43,81;36,2;7,61;41627;3785;0.0909;3301;484;54358;21596;0.3973;19606;1990
2017-11-10 10:00:00;41,0;33,97;7,03;41627;6643;0.1596;5786;857;54358;22370;0.4116;20603;1767
2017-11-10 11:00:00;38,91;32,35;6,56;41627;9237;0.2219;7869;1368;54358;23232;0.4274;21649;1583
2017-11-10 12:00:00;31,89;26,63;5,26;41627;10172;0.2444;9089;1083;54358;23928;0.4402;22374;1554
2017-11-10 13:00:00;31,81;27,15;4,66;41627;9519;0.2286;9193;326;54358;24333;0.4476;22657;1676
2017-11-10 14:00:00;30,54;29,44;1,1;41627;8452;0.203;8432;20;54358;23314;0.4289;22491;823
2017-11-10 15:00:00;31,7;33,11;-1,41;41627;7114;0.1709;6861;253;54358;21905;0.403;21743;162
2017-11-10 16:00:00;36,35;38,42;-2,07;41627;4811;0.1156;4483;328;54358;21461;0.3948;20725;736
2017-11-10 17:00:00;41,18;41,69;-0,51;41627;1954;0.0469;1741;213;54358;20930;0.385;19987;943
2017-11-10 18:00:00;42,98;43,65;-0,67;41627;140;0.0034;163;-23;54358;21030;0.3869;19724;1306
2017-11-10 19:00:00;46,49;46,75;-0,26;41627;0;0;0;0;54358;21176;0.3896;19955;1221
2017-11-10 20:00:00;39,9;38,51;1,39;41627;0;0;0;0;54358;21685;0.3989;20492;1193
2017-11-10 21:00:00;31,93;29,46;2,47;41627;0;0;0;0;54358;22246;0.4092;21327;919
2017-11-10 22:00:00;29,58;27,44;2,14;41627;0;0;0;0;54358;21736;0.3999;22178;-442
2017-11-10 23:00:00;22,09;25,47;-3,38;41627;0;0;0;0;54358;22337;0.4109;22932;-595
2017-12-10 00:00:00;13,32;23,42;-10,1;41640;0;0;0;0;54361;22958;0.4223;23469;-511
2017-12-10 01:00:00;12,66;21,26;-8,6;41640;0;0;0;0;54361;23983;0.4412;24043;-60
2017-12-10 02:00:00;12,67;17,87;-5,2;41640;0;0;0;0;54361;25458;0.4683;25140;318
2017-12-10 03:00:00;9,7;13,11;-3,41;41640;0;0;0;0;54361;27051;0.4976;26180;871
2017-12-10 04:00:00;10,28;9,09;1,19;41640;0;0;0;0;54361;27515;0.5061;27144;371
2017-12-10 05:00:00;11,17;11,74;-0,57;41640;0;0;0;0;54361;27952;0.5142;27756;196
2017-12-10 06:00:00;28,04;24,54;3,5;41640;0;0;0;0;54361;29482;0.5424;28009;1473
2017-12-10 07:00:00;38,09;32,24;5,85;41640;50;0.0012;66;-16;54361;30250;0.5564;28380;1870
2017-12-10 08:00:00;36,99;30,65;6,34;41640;1603;0.0385;1548;55;54361;29466;0.542;28839;627
2017-12-10 09:00:00;30,54;24,99;5,55;41640;5073;0.1218;4842;231;54361;29148;0.5362;29252;-104
2017-12-10 10:00:00;21,49;14,73;6,76;41640;8460;0.2032;8166;294;54361;30056;0.5529;29808;248
2017-12-10 11:00:00;17,52;13,63;3,89;41640;10907;0.262;10776;131;54361;30901;0.5684;30645;256
2017-12-10 12:00:00;12,78;11,19;1,59;41640;11653;0.2798;12168;-515;54361;31530;0.58;31261;269
2017-12-10 13:00:00;13,54;14,17;-0,63;41640;11778;0.2828;11910;-132;54361;31691;0.583;31465;226
2017-12-10 14:00:00;15,12;16,99;-1,87;41640;11110;0.2668;10508;602;54361;30622;0.5634;31177;-555
2017-12-10 15:00:00;21,62;23,61;-1,99;41640;9186;0.2206;8282;904;54361;29622;0.5449;30083;-461
2017-12-10 16:00:00;26,04;27,28;-1,24;41640;6054;0.1454;5271;783;54361;27503;0.5059;28329;-826
2017-12-10 17:00:00;34,93;36,85;-1,92;41640;2452;0.0589;1923;529;54361;23987;0.4412;26161;-2174
2017-12-10 18:00:00;42,05;45,05;-3,0;41640;161;0.0039;155;6;54361;21498;0.3955;23623;-2125
2017-12-10 19:00:00;46,32;50,59;-4,27;41640;0;0;0;0;54361;20380;0.3749;21552;-1172
2017-12-10 20:00:00;40,98;44,55;-3,57;41640;0;0;0;0;54361;20763;0.382;19880;883
2017-12-10 21:00:00;42,94;41,33;1,61;41640;0;0;0;0;54361;20387;0.375;18476;1911
2017-12-10 22:00:00;38,96;34,36;4,6;41640;0;0;0;0;54361;19083;0.351;17062;2021
2017-12-10 23:00:00;31,37;25,83;5,54;41640;0;0;0;0;54361;18333;0.3373;15796;2537
2017-10-13 00:00:00;30,53;27,66;2,87;41652;0;0;0;0;54368;17520;0.3222;15477;2043
2017-10-13 01:00:00;29,38;27,27;2,11;41652;0;0;0;0;54368;16736;0.3078;14704;2032
2017-10-13 02:00:00;28,34;28,24;0,1;41652;0;0;0;0;54368;16051;0.2952;14033;2018
2017-10-13 03:00:00;28,46;27,95;0,51;41652;0;0;0;0;54368;14766;0.2716;13230;1536
2017-10-13 04:00:00;29,03;28,37;0,66;41652;0;0;0;0;54368;13995;0.2574;12602;1393
2017-10-13 05:00:00;31,47;31,79;-0,32;41652;0;0;0;0;54368;13621;0.2505;12110;1511
2017-10-13 06:00:00;43,08;44,34;-1,26;41652;0;0;0;0;54368;12914;0.2375;11602;1312
2017-10-13 07:00:00;59,93;59,1;0,83;41652;57;0.0013;56;1;54368;12195;0.2243;11039;1156
2017-10-13 08:00:00;64,82;63,25;1,57;41652;1802;0.0433;1630;172;54368;11748;0.2161;10355;1393
2017-10-13 09:00:00;50,81;50,07;0,74;41652;5410;0.1299;5213;197;54368;10584;0.1947;9552;1032
2017-10-13 10:00:00;46,46;45,37;1,09;41652;9598;0.2304;8854;744;54368;9477;0.1743;8996;481
2017-10-13 11:00:00;44,4;44,29;0,11;41652;13201;0.3169;11699;1502;54368;9500;0.1747;9226;274
2017-10-13 12:00:00;38,03;37,77;0,26;41652;15035;0.361;13272;1763;54368;10689;0.1966;10116;573
2017-10-13 13:00:00;33,49;33,19;0,3;41652;14552;0.3494;13369;1183;54368;11923;0.2193;11048;875
2017-10-13 14:00:00;31,29;34,37;-3,08;41652;12938;0.3106;12145;793;54368;12436;0.2287;11555;881
2017-10-13 15:00:00;34,72;37,89;-3,17;41652;10128;0.2432;9670;458;54368;12115;0.2228;11362;753
2017-10-13 16:00:00;36,99;40,72;-3,73;41652;6338;0.1522;6113;225;54368;10873;0.2;10851;22
2017-10-13 17:00:00;46,45;50,14;-3,69;41652;2346;0.0563;2221;125;54368;10028;0.1844;10483;-455
2017-10-13 18:00:00;55,9;65,46;-9,56;41652;120;0.0029;174;-54;54368;10552;0.1941;10654;-102
2017-10-13 19:00:00;49,9;65,3;-15,4;41652;0;0;0;0;54368;11370;0.2091;11240;130
2017-10-13 20:00:00;39,27;45,16;-5,89;41652;0;0;0;0;54368;12521;0.2303;11949;572
2017-10-13 21:00:00;35,21;41,06;-5,85;41652;0;0;0;0;54368;13378;0.246;12741;637
2017-10-13 22:00:00;31,66;38,5;-6,84;41652;0;0;0;0;54368;13787;0.2536;13508;279
2017-10-13 23:00:00;29,63;38,35;-8,72;41652;0;0;0;0;54368;14311;0.2632;14090;221
2017-10-14 00:00:00;28,0;32,17;-4,17;41653;0;0;0;0;54371;14498;0.2666;13998;500
2017-10-14 01:00:00;26,99;31,67;-4,68;41653;0;0;0;0;54371;14384;0.2645;14164;220
2017-10-14 02:00:00;27,41;31,69;-4,28;41653;0;0;0;0;54371;14592;0.2684;14377;215
2017-10-14 03:00:00;26,4;31,11;-4,71;41653;0;0;0;0;54371;14617;0.2688;14391;226
2017-10-14 04:00:00;26,17;31,28;-5,11;41653;0;0;0;0;54371;14314;0.2633;14389;-75
2017-10-14 05:00:00;26,1;31,35;-5,25;41653;0;0;0;0;54371;14392;0.2647;14377;15
2017-10-14 06:00:00;28,0;33,74;-5,74;41653;0;0;0;0;54371;14804;0.2723;14369;435
2017-10-14 07:00:00;33,99;43,65;-9,66;41653;43;0.001;59;-16;54371;14876;0.2736;14315;561
2017-10-14 08:00:00;39,42;46,25;-6,83;41653;1843;0.0442;1946;-103;54371;14741;0.2711;14139;602
2017-10-14 09:00:00;35,95;41,16;-5,21;41653;6083;0.1461;6244;-161;54371;14249;0.2621;13831;418
2017-10-14 10:00:00;28,04;31,01;-2,97;41653;11075;0.2659;10659;416;54371;13563;0.2494;13631;-68
2017-10-14 11:00:00;22,86;26,59;-3,73;41653;15324;0.3679;14096;1228;54371;13669;0.2514;13652;17
2017-10-14 12:00:00;26,07;23,29;2,78;41653;17609;0.4228;15933;1676;54371;13902;0.2557;13694;208
2017-10-14 13:00:00;12,67;9,92;2,75;41653;17874;0.4291;16120;1754;54371;13708;0.2521;13569;139
2017-10-14 14:00:00;13,31;12,05;1,26;41653;16373;0.3931;14736;1637;54371;13160;0.242;13077;83
2017-10-14 15:00:00;26,42;24,33;2,09;41653;13136;0.3154;11887;1249;54371;12397;0.228;12068;329
2017-10-14 16:00:00;31,44;33,25;-1,81;41653;8280;0.1988;7613;667;54371;10877;0.2;10928;-51
2017-10-14 17:00:00;40,02;44,58;-4,56;41653;2869;0.0689;2802;67;54371;9936;0.1828;10002;-66
2017-10-14 18:00:00;49,71;57,78;-8,07;41653;124;0.003;202;-78;54371;9838;0.181;9528;310
2017-10-14 19:00:00;52,51;63,39;-10,88;41653;0;0;0;0;54371;10379;0.1909;9421;958
2017-10-14 20:00:00;43,97;47,3;-3,33;41653;0;0;0;0;54371;10645;0.1958;9428;1217
2017-10-14 21:00:00;40,03;43,95;-3,92;41653;0;0;0;0;54371;10370;0.1907;9220;1150
2017-10-14 22:00:00;39,07;42,48;-3,41;41653;0;0;0;0;54371;9486;0.1744;8803;683
2017-10-14 23:00:00;31,43;34,37;-2,94;41653;0;0;0;0;54371;8902;0.1637;8264;638
2017-10-15 00:00:00;34,26;33,67;0,59;41654;0;0;0;0;54371;8197;0.1508;7135;1062
2017-10-15 01:00:00;31,56;29,78;1,78;41654;0;0;0;0;54371;7868;0.1447;6677;1191
2017-10-15 02:00:00;30,41;28,89;1,52;41654;0;0;0;0;54371;7374;0.1356;6378;996
2017-10-15 03:00:00;29,27;29,05;0,22;41654;0;0;0;0;54371;6834;0.1257;6012;822
2017-10-15 04:00:00;29,04;26,58;2,46;41654;0;0;0;0;54371;6491;0.1194;5750;741
2017-10-15 05:00:00;28,91;27,74;1,17;41654;0;0;0;0;54371;5804;0.1067;5657;147
2017-10-15 06:00:00;31,18;28,85;2,33;41654;0;0;0;0;54371;5475;0.1007;5768;-293
2017-10-15 07:00:00;35,9;33,43;2,47;41654;47;0.0012;59;-12;54371;5593;0.1028;5924;-331
2017-10-15 08:00:00;34,22;36,07;-1,85;41654;2148;0.0516;2253;-105;54371;5854;0.1076;5977;-123
2017-10-15 09:00:00;33,24;32,09;1,15;41654;7123;0.171;7380;-257;54371;6160;0.1133;5800;360
2017-10-15 10:00:00;31,58;32,52;-0,94;41654;12812;0.3076;12634;178;54371;5819;0.107;5471;348
2017-10-15 11:00:00;30,97;29,63;1,34;41654;16969;0.4074;16704;265;54371;5270;0.0969;5312;-42
2017-10-15 12:00:00;22,77;23,53;-0,76;41654;19424;0.4663;18956;468;54371;4936;0.0908;5613;-677
2017-10-15 13:00:00;17,07;20,29;-3,22;41654;19902;0.4778;19308;594;54371;5374;0.0988;6040;-666
2017-10-15 14:00:00;22,44;25,49;-3,05;41654;18407;0.4419;17780;627;54371;5742;0.1056;6447;-705
2017-10-15 15:00:00;26,63;26,99;-0,36;41654;14700;0.3529;14421;279;54371;6168;0.1134;6642;-474
2017-10-15 16:00:00;28,03;29,79;-1,76;41654;9096;0.2184;9260;-164;54371;6369;0.1172;6943;-574
2017-10-15 17:00:00;39,38;39,4;-0,02;41654;2982;0.0716;3352;-370;54371;7111;0.1308;7704;-593
2017-10-15 18:00:00;45,05;47,85;-2,8;41654;105;0.0025;213;-108;54371;10387;0.191;9811;576
2017-10-15 19:00:00;45,04;45,17;-0,13;41654;0;0;0;0;54371;14193;0.261;12427;1766
2017-10-15 20:00:00;31,75;35,77;-4,02;41654;0;0;0;0;54371;16088;0.2959;14381;1707
2017-10-15 21:00:00;31,73;31,8;-0,07;41654;0;0;0;0;54371;17554;0.3228;15392;2162
2017-10-15 22:00:00;29,09;29,86;-0,77;41654;0;0;0;0;54371;18127;0.3334;15745;2382
2017-10-15 23:00:00;18,4;18,24;0,16;41654;0;0;0;0;54371;18100;0.3329;15562;2538
2017-10-16 00:00:00;22,99;18,89;4,1;41658;0;0;0;0;54374;17264;0.3175;16051;1213
2017-10-16 01:00:00;21,26;19,9;1,36;41658;0;0;0;0;54374;16193;0.2978;15461;732
2017-10-16 02:00:00;21,86;25,45;-3,59;41658;0;0;0;0;54374;15353;0.2824;14877;476
2017-10-16 03:00:00;21,79;21,68;0,11;41658;0;0;0;0;54374;14306;0.2631;14030;276
2017-10-16 04:00:00;22,93;18,74;4,19;41658;0;0;0;0;54374;13276;0.2442;13213;63
2017-10-16 05:00:00;28,9;29,04;-0,14;41658;0;0;0;0;54374;12565;0.2311;12552;13
2017-10-16 06:00:00;42,0;45,07;-3,07;41658;0;0;0;0;54374;11902;0.2189;12103;-201
2017-10-16 07:00:00;55,34;58,11;-2,77;41658;48;0.0011;54;-6;54374;11066;0.2035;11659;-593
2017-10-16 08:00:00;51,65;54,98;-3,33;41658;2284;0.0548;2385;-101;54374;10422;0.1917;10852;-430
2017-10-16 09:00:00;43,12;41,79;1,33;41658;7328;0.1759;7798;-470;54374;8918;0.164;9559;-641
2017-10-16 10:00:00;37,3;36,6;0,7;41658;12794;0.3071;13094;-300;54374;6200;0.114;8001;-1801
2017-10-16 11:00:00;33,16;34,73;-1,57;41658;17028;0.4088;16949;79;54374;4187;0.077;6843;-2656
2017-10-16 12:00:00;32,26;36,09;-3,83;41658;19122;0.459;18900;222;54374;3402;0.0626;6381;-2979
2017-10-16 13:00:00;31,68;35,32;-3,64;41658;19054;0.4574;19109;-55;54374;3242;0.0596;6003;-2761
2017-10-16 14:00:00;40,56;44,6;-4,04;41658;17132;0.4112;17493;-361;54374;3310;0.0608;5378;-2068
2017-10-16 15:00:00;42,5;45,26;-2,76;41658;13313;0.3196;14087;-774;54374;3652;0.0672;4616;-964
2017-10-16 16:00:00;44,62;47,39;-2,77;41658;7927;0.1903;8965;-1038;54374;4232;0.0778;4211;21
2017-10-16 17:00:00;50,9;54,97;-4,07;41658;2450;0.0588;3099;-649;54374;5653;0.104;4551;1102
2017-10-16 18:00:00;63,47;57,41;6,06;41658;74;0.0018;168;-94;54374;9065;0.1667;6096;2969
2017-10-16 19:00:00;66,73;55,34;11,39;41658;0;0;0;0;54374;12940;0.238;8327;4613
2017-10-16 20:00:00;45,95;38,07;7,88;41658;0;0;0;0;54374;15242;0.2803;10578;4664
2017-10-16 21:00:00;39,05;33,82;5,23;41658;0;0;0;0;54374;15972;0.2937;12141;3831
2017-10-16 22:00:00;34,07;32,91;1,16;41658;0;0;0;0;54374;16390;0.3014;13252;3138
2017-10-16 23:00:00;31,11;29,73;1,38;41658;0;0;0;0;54374;16596;0.3052;13895;2701
2017-10-17 00:00:00;28,95;26,89;2,06;41662;0;0;0;0;54381;16906;0.3109;15509;1397
2017-10-17 01:00:00;27,02;28,47;-1,45;41662;0;0;0;0;54381;16644;0.306;15253;1391
2017-10-17 02:00:00;26,99;28,28;-1,29;41662;0;0;0;0;54381;15490;0.2848;15031;459
2017-10-17 03:00:00;27,04;30,81;-3,77;41662;0;0;0;0;54381;14663;0.2696;14541;122
2017-10-17 04:00:00;28,06;29,89;-1,83;41662;0;0;0;0;54381;14644;0.2693;14063;581
2017-10-17 05:00:00;30,57;33,07;-2,5;41662;0;0;0;0;54381;14836;0.2728;13748;1088
2017-10-17 06:00:00;34,99;37,78;-2,79;41662;0;0;0;0;54381;14707;0.2705;13602;1105
2017-10-17 07:00:00;46,16;50,86;-4,7;41662;36;0.0008;40;-4;54381;14240;0.2619;13378;862
2017-10-17 08:00:00;44,97;46,34;-1,37;41662;1995;0.0479;2161;-166;54381;13594;0.25;12951;643
2017-10-17 09:00:00;36,95;36,88;0,07;41662;6646;0.1596;7433;-787;54381;12383;0.2277;12241;142
2017-10-17 10:00:00;33,46;35,24;-1,78;41662;11545;0.2771;12674;-1129;54381;10978;0.2019;11120;-142
2017-10-17 11:00:00;31,34;34,25;-2,91;41662;15288;0.367;16596;-1308;54381;10163;0.1869;10373;-210
2017-10-17 12:00:00;29,24;33,29;-4,05;41662;17253;0.4141;18675;-1422;54381;9876;0.1816;10602;-726
2017-10-17 13:00:00;30,22;34,16;-3,94;41662;17343;0.4163;18925;-1582;54381;9802;0.1802;11020;-1218
2017-10-17 14:00:00;29,72;35,49;-5,77;41662;15576;0.3738;17327;-1751;54381;9522;0.1751;11010;-1488
2017-10-17 15:00:00;32,8;38,32;-5,52;41662;11901;0.2856;13876;-1975;54381;8990;0.1653;10534;-1544
2017-10-17 16:00:00;35,47;44,24;-8,77;41662;6858;0.1646;8678;-1820;54381;8537;0.157;9923;-1386
2017-10-17 17:00:00;47,92;63,07;-15,15;41662;2060;0.0494;2892;-832;54381;8586;0.1579;9397;-811
2017-10-17 18:00:00;63,36;64,84;-1,48;41662;55;0.0013;144;-89;54381;9068;0.1667;9465;-397
2017-10-17 19:00:00;67,92;74,52;-6,6;41662;0;0;0;0;54381;9333;0.1716;9987;-654
2017-10-17 20:00:00;47,38;54,64;-7,26;41662;0;0;0;0;54381;9354;0.172;10115;-761
2017-10-17 21:00:00;43,61;46,51;-2,9;41662;0;0;0;0;54381;8824;0.1622;9834;-1010
2017-10-17 22:00:00;39,99;43,47;-3,48;41662;0;0;0;0;54381;8665;0.1593;9136;-471
2017-10-17 23:00:00;36,79;35,39;1,4;41662;0;0;0;0;54381;8564;0.1575;8282;282
2017-10-18 00:00:00;33,22;37,58;-4,36;41676;0;0;0;0;54386;8092;0.1488;7771;321
2017-10-18 01:00:00;34,02;36,02;-2,0;41676;0;0;0;0;54386;7104;0.1306;7117;-13
2017-10-18 02:00:00;34,02;34,9;-0,88;41676;0;0;0;0;54386;6242;0.1148;6577;-335
2017-10-18 03:00:00;31,89;34,02;-2,13;41676;0;0;0;0;54386;5804;0.1067;5867;-63
2017-10-18 04:00:00;31,81;35,31;-3,5;41676;0;0;0;0;54386;5095;0.0937;5242;-147
2017-10-18 05:00:00;36,03;37,79;-1,76;41676;0;0;0;0;54386;4590;0.0844;4712;-122
2017-10-18 06:00:00;49,87;53,29;-3,42;41676;0;0;0;0;54386;4225;0.0777;4299;-74
2017-10-18 07:00:00;66,0;68,12;-2,12;41676;18;0.0004;24;-6;54386;3746;0.0689;3886;-140
2017-10-18 08:00:00;69,94;67,77;2,17;41676;1364;0.0328;1554;-190;54386;3193;0.0587;3334;-141
2017-10-18 09:00:00;67,91;65,57;2,34;41676;5023;0.1205;5694;-671;54386;2523;0.0464;2601;-78
2017-10-18 10:00:00;64,42;60,7;3,72;41676;9458;0.227;10259;-801;54386;1612;0.0296;1823;-211
2017-10-18 11:00:00;63,08;56,21;6,87;41676;13631;0.3271;14060;-429;54386;970;0.0178;1298;-328
2017-10-18 12:00:00;47,93;47,85;0,08;41676;16051;0.3852;16231;-180;54386;641;0.0118;1139;-498
2017-10-18 13:00:00;45,97;51,61;-5,64;41676;16644;0.3994;16519;125;54386;526;0.0096;1030;-504
2017-10-18 14:00:00;46,07;50,07;-4,0;41676;15312;0.3674;15128;184;54386;502;0.0092;870;-368
2017-10-18 15:00:00;55,84;53,74;2,1;41676;11890;0.2853;12041;-151;54386;578;0.0106;728;-150
2017-10-18 16:00:00;62,65;63,65;-1,0;41676;6987;0.1677;7456;-469;54386;632;0.0116;772;-140
2017-10-18 17:00:00;65,66;68,1;-2,44;41676;2077;0.0499;2441;-364;54386;714;0.0132;1044;-330
2017-10-18 18:00:00;73,41;90,58;-17,17;41676;45;0.0011;122;-77;54386;1280;0.0235;1732;-452
2017-10-18 19:00:00;83,02;104,9;-21,88;41676;0;0;0;0;54386;2019;0.0372;2501;-482
2017-10-18 20:00:00;66,84;68,43;-1,59;41676;0;0;0;0;54386;2554;0.047;3025;-471
2017-10-18 21:00:00;54,27;52,61;1,66;41676;0;0;0;0;54386;2861;0.0526;3345;-484
2017-10-18 22:00:00;40,45;44,51;-4,06;41676;0;0;0;0;54386;3024;0.0556;3611;-587
2017-10-18 23:00:00;36,94;41,23;-4,29;41676;0;0;0;0;54386;3343;0.0615;3767;-424
2017-10-19 00:00:00;34,28;36,18;-1,9;41680;0;0;0;0;54394;3692;0.0679;3515;177
2017-10-19 01:00:00;34,26;32,1;2,16;41680;0;0;0;0;54394;3890;0.0715;3625;265
2017-10-19 02:00:00;33,59;30,51;3,08;41680;0;0;0;0;54394;4250;0.0782;3851;399
2017-10-19 03:00:00;33,74;30,36;3,38;41680;0;0;0;0;54394;4204;0.0773;3760;444
2017-10-19 04:00:00;34,0;30,77;3,23;41680;0;0;0;0;54394;3987;0.0733;3742;245
2017-10-19 05:00:00;34,89;34,34;0,55;41680;0;0;0;0;54394;3917;0.072;3814;103
2017-10-19 06:00:00;53,71;52,23;1,48;41680;0;0;0;0;54394;3899;0.0716;3881;18
2017-10-19 07:00:00;67,66;64,69;2,97;41680;14;0.0004;20;-6;54394;3781;0.0695;3857;-76
2017-10-19 08:00:00;68,54;66,96;1,58;41680;1374;0.033;1446;-72;54394;3904;0.0718;3708;196
2017-10-19 09:00:00;67,82;60,05;7,77;41680;5442;0.1306;5330;112;54394;3918;0.072;3366;552
2017-10-19 10:00:00;62,07;48,86;13,21;41680;9789;0.2348;9629;160;54394;3496;0.0643;2992;504
2017-10-19 11:00:00;49,97;43,75;6,22;41680;13291;0.3189;13237;54;54394;3260;0.06;2740;520
2017-10-19 12:00:00;46,57;40,02;6,55;41680;15165;0.3638;15298;-133;54394;3266;0.06;2629;637
2017-10-19 13:00:00;41,55;37,01;4,54;41680;15596;0.3742;15737;-141;54394;2966;0.0545;2609;357
2017-10-19 14:00:00;40,53;38,4;2,13;41680;14394;0.3454;14567;-173;54394;2756;0.0506;2588;168
2017-10-19 15:00:00;43,63;41,31;2,32;41680;11438;0.2744;11586;-148;54394;3050;0.0561;2634;416
2017-10-19 16:00:00;49,91;42,51;7,4;41680;6742;0.1618;7113;-371;54394;3604;0.0663;3079;525
2017-10-19 17:00:00;58,01;50,46;7,55;41680;1895;0.0455;2228;-333;54394;5496;0.101;4333;1163
2017-10-19 18:00:00;61,27;70,3;-9,03;41680;38;0.0009;92;-54;54394;8832;0.1624;6805;2027
2017-10-19 19:00:00;54,3;55,37;-1,07;41680;0;0;0;0;54394;11912;0.219;9700;2212
2017-10-19 20:00:00;41,55;35,97;5,58;41680;0;0;0;0;54394;13476;0.2478;11722;1754
2017-10-19 21:00:00;34,6;34,11;0,49;41680;0;0;0;0;54394;13804;0.2538;12686;1118
2017-10-19 22:00:00;34,87;35,08;-0,21;41680;0;0;0;0;54394;13567;0.2494;13163;404
2017-10-19 23:00:00;31,04;30,04;1,0;41680;0;0;0;0;54394;13424;0.2468;13279;145
2017-10-20 00:00:00;29,62;33,35;-3,73;41687;0;0;0;0;54414;13119;0.2411;13316;-197
2017-10-20 01:00:00;29,02;33,69;-4,67;41687;0;0;0;0;54414;12786;0.235;13172;-386
2017-10-20 02:00:00;29,06;33,25;-4,19;41687;0;0;0;0;54414;12641;0.2323;13077;-436
2017-10-20 03:00:00;29,88;30,12;-0,24;41687;0;0;0;0;54414;12635;0.2322;12831;-196
2017-10-20 04:00:00;30,0;31,43;-1,43;41687;0;0;0;0;54414;12232;0.2248;12661;-429
2017-10-20 05:00:00;31,01;34,02;-3,01;41687;0;0;0;0;54414;12214;0.2245;12795;-581
2017-10-20 06:00:00;39,91;43,34;-3,43;41687;0;0;0;0;54414;13360;0.2455;13224;136
2017-10-20 07:00:00;47,05;45,77;1,28;41687;10;0.0002;15;-5;54414;14076;0.2587;13713;363
2017-10-20 08:00:00;51,28;48,12;3,16;41687;1082;0.026;1262;-180;54414;15441;0.2838;14158;1283
2017-10-20 09:00:00;47,0;41,99;5,01;41687;3903;0.0936;4450;-547;54414;16044;0.2948;14345;1699
2017-10-20 10:00:00;43,14;36,44;6,7;41687;6872;0.1649;7575;-703;54414;15754;0.2895;14230;1524
2017-10-20 11:00:00;41,28;36,49;4,79;41687;9148;0.2194;9793;-645;54414;16049;0.2949;14218;1831
2017-10-20 12:00:00;37,59;33,4;4,19;41687;10688;0.2564;10855;-167;54414;16048;0.2949;14363;1685
2017-10-20 13:00:00;33,06;30,13;2,93;41687;10672;0.256;10612;60;54414;16073;0.2954;14719;1354
2017-10-20 14:00:00;32,89;31,35;1,54;41687;9186;0.2204;9325;-139;54414;16099;0.2958;14906;1193
2017-10-20 15:00:00;32,61;32,3;0,31;41687;6756;0.162;7170;-414;54414;15716;0.2888;14746;970
2017-10-20 16:00:00;33,04;30,21;2,83;41687;3643;0.0874;4207;-564;54414;15603;0.2868;14619;984
2017-10-20 17:00:00;44,61;36,91;7,7;41687;942;0.0226;1218;-276;54414;15239;0.28;14540;699
2017-10-20 18:00:00;47,86;40,75;7,11;41687;17;0.0004;49;-32;54414;16295;0.2994;14586;1709
2017-10-20 19:00:00;46,94;40,69;6,25;41687;0;0;0;0;54414;16946;0.3114;14765;2181
2017-10-20 20:00:00;38,98;33,8;5,18;41687;0;0;0;0;54414;16751;0.3078;14876;1875
2017-10-20 21:00:00;41,84;33,11;8,73;41687;0;0;0;0;54414;15974;0.2936;14585;1389
2017-10-20 22:00:00;35,86;33,19;2,67;41687;0;0;0;0;54414;14532;0.267;14035;497
2017-10-20 23:00:00;32,74;29,94;2,8;41687;0;0;0;0;54414;13030;0.2395;13342;-312
2017-10-21 00:00:00;35,0;31,65;3,35;41688;0;0;0;0;54417;11867;0.2181;11760;107
2017-10-21 01:00:00;32,52;32,08;0,44;41688;0;0;0;0;54417;10964;0.2015;10920;44
2017-10-21 02:00:00;32,05;30,32;1,73;41688;0;0;0;0;54417;10175;0.187;10349;-174
2017-10-21 03:00:00;30,84;30,08;0,76;41688;0;0;0;0;54417;9642;0.1772;9806;-164
2017-10-21 04:00:00;29,35;29,84;-0,49;41688;0;0;0;0;54417;9507;0.1747;9329;178
2017-10-21 05:00:00;30,3;30,66;-0,36;41688;0;0;0;0;54417;9213;0.1693;9004;209
2017-10-21 06:00:00;31,16;31,72;-0,56;41688;0;0;0;0;54417;9831;0.1807;9046;785
2017-10-21 07:00:00;35,88;33,04;2,84;41688;5;0.0001;6;-1;54417;9969;0.1832;9243;726
2017-10-21 08:00:00;41,91;38,54;3,37;41688;618;0.0148;609;9;54417;10040;0.1845;9254;786
2017-10-21 09:00:00;46,07;43,2;2,87;41688;2583;0.062;2637;-54;54417;10425;0.1916;9071;1354
2017-10-21 10:00:00;47,71;44,18;3,53;41688;5108;0.1225;4946;162;54417;10612;0.195;8914;1698
2017-10-21 11:00:00;45,98;44,43;1,55;41688;7286;0.1748;6894;392;54417;10869;0.1997;9112;1757
2017-10-21 12:00:00;35,0;35,88;-0,88;41688;8342;0.2001;7913;429;54417;11313;0.2079;9906;1407
2017-10-21 13:00:00;31,02;33,46;-2,44;41688;7470;0.1792;7479;-9;54417;11186;0.2056;10678;508
2017-10-21 14:00:00;32,09;40,41;-8,32;41688;5885;0.1412;6185;-300;54417;11212;0.206;11123;89
2017-10-21 15:00:00;32,0;39,17;-7,17;41688;4291;0.1029;4445;-154;54417;10894;0.2002;11128;-234
2017-10-21 16:00:00;32,09;41,88;-9,79;41688;2359;0.0566;2480;-121;54417;10530;0.1935;11222;-692
2017-10-21 17:00:00;36,56;46,72;-10,16;41688;661;0.0159;685;-24;54417;10225;0.1879;11500;-1275
2017-10-21 18:00:00;40,2;51,0;-10,8;41688;18;0.0004;28;-10;54417;11282;0.2073;12092;-810
2017-10-21 19:00:00;40,71;49,86;-9,15;41688;0;0;0;0;54417;12298;0.226;12940;-642
2017-10-21 20:00:00;31,75;40,61;-8,86;41688;0;0;0;0;54417;13794;0.2535;13700;94
2017-10-21 21:00:00;28,59;34,09;-5,5;41688;0;0;0;0;54417;15042;0.2764;14487;555
2017-10-21 22:00:00;27,5;30,43;-2,93;41688;0;0;0;0;54417;15608;0.2868;15346;262
2017-10-21 23:00:00;15,48;22,51;-7,03;41688;0;0;0;0;54417;16870;0.31;16243;627
2017-10-22 00:00:00;19,1;21,48;-2,38;41688;0;0;0;0;54417;17044;0.3132;16424;620
2017-10-22 01:00:00;19,03;17,81;1,22;41688;0;0;0;0;54417;17840;0.3278;17297;543
2017-10-22 02:00:00;16,9;18,0;-1,1;41688;0;0;0;0;54417;18715;0.3439;18344;371
2017-10-22 03:00:00;12,98;12,31;0,67;41688;0;0;0;0;54417;19602;0.3602;19184;418
2017-10-22 04:00:00;9,24;8,67;0,57;41688;0;0;0;0;54417;21120;0.3881;19991;1129
2017-10-22 05:00:00;5,23;3,48;1,75;41688;0;0;0;0;54417;21945;0.4033;20542;1403
2017-10-22 06:00:00;9,86;-1,75;11,61;41688;0;0;0;0;54417;22860;0.4201;20890;1970
2017-10-22 07:00:00;9,85;-2,78;12,63;41688;3;0.0001;5;-2;54417;22980;0.4223;21234;1746
2017-10-22 08:00:00;13,04;2,7;10,34;41688;702;0.0168;719;-17;54417;22439;0.4124;21382;1057
2017-10-22 09:00:00;12,9;10,4;2,5;41688;3148;0.0755;3085;63;54417;22028;0.4048;21284;744
2017-10-22 10:00:00;13,09;15,34;-2,25;41688;5581;0.1338;5607;-26;54417;22152;0.407;21334;818
2017-10-22 11:00:00;14,3;13,36;0,94;41688;7292;0.1749;7488;-196;54417;21883;0.4021;21384;499
2017-10-22 12:00:00;13,58;13,98;-0,4;41688;7841;0.1881;8293;-452;54417;20247;0.3721;20926;-679
2017-10-22 13:00:00;13,44;22,37;-8,93;41688;7500;0.1799;7968;-468;54417;18438;0.3388;20060;-1622
2017-10-22 14:00:00;13,5;28,43;-14,93;41688;6222;0.1492;6811;-589;54417;16863;0.3099;18847;-1984
2017-10-22 15:00:00;23,39;32,52;-9,13;41688;4442;0.1066;4959;-517;54417;15544;0.2856;17349;-1805
2017-10-22 16:00:00;28,65;35,66;-7,01;41688;2595;0.0622;2683;-88;54417;14810;0.2722;15867;-1057
2017-10-22 17:00:00;34,45;36,6;-2,15;41688;744;0.0178;672;72;54417;14203;0.261;14620;-417
2017-10-22 18:00:00;49,9;51,99;-2,09;41688;10;0.0002;22;-12;54417;14032;0.2579;14058;-26
2017-10-22 19:00:00;49,97;58,07;-8,1;41688;0;0;0;0;54417;14300;0.2628;13937;363
2017-10-22 20:00:00;44,92;50,78;-5,86;41688;0;0;0;0;54417;14386;0.2643;13886;500
2017-10-22 21:00:00;35,88;39,53;-3,65;41688;0;0;0;0;54417;14114;0.2594;13787;327
2017-10-22 22:00:00;32,24;33,44;-1,2;41688;0;0;0;0;54417;13315;0.2447;13735;-420
2017-10-22 23:00:00;29,05;31,35;-2,3;41688;0;0;0;0;54417;12977;0.2384;13579;-602
2017-10-23 00:00:00;28,61;31,19;-2,58;41693;0;0;0;0;54417;12804;0.2352;13221;-417
2017-10-23 01:00:00;27,86;26,34;1,52;41693;0;0;0;0;54417;13010;0.2391;13155;-145
2017-10-23 02:00:00;26,43;25,8;0,63;41693;0;0;0;0;54417;13660;0.251;13182;478
2017-10-23 03:00:00;23,07;22,01;1,06;41693;0;0;0;0;54417;13836;0.2542;13105;731
2017-10-23 04:00:00;22,22;17,32;4,9;41693;0;0;0;0;54417;13797;0.2536;13016;781
2017-10-23 05:00:00;30,33;26,92;3,41;41693;0;0;0;0;54417;13834;0.2543;12948;886
2017-10-23 06:00:00;42,36;39,53;2,83;41693;0;0;0;0;54417;14215;0.2612;13041;1174
2017-10-23 07:00:00;50,21;48,1;2,11;41693;2;0;4;-2;54417;14290;0.2626;13179;1111
2017-10-23 08:00:00;50,0;42,02;7,98;41693;376;0.009;361;15;54417;14293;0.2626;13130;1163
2017-10-23 09:00:00;45,39;37,96;7,43;41693;1804;0.0432;1625;179;54417;14170;0.2604;12884;1286
2017-10-23 10:00:00;46,02;38,57;7,45;41693;3588;0.086;3043;545;54417;13954;0.2564;12834;1120
2017-10-23 11:00:00;46,1;40,1;6,0;41693;4747;0.1138;4075;672;54417;14273;0.2623;12670;1603
2017-10-23 12:00:00;43,16;38,27;4,89;41693;5368;0.1288;4594;774;54417;13657;0.251;12288;1369
2017-10-23 13:00:00;46,34;40,87;5,47;41693;5091;0.1221;4620;471;54417;12721;0.2338;11904;817
2017-10-23 14:00:00;46,74;42,72;4,02;41693;4137;0.0992;4213;-76;54417;11987;0.2202;11200;787
2017-10-23 15:00:00;46,01;45,29;0,72;41693;3043;0.073;3320;-277;54417;10794;0.1984;9957;837
2017-10-23 16:00:00;46,08;46,55;-0,47;41693;1751;0.042;1878;-127;54417;9580;0.176;8671;909
2017-10-23 17:00:00;49,66;48,14;1,52;41693;431;0.0103;474;-43;54417;8254;0.1517;7543;711
2017-10-23 18:00:00;54,2;55,79;-1,59;41693;5;0.0001;14;-9;54417;7271;0.1336;6846;425
2017-10-23 19:00:00;53,91;59,03;-5,12;41693;0;0;0;0;54417;7098;0.1304;6466;632
2017-10-23 20:00:00;50,12;51,87;-1,75;41693;0;0;0;0;54417;7060;0.1297;6141;919
2017-10-23 21:00:00;45,48;44,94;0,54;41693;0;0;0;0;54417;6784;0.1247;5807;977
2017-10-23 22:00:00;37,7;36,05;1,65;41693;0;0;0;0;54417;6432;0.1182;5432;1000
2017-10-23 23:00:00;36,0;35,6;0,4;41693;0;0;0;0;54417;6154;0.1131;5109;1045
2017-10-24 00:00:00;31,68;33,8;-2,12;41697;0;0;0;0;54422;5608;0.103;5083;525
2017-10-24 01:00:00;32,41;31,58;0,83;41697;0;0;0;0;54422;5270;0.0968;5010;260
2017-10-24 02:00:00;32,09;32,91;-0,82;41697;0;0;0;0;54422;5159;0.0948;5230;-71
2017-10-24 03:00:00;31,67;32,39;-0,72;41697;0;0;0;0;54422;5319;0.0977;5510;-191
2017-10-24 04:00:00;32,07;33,98;-1,91;41697;0;0;0;0;54422;5699;0.1047;5791;-92
2017-10-24 05:00:00;34,3;35,21;-0,91;41697;0;0;0;0;54422;5904;0.1085;6038;-134
2017-10-24 06:00:00;43,56;49,13;-5,57;41697;0;0;0;0;54422;6400;0.1176;6233;167
2017-10-24 07:00:00;46,59;52,12;-5,53;41697;1;0;3;-2;54422;6938;0.1275;6466;472
2017-10-24 08:00:00;53,91;61,28;-7,37;41697;415;0.01;277;138;54422;8199;0.1507;6661;1538
2017-10-24 09:00:00;48,42;54,42;-6,0;41697;2146;0.0515;1204;942;54422;8843;0.1625;6850;1993
2017-10-24 10:00:00;49,08;49,95;-0,87;41697;4311;0.1034;2360;1951;54422;9394;0.1726;7188;2206
2017-10-24 11:00:00;45,39;43,97;1,42;41697;6090;0.1461;3340;2750;54422;9504;0.1746;7783;1721
2017-10-24 12:00:00;38,58;37,66;0,92;41697;6896;0.1654;3917;2979;54422;10460;0.1922;8627;1833
2017-10-24 13:00:00;38,23;36,25;1,98;41697;6995;0.1678;3835;3160;54422;11204;0.2058;9583;1621
2017-10-24 14:00:00;36,99;34,33;2,66;41697;6576;0.1577;3307;3269;54422;11351;0.2086;10219;1132
2017-10-24 15:00:00;36,99;35,33;1,66;41697;4994;0.1198;2385;2609;54422;11868;0.2181;10395;1473
2017-10-24 16:00:00;36,1;36,49;-0,39;41697;2498;0.0599;1227;1271;54422;13108;0.2409;10720;2388
2017-10-24 17:00:00;39,68;39,91;-0,23;41697;556;0.0134;307;249;54422;14404;0.2647;11458;2946
2017-10-24 18:00:00;44,9;42,82;2,08;41697;1;0;10;-9;54422;16199;0.2976;12722;3477
2017-10-24 19:00:00;39,56;36,79;2,77;41697;0;0;0;0;54422;18127;0.3331;14340;3787
2017-10-24 20:00:00;33,0;33,4;-0,4;41697;0;0;0;0;54422;18875;0.3468;15805;3070
2017-10-24 21:00:00;32,6;30,5;2,1;41697;0;0;0;0;54422;19298;0.3546;16967;2331
2017-10-24 22:00:00;30,18;30,49;-0,31;41697;0;0;0;0;54422;18701;0.3436;17955;746
2017-10-24 23:00:00;27,02;31,07;-4,05;41697;0;0;0;0;54422;18384;0.3378;18588;-204
2017-10-25 00:00:00;15,78;25,35;-9,57;41701;0;0;0;0;54426;18604;0.3418;18628;-24
2017-10-25 01:00:00;15,05;18,0;-2,95;41701;0;0;0;0;54426;18458;0.3392;18379;79
2017-10-25 02:00:00;12,79;15,58;-2,79;41701;0;0;0;0;54426;17980;0.3304;18200;-220
2017-10-25 03:00:00;13,99;16,35;-2,36;41701;0;0;0;0;54426;17683;0.3249;17859;-176
2017-10-25 04:00:00;17,03;22,15;-5,12;41701;0;0;0;0;54426;17640;0.3241;17599;41
2017-10-25 05:00:00;26,35;26,66;-0,31;41701;0;0;0;0;54426;18341;0.337;17826;515
2017-10-25 06:00:00;34,67;35,71;-1,04;41701;0;0;0;0;54426;18689;0.3434;18704;-15
2017-10-25 07:00:00;44,84;39,89;4,95;41701;0;0;1;-1;54426;19118;0.3513;19708;-590
2017-10-25 08:00:00;45,0;47,35;-2,35;41701;418;0.01;326;92;54426;20229;0.3717;20895;-666
2017-10-25 09:00:00;43,94;44,04;-0,1;41701;2284;0.0548;1710;574;54426;21254;0.3905;22099;-845
2017-10-25 10:00:00;37,11;36,5;0,61;41701;4899;0.1175;3736;1163;54426;22784;0.4186;23464;-680
2017-10-25 11:00:00;31,57;32,17;-0,6;41701;7210;0.1729;5822;1388;54426;24477;0.4498;24763;-286
2017-10-25 12:00:00;29,79;28,95;0,84;41701;8470;0.2031;7316;1154;54426;25550;0.4694;25506;44
2017-10-25 13:00:00;29,66;29,88;-0,22;41701;8728;0.2093;7682;1046;54426;25550;0.4694;26000;-450
2017-10-25 14:00:00;30,0;30,11;-0,11;41701;8676;0.208;7149;1527;54426;24590;0.4518;25509;-919
2017-10-25 15:00:00;31,05;32,72;-1,67;41701;6906;0.1656;5641;1265;54426;22736;0.4178;23709;-973
2017-10-25 16:00:00;34,03;33,55;0,48;41701;3906;0.0937;3192;714;54426;20072;0.3688;21395;-1323
2017-10-25 17:00:00;44,74;41,47;3,27;41701;861;0.0207;789;72;54426;17900;0.3288;18868;-968
2017-10-25 18:00:00;50,56;47,77;2,79;41701;3;0.0001;22;-19;54426;17060;0.3134;16982;78
2017-10-25 19:00:00;56,85;53,02;3,83;41701;0;0;0;0;54426;16702;0.3068;15599;1103
2017-10-25 20:00:00;46,19;42,97;3,22;41701;0;0;0;0;54426;16241;0.2984;14507;1734
2017-10-25 21:00:00;45,92;40,52;5,4;41701;0;0;0;0;54426;15533;0.2854;13635;1898
2017-10-25 22:00:00;40,58;38,43;2,15;41701;0;0;0;0;54426;14528;0.2669;12666;1862
2017-10-25 23:00:00;33,09;32,2;0,89;41701;0;0;0;0;54426;13879;0.255;11780;2099
2017-10-26 00:00:00;31,67;30,94;0,73;41713;0;0;0;0;54442;13338;0.245;11707;1631
2017-10-26 01:00:00;32,18;31,75;0,43;41713;0;0;0;0;54442;13085;0.2404;11127;1958
2017-10-26 02:00:00;32,21;31,66;0,55;41713;0;0;0;0;54442;13000;0.2388;10743;2257
2017-10-26 03:00:00;32,25;30,65;1,6;41713;0;0;0;0;54442;12442;0.2285;10383;2059
2017-10-26 04:00:00;32,25;31,46;0,79;41713;0;0;0;0;54442;11984;0.2201;10134;1850
2017-10-26 05:00:00;35,36;36,14;-0,78;41713;0;0;0;0;54442;11199;0.2057;10012;1187
2017-10-26 06:00:00;45,25;48,18;-2,93;41713;0;0;0;0;54442;10994;0.202;10056;938
2017-10-26 07:00:00;55,93;54,69;1,24;41713;1;0;3;-2;54442;11116;0.2042;10124;992
2017-10-26 08:00:00;56,93;49,06;7,87;41713;464;0.0111;539;-75;54442;11165;0.2051;10169;996
2017-10-26 09:00:00;51,9;44,04;7,86;41713;2554;0.0612;2839;-285;54442;11312;0.2078;10214;1098
2017-10-26 10:00:00;46,01;43,37;2,64;41713;5107;0.1224;5836;-729;54442;11211;0.2059;10520;691
2017-10-26 11:00:00;43,25;44,89;-1,64;41713;7620;0.1827;8416;-796;54442;12028;0.221;11281;747
2017-10-26 12:00:00;38,3;42,22;-3,92;41713;9305;0.223;10068;-763;54442;12902;0.237;12468;434
2017-10-26 13:00:00;32,38;38,82;-6,44;41713;9681;0.2321;10312;-631;54442;13846;0.2543;13594;252
2017-10-26 14:00:00;33,07;38,35;-5,28;41713;8990;0.2156;9221;-231;54442;14755;0.271;14118;637
2017-10-26 15:00:00;36,97;35,63;1,34;41713;6792;0.1628;6916;-124;54442;14610;0.2684;13797;813
2017-10-26 16:00:00;45,42;39,33;6,09;41713;3581;0.0858;3766;-185;54442;14153;0.26;13062;1091
2017-10-26 17:00:00;48,91;44,67;4,24;41713;738;0.0177;910;-172;54442;13865;0.2547;12577;1288
2017-10-26 18:00:00;50,03;46,36;3,67;41713;3;0;20;-17;54442;14250;0.2618;12613;1637
2017-10-26 19:00:00;50,93;45,97;4,96;41713;1;0;0;1;54442;14530;0.2669;13155;1375
2017-10-26 20:00:00;40,99;38,88;2,11;41713;1;0;0;1;54442;14957;0.2748;13849;1108
2017-10-26 21:00:00;34,97;37,26;-2,29;41713;1;0;0;1;54442;15936;0.2927;14405;1531
2017-10-26 22:00:00;32,34;35,29;-2,95;41713;0;0;0;0;54442;16064;0.295;14916;1148
2017-10-26 23:00:00;30,92;31,99;-1,07;41713;0;0;0;0;54442;16388;0.301;15444;944
2017-10-27 00:00:00;22,48;33,06;-10,58;41721;0;0;0;0;54455;17206;0.316;18157;-951
2017-10-27 01:00:00;21,71;30,77;-9,06;41721;0;0;0;0;54455;17797;0.3268;18963;-1166
2017-10-27 02:00:00;12,9;26,36;-13,46;41721;0;0;0;0;54455;18762;0.3446;19774;-1012
2017-10-27 03:00:00;12,81;23,94;-11,13;41721;0;0;0;0;54455;19623;0.3603;20525;-902
2017-10-27 04:00:00;19,04;23,31;-4,27;41721;0;0;0;0;54455;20473;0.376;21291;-818
2017-10-27 05:00:00;24,01;23,86;0,15;41721;0;0;0;0;54455;21535;0.3954;22019;-484
2017-10-27 06:00:00;32,0;38,87;-6,87;41721;0;0;0;0;54455;22884;0.4202;22861;23
2017-10-27 07:00:00;36,79;39,71;-2,92;41721;0;0;1;-1;54455;23464;0.4309;23671;-207
2017-10-27 08:00:00;38,91;41,1;-2,19;41721;308;0.0074;351;-43;54455;23500;0.4316;24178;-678
2017-10-27 09:00:00;38,69;42,81;-4,12;41721;2120;0.0508;2072;48;54455;23260;0.4272;24456;-1196
2017-10-27 10:00:00;38,36;40,89;-2,53;41721;4834;0.1159;4447;387;54455;24293;0.4461;24888;-595
2017-10-27 11:00:00;33,52;33,81;-0,29;41721;6943;0.1664;6801;142;54455;25686;0.4717;25559;127
2017-10-27 12:00:00;28,51;29,3;-0,79;41721;8451;0.2026;8590;-139;54455;27558;0.5061;26281;1277
2017-10-27 13:00:00;25,97;25,46;0,51;41721;9568;0.2294;9351;217;54455;27536;0.5057;26667;869
2017-10-27 14:00:00;27,09;17,68;9,41;41721;8822;0.2114;9057;-235;54455;26549;0.4875;26435;114
2017-10-27 15:00:00;26,99;21,36;5,63;41721;6746;0.1617;7302;-556;54455;25324;0.465;25273;51
2017-10-27 16:00:00;30,01;28,23;1,78;41721;3776;0.0905;4105;-329;54455;23396;0.4296;23668;-272
2017-10-27 17:00:00;37,8;36,1;1,7;41721;796;0.0191;969;-173;54455;21060;0.3867;21893;-833
2017-10-27 18:00:00;44,93;44,63;0,3;41721;4;0.0001;19;-15;54455;19544;0.3589;20149;-605
2017-10-27 19:00:00;46,93;45,21;1,72;41721;1;0;0;1;54455;17705;0.3252;18873;-1168
2017-10-27 20:00:00;44,18;41,99;2,19;41721;1;0;0;1;54455;17738;0.3257;18107;-369
2017-10-27 21:00:00;35,99;29,8;6,19;41721;1;0;0;1;54455;18252;0.3352;17839;413
2017-10-27 22:00:00;32,04;23,67;8,37;41721;0;0;0;0;54455;18407;0.338;18040;367
2017-10-27 23:00:00;19,17;14,93;4,24;41721;0;0;0;0;54455;19522;0.3585;18569;953
2017-10-28 00:00:00;16,04;11,49;4,55;41723;0;0;0;0;54458;20406;0.3747;21557;-1151
2017-10-28 01:00:00;9,41;14,93;-5,52;41723;0;0;0;0;54458;21714;0.3987;22759;-1045
2017-10-28 02:00:00;0,03;6,48;-6,45;41723;0;0;0;0;54458;23265;0.4272;24078;-813
2017-10-28 03:00:00;-9,69;4,33;-14,02;41723;0;0;0;0;54458;24701;0.4536;25275;-574
2017-10-28 04:00:00;-13,02;5,06;-18,08;41723;0;0;0;0;54458;25774;0.4733;26463;-689
2017-10-28 05:00:00;-15,01;4,5;-19,51;41723;0;0;0;0;54458;26810;0.4923;27593;-783
2017-10-28 06:00:00;-9,6;6,13;-15,73;41723;0;0;0;0;54458;29086;0.5341;28719;367
2017-10-28 07:00:00;0,12;9,62;-9,5;41723;0;0;1;-1;54458;30814;0.5658;29949;865
2017-10-28 08:00:00;0,12;7,39;-7,27;41723;316;0.0076;315;1;54458;31695;0.582;31286;409
2017-10-28 09:00:00;5,41;6,87;-1,46;41723;1614;0.0387;1778;-164;54458;32976;0.6056;32792;184
2017-10-28 10:00:00;0,27;3,64;-3,37;41723;3143;0.0754;3578;-435;54458;34766;0.6384;34450;316
2017-10-28 11:00:00;0,11;5,27;-5,16;41723;4268;0.1023;4896;-628;54458;36562;0.6714;35871;691
2017-10-28 12:00:00;-0,1;-5,65;5,55;41723;4782;0.1146;5503;-721;54458;38020;0.6982;36802;1218
2017-10-28 13:00:00;-13,38;-12,11;-1,27;41723;4608;0.1104;5265;-657;54458;38382;0.7048;37458;924
2017-10-28 14:00:00;-31,42;-33,24;1,82;41723;3894;0.0933;4353;-459;54458;38343;0.7041;37746;597
2017-10-28 15:00:00;-17,03;-24,97;7,94;41723;2679;0.0642;2990;-311;54458;38527;0.7074;37722;805
2017-10-28 16:00:00;-4,02;-12,79;8,77;41723;1291;0.031;1480;-189;54458;38356;0.7043;37497;859
2017-10-28 17:00:00;0,08;-9,51;9,59;41723;204;0.0049;332;-128;54458;38495;0.7068;37318;1177
2017-10-28 18:00:00;7,56;-5,95;13,51;41723;0;0;7;-7;54458;38854;0.7134;37380;1474
2017-10-28 19:00:00;8,89;-11,54;20,43;41723;0;0;0;0;54458;39231;0.7204;37610;1621
2017-10-28 20:00:00;0,23;-30,66;30,89;41723;0;0;0;0;54458;39149;0.7189;37922;1227
2017-10-28 21:00:00;-38,19;-46,03;7,84;41723;0;0;0;0;54458;38978;0.7157;38265;713
2017-10-28 22:00:00;-49,98;-57,7;7,72;41723;0;0;0;0;54458;37810;0.6943;38851;-1041
2017-10-28 23:00:00;-70,09;-76,33;6,24;41723;0;0;0;0;54458;36509;0.6704;39417;-2908
2017-10-29 00:00:00;-79,94;-80,87;0,93;41723;0;0;0;0;54461;32698;0.6004;40368;-7670
2017-10-29 01:00:00;-83,0;-86,78;3,78;41723;0;0;0;0;54461;30017;0.5512;40366;-10349
2017-10-29 02:00:00;-83,06;-90,45;7,39;41723;0;0;0;0;54461;27318;0.5016;40257;-12939
2017-10-29 03:00:00;-83,03;-85,36;2,33;41723;0;0;0;0;54461;26860;0.4932;40347;-13487
2017-10-29 04:00:00;-83,04;-78,63;-4,41;41723;0;0;0;0;54461;28501;0.5233;40136;-11635
2017-10-29 05:00:00;-83,02;-77,72;-5,3;41723;0;0;0;0;54461;30998;0.5692;40103;-9105
2017-10-29 06:00:00;-83,01;-73,31;-9,7;41723;0;0;0;0;54461;31718;0.5824;39986;-8268
2017-10-29 07:00:00;-80,0;-53,05;-26,95;41723;274;0.0066;284;-10;54461;33321;0.6118;39689;-6368
2017-10-29 08:00:00;-79,96;-41,49;-38,47;41723;1834;0.044;1800;34;54461;33737;0.6195;39280;-5543
2017-10-29 09:00:00;-76,02;-28,91;-47,11;41723;4047;0.097;3876;171;54461;35713;0.6558;38829;-3116
2017-10-29 10:00:00;-67,08;-18,6;-48,48;41723;6399;0.1533;6039;360;54461;36335;0.6672;38435;-2100
2017-10-29 11:00:00;-81,95;-16,26;-65,69;41723;8672;0.2078;7757;915;54461;35803;0.6574;37916;-2113
2017-10-29 12:00:00;-67,07;-42,78;-24,29;41723;9543;0.2288;8675;868;54461;35161;0.6456;37280;-2119
2017-10-29 13:00:00;-80,07;-43,81;-36,26;41723;9367;0.2245;8562;805;54461;32975;0.6055;36296;-3321
2017-10-29 14:00:00;-79,95;-40,02;-39,93;41723;7330;0.1757;6925;405;54461;32988;0.6057;34900;-1912
2017-10-29 15:00:00;-76,06;-10,42;-65,64;41723;4014;0.0962;3798;216;54461;31166;0.5722;33245;-2079
2017-10-29 16:00:00;-0,92;14,66;-15,58;41723;740;0.0177;779;-39;54461;28716;0.5272;31218;-2502
2017-10-29 17:00:00;8,51;27,16;-18,65;41723;2;0;12;-10;54461;28515;0.5236;29377;-862
2017-10-29 18:00:00;27,62;30,43;-2,81;41723;0;0;0;0;54461;28332;0.5202;28032;300
2017-10-29 19:00:00;29,77;20,98;8,79;41723;0;0;0;0;54461;27922;0.5127;27049;873
2017-10-29 20:00:00;22,06;8,96;13,1;41723;0;0;0;0;54461;27292;0.5011;26218;1074
2017-10-29 21:00:00;17,0;-0,95;17,95;41723;0;0;0;0;54461;26109;0.4794;25419;690
2017-10-29 22:00:00;12,44;6,49;5,95;41723;0;0;0;0;54461;24613;0.4519;24666;-53
2017-10-29 23:00:00;-70,05;0,44;-70,49;41723;0;0;0;0;54461;24093;0.4424;24037;56
2017-10-30 00:00:00;0,75;11,11;-10,36;41743;0;0;0;0;54461;24026;0.4412;24845;-819
2017-10-30 01:00:00;0,01;6,9;-6,89;41743;0;0;0;0;54461;23789;0.4368;24484;-695
2017-10-30 02:00:00;0,08;3,25;-3,17;41743;0;0;0;0;54461;23147;0.425;24090;-943
2017-10-30 03:00:00;4,05;3,99;0,06;41743;0;0;0;0;54461;22467;0.4126;23515;-1048
2017-10-30 04:00:00;2,95;8,58;-5,63;41743;0;0;0;0;54461;21738;0.3992;22808;-1070
2017-10-30 05:00:00;18,09;21,09;-3,0;41743;0;0;0;0;54461;21719;0.3988;22052;-333
2017-10-30 06:00:00;28,42;30,86;-2,44;41743;0;0;1;-1;54461;21350;0.392;21350;0
2017-10-30 07:00:00;36,43;34,73;1,7;41743;700;0.0168;812;-112;54461;19810;0.3637;20290;-480
2017-10-30 08:00:00;33,48;29,73;3,75;41743;3912;0.0937;4494;-582;54461;17974;0.33;18979;-1005
2017-10-30 09:00:00;30,38;33,4;-3,02;41743;7947;0.1904;8694;-747;54461;16048;0.2947;17985;-1937
2017-10-30 10:00:00;29,74;32,55;-2,81;41743;11360;0.2722;11668;-308;54461;15380;0.2824;17756;-2376
2017-10-30 11:00:00;29,46;28,96;0,5;41743;12753;0.3055;12882;-129;54461;16097;0.2956;18139;-2042
2017-10-30 12:00:00;29,7;24,1;5,6;41743;12130;0.2906;12384;-254;54461;17890;0.3285;18502;-612
2017-10-30 13:00:00;29,98;22,05;7,93;41743;9929;0.2378;10629;-700;54461;18729;0.3439;18334;395
2017-10-30 14:00:00;36,36;25,1;11,26;41743;7046;0.1688;7765;-719;54461;18171;0.3337;17391;780
2017-10-30 15:00:00;43,99;32,96;11,03;41743;3523;0.0844;4072;-549;54461;16996;0.3121;16047;949
2017-10-30 16:00:00;46,34;37,81;8,53;41743;580;0.0139;752;-172;54461;15448;0.2837;14766;682
2017-10-30 17:00:00;61,0;52,48;8,52;41743;1;0;8;-7;54461;13764;0.2527;14043;-279
2017-10-30 18:00:00;70,09;56,57;13,52;41743;0;0;0;0;54461;13337;0.2449;13555;-218
2017-10-30 19:00:00;51,98;43,71;8,27;41743;0;0;0;0;54461;13126;0.241;13044;82
2017-10-30 20:00:00;48,13;39,96;8,17;41743;0;0;0;0;54461;12871;0.2363;12461;410
2017-10-30 21:00:00;47,18;36,11;11,07;41743;0;0;0;0;54461;12427;0.2282;11761;666
2017-10-30 22:00:00;46,05;33,9;12,15;41743;0;0;0;0;54461;11864;0.2178;11153;711
2017-10-30 23:00:00;41,97;25,45;16,52;41743;0;0;0;0;54461;11946;0.2194;10652;1294
2017-10-31 00:00:00;30,08;24,68;5,4;41744;0;0;0;0;54465;10964;0.2013;9555;1409
2017-10-31 01:00:00;30,89;24,69;6,2;41744;0;0;0;0;54465;10605;0.1947;9371;1234
2017-10-31 02:00:00;30,01;23,21;6,8;41744;0;0;0;0;54465;9916;0.182;9116;800
2017-10-31 03:00:00;29,09;25,28;3,81;41744;0;0;0;0;54465;9577;0.1758;8776;801
2017-10-31 04:00:00;30,29;29,28;1,01;41744;0;0;0;0;54465;9449;0.1735;8444;1005
2017-10-31 05:00:00;32,24;35,27;-3,03;41744;0;0;0;0;54465;9070;0.1666;8279;791
2017-10-31 06:00:00;38,94;40,28;-1,34;41744;0;0;0;0;54465;8954;0.1644;8295;659
2017-10-31 07:00:00;37,9;40,24;-2,34;41744;541;0.013;512;29;54465;8549;0.157;8331;218
2017-10-31 08:00:00;41,09;37,53;3,56;41744;3426;0.0821;2872;554;54465;8501;0.1561;8366;135
2017-10-31 09:00:00;39,92;33,85;6,07;41744;6701;0.1605;5567;1134;54465;8233;0.1512;8676;-443
2017-10-31 10:00:00;37,98;30,15;7,83;41744;9126;0.2186;7540;1586;54465;8513;0.1563;9340;-827
2017-10-31 11:00:00;39,97;31,84;8,13;41744;10191;0.2441;8352;1839;54465;9365;0.172;10253;-888
2017-10-31 12:00:00;36,95;30,45;6,5;41744;9642;0.231;7915;1727;54465;10078;0.185;11237;-1159
2017-10-31 13:00:00;34,14;28,75;5,39;41744;7994;0.1915;6612;1382;54465;10427;0.1914;11856;-1429
2017-10-31 14:00:00;35,65;31,59;4,06;41744;5673;0.1359;4690;983;54465;10178;0.1869;11935;-1757
2017-10-31 15:00:00;38,99;40,27;-1,28;41744;2939;0.0704;2412;527;54465;10256;0.1883;11869;-1613
2017-10-31 16:00:00;42,45;46,07;-3,62;41744;534;0.0128;503;31;54465;10312;0.1893;11885;-1573
2017-10-31 17:00:00;46,92;51,87;-4,95;41744;0;0;6;-6;54465;10622;0.195;12131;-1509
2017-10-31 18:00:00;47,36;53,62;-6,26;41744;0;0;0;0;54465;11352;0.2084;12607;-1255
2017-10-31 19:00:00;44,31;51,55;-7,24;41744;0;0;0;0;54465;12124;0.2226;13119;-995
2017-10-31 20:00:00;39,0;42,85;-3,85;41744;0;0;0;0;54465;12564;0.2306;13640;-1076
2017-10-31 21:00:00;37,1;40,0;-2,9;41744;0;0;0;0;54465;13445;0.2468;14073;-628
2017-10-31 22:00:00;34,98;40,1;-5,12;41744;0;0;0;0;54465;14422;0.2648;14458;-36
2017-10-31 23:00:00;30,82;32,7;-1,88;41744;0;0;0;0;54465;15024;0.2758;14734;290
2017-01-11 00:00:00;26,91;30,96;-4,05;41746;0;0;0;0;54465;15424;0.2832;15570;-146
2017-01-11 01:00:00;23,06;30,78;-7,72;41746;0;0;0;0;54465;15605;0.2865;15900;-295
2017-01-11 02:00:00;22,27;29,31;-7,04;41746;0;0;0;0;54465;16219;0.2978;16259;-40
2017-01-11 03:00:00;22,97;28,2;-5,23;41746;0;0;0;0;54465;16578;0.3044;16459;119
2017-01-11 04:00:00;26,66;29,24;-2,58;41746;0;0;0;0;54465;16914;0.3106;16547;367
2017-01-11 05:00:00;27,03;29,95;-2,92;41746;0;0;0;0;54465;16884;0.31;16617;267
2017-01-11 06:00:00;29,07;32,53;-3,46;41746;0;0;0;0;54465;16948;0.3112;16674;274
2017-01-11 07:00:00;31,0;33,36;-2,36;41746;145;0.0035;204;-59;54465;17077;0.3135;16619;458
2017-01-11 08:00:00;36,06;40,8;-4,74;41746;1146;0.0274;1423;-277;54465;17099;0.314;16586;513
2017-01-11 09:00:00;35,16;43,19;-8,03;41746;2762;0.0662;3376;-614;54465;17250;0.3167;16715;535
2017-01-11 10:00:00;32,37;42,1;-9,73;41746;4495;0.1077;5452;-957;54465;16856;0.3095;16894;-38
2017-01-11 11:00:00;33,08;42,97;-9,89;41746;5885;0.141;6868;-983;54465;16714;0.3069;17090;-376
2017-01-11 12:00:00;29,79;39,56;-9,77;41746;6864;0.1644;7451;-587;54465;16972;0.3116;17180;-208
2017-01-11 13:00:00;29,06;36,17;-7,11;41746;6894;0.1652;7200;-306;54465;16751;0.3076;17083;-332
2017-01-11 14:00:00;29,18;34,95;-5,77;41746;5477;0.1312;5813;-336;54465;16312;0.2995;16819;-507
2017-01-11 15:00:00;30,01;38,44;-8,43;41746;2874;0.0688;3204;-330;54465;16416;0.3014;16505;-89
2017-01-11 16:00:00;36,93;43,64;-6,71;41746;504;0.0121;677;-173;54465;17250;0.3167;16470;780
2017-01-11 17:00:00;42,49;46,0;-3,51;41746;0;0;9;-9;54465;17837;0.3275;16884;953
2017-01-11 18:00:00;43,93;45,19;-1,26;41746;0;0;0;0;54465;18445;0.3386;17544;901
2017-01-11 19:00:00;41,97;41,69;0,28;41746;0;0;0;0;54465;18974;0.3484;18166;808
2017-01-11 20:00:00;36,52;31,96;4,56;41746;0;0;0;0;54465;19292;0.3542;18802;490
2017-01-11 21:00:00;30,07;32,33;-2,26;41746;0;0;0;0;54465;19741;0.3625;19389;352
2017-01-11 22:00:00;27,02;33,39;-6,37;41746;0;0;0;0;54465;19576;0.3594;19922;-346
2017-01-11 23:00:00;18,97;26,22;-7,25;41746;0;0;0;0;54465;19314;0.3546;20405;-1091
2017-02-11 00:00:00;20,18;25,24;-5,06;41749;0;0;0;0;54474;19422;0.3566;20820;-1398
2017-02-11 01:00:00;12,62;27,0;-14,38;41749;0;0;0;0;54474;19610;0.36;21250;-1640
2017-02-11 02:00:00;12,61;25,04;-12,43;41749;0;0;0;0;54474;19924;0.3657;21530;-1606
2017-02-11 03:00:00;10,96;18,6;-7,64;41749;0;0;0;0;54474;20426;0.375;21616;-1190
2017-02-11 04:00:00;14,04;19,96;-5,92;41749;0;0;0;0;54474;20299;0.3726;21475;-1176
2017-02-11 05:00:00;25,97;31,13;-5,16;41749;0;0;0;0;54474;19353;0.3553;21173;-1820
2017-02-11 06:00:00;35,05;42,31;-7,26;41749;0;0;0;0;54474;19145;0.3514;20790;-1645
2017-02-11 07:00:00;45,9;48,52;-2,62;41749;258;0.0062;417;-159;54474;17801;0.3268;20228;-2427
2017-02-11 08:00:00;43,83;46,84;-3,01;41749;2416;0.0579;3028;-612;54474;16827;0.3089;19442;-2615
2017-02-11 09:00:00;35,59;44,99;-9,4;41749;5807;0.1391;6617;-810;54474;15298;0.2808;18754;-3456
2017-02-11 10:00:00;32,33;42,71;-10,38;41749;8823;0.2114;9605;-782;54474;14515;0.2664;18675;-4160
2017-02-11 11:00:00;32,36;40,78;-8,42;41749;10444;0.2502;11235;-791;54474;14874;0.273;19137;-4263
2017-02-11 12:00:00;31,32;39,83;-8,51;41749;9938;0.238;10969;-1031;54474;14966;0.2748;19536;-4570
2017-02-11 13:00:00;32,49;43,24;-10,75;41749;7491;0.1794;9263;-1772;54474;15008;0.2755;19445;-4437
2017-02-11 14:00:00;33,94;45,52;-11,58;41749;4438;0.1063;6542;-2104;54474;14343;0.2633;18556;-4213
2017-02-11 15:00:00;39,1;51,88;-12,78;41749;1704;0.0408;3215;-1511;54474;13084;0.2402;17215;-4131
2017-02-11 16:00:00;45,95;57,5;-11,55;41749;185;0.0044;564;-379;54474;11972;0.2198;15833;-3861
2017-02-11 17:00:00;51,91;63,32;-11,41;41749;0;0;7;-7;54474;11330;0.208;14766;-3436
2017-02-11 18:00:00;51,92;62,46;-10,54;41749;0;0;0;0;54474;10882;0.1998;14058;-3176
2017-02-11 19:00:00;50,07;86,17;-36,1;41749;0;0;0;0;54474;10125;0.1859;13357;-3232
2017-02-11 20:00:00;46,01;52,36;-6,35;41749;0;0;0;0;54474;9234;0.1695;12311;-3077
2017-02-11 21:00:00;42,06;45,46;-3,4;41749;0;0;0;0;54474;8354;0.1534;11116;-2762
2017-02-11 22:00:00;36,12;37,32;-1,2;41749;0;0;0;0;54474;7435;0.1365;9925;-2490
2017-02-11 23:00:00;35,45;35,61;-0,16;41749;0;0;0;0;54474;6472;0.1188;8920;-2448
2017-03-11 00:00:00;36,07;36,49;-0,42;41751;0;0;0;0;54488;5468;0.1004;6103;-635
2017-03-11 01:00:00;36,09;37,16;-1,07;41751;0;0;0;0;54488;4624;0.0848;5457;-833
2017-03-11 02:00:00;36,13;37,9;-1,77;41751;0;0;0;0;54488;3866;0.0709;4827;-961
2017-03-11 03:00:00;36,09;37,98;-1,89;41751;0;0;0;0;54488;3164;0.058;4227;-1063
2017-03-11 04:00:00;38,24;43,25;-5,01;41751;0;0;0;0;54488;2693;0.0494;3746;-1053
2017-03-11 05:00:00;40,66;41,69;-1,03;41751;0;0;0;0;54488;2411;0.0442;3343;-932
2017-03-11 06:00:00;52,97;53,17;-0,2;41751;0;0;0;0;54488;2351;0.0431;3012;-661
2017-03-11 07:00:00;61,74;54,72;7,02;41751;171;0.0041;233;-62;54488;2166;0.0397;2663;-497
2017-03-11 08:00:00;65,8;57,76;8,04;41751;1610;0.0386;1834;-224;54488;1954;0.0358;2304;-350
2017-03-11 09:00:00;62,18;58,85;3,33;41751;4208;0.1008;4456;-248;54488;1882;0.0346;2048;-166
2017-03-11 10:00:00;58,69;53,1;5,59;41751;7293;0.1747;6860;433;54488;1930;0.0354;2031;-101
2017-03-11 11:00:00;58,67;51,81;6,86;41751;9189;0.2201;8319;870;54488;2069;0.038;2311;-242
2017-03-11 12:00:00;54,55;47,91;6,64;41751;9568;0.2292;8580;988;54488;2707;0.0497;2685;22
2017-03-11 13:00:00;51,5;46,76;4,74;41751;8702;0.2084;7784;918;54488;3010;0.0552;2865;145
2017-03-11 14:00:00;51,17;48,33;2,84;41751;6313;0.1512;5937;376;54488;3349;0.0614;2853;496
2017-03-11 15:00:00;56,64;53,34;3,3;41751;3220;0.0771;3009;211;54488;3712;0.0681;3013;699
2017-03-11 16:00:00;60,88;57,32;3,56;41751;487;0.0116;502;-15;54488;4462;0.0819;3402;1060
2017-03-11 17:00:00;66,0;61,94;4,06;41751;0;0;3;-3;54488;5413;0.0993;4176;1237
2017-03-11 18:00:00;68,68;58,21;10,47;41751;0;0;0;0;54488;6486;0.119;5207;1279
2017-03-11 19:00:00;58,63;52,67;5,96;41751;0;0;0;0;54488;7930;0.1455;6143;1787
2017-03-11 20:00:00;49,01;45,67;3,34;41751;0;0;0;0;54488;9042;0.166;6894;2148
2017-03-11 21:00:00;39,01;39,76;-0,75;41751;0;0;0;0;54488;9551;0.1753;7521;2030
2017-03-11 22:00:00;36,11;39,59;-3,48;41751;0;0;0;0;54488;10242;0.188;7901;2341
2017-03-11 23:00:00;34,97;38,44;-3,47;41751;0;0;0;0;54488;10410;0.191;8024;2386
2017-04-11 00:00:00;36,16;36,05;0,11;41752;0;0;0;0;54491;10503;0.1927;9199;1304
2017-04-11 01:00:00;35,06;35,03;0,03;41752;0;0;0;0;54491;10446;0.1917;8920;1526
2017-04-11 02:00:00;34,42;33,08;1,34;41752;0;0;0;0;54491;10003;0.1836;8499;1504
2017-04-11 03:00:00;33,61;31,55;2,06;41752;0;0;0;0;54491;9326;0.1712;8076;1250
2017-04-11 04:00:00;33,4;33,17;0,23;41752;0;0;0;0;54491;8840;0.1622;7855;985
2017-04-11 05:00:00;33,22;32,39;0,83;41752;0;0;0;0;54491;8548;0.1568;7941;607
2017-04-11 06:00:00;33,73;32,3;1,43;41752;0;0;0;0;54491;8679;0.1593;8141;538
2017-04-11 07:00:00;37,63;32,81;4,82;41752;301;0.0072;300;1;54491;9175;0.1684;8155;1020
2017-04-11 08:00:00;42,99;33,1;9,89;41752;2670;0.0639;2463;207;54491;9273;0.1702;7979;1294
2017-04-11 09:00:00;40,39;35,13;5,26;41752;5741;0.1375;5811;-70;54491;8606;0.158;7694;912
2017-04-11 10:00:00;39,84;35,9;3,94;41752;8620;0.2065;8787;-167;54491;7429;0.1363;7552;-123
2017-04-11 11:00:00;37,02;36,51;0,51;41752;10246;0.2454;10547;-301;54491;6830;0.1253;7783;-953
2017-04-11 12:00:00;36,1;34,18;1,92;41752;10452;0.2503;10764;-312;54491;6855;0.1258;8403;-1548
2017-04-11 13:00:00;34,33;33,0;1,33;41752;9334;0.2236;9516;-182;54491;7692;0.1412;9468;-1776
2017-04-11 14:00:00;34,34;32,43;1,91;41752;6615;0.1584;6892;-277;54491;8901;0.1633;11094;-2193
2017-04-11 15:00:00;35,04;35,12;-0,08;41752;3014;0.0722;3403;-389;54491;11338;0.2081;13310;-1972
2017-04-11 16:00:00;37,03;36,3;0,73;41752;365;0.0087;553;-188;54491;14598;0.2679;15920;-1322
2017-04-11 17:00:00;43,94;42,76;1,18;41752;0;0;4;-4;54491;18253;0.335;18566;-313
2017-04-11 18:00:00;35,51;35,47;0,04;41752;0;0;0;0;54491;20702;0.3799;20938;-236
2017-04-11 19:00:00;32,25;32,96;-0,71;41752;0;0;0;0;54491;22251;0.4084;22431;-180
2017-04-11 20:00:00;28,83;28,39;0,44;41752;0;0;0;0;54491;21874;0.4014;22773;-899
2017-04-11 21:00:00;26,77;24,69;2,08;41752;0;0;0;0;54491;20889;0.3834;22638;-1749
2017-04-11 22:00:00;26,53;25,54;0,99;41752;0;0;0;0;54491;20618;0.3784;21828;-1210
2017-04-11 23:00:00;20,65;21,91;-1,26;41752;0;0;0;0;54491;20073;0.3684;20235;-162
2017-05-11 00:00:00;13,2;17,9;-4,7;41752;0;0;0;0;54496;18182;0.3336;19994;-1812
2017-05-11 01:00:00;13,2;19,37;-6,17;41752;0;0;0;0;54496;16487;0.3025;18710;-2223
2017-05-11 02:00:00;14,64;20,84;-6,2;41752;0;0;0;0;54496;13660;0.2506;16755;-3095
2017-05-11 03:00:00;11,68;22,78;-11,1;41752;0;0;0;0;54496;11968;0.2196;14618;-2650
2017-05-11 04:00:00;13,93;19,48;-5,55;41752;0;0;0;0;54496;11548;0.2119;12809;-1261
2017-05-11 05:00:00;20,01;19,2;0,81;41752;0;0;0;0;54496;11102;0.2037;11578;-476
2017-05-11 06:00:00;21,87;14,16;7,71;41752;0;0;0;0;54496;10972;0.2013;10619;353
2017-05-11 07:00:00;24,6;15,27;9,33;41752;264;0.0063;244;20;54496;10254;0.1881;9727;527
2017-05-11 08:00:00;31,47;23,83;7,64;41752;1864;0.0446;1492;372;54496;9962;0.1828;8814;1148
2017-05-11 09:00:00;33,92;25,19;8,73;41752;3550;0.085;3097;453;54496;9104;0.167;8133;971
2017-05-11 10:00:00;36,54;30,04;6,5;41752;4413;0.1057;4315;98;54496;8666;0.159;7783;883
2017-05-11 11:00:00;38,9;33,73;5,17;41752;4782;0.1145;4792;-10;54496;8363;0.1535;7922;441
2017-05-11 12:00:00;36,11;35,48;0,63;41752;4059;0.0972;4492;-433;54496;9061;0.1663;8480;581
2017-05-11 13:00:00;36,2;33,99;2,21;41752;3244;0.0777;3602;-358;54496;9074;0.1665;8906;168
2017-05-11 14:00:00;33,78;33,55;0,23;41752;2030;0.0486;2315;-285;54496;9382;0.1722;8945;437
2017-05-11 15:00:00;33,96;34,0;-0,04;41752;906;0.0217;1023;-117;54496;9788;0.1796;9028;760
2017-05-11 16:00:00;35,0;35,39;-0,39;41752;149;0.0036;170;-21;54496;10108;0.1855;9000;1108
2017-05-11 17:00:00;41,82;41,52;0,3;41752;0;0;1;-1;54496;10702;0.1964;9117;1585
2017-05-11 18:00:00;41,74;34,62;7,12;41752;0;0;0;0;54496;11267;0.2068;9409;1858
2017-05-11 19:00:00;42,82;32,66;10,16;41752;0;0;0;0;54496;11909;0.2186;9814;2095
2017-05-11 20:00:00;40,91;32,41;8,5;41752;0;0;0;0;54496;11765;0.2158;9880;1885
2017-05-11 21:00:00;39,59;31,91;7,68;41752;0;0;0;0;54496;11725;0.2151;9751;1974
2017-05-11 22:00:00;38,87;33,99;4,88;41752;0;0;0;0;54496;11128;0.2042;9600;1528
2017-05-11 23:00:00;35,0;30,67;4,33;41752;0;0;0;0;54496;10978;0.2015;9336;1642
2017-06-11 00:00:00;31,74;27,6;4,14;41754;0;0;0;0;54508;10398;0.1908;8647;1751
2017-06-11 01:00:00;33,73;26,26;7,47;41754;0;0;0;0;54508;9944;0.1824;8529;1415
2017-06-11 02:00:00;33,02;23,76;9,26;41754;0;0;0;0;54508;9644;0.177;8347;1297
2017-06-11 03:00:00;27,61;23,63;3,98;41754;0;0;0;0;54508;8733;0.1602;8194;539
2017-06-11 04:00:00;28,1;26,71;1,39;41754;0;0;0;0;54508;7783;0.1428;7917;-134
2017-06-11 05:00:00;32,99;37,01;-4,02;41754;0;0;0;0;54508;7103;0.1303;7490;-387
2017-06-11 06:00:00;44,83;48,24;-3,41;41754;0;0;0;0;54508;6679;0.1226;7020;-341
2017-06-11 07:00:00;54,96;62,59;-7,63;41754;138;0.0033;140;-2;54508;5718;0.1049;6280;-562
2017-06-11 08:00:00;60,38;68,33;-7,95;41754;1638;0.0392;1694;-56;54508;4926;0.0904;5301;-375
2017-06-11 09:00:00;55,38;61,85;-6,47;41754;4093;0.098;4219;-126;54508;3558;0.0652;4362;-804
2017-06-11 10:00:00;54,95;60,96;-6,01;41754;6458;0.1546;6377;81;54508;2456;0.045;3650;-1194
2017-06-11 11:00:00;54,97;61,42;-6,45;41754;7666;0.1836;7660;6;54508;1832;0.0336;3189;-1357
2017-06-11 12:00:00;54,93;58,73;-3,8;41754;7569;0.1813;7834;-265;54508;1709;0.0313;2915;-1206
2017-06-11 13:00:00;55,91;58,72;-2,81;41754;6324;0.1514;6972;-648;54508;1722;0.0316;2684;-962
2017-06-11 14:00:00;55,93;60,49;-4,56;41754;4291;0.1028;5112;-821;54508;1654;0.0304;2363;-709
2017-06-11 15:00:00;57,85;63,1;-5,25;41754;1909;0.0457;2486;-577;54508;1539;0.0282;2115;-576
2017-06-11 16:00:00;62,56;69,23;-6,67;41754;212;0.0051;370;-158;54508;1582;0.029;1958;-376
2017-06-11 17:00:00;78,28;96,4;-18,12;41754;0;0;2;-2;54508;1758;0.0322;1964;-206
2017-06-11 18:00:00;89,93;102,73;-12,8;41754;0;0;0;0;54508;1870;0.0343;2058;-188
2017-06-11 19:00:00;74,51;76,5;-1,99;41754;0;0;0;0;54508;2069;0.038;2183;-114
2017-06-11 20:00:00;55,02;52,19;2,83;41754;0;0;0;0;54508;2274;0.0418;2348;-74
2017-06-11 21:00:00;50,61;47,81;2,8;41754;0;0;0;0;54508;2477;0.0454;2542;-65
2017-06-11 22:00:00;39,11;39,8;-0,69;41754;0;0;0;0;54508;3006;0.0552;2761;245
2017-06-11 23:00:00;37,1;38,09;-0,99;41754;0;0;0;0;54508;3920;0.072;2972;948
2017-07-11 00:00:00;36,63;30,21;6,42;41757;0;0;0;0;54522;4464;0.0819;3402;1062
2017-07-11 01:00:00;35,05;30,29;4,76;41757;0;0;0;0;54522;4722;0.0866;3833;889
2017-07-11 02:00:00;36,87;32,17;4,7;41757;0;0;0;0;54522;5024;0.0921;4096;928
2017-07-11 03:00:00;36,02;30,74;5,28;41757;0;0;0;0;54522;5464;0.1002;4377;1087
2017-07-11 04:00:00;37,04;32,12;4,92;41757;0;0;0;0;54522;5863;0.1075;4709;1154
2017-07-11 05:00:00;34,43;30,03;4,4;41757;0;0;0;0;54522;5829;0.1069;5025;804
2017-07-11 06:00:00;49,77;43,36;6,41;41757;0;0;0;0;54522;5736;0.1052;5365;371
2017-07-11 07:00:00;59,26;53,24;6,02;41757;88;0.0021;122;-34;54522;6258;0.1148;5530;728
2017-07-11 08:00:00;64,37;56,49;7,88;41757;1092;0.0262;1360;-268;54522;6385;0.1171;5364;1021
2017-07-11 09:00:00;55,07;50,9;4,17;41757;2838;0.068;3550;-712;54522;6398;0.1173;5131;1267
2017-07-11 10:00:00;54,94;53,09;1,85;41757;4472;0.107;5484;-1012;54522;5762;0.1057;5016;746
2017-07-11 11:00:00;54,92;55,25;-0,33;41757;5391;0.1291;6551;-1160;54522;5386;0.0988;5128;258
2017-07-11 12:00:00;53,93;54,19;-0,26;41757;5346;0.128;6470;-1124;54522;4982;0.0914;5301;-319
2017-07-11 13:00:00;54,94;56,82;-1,88;41757;4380;0.1049;5512;-1132;54522;4818;0.0884;5399;-581
2017-07-11 14:00:00;56,93;60,38;-3,45;41757;2635;0.0631;3830;-1195;54522;5353;0.0982;5470;-117
2017-07-11 15:00:00;66,75;68,1;-1,35;41757;986;0.0236;1681;-695;54522;5821;0.1068;5716;105
2017-07-11 16:00:00;65,58;73,93;-8,35;41757;74;0.0018;219;-145;54522;6374;0.1169;6280;94
2017-07-11 17:00:00;81,56;86,43;-4,87;41757;0;0;1;-1;54522;7525;0.138;7120;405
2017-07-11 18:00:00;82,3;85,64;-3,34;41757;0;0;0;0;54522;8246;0.1512;7875;371
2017-07-11 19:00:00;64,2;59,03;5,17;41757;0;0;0;0;54522;8148;0.1494;8200;-52
2017-07-11 20:00:00;53,94;48,87;5,07;41757;0;0;0;0;54522;7687;0.141;7939;-252
2017-07-11 21:00:00;46,94;45,61;1,33;41757;0;0;0;0;54522;7433;0.1363;7394;39
2017-07-11 22:00:00;41,7;37,83;3,87;41757;0;0;0;0;54522;7090;0.13;6670;420
2017-07-11 23:00:00;37,86;33,93;3,93;41757;0;0;0;0;54522;6555;0.1202;5917;638
2017-08-11 00:00:00;33,7;32,76;0,94;41761;0;0;0;0;54544;5926;0.1087;4671;1255
2017-08-11 01:00:00;33,62;31,85;1,77;41761;0;0;0;0;54544;5218;0.0957;4268;950
2017-08-11 02:00:00;33,64;33,48;0,16;41761;0;0;0;0;54544;4750;0.0871;3924;826
2017-08-11 03:00:00;33,62;33,42;0,2;41761;0;0;0;0;54544;4558;0.0836;3637;921
2017-08-11 04:00:00;35,53;33,6;1,93;41761;0;0;0;0;54544;4278;0.0784;3412;866
2017-08-11 05:00:00;36,15;36,1;0,05;41761;0;0;0;0;54544;4168;0.0764;3300;868
2017-08-11 06:00:00;54,07;51,38;2,69;41761;0;0;0;0;54544;4047;0.0742;3295;752
2017-08-11 07:00:00;75,76;82,59;-6,83;41761;106;0.0025;113;-7;54544;4226;0.0774;3193;1033
2017-08-11 08:00:00;79,28;79,03;0,25;41761;1025;0.0246;931;94;54544;4014;0.0736;2911;1103
2017-08-11 09:00:00;77,07;75,58;1,49;41761;2350;0.0563;2217;133;54544;3395;0.0622;2527;868
2017-08-11 10:00:00;84,22;75,27;8,95;41761;3363;0.0805;3328;35;54544;2754;0.0505;2208;546
2017-08-11 11:00:00;84,98;77,89;7,09;41761;3668;0.0878;3818;-150;54544;2262;0.0415;2034;228
2017-08-11 12:00:00;83,8;76,37;7,43;41761;3254;0.0779;3607;-353;54544;1924;0.0353;1891;33
2017-08-11 13:00:00;88,19;81,3;6,89;41761;2462;0.059;2867;-405;54544;1705;0.0312;1734;-29
2017-08-11 14:00:00;89,9;85,07;4,83;41761;1523;0.0365;1814;-291;54544;1625;0.0298;1544;81
2017-08-11 15:00:00;81,89;87,22;-5,33;41761;543;0.013;729;-186;54544;1736;0.0318;1517;219
2017-08-11 16:00:00;88,2;95,4;-7,2;41761;38;0.0009;96;-58;54544;1738;0.0319;1594;144
2017-08-11 17:00:00;111,4;122,89;-11,49;41761;0;0;0;0;54544;1864;0.0342;1715;149
2017-08-11 18:00:00;120,0;125,49;-5,49;41761;0;0;0;0;54544;1933;0.0354;1762;171
2017-08-11 19:00:00;89,93;89,89;0,04;41761;0;0;0;0;54544;1567;0.0288;1678;-111
2017-08-11 20:00:00;60,1;69,02;-8,92;41761;0;0;0;0;54544;1274;0.0234;1465;-191
2017-08-11 21:00:00;52,32;54,15;-1,83;41761;0;0;0;0;54544;1099;0.0202;1240;-141
2017-08-11 22:00:00;48,05;46,58;1,47;41761;0;0;0;0;54544;1017;0.0186;1045;-28
2017-08-11 23:00:00;38,57;40,68;-2,11;41761;0;0;0;0;54544;822;0.0151;889;-67
2017-09-11 00:00:00;38,61;35,02;3,59;41764;0;0;0;0;54609;693;0.0127;606;87
2017-09-11 01:00:00;39,3;37,42;1,88;41764;0;0;0;0;54609;672;0.0123;605;67
2017-09-11 02:00:00;38,48;37,13;1,35;41764;0;0;0;0;54609;760;0.0139;607;153
2017-09-11 03:00:00;40,53;37,36;3,17;41764;0;0;0;0;54609;1022;0.0187;689;333
2017-09-11 04:00:00;39,9;35,67;4,23;41764;0;0;0;0;54609;1541;0.0282;876;665
2017-09-11 05:00:00;43,95;41,53;2,42;41764;0;0;0;0;54609;2242;0.0411;1210;1032
2017-09-11 06:00:00;58,65;43,51;15,14;41764;0;0;0;0;54609;3193;0.0585;1727;1466
2017-09-11 07:00:00;72,1;52,52;19,58;41764;49;0.0012;94;-45;54609;4405;0.0806;2462;1943
2017-09-11 08:00:00;84,73;56,55;28,18;41764;564;0.0135;865;-301;54609;5598;0.1025;3375;2223
2017-09-11 09:00:00;61,99;51,43;10,56;41764;1513;0.0362;2241;-728;54609;6510;0.1192;4376;2134
2017-09-11 10:00:00;61,37;54,72;6,65;41764;2322;0.0556;3553;-1231;54609;7381;0.1352;5466;1915
2017-09-11 11:00:00;60,69;55,0;5,69;41764;2801;0.067;4318;-1517;54609;7939;0.1454;6697;1242
2017-09-11 12:00:00;55,12;58,17;-3,05;41764;2914;0.0698;4337;-1423;54609;8987;0.1646;7927;1060
2017-09-11 13:00:00;53,99;56,05;-2,06;41764;2586;0.0619;3715;-1129;54609;9533;0.1746;8942;591
2017-09-11 14:00:00;54,91;57,61;-2,7;41764;1774;0.0425;2542;-768;54609;10245;0.1876;9514;731
2017-09-11 15:00:00;55,0;57,13;-2,13;41764;708;0.017;1081;-373;54609;11101;0.2033;9861;1240
2017-09-11 16:00:00;55,92;56,31;-0,39;41764;58;0.0014;142;-84;54609;12115;0.2219;10262;1853
2017-09-11 17:00:00;56,94;50,56;6,38;41764;0;0;0;0;54609;12969;0.2375;10673;2296
2017-09-11 18:00:00;55,93;46,91;9,02;41764;0;0;0;0;54609;13133;0.2405;11350;1783
2017-09-11 19:00:00;55,0;44,37;10,63;41764;0;0;0;0;54609;14032;0.2569;11994;2038
2017-09-11 20:00:00;40,3;37,91;2,39;41764;0;0;0;0;54609;15072;0.276;12480;2592
2017-09-11 21:00:00;42,81;35,6;7,21;41764;0;0;0;0;54609;15522;0.2842;12989;2533
2017-09-11 22:00:00;36,78;30,76;6,02;41764;0;0;0;0;54609;15254;0.2793;13545;1709
2017-09-11 23:00:00;33,61;32,76;0,85;41764;0;0;0;0;54609;15348;0.2811;14092;1256
2017-10-11 00:00:00;26,41;27,92;-1,51;41779;0;0;0;0;54631;15914;0.2913;14782;1132
2017-10-11 01:00:00;25,35;30,1;-4,75;41779;0;0;0;0;54631;16702;0.3057;15534;1168
2017-10-11 02:00:00;26,6;30,81;-4,21;41779;0;0;0;0;54631;17525;0.3208;16359;1166
2017-10-11 03:00:00;27,31;30,92;-3,61;41779;0;0;0;0;54631;17808;0.326;17070;738
2017-10-11 04:00:00;27,1;29,29;-2,19;41779;0;0;0;0;54631;18006;0.3296;17890;116
2017-10-11 05:00:00;28,92;32,43;-3,51;41779;0;0;0;0;54631;18986;0.3475;18844;142
2017-10-11 06:00:00;40,15;44,48;-4,33;41779;0;0;0;0;54631;20092;0.3678;20090;2
2017-10-11 07:00:00;51,2;53,78;-2,58;41779;48;0.0012;72;-24;54631;20596;0.377;21701;-1105
2017-10-11 08:00:00;47,41;49,25;-1,84;41779;511;0.0122;628;-117;54631;21724;0.3976;23633;-1909
2017-10-11 09:00:00;38,61;47,46;-8,85;41779;1396;0.0334;1494;-98;54631;23329;0.427;25573;-2244
2017-10-11 10:00:00;38,89;49,73;-10,84;41779;2156;0.0516;2240;-84;54631;25327;0.4636;27291;-1964
2017-10-11 11:00:00;38,79;50,1;-11,31;41779;2421;0.058;2536;-115;54631;27279;0.4993;28918;-1639
2017-10-11 12:00:00;35,25;45,55;-10,3;41779;2181;0.0522;2419;-238;54631;29488;0.5398;30442;-954
2017-10-11 13:00:00;31,16;40,04;-8,88;41779;1871;0.0448;2050;-179;54631;30591;0.56;31361;-770
2017-10-11 14:00:00;30,16;38,66;-8,5;41779;1392;0.0333;1440;-48;54631;30959;0.5667;31653;-694
2017-10-11 15:00:00;30,12;33,02;-2,9;41779;734;0.0176;637;97;54631;31991;0.5856;31845;146
2017-10-11 16:00:00;31,02;31,93;-0,91;41779;76;0.0018;81;-5;54631;33204;0.6078;31783;1421
2017-10-11 17:00:00;36,19;32,56;3,63;41779;0;0;0;0;54631;32992;0.6039;31502;1490
2017-10-11 18:00:00;36,02;32,59;3,43;41779;0;0;0;0;54631;32234;0.59;30992;1242
2017-10-11 19:00:00;31,08;31,09;-0,01;41779;0;0;0;0;54631;30838;0.5645;30494;344
2017-10-11 20:00:00;29,39;30,7;-1,31;41779;0;0;0;0;54631;30264;0.554;29790;474
2017-10-11 21:00:00;22,26;21,31;0,95;41779;0;0;0;0;54631;30262;0.5539;29058;1204
2017-10-11 22:00:00;15,51;19,25;-3,74;41779;0;0;0;0;54631;29510;0.5402;28431;1079
2017-10-11 23:00:00;11,46;13,92;-2,46;41779;0;0;0;0;54631;29491;0.5398;27720;1771
2017-11-11 00:00:00;9,2;11,68;-2,48;41780;0;0;0;0;54631;28616;0.5238;30186;-1570
2017-11-11 01:00:00;2,03;10,3;-8,27;41780;0;0;0;0;54631;28115;0.5146;29508;-1393
2017-11-11 02:00:00;0,08;10,61;-10,53;41780;0;0;0;0;54631;27360;0.5008;28714;-1354
2017-11-11 03:00:00;6,47;13,55;-7,08;41780;0;0;0;0;54631;27100;0.4961;27853;-753
2017-11-11 04:00:00;11,27;17,54;-6,27;41780;0;0;0;0;54631;27132;0.4966;27168;-36
2017-11-11 05:00:00;12,59;17,0;-4,41;41780;0;0;0;0;54631;26052;0.4769;26754;-702
2017-11-11 06:00:00;9,63;16,96;-7,33;41780;0;0;0;0;54631;25832;0.4729;26615;-783
2017-11-11 07:00:00;13,55;25,96;-12,41;41780;77;0.0018;138;-61;54631;25338;0.4638;26506;-1168
2017-11-11 08:00:00;20,1;31,27;-11,17;41780;1030;0.0246;1321;-291;54631;24824;0.4544;26307;-1483
2017-11-11 09:00:00;24,66;35,19;-10,53;41780;2449;0.0586;2969;-520;54631;25113;0.4597;26289;-1176
2017-11-11 10:00:00;21,47;34,71;-13,24;41780;3165;0.0758;4017;-852;54631;24838;0.4546;26353;-1515
2017-11-11 11:00:00;18,9;35,07;-16,17;41780;3287;0.0787;4197;-910;54631;24973;0.4572;26327;-1354
2017-11-11 12:00:00;21,03;33,19;-12,16;41780;3019;0.0722;3601;-582;54631;23968;0.4387;25874;-1906
2017-11-11 13:00:00;22,86;34,01;-11,15;41780;2552;0.0611;2697;-145;54631;22518;0.4122;24912;-2394
2017-11-11 14:00:00;28,2;37,07;-8,87;41780;1803;0.0432;1635;168;54631;20602;0.3771;23580;-2978
2017-11-11 15:00:00;30,48;38,49;-8,01;41780;732;0.0175;622;110;54631;19141;0.3504;22069;-2928
2017-11-11 16:00:00;35,81;42,81;-7,0;41780;50;0.0012;67;-17;54631;17974;0.329;20776;-2802
2017-11-11 17:00:00;44,49;51,02;-6,53;41780;0;0;0;0;54631;18036;0.3302;19853;-1817
2017-11-11 18:00:00;46,76;50,58;-3,82;41780;0;0;0;0;54631;17223;0.3153;19126;-1903
2017-11-11 19:00:00;41,03;42,81;-1,78;41780;0;0;0;0;54631;17476;0.3199;18398;-922
2017-11-11 20:00:00;35,92;27,59;8,33;41780;0;0;0;0;54631;17468;0.3197;17712;-244
2017-11-11 21:00:00;35,82;23,28;12,54;41780;0;0;0;0;54631;17592;0.322;17247;345
2017-11-11 22:00:00;37,06;20,61;16,45;41780;0;0;0;0;54631;17632;0.3228;16948;684
2017-11-11 23:00:00;28,29;14,07;14,22;41780;0;0;0;0;54631;17285;0.3164;16811;474
2017-12-11 00:00:00;14,07;13,36;0,71;41780;0;0;0;0;54641;17327;0.3171;16888;439
2017-12-11 01:00:00;15,99;13,36;2,63;41780;0;0;0;0;54641;16983;0.3108;16985;-2
2017-12-11 02:00:00;13,8;21,04;-7,24;41780;0;0;0;0;54641;16854;0.3084;16861;-7
2017-12-11 03:00:00;13,53;22,83;-9,3;41780;0;0;0;0;54641;16397;0.3;16599;-202
2017-12-11 04:00:00;15,25;20,19;-4,94;41780;0;0;0;0;54641;15431;0.2824;16170;-739
2017-12-11 05:00:00;21,86;25,76;-3,9;41780;0;0;0;0;54641;14301;0.2618;15542;-1241
2017-12-11 06:00:00;22,52;26,35;-3,83;41780;0;0;0;0;54641;13058;0.239;14664;-1606
2017-12-11 07:00:00;27,06;24,75;2,31;41780;43;0.001;51;-8;54641;11385;0.2084;13276;-1891
2017-12-11 08:00:00;30,94;29,13;1,81;41780;780;0.0186;630;150;54641;9832;0.18;11609;-1777
2017-12-11 09:00:00;33,03;32,09;0,94;41780;1926;0.0461;1623;303;54641;8030;0.147;10028;-1998
2017-12-11 10:00:00;42,79;37,64;5,15;41780;2565;0.0614;2454;111;54641;6252;0.1144;8753;-2501
2017-12-11 11:00:00;47,65;43,05;4,6;41780;2908;0.0696;2854;54;54641;4864;0.089;8092;-3228
2017-12-11 12:00:00;48,13;42,79;5,34;41780;2848;0.0682;2727;121;54641;4122;0.0754;7695;-3573
2017-12-11 13:00:00;44,28;42,9;1,38;41780;2318;0.0555;2230;88;54641;4657;0.0852;7319;-2662
2017-12-11 14:00:00;38,43;36,85;1,58;41780;1640;0.0393;1427;213;54641;5108;0.0935;7312;-2204
2017-12-11 15:00:00;37,8;36,69;1,11;41780;656;0.0157;568;88;54641;5218;0.0955;7818;-2600
2017-12-11 16:00:00;40,82;38,05;2,77;41780;48;0.0011;70;-22;54641;6260;0.1146;8646;-2386
2017-12-11 17:00:00;53,91;49,9;4,01;41780;0;0;0;0;54641;7325;0.134;9540;-2215
2017-12-11 18:00:00;53,94;49,76;4,18;41780;0;0;0;0;54641;8054;0.1474;10375;-2321
2017-12-11 19:00:00;46,54;42,95;3,59;41780;0;0;0;0;54641;8584;0.1571;10994;-2410
2017-12-11 20:00:00;39,59;40,86;-1,27;41780;0;0;0;0;54641;9112;0.1668;11414;-2302
2017-12-11 21:00:00;33,11;36,72;-3,61;41780;0;0;0;0;54641;10094;0.1847;11859;-1765
2017-12-11 22:00:00;33,17;37,87;-4,7;41780;0;0;0;0;54641;10552;0.1931;12290;-1738
2017-12-11 23:00:00;29,73;27,58;2,15;41780;0;0;0;0;54641;11252;0.2059;12600;-1348
2017-11-13 00:00:00;31,06;26,83;4,23;41782;0;0;0;0;54658;11697;0.214;10274;1423
2017-11-13 01:00:00;30,41;23,62;6,79;41782;0;0;0;0;54658;11858;0.2169;10680;1178
2017-11-13 02:00:00;29,64;19,53;10,11;41782;0;0;0;0;54658;11795;0.2158;10870;925
2017-11-13 03:00:00;29,66;22,2;7,46;41782;0;0;0;0;54658;12096;0.2213;10912;1184
2017-11-13 04:00:00;29,79;22,6;7,19;41782;0;0;0;0;54658;11970;0.219;10705;1265
2017-11-13 05:00:00;31,68;26,83;4,85;41782;0;0;0;0;54658;11713;0.2143;10309;1404
2017-11-13 06:00:00;42,76;37,77;4,99;41782;0;0;0;0;54658;11153;0.204;9965;1188
2017-11-13 07:00:00;54,9;49,72;5,18;41782;29;0.0007;72;-43;54658;10564;0.1932;9389;1175
2017-11-13 08:00:00;54,33;48,86;5,47;41782;834;0.02;1092;-258;54658;9897;0.1811;8731;1166
2017-11-13 09:00:00;48,15;42,83;5,32;41782;2865;0.0686;3220;-355;54658;8759;0.1602;8161;598
2017-11-13 10:00:00;45,83;43,44;2,39;41782;5116;0.1224;5191;-75;54658;7782;0.1424;7773;9
2017-11-13 11:00:00;46,61;44,97;1,64;41782;6933;0.1659;6515;418;54658;7154;0.1309;7622;-468
2017-11-13 12:00:00;41,48;44,17;-2,69;41782;7497;0.1794;6905;592;54658;7593;0.1389;7588;5
2017-11-13 13:00:00;48,08;45,78;2,3;41782;6852;0.164;6274;578;54658;7866;0.1439;7531;335
2017-11-13 14:00:00;50,81;47,9;2,91;41782;4765;0.1141;4541;224;54658;7804;0.1428;7298;506
2017-11-13 15:00:00;54,93;50,88;4,05;41782;1945;0.0465;1977;-32;54658;7738;0.1416;7104;634
2017-11-13 16:00:00;55,92;50,01;5,91;41782;161;0.0039;188;-27;54658;8422;0.1541;7067;1355
2017-11-13 17:00:00;70,08;51,63;18,45;41782;0;0;0;0;54658;8798;0.161;7140;1658
2017-11-13 18:00:00;62,3;43,94;18,36;41782;0;0;0;0;54658;8580;0.157;7146;1434
2017-11-13 19:00:00;57,73;43,36;14,37;41782;0;0;0;0;54658;7657;0.1401;6922;735
2017-11-13 20:00:00;54,94;47,07;7,87;41782;0;0;0;0;54658;6910;0.1264;6218;692
2017-11-13 21:00:00;49,0;45,36;3,64;41782;0;0;0;0;54658;5549;0.1015;5426;123
2017-11-13 22:00:00;41,0;41,59;-0,59;41782;0;0;0;0;54658;4625;0.0846;4793;-168
2017-11-13 23:00:00;36,55;36,84;-0,29;41782;0;0;0;0;54658;4207;0.0769;4452;-245
2017-11-14 00:00:00;37,83;31,93;5,9;41786;0;0;0;0;54669;4582;0.0838;4700;-118
2017-11-14 01:00:00;36,01;34,54;1,47;41786;0;0;0;0;54669;5428;0.0993;5036;392
2017-11-14 02:00:00;34,03;32,66;1,37;41786;0;0;0;0;54669;6818;0.1247;5675;1143
2017-11-14 03:00:00;33,54;31,73;1,81;41786;0;0;0;0;54669;8850;0.1618;6720;2130
2017-11-14 04:00:00;33,9;31,6;2,3;41786;0;0;0;0;54669;10350;0.1893;8012;2338
2017-11-14 05:00:00;34,04;34,23;-0,19;41786;0;0;0;0;54669;10949;0.2003;9445;1504
2017-11-14 06:00:00;38,12;41,45;-3,33;41786;0;0;0;0;54669;12168;0.2226;10871;1297
2017-11-14 07:00:00;43,52;47,33;-3,81;41786;61;0.0014;108;-47;54669;13246;0.2423;12141;1105
2017-11-14 08:00:00;49,58;50,02;-0,44;41786;1377;0.033;1440;-63;54669;14003;0.2562;13161;842
2017-11-14 09:00:00;37,2;40,63;-3,43;41786;4059;0.0971;3763;296;54669;14547;0.2661;14062;485
2017-11-14 10:00:00;36,56;37,23;-0,67;41786;6498;0.1555;5732;766;54669;14368;0.2628;14764;-396
2017-11-14 11:00:00;36,19;38,14;-1,95;41786;7632;0.1826;6817;815;54669;15122;0.2766;15211;-89
2017-11-14 12:00:00;36,88;37,39;-0,51;41786;7269;0.174;6786;483;54669;15698;0.2872;15732;-34
2017-11-14 13:00:00;36,6;37,96;-1,36;41786;6000;0.1436;5773;227;54669;15820;0.2894;15857;-37
2017-11-14 14:00:00;36,86;39,31;-2,45;41786;4042;0.0968;3940;102;54669;15799;0.289;15192;607
2017-11-14 15:00:00;40,07;41,33;-1,26;41786;1685;0.0403;1669;16;54669;15489;0.2833;14572;917
2017-11-14 16:00:00;49,06;44,73;4,33;41786;149;0.0036;153;-4;54669;15337;0.2806;14128;1209
2017-11-14 17:00:00;51,71;45,78;5,93;41786;0;0;0;0;54669;15128;0.2767;13673;1455
2017-11-14 18:00:00;52,94;44,35;8,59;41786;0;0;0;0;54669;14640;0.2678;13020;1620
2017-11-14 19:00:00;51,25;44,28;6,97;41786;0;0;0;0;54669;13333;0.2439;12305;1028
2017-11-14 20:00:00;44,92;40,49;4,43;41786;0;0;0;0;54669;11817;0.2162;11462;355
2017-11-14 21:00:00;39,44;40,25;-0,81;41786;0;0;0;0;54669;10260;0.1877;10383;-123
2017-11-14 22:00:00;37,6;42,47;-4,87;41786;0;0;0;0;54669;9223;0.1687;9404;-181
2017-11-14 23:00:00;36,36;33,89;2,47;41786;0;0;0;0;54669;8198;0.15;8590;-392
2017-11-15 00:00:00;33,5;34,49;-0,99;41788;0;0;0;0;54715;7892;0.1442;8184;-292
2017-11-15 01:00:00;34,06;39,48;-5,42;41788;0;0;0;0;54715;7833;0.1432;7537;296
2017-11-15 02:00:00;33,42;37,27;-3,85;41788;0;0;0;0;54715;7049;0.1288;7004;45
2017-11-15 03:00:00;35,62;34,89;0,73;41788;0;0;0;0;54715;6596;0.1206;6601;-5
2017-11-15 04:00:00;33,74;35,87;-2,13;41788;0;0;0;0;54715;6852;0.1252;6277;575
2017-11-15 05:00:00;37,0;40,91;-3,91;41788;0;0;0;0;54715;6652;0.1216;6015;637
2017-11-15 06:00:00;58,5;61,0;-2,5;41788;0;0;0;0;54715;6555;0.1198;5848;707
2017-11-15 07:00:00;77,4;85,64;-8,24;41788;44;0.001;116;-72;54715;6380;0.1166;5649;731
2017-11-15 08:00:00;78,01;81,17;-3,16;41788;786;0.0188;1446;-660;54715;5709;0.1043;5339;370
2017-11-15 09:00:00;68,87;85,71;-16,84;41788;2262;0.0541;3736;-1474;54715;5640;0.1031;4998;642
2017-11-15 10:00:00;61,65;72,07;-10,42;41788;3672;0.0879;5760;-2088;54715;5082;0.0929;4585;497
2017-11-15 11:00:00;71,76;71,7;0,06;41788;4774;0.1142;6959;-2185;54715;4320;0.0789;4102;218
2017-11-15 12:00:00;64,1;67,23;-3,13;41788;5224;0.125;7188;-1964;54715;3526;0.0644;3633;-107
2017-11-15 13:00:00;70,77;98,06;-27,29;41788;4658;0.1115;6387;-1729;54715;2868;0.0524;3121;-253
2017-11-15 14:00:00;72,81;74,5;-1,69;41788;3127;0.0748;4500;-1373;54715;2381;0.0435;2545;-164
2017-11-15 15:00:00;79,18;83,55;-4,37;41788;1189;0.0284;1933;-744;54715;1968;0.036;2162;-194
2017-11-15 16:00:00;89,95;110,41;-20,46;41788;66;0.0016;189;-123;54715;1900;0.0348;1997;-97
2017-11-15 17:00:00;112,09;137,62;-25,53;41788;0;0;0;0;54715;1904;0.0348;2060;-156
2017-11-15 18:00:00;124,29;168,49;-44,2;41788;0;0;0;0;54715;1958;0.0358;2131;-173
2017-11-15 19:00:00;86,34;98,24;-11,9;41788;0;0;0;0;54715;1926;0.0352;2210;-284
2017-11-15 20:00:00;76,13;74,8;1,33;41788;0;0;0;0;54715;1969;0.036;2253;-284
2017-11-15 21:00:00;62,01;65,71;-3,7;41788;0;0;0;0;54715;2001;0.0366;2268;-267
2017-11-15 22:00:00;51,91;58,35;-6,44;41788;0;0;0;0;54715;2107;0.0385;2297;-190
2017-11-15 23:00:00;39,03;56,26;-17,23;41788;0;0;0;0;54715;2348;0.0429;2320;28
2017-11-16 00:00:00;37,04;37,71;-0,67;41791;0;0;0;0;54740;2505;0.0458;2669;-164
2017-11-16 01:00:00;37,06;36,22;0,84;41791;0;0;0;0;54740;2887;0.0527;3054;-167
2017-11-16 02:00:00;36,13;35,94;0,19;41791;0;0;0;0;54740;3218;0.0588;3425;-207
2017-11-16 03:00:00;36,59;35,0;1,59;41791;0;0;0;0;54740;3490;0.0638;3867;-377
2017-11-16 04:00:00;37,04;35,11;1,93;41791;0;0;0;0;54740;3942;0.072;4343;-401
2017-11-16 05:00:00;36,87;38,89;-2,02;41791;0;0;0;0;54740;4095;0.0748;4954;-859
2017-11-16 06:00:00;51,61;52,86;-1,25;41791;0;0;0;0;54740;4527;0.0827;5755;-1228
2017-11-16 07:00:00;61,89;71,8;-9,91;41791;32;0.0008;90;-58;54740;5256;0.096;6572;-1316
2017-11-16 08:00:00;68,63;110,88;-42,25;41791;687;0.0164;1310;-623;54740;5852;0.1069;7353;-1501
2017-11-16 09:00:00;57,02;107,22;-50,2;41791;1829;0.0438;3555;-1726;54740;5918;0.1081;7999;-2081
2017-11-16 10:00:00;55,93;104,48;-48,55;41791;2851;0.0682;5621;-2770;54740;6320;0.1155;8496;-2176
2017-11-16 11:00:00;53,96;96,22;-42,26;41791;3705;0.0887;6920;-3215;54740;6633;0.1212;8872;-2239
2017-11-16 12:00:00;49,01;93,92;-44,91;41791;3716;0.0889;7070;-3354;54740;7084;0.1294;9191;-2107
2017-11-16 13:00:00;49,31;81,31;-32,0;41791;2984;0.0714;6104;-3120;54740;7424;0.1356;9397;-1973
2017-11-16 14:00:00;54,0;84,4;-30,4;41791;1744;0.0417;4163;-2419;54740;7573;0.1384;9539;-1966
2017-11-16 15:00:00;57,94;106,4;-48,46;41791;579;0.0138;1702;-1123;54740;8052;0.1471;9863;-1811
2017-11-16 16:00:00;56,16;126,41;-70,25;41791;18;0.0004;163;-145;54740;8777;0.1604;10325;-1548
2017-11-16 17:00:00;56,42;142,65;-86,23;41791;0;0;0;0;54740;9993;0.1826;10921;-928
2017-11-16 18:00:00;53,93;86,63;-32,7;41791;0;0;0;0;54740;11111;0.203;11559;-448
2017-11-16 19:00:00;46,3;73,48;-27,18;41791;0;0;0;0;54740;11565;0.2113;11692;-127
2017-11-16 20:00:00;37,03;49,38;-12,35;41791;0;0;0;0;54740;11840;0.2163;11246;594
2017-11-16 21:00:00;38,03;46,23;-8,2;41791;0;0;0;0;54740;11383;0.2079;10632;751
2017-11-16 22:00:00;38,15;40,13;-1,98;41791;0;0;0;0;54740;10987;0.2007;10042;945
2017-11-16 23:00:00;35,07;40,34;-5,27;41791;0;0;0;0;54740;10959;0.2002;9259;1700
2017-11-17 00:00:00;33,15;38,19;-5,04;41793;0;0;0;0;54781;10605;0.1936;10949;-344
2017-11-17 01:00:00;32,72;36,09;-3,37;41793;0;0;0;0;54781;9886;0.1805;10418;-532
2017-11-17 02:00:00;33,16;34,63;-1,47;41793;0;0;0;0;54781;8726;0.1593;9747;-1021
2017-11-17 03:00:00;34,06;37,44;-3,38;41793;0;0;0;0;54781;8074;0.1474;9070;-996
2017-11-17 04:00:00;34,05;36,48;-2,43;41793;0;0;0;0;54781;7711;0.1408;8437;-726
2017-11-17 05:00:00;36,09;39,26;-3,17;41793;0;0;0;0;54781;7241;0.1322;7833;-592
2017-11-17 06:00:00;46,83;51,46;-4,63;41793;0;0;0;0;54781;6799;0.1241;7306;-507
2017-11-17 07:00:00;49,99;54,63;-4,64;41793;22;0.0005;37;-15;54781;6613;0.1207;6905;-292
2017-11-17 08:00:00;53,93;58,67;-4,74;41793;802;0.0192;1062;-260;54781;6554;0.1196;6721;-167
2017-11-17 09:00:00;49,99;51,12;-1,13;41793;2802;0.0671;3265;-463;54781;5918;0.108;6633;-715
2017-11-17 10:00:00;49,97;48,94;1,03;41793;4897;0.1172;5329;-432;54781;5269;0.0962;6573;-1304
2017-11-17 11:00:00;49,97;49,34;0,63;41793;6477;0.155;6594;-117;54781;4816;0.0879;6531;-1715
2017-11-17 12:00:00;49,09;50,52;-1,43;41793;6948;0.1662;6768;180;54781;5037;0.0919;6695;-1658
2017-11-17 13:00:00;46,55;47,64;-1,09;41793;5841;0.1397;5856;-15;54781;5362;0.0979;7164;-1802
2017-11-17 14:00:00;42,3;45,72;-3,42;41793;3764;0.0901;3977;-213;54781;6002;0.1096;7857;-1855
2017-11-17 15:00:00;49,95;50,66;-0,71;41793;1304;0.0312;1529;-225;54781;6417;0.1172;8676;-2259
2017-11-17 16:00:00;49,9;56,01;-6,11;41793;62;0.0015;103;-41;54781;7738;0.1413;9613;-1875
2017-11-17 17:00:00;49,91;56,53;-6,62;41793;0;0;0;0;54781;9687;0.1768;10674;-987
2017-11-17 18:00:00;48,18;50,48;-2,3;41793;0;0;0;0;54781;10633;0.1941;11705;-1072
2017-11-17 19:00:00;42,97;52,31;-9,34;41793;0;0;0;0;54781;11437;0.2088;12575;-1138
2017-11-17 20:00:00;38,35;40,91;-2,56;41793;0;0;0;0;54781;12141;0.2216;13414;-1273
2017-11-17 21:00:00;39,8;39,53;0,27;41793;0;0;0;0;54781;12385;0.2261;14273;-1888
2017-11-17 22:00:00;36,15;39,38;-3,23;41793;0;0;0;0;54781;12357;0.2256;15076;-2719
2017-11-17 23:00:00;32,41;36,63;-4,22;41793;0;0;0;0;54781;13320;0.2432;15781;-2461
2017-11-18 00:00:00;27,78;35,22;-7,44;41794;0;0;0;0;54800;14341;0.2617;15205;-864
2017-11-18 01:00:00;23,56;33,07;-9,51;41794;0;0;0;0;54800;15244;0.2782;16112;-868
2017-11-18 02:00:00;20,04;24,09;-4,05;41794;0;0;0;0;54800;16094;0.2937;16979;-885
2017-11-18 03:00:00;17,63;36,8;-19,17;41794;0;0;0;0;54800;17284;0.3154;17933;-649
2017-11-18 04:00:00;13,33;26,24;-12,91;41794;0;0;0;0;54800;18242;0.3329;19035;-793
2017-11-18 05:00:00;12,87;28,14;-15,27;41794;0;0;0;0;54800;19413;0.3543;20211;-798
2017-11-18 06:00:00;16,12;27,9;-11,78;41794;0;0;0;0;54800;21078;0.3846;21385;-307
2017-11-18 07:00:00;19,38;29,02;-9,64;41794;20;0.0005;31;-11;54800;22361;0.4081;22488;-127
2017-11-18 08:00:00;27,97;36,28;-8,31;41794;725;0.0174;872;-147;54800;23835;0.435;23540;295
2017-11-18 09:00:00;28,61;33,22;-4,61;41794;2336;0.0559;2752;-416;54800;24886;0.4542;24750;136
2017-11-18 10:00:00;28,08;32,83;-4,75;41794;3609;0.0863;4550;-941;54800;27007;0.4928;26220;787
2017-11-18 11:00:00;14,97;27,44;-12,47;41794;3795;0.0908;5631;-1836;54800;28729;0.5242;27808;921
2017-11-18 12:00:00;18,19;28,87;-10,68;41794;3436;0.0822;5616;-2180;54800;31062;0.5668;29479;1583
2017-11-18 13:00:00;13,01;25,38;-12,37;41794;2714;0.0649;4713;-1999;54800;31128;0.568;30239;889
2017-11-18 14:00:00;18,46;31,59;-13,13;41794;1646;0.0394;3150;-1504;54800;30432;0.5554;29914;518
2017-11-18 15:00:00;24,84;31,01;-6,17;41794;576;0.0138;1215;-639;54800;29922;0.546;29056;866
2017-11-18 16:00:00;28,33;34,04;-5,71;41794;23;0.0005;97;-74;54800;29903;0.5457;28366;1537
2017-11-18 17:00:00;29,77;33,96;-4,19;41794;0;0;0;0;54800;29353;0.5356;28005;1348
2017-11-18 18:00:00;29,7;32,82;-3,12;41794;0;0;0;0;54800;28754;0.5247;27736;1018
2017-11-18 19:00:00;24,03;25,96;-1,93;41794;0;0;0;0;54800;28326;0.5169;27580;746
2017-11-18 20:00:00;13,06;20,86;-7,8;41794;0;0;0;0;54800;27274;0.4977;27552;-278
2017-11-18 21:00:00;12,69;18,27;-5,58;41794;0;0;0;0;54800;26920;0.4912;27639;-719
2017-11-18 22:00:00;11,38;19,73;-8,35;41794;0;0;0;0;54800;26334;0.4805;27660;-1326
2017-11-18 23:00:00;0,41;18,87;-18,46;41794;0;0;0;0;54800;26374;0.4813;27686;-1312
2017-11-19 00:00:00;0,37;15,73;-15,36;41794;0;0;0;0;54800;26708;0.4874;27827;-1119
2017-11-19 01:00:00;4,33;11,56;-7,23;41794;0;0;0;0;54800;26773;0.4886;28020;-1247
2017-11-19 02:00:00;2,91;9,67;-6,76;41794;0;0;0;0;54800;26782;0.4887;28239;-1457
2017-11-19 03:00:00;2,17;9,16;-6,99;41794;0;0;0;0;54800;27282;0.4978;28587;-1305
2017-11-19 04:00:00;2,14;12,77;-10,63;41794;0;0;0;0;54800;27876;0.5087;28978;-1102
2017-11-19 05:00:00;0,03;11,22;-11,19;41794;0;0;0;0;54800;28620;0.5222;29466;-846
2017-11-19 06:00:00;-0,03;9,79;-9,82;41794;0;0;0;0;54800;29492;0.5382;29959;-467
2017-11-19 07:00:00;0,04;9,07;-9,03;41794;12;0.0003;24;-12;54800;30173;0.5506;30482;-309
2017-11-19 08:00:00;5,08;4,46;0,62;41794;750;0.0179;735;15;54800;30324;0.5533;30979;-655
2017-11-19 09:00:00;23,49;20,15;3,34;41794;2761;0.0661;2597;164;54800;30681;0.5598;31570;-889
2017-11-19 10:00:00;12,77;24,27;-11,5;41794;4683;0.112;4495;188;54800;31168;0.5688;32234;-1066
2017-11-19 11:00:00;21,94;23,53;-1,59;41794;5580;0.1335;5730;-150;54800;31526;0.5753;32711;-1185
2017-11-19 12:00:00;12,5;20,63;-8,13;41794;5509;0.1318;6002;-493;54800;31641;0.5774;33051;-1410
2017-11-19 13:00:00;9,09;13,22;-4,13;41794;4928;0.1179;5359;-431;54800;31460;0.5741;33048;-1588
2017-11-19 14:00:00;5,09;11,29;-6,2;41794;3183;0.0761;3819;-636;54800;31450;0.5739;32592;-1142
2017-11-19 15:00:00;9,63;18,45;-8,82;41794;1180;0.0282;1534;-354;54800;31940;0.5828;31796;144
2017-11-19 16:00:00;5,99;19,1;-13,11;41794;65;0.0016;118;-53;54800;32664;0.596;31020;1644
2017-11-19 17:00:00;23,14;23,56;-0,42;41794;0;0;0;0;54800;32677;0.5963;30303;2374
2017-11-19 18:00:00;21,94;22,81;-0,87;41794;0;0;0;0;54800;32564;0.5942;29748;2816
2017-11-19 19:00:00;13,3;15,61;-2,31;41794;0;0;0;0;54800;31891;0.582;29027;2864
2017-11-19 20:00:00;12,62;12,09;0,53;41794;0;0;0;0;54800;31066;0.5669;28107;2959
2017-11-19 21:00:00;11,38;9,86;1,52;41794;0;0;0;0;54800;29967;0.5469;27076;2891
2017-11-19 22:00:00;13,95;9,71;4,24;41794;0;0;0;0;54800;28962;0.5285;26017;2945
2017-11-19 23:00:00;12,21;6,92;5,29;41794;0;0;0;0;54800;27864;0.5085;25188;2676
2017-11-20 00:00:00;12,59;-3,89;16,48;41797;0;0;0;0;54829;26395;0.4814;24543;1852
2017-11-20 01:00:00;12,51;-8,1;20,61;41797;0;0;0;0;54829;25224;0.46;23554;1670
2017-11-20 02:00:00;10,49;-11,68;22,17;41797;0;0;0;0;54829;23010;0.4197;22356;654
2017-11-20 03:00:00;11,0;-5,46;16,46;41797;0;0;0;0;54829;21830;0.3982;21197;633
2017-11-20 04:00:00;14,96;8,15;6,81;41797;0;0;0;0;54829;19800;0.3611;20107;-307
2017-11-20 05:00:00;23,81;31,3;-7,49;41797;0;0;0;0;54829;19145;0.3492;19122;23
2017-11-20 06:00:00;39,94;41,79;-1,85;41797;0;0;0;0;54829;18771;0.3424;18212;559
2017-11-20 07:00:00;41,99;49,49;-7,5;41797;14;0.0004;21;-7;54829;18618;0.3396;17165;1453
2017-11-20 08:00:00;43,92;46,35;-2,43;41797;558;0.0134;484;74;54829;17494;0.3191;16289;1205
2017-11-20 09:00:00;43,91;53,1;-9,19;41797;1798;0.043;1525;273;54829;16258;0.2965;15681;577
2017-11-20 10:00:00;43,68;52,32;-8,64;41797;2762;0.0661;2406;356;54829;15193;0.2771;15303;-110
2017-11-20 11:00:00;43,94;52,72;-8,78;41797;3126;0.0748;2779;347;54829;14902;0.2718;15339;-437
2017-11-20 12:00:00;44,36;52,57;-8,21;41797;2813;0.0673;2579;234;54829;14975;0.2731;15579;-604
2017-11-20 13:00:00;49,05;53,6;-4,55;41797;2174;0.052;1988;186;54829;14258;0.2601;15521;-1263
2017-11-20 14:00:00;53,46;58,9;-5,44;41797;1275;0.0305;1157;118;54829;13525;0.2467;15034;-1509
2017-11-20 15:00:00;50,99;62,42;-11,43;41797;392;0.0094;386;6;54829;13330;0.2431;14505;-1175
2017-11-20 16:00:00;59,3;72,02;-12,72;41797;10;0.0002;33;-23;54829;13246;0.2416;14240;-994
2017-11-20 17:00:00;66,02;94,45;-28,43;41797;0;0;0;0;54829;13571;0.2475;14143;-572
2017-11-20 18:00:00;53,38;91,99;-38,61;41797;0;0;0;0;54829;13496;0.2462;14121;-625
2017-11-20 19:00:00;47,93;59,9;-11,97;41797;0;0;0;0;54829;13190;0.2406;14089;-899
2017-11-20 20:00:00;43,95;45,89;-1,94;41797;0;0;0;0;54829;12904;0.2354;13872;-968
2017-11-20 21:00:00;38,63;39,58;-0,95;41797;0;0;0;0;54829;12371;0.2256;13641;-1270
2017-11-20 22:00:00;38,76;37,22;1,54;41797;0;0;0;0;54829;11922;0.2175;13256;-1334
2017-11-20 23:00:00;34,97;37,15;-2,18;41797;0;0;0;0;54829;11636;0.2122;12690;-1054
2017-11-21 00:00:00;36,03;31,76;4,27;41801;0;0;0;0;54845;11615;0.2118;11269;346
2017-11-21 01:00:00;35,46;31,14;4,32;41801;0;0;0;0;54845;11521;0.2101;10797;724
2017-11-21 02:00:00;35,63;30,24;5,39;41801;0;0;0;0;54845;11474;0.2092;10477;997
2017-11-21 03:00:00;35,73;31,28;4,45;41801;0;0;0;0;54845;10949;0.1996;10175;774
2017-11-21 04:00:00;35,42;34,48;0,94;41801;0;0;0;0;54845;10750;0.196;9844;906
2017-11-21 05:00:00;37,92;34,56;3,36;41801;0;0;0;0;54845;10746;0.196;9587;1159
2017-11-21 06:00:00;46,51;38,12;8,39;41801;0;0;0;0;54845;10910;0.1989;9458;1452
2017-11-21 07:00:00;67,86;56,72;11,14;41801;6;0.0001;8;-2;54845;10921;0.1991;9317;1604
2017-11-21 08:00:00;72,63;59,56;13,07;41801;266;0.0064;232;34;54845;10938;0.1994;9202;1736
2017-11-21 09:00:00;54,99;49,23;5,76;41801;964;0.023;744;220;54845;10945;0.1996;9125;1820
2017-11-21 10:00:00;54,26;46,96;7,3;41801;1604;0.0384;1255;349;54845;10454;0.1906;9060;1394
2017-11-21 11:00:00;64,03;50,09;13,94;41801;1970;0.0472;1542;428;54845;10276;0.1874;9030;1246
2017-11-21 12:00:00;55,27;49,86;5,41;41801;2198;0.0526;1584;614;54845;10093;0.184;9090;1003
2017-11-21 13:00:00;64,91;54,84;10,07;41801;2156;0.0516;1398;758;54845;10092;0.184;9229;863
2017-11-21 14:00:00;62,65;56,68;5,97;41801;1536;0.0368;961;575;54845;10544;0.1922;9483;1061
2017-11-21 15:00:00;62,65;57,58;5,07;41801;530;0.0127;378;152;54845;11034;0.2012;9977;1057
2017-11-21 16:00:00;62,65;59,33;3,32;41801;10;0.0002;35;-25;54845;11919;0.2173;10881;1038
2017-11-21 17:00:00;68,05;72,27;-4,22;41801;0;0;0;0;54845;12812;0.2336;12358;454
2017-11-21 18:00:00;57,46;62,71;-5,25;41801;0;0;0;0;54845;14142;0.2579;13977;165
2017-11-21 19:00:00;43,99;48,77;-4,78;41801;0;0;0;0;54845;15924;0.2904;15386;538
2017-11-21 20:00:00;35,42;41,67;-6,25;41801;0;0;0;0;54845;18138;0.3307;17017;1121
2017-11-21 21:00:00;32,64;37,39;-4,75;41801;0;0;0;0;54845;19549;0.3564;18609;940
2017-11-21 22:00:00;31,31;36,98;-5,67;41801;0;0;0;0;54845;20424;0.3724;19723;701
2017-11-21 23:00:00;29,69;31,86;-2,17;41801;0;0;0;0;54845;21449;0.3911;20483;966
2017-11-22 00:00:00;27,15;16,24;10,91;41809;0;0;0;0;54873;22587;0.4116;21691;896
2017-11-22 01:00:00;15,7;12,27;3,43;41809;0;0;0;0;54873;24319;0.4432;22753;1566
2017-11-22 02:00:00;10,7;7,42;3,28;41809;0;0;0;0;54873;25442;0.4636;23831;1611
2017-11-22 03:00:00;10,96;5,79;5,17;41809;0;0;0;0;54873;26680;0.4862;24872;1808
2017-11-22 04:00:00;10,75;3,65;7,1;41809;0;0;0;0;54873;27144;0.4947;25827;1317
2017-11-22 05:00:00;20,24;9,35;10,89;41809;0;0;0;0;54873;27422;0.4998;26678;744
2017-11-22 06:00:00;29,92;17,17;12,75;41809;0;0;0;0;54873;28134;0.5127;27426;708
2017-11-22 07:00:00;37,37;30,48;6,89;41809;24;0.0006;37;-13;54873;26974;0.4916;27827;-853
2017-11-22 08:00:00;35,72;32,33;3,39;41809;1234;0.0295;1177;57;54873;26080;0.4753;27783;-1703
2017-11-22 09:00:00;32,49;33,82;-1,33;41809;3744;0.0896;3502;242;54873;25211;0.4594;27626;-2415
2017-11-22 10:00:00;31,98;35,29;-3,31;41809;6335;0.1515;5680;655;54873;24190;0.4408;27106;-2916
2017-11-22 11:00:00;31,8;37,55;-5,75;41809;8286;0.1982;7103;1183;54873;22844;0.4163;26187;-3343
2017-11-22 12:00:00;31,03;35,26;-4,23;41809;9214;0.2204;7558;1656;54873;21601;0.3936;24906;-3305
2017-11-22 13:00:00;31,3;35,8;-4,5;41809;8628;0.2064;6901;1727;54873;20137;0.367;23452;-3315
2017-11-22 14:00:00;32,56;38,56;-6,0;41809;6151;0.1471;4997;1154;54873;18540;0.3379;22132;-3592
2017-11-22 15:00:00;41,43;42,75;-1,32;41809;2412;0.0577;2130;282;54873;17143;0.3124;21115;-3972
2017-11-22 16:00:00;50,06;57,96;-7,9;41809;119;0.0029;170;-51;54873;18688;0.3406;20897;-2209
2017-11-22 17:00:00;61,26;66,53;-5,27;41809;0;0;0;0;54873;21603;0.3937;21562;41
2017-11-22 18:00:00;50,93;48,5;2,43;41809;0;0;0;0;54873;23903;0.4356;22416;1487
2017-11-22 19:00:00;43,97;36,08;7,89;41809;0;0;0;0;54873;25418;0.4632;23225;2193
2017-11-22 20:00:00;39,99;30,79;9,2;41809;0;0;0;0;54873;26547;0.4838;23939;2608
2017-11-22 21:00:00;33,7;23,46;10,24;41809;0;0;0;0;54873;27337;0.4982;24721;2616
2017-11-22 22:00:00;29,56;19,02;10,54;41809;0;0;0;0;54873;27018;0.4924;25447;1571
2017-11-22 23:00:00;20,6;10,99;9,61;41809;0;0;0;0;54873;27573;0.5025;26024;1549
2017-11-23 00:00:00;9,67;13,3;-3,63;41814;0;0;0;0;54891;28286;0.5153;27564;722
2017-11-23 01:00:00;12,76;21,1;-8,34;41814;0;0;0;0;54891;28442;0.5181;27947;495
2017-11-23 02:00:00;9,64;20,73;-11,09;41814;0;0;0;0;54891;28458;0.5184;28416;42
2017-11-23 03:00:00;9,47;14,91;-5,44;41814;0;0;0;0;54891;28812;0.5249;29020;-208
2017-11-23 04:00:00;9,46;15,33;-5,87;41814;0;0;0;0;54891;29778;0.5425;29735;43
2017-11-23 05:00:00;12,77;18,35;-5,58;41814;0;0;0;0;54891;30995;0.5647;30637;358
2017-11-23 06:00:00;17,1;17,14;-0,04;41814;0;0;0;0;54891;32328;0.5889;31544;784
2017-11-23 07:00:00;32,93;26,58;6,35;41814;29;0.0007;47;-18;54891;32596;0.5938;32317;279
2017-11-23 08:00:00;31,09;25,21;5,88;41814;1749;0.0418;1693;56;54891;33098;0.603;32864;234
2017-11-23 09:00:00;29,96;14,88;15,08;41814;5185;0.124;5150;35;54891;33075;0.6026;33359;-284
2017-11-23 10:00:00;24,03;10,28;13,75;41814;7302;0.1746;7878;-576;54891;33196;0.6048;33747;-551
2017-11-23 11:00:00;16,24;16,11;0,13;41814;8030;0.1921;9050;-1020;54891;33470;0.6097;33973;-503
2017-11-23 12:00:00;12,75;17,26;-4,51;41814;7764;0.1857;8725;-961;54891;33938;0.6183;34082;-144
2017-11-23 13:00:00;16,63;22,09;-5,46;41814;6387;0.1528;7176;-789;54891;34156;0.6222;34037;119
2017-11-23 14:00:00;26,23;29,45;-3,22;41814;4165;0.0996;4611;-446;54891;33620;0.6124;33736;-116
2017-11-23 15:00:00;30,76;32,6;-1,84;41814;1384;0.0331;1689;-305;54891;32484;0.5918;33157;-673
2017-11-23 16:00:00;31,95;33,31;-1,36;41814;52;0.0012;106;-54;54891;32244;0.5874;32370;-126
2017-11-23 17:00:00;37,97;35,81;2,16;41814;0;0;0;0;54891;30842;0.5619;31394;-552
2017-11-23 18:00:00;37,57;30,75;6,82;41814;0;0;0;0;54891;30450;0.5547;30511;-61
2017-11-23 19:00:00;36,98;34,54;2,44;41814;0;0;0;0;54891;29584;0.5389;29737;-153
2017-11-23 20:00:00;33,94;30,0;3,94;41814;0;0;0;0;54891;28912;0.5267;28500;412
2017-11-23 21:00:00;29,34;27,54;1,8;41814;0;0;0;0;54891;27733;0.5052;27103;630
2017-11-23 22:00:00;27,41;27,21;0,2;41814;0;0;0;0;54891;26029;0.4742;25297;732
2017-11-23 23:00:00;24,05;20,3;3,75;41814;0;0;0;0;54891;24249;0.4418;23207;1042
2017-11-24 00:00:00;26,93;26,2;0,73;41818;0;0;0;0;54921;22239;0.4049;20837;1402
2017-11-24 01:00:00;27,75;31,19;-3,44;41818;0;0;0;0;54921;20208;0.368;19698;510
2017-11-24 02:00:00;28,04;32,82;-4,78;41818;0;0;0;0;54921;18689;0.3403;18066;623
2017-11-24 03:00:00;27,1;30,22;-3,12;41818;0;0;0;0;54921;17515;0.3189;16544;971
2017-11-24 04:00:00;28,22;28,72;-0,5;41818;0;0;0;0;54921;16999;0.3095;15328;1671
2017-11-24 05:00:00;35,66;26,05;9,61;41818;0;0;0;0;54921;16636;0.3029;14656;1980
2017-11-24 06:00:00;49,01;39,92;9,09;41818;0;0;0;0;54921;16348;0.2976;14322;2026
2017-11-24 07:00:00;49,07;38,62;10,45;41818;25;0.0006;34;-9;54921;16713;0.3043;14253;2460
2017-11-24 08:00:00;48,0;38,42;9,58;41818;1080;0.0258;1164;-84;54921;17597;0.3204;14292;3305
2017-11-24 09:00:00;46,92;37,11;9,81;41818;3336;0.0798;3443;-107;54921;17856;0.3251;14550;3306
2017-11-24 10:00:00;45,43;37,75;7,68;41818;5440;0.1301;5218;222;54921;17593;0.3203;14766;2827
2017-11-24 11:00:00;46,5;38,47;8,03;41818;6356;0.152;6076;280;54921;17330;0.3155;14908;2422
2017-11-24 12:00:00;39,57;37,3;2,27;41818;5980;0.143;5881;99;54921;15700;0.2859;14890;810
2017-11-24 13:00:00;41,13;41,46;-0,33;41818;4938;0.1181;4809;129;54921;14416;0.2625;14559;-143
2017-11-24 14:00:00;43,13;44,37;-1,24;41818;2566;0.0614;3020;-454;54921;12532;0.2282;13728;-1196
2017-11-24 15:00:00;44,91;46,79;-1,88;41818;706;0.0169;1060;-354;54921;10705;0.1949;12673;-1968
2017-11-24 16:00:00;46,94;54,07;-7,13;41818;14;0.0004;63;-49;54921;9994;0.182;11601;-1607
2017-11-24 17:00:00;53,97;66,81;-12,84;41818;0;0;0;0;54921;9316;0.1696;10559;-1243
2017-11-24 18:00:00;56,24;67,3;-11,06;41818;0;0;0;0;54921;8736;0.1591;9589;-853
2017-11-24 19:00:00;55,97;61,51;-5,54;41818;0;0;0;0;54921;8259;0.1504;8637;-378
2017-11-24 20:00:00;48,0;45,59;2,41;41818;0;0;0;0;54921;7632;0.139;7687;-55
2017-11-24 21:00:00;47,98;43,2;4,78;41818;0;0;0;0;54921;6475;0.1179;6926;-451
2017-11-24 22:00:00;47,98;42,82;5,16;41818;0;0;0;0;54921;5800;0.1056;6264;-464
2017-11-24 23:00:00;40,99;34,61;6,38;41818;0;0;0;0;54921;5056;0.0921;5801;-745
2017-11-25 00:00:00;39,89;35,71;4,18;41818;0;0;0;0;54932;4981;0.0907;5144;-163
2017-11-25 01:00:00;36,19;35,06;1,13;41818;0;0;0;0;54932;4873;0.0887;4709;164
2017-11-25 02:00:00;34,49;32,6;1,89;41818;0;0;0;0;54932;4692;0.0854;4283;409
2017-11-25 03:00:00;36,2;31,8;4,4;41818;0;0;0;0;54932;4394;0.08;4002;392
2017-11-25 04:00:00;38,0;33,49;4,51;41818;0;0;0;0;54932;4594;0.0836;3815;779
2017-11-25 05:00:00;35,86;33,07;2,79;41818;0;0;0;0;54932;4818;0.0877;3788;1030
2017-11-25 06:00:00;35,03;36,04;-1,01;41818;0;0;0;0;54932;5400;0.0983;3956;1444
2017-11-25 07:00:00;42,37;38,33;4,04;41818;9;0.0002;12;-3;54932;5804;0.1057;4089;1715
2017-11-25 08:00:00;49,95;43,37;6,58;41818;307;0.0073;400;-93;54932;6517;0.1186;4255;2262
2017-11-25 09:00:00;49,94;42,71;7,23;41818;1118;0.0268;1309;-191;54932;7182;0.1307;4550;2632
2017-11-25 10:00:00;51,97;42,43;9,54;41818;2145;0.0513;2161;-16;54932;7682;0.1398;4985;2697
2017-11-25 11:00:00;53,51;42,66;10,85;41818;2853;0.0682;2624;229;54932;7600;0.1383;5593;2007
2017-11-25 12:00:00;49,96;41,49;8,47;41818;2834;0.0678;2559;275;54932;7574;0.1379;6435;1139
2017-11-25 13:00:00;46,98;39,87;7,11;41818;2208;0.0528;2093;115;54932;8617;0.1569;7346;1271
2017-11-25 14:00:00;38,98;39,04;-0,06;41818;1466;0.0351;1373;93;54932;9604;0.1748;8346;1258
2017-11-25 15:00:00;35,29;37,12;-1,83;41818;586;0.014;513;73;54932;10568;0.1924;9422;1146
2017-11-25 16:00:00;39,56;42,33;-2,77;41818;26;0.0006;39;-13;54932;12068;0.2197;10349;1719
2017-11-25 17:00:00;44,26;45,75;-1,49;41818;0;0;0;0;54932;12748;0.232;11176;1572
2017-11-25 18:00:00;38,41;39,99;-1,58;41818;0;0;0;0;54932;13385;0.2436;12015;1370
2017-11-25 19:00:00;37,93;36,66;1,27;41818;0;0;0;0;54932;14460;0.2632;13037;1423
2017-11-25 20:00:00;36,12;32,49;3,63;41818;0;0;0;0;54932;15400;0.2804;13894;1506
2017-11-25 21:00:00;32,12;27,43;4,69;41818;0;0;0;0;54932;16227;0.2954;14584;1643
2017-11-25 22:00:00;30,09;24,95;5,14;41818;0;0;0;0;54932;16954;0.3086;15371;1583
2017-11-25 23:00:00;27,58;17,94;9,64;41818;0;0;0;0;54932;17993;0.3276;16069;1924
2017-11-26 00:00:00;19,21;11,25;7,96;41818;0;0;0;0;54961;19516;0.3551;17108;2408
2017-11-26 01:00:00;12,59;8,13;4,46;41818;0;0;0;0;54961;21104;0.384;18192;2912
2017-11-26 02:00:00;11,56;6,29;5,27;41818;0;0;0;0;54961;22220;0.4043;19390;2830
2017-11-26 03:00:00;11,45;11,47;-0,02;41818;0;0;0;0;54961;23508;0.4277;20548;2960
2017-11-26 04:00:00;15,74;11,64;4,1;41818;0;0;0;0;54961;24116;0.4388;21651;2465
2017-11-26 05:00:00;12,85;11,67;1,18;41818;0;0;0;0;54961;24506;0.4459;22561;1945
2017-11-26 06:00:00;11,41;14,84;-3,43;41818;0;0;0;0;54961;25438;0.4628;23304;2134
2017-11-26 07:00:00;9,77;13,95;-4,18;41818;5;0.0001;14;-9;54961;25434;0.4628;23911;1523
2017-11-26 08:00:00;19,36;16,71;2,65;41818;631;0.0151;853;-222;54961;25014;0.4551;24335;679
2017-11-26 09:00:00;11,58;23,05;-11,47;41818;2180;0.0521;3007;-827;54961;24726;0.4499;25070;-344
2017-11-26 10:00:00;19,95;24,36;-4,41;41818;3826;0.0915;4904;-1078;54961;24915;0.4533;25977;-1062
2017-11-26 11:00:00;21,6;29,44;-7,84;41818;4812;0.1151;5841;-1029;54961;25343;0.4611;26951;-1608
2017-11-26 12:00:00;11,48;25,89;-14,41;41818;4704;0.1125;5766;-1062;54961;25873;0.4708;27742;-1869
2017-11-26 13:00:00;11,49;23,58;-12,09;41818;3615;0.0864;4868;-1253;54961;25632;0.4664;27944;-2312
2017-11-26 14:00:00;15,75;26,25;-10,5;41818;2082;0.0498;3237;-1155;54961;25127;0.4572;27534;-2407
2017-11-26 15:00:00;15,55;27,92;-12,37;41818;696;0.0167;1152;-456;54961;24838;0.4519;26581;-1743
2017-11-26 16:00:00;23,6;32,43;-8,83;41818;35;0.0008;67;-32;54961;25362;0.4615;26059;-697
2017-11-26 17:00:00;29,17;32,96;-3,79;41818;0;0;0;0;54961;26084;0.4746;25996;88
2017-11-26 18:00:00;29,43;33,45;-4,02;41818;0;0;0;0;54961;26512;0.4824;26216;296
2017-11-26 19:00:00;29,51;31,01;-1,5;41818;0;0;0;0;54961;26548;0.483;26317;231
2017-11-26 20:00:00;29,07;30,21;-1,14;41818;0;0;0;0;54961;26680;0.4854;26206;474
2017-11-26 21:00:00;29,01;29,28;-0,27;41818;0;0;0;0;54961;25900;0.4712;25982;-82
2017-11-26 22:00:00;28,37;31,19;-2,82;41818;0;0;0;0;54961;24974;0.4544;25717;-743
2017-11-26 23:00:00;21,94;30,16;-8,22;41818;0;0;0;0;54961;24618;0.4479;25363;-745
2017-11-27 00:00:00;11,47;18,34;-6,87;41822;0;0;0;0;54985;24858;0.4521;23846;1012
2017-11-27 01:00:00;14,95;15,0;-0,05;41822;0;0;0;0;54985;24758;0.4503;23483;1275
2017-11-27 02:00:00;17,06;13,77;3,29;41822;0;0;0;0;54985;24359;0.443;23236;1123
2017-11-27 03:00:00;13,06;13,33;-0,27;41822;0;0;0;0;54985;24170;0.4396;23133;1037
2017-11-27 04:00:00;10,02;11,27;-1,25;41822;0;0;0;0;54985;24484;0.4453;23288;1196
2017-11-27 05:00:00;20,96;11,68;9,28;41822;0;0;0;0;54985;25468;0.4632;23811;1657
2017-11-27 06:00:00;40,1;33,35;6,75;41822;0;0;0;0;54985;26430;0.4807;24538;1892
2017-11-27 07:00:00;36,12;35,37;0,75;41822;4;0.0001;11;-7;54985;27192;0.4945;25812;1380
2017-11-27 08:00:00;40,06;41,46;-1,4;41822;572;0.0137;635;-63;54985;28233;0.5135;27179;1054
2017-11-27 09:00:00;36,04;37,86;-1,82;41822;2366;0.0566;2188;178;54985;29514;0.5368;28843;671
2017-11-27 10:00:00;34,06;33,05;1,01;41822;4263;0.102;3526;737;54985;31027;0.5643;30214;813
2017-11-27 11:00:00;34,73;30,04;4,69;41822;4835;0.1156;4054;781;54985;32792;0.5964;31395;1397
2017-11-27 12:00:00;31,1;28,91;2,19;41822;4504;0.1077;3781;723;54985;34147;0.621;32548;1599
2017-11-27 13:00:00;32,38;29,71;2,67;41822;3174;0.0759;2840;334;54985;34820;0.6333;32881;1939
2017-11-27 14:00:00;33,33;31,54;1,79;41822;1722;0.0412;1667;55;54985;35178;0.6398;32668;2510
2017-11-27 15:00:00;34,82;33,33;1,49;41822;529;0.0126;555;-26;54985;35566;0.6468;32304;3262
2017-11-27 16:00:00;35,7;30,23;5,47;41822;14;0.0003;35;-21;54985;35520;0.646;31825;3695
2017-11-27 17:00:00;40,32;35,87;4,45;41822;0;0;0;0;54985;35272;0.6415;31194;4078
2017-11-27 18:00:00;36,7;32,32;4,38;41822;0;0;0;0;54985;34874;0.6343;30537;4337
2017-11-27 19:00:00;35,26;30,43;4,83;41822;0;0;0;0;54985;35006;0.6366;29754;5252
2017-11-27 20:00:00;35,95;28,33;7,62;41822;0;0;0;0;54985;34368;0.625;29118;5250
2017-11-27 21:00:00;30,93;22,42;8,51;41822;0;0;0;0;54985;33361;0.6067;28527;4834
2017-11-27 22:00:00;30,0;19,13;10,87;41822;0;0;0;0;54985;32358;0.5885;27929;4429
2017-11-27 23:00:00;15,87;9,86;6,01;41822;0;0;0;0;54985;32334;0.588;27564;4770
2017-11-28 00:00:00;22,5;9,37;13,13;41825;0;0;0;0;55013;32049;0.5826;29717;2332
2017-11-28 01:00:00;16,07;5,77;10,3;41825;0;0;0;0;55013;31358;0.57;29548;1810
2017-11-28 02:00:00;15,46;7,22;8,24;41825;0;0;0;0;55013;30457;0.5536;29414;1043
2017-11-28 03:00:00;16,29;8,91;7,38;41825;0;0;0;0;55013;29982;0.545;29205;777
2017-11-28 04:00:00;22,04;16,38;5,66;41825;0;0;0;0;55013;28768;0.5229;28817;-49
2017-11-28 05:00:00;24,7;23,75;0,95;41825;0;0;0;0;55013;27997;0.5089;28244;-247
2017-11-28 06:00:00;34,01;36,65;-2,64;41825;0;0;0;0;55013;27172;0.4939;27722;-550
2017-11-28 07:00:00;40,13;49,3;-9,17;41825;2;0;5;-3;55013;27149;0.4935;27375;-226
2017-11-28 08:00:00;37,78;45,33;-7,55;41825;401;0.0096;434;-33;55013;26772;0.4867;27057;-285
2017-11-28 09:00:00;36,39;39,56;-3,17;41825;1814;0.0434;1770;44;55013;25566;0.4648;26489;-923
2017-11-28 10:00:00;35,84;38,81;-2,97;41825;3224;0.0771;3204;20;55013;24814;0.451;25835;-1021
2017-11-28 11:00:00;36,05;39,07;-3,02;41825;3930;0.094;4155;-225;55013;23312;0.4238;25210;-1898
2017-11-28 12:00:00;39,91;40,56;-0,65;41825;4163;0.0995;4304;-141;55013;21642;0.3934;24337;-2695
2017-11-28 13:00:00;45,07;45,05;0,02;41825;3365;0.0804;3685;-320;55013;20707;0.3764;22704;-1997
2017-11-28 14:00:00;48,59;48,51;0,08;41825;2050;0.049;2395;-345;55013;19408;0.3528;20429;-1021
2017-11-28 15:00:00;52,94;49,13;3,81;41825;683;0.0164;797;-114;55013;17719;0.3221;18206;-487
2017-11-28 16:00:00;51,97;50,29;1,68;41825;26;0.0006;47;-21;55013;16948;0.3081;16638;310
2017-11-28 17:00:00;59,7;53,6;6,1;41825;0;0;0;0;55013;16801;0.3054;15745;1056
2017-11-28 18:00:00;52,98;48,64;4,34;41825;0;0;0;0;55013;16478;0.2996;14830;1648
2017-11-28 19:00:00;51,32;45,81;5,51;41825;0;0;0;0;55013;15899;0.289;13757;2142
2017-11-28 20:00:00;49,99;42,37;7,62;41825;0;0;0;0;55013;15298;0.2781;12719;2579
2017-11-28 21:00:00;36,59;36,65;-0,06;41825;0;0;0;0;55013;14570;0.2648;11748;2822
2017-11-28 22:00:00;36,64;34,62;2,02;41825;0;0;0;0;55013;13212;0.2402;10931;2281
2017-11-28 23:00:00;35,01;32,07;2,94;41825;0;0;0;0;55013;11973;0.2176;10111;1862
2017-11-29 00:00:00;36,56;30,81;5,75;41827;0;0;0;0;55044;10929;0.1986;8532;2397
2017-11-29 01:00:00;36,79;29,66;7,13;41827;0;0;0;0;55044;9711;0.1764;7712;1999
2017-11-29 02:00:00;35,56;29,08;6,48;41827;0;0;0;0;55044;8966;0.1629;7028;1938
2017-11-29 03:00:00;35,06;30,37;4,69;41827;0;0;0;0;55044;8527;0.1549;6404;2123
2017-11-29 04:00:00;36,17;30,6;5,57;41827;0;0;0;0;55044;8153;0.1481;5836;2317
2017-11-29 05:00:00;38,97;32,47;6,5;41827;0;0;0;0;55044;7380;0.134;5328;2052
2017-11-29 06:00:00;57,72;49,4;8,32;41827;0;0;0;0;55044;6525;0.1186;4828;1697
2017-11-29 07:00:00;84,97;75,49;9,48;41827;3;0.0001;4;-1;55044;5883;0.1069;4305;1578
2017-11-29 08:00:00;88,52;86,85;1,67;41827;570;0.0136;612;-42;55044;5532;0.1005;3804;1728
2017-11-29 09:00:00;90,1;88,47;1,63;41827;2325;0.0556;2398;-73;55044;4747;0.0862;3331;1416
2017-11-29 10:00:00;88,33;86,8;1,53;41827;4072;0.0973;4159;-87;55044;3292;0.0598;2871;421
2017-11-29 11:00:00;86,0;87,15;-1,15;41827;5174;0.1237;5193;-19;55044;2523;0.0458;2550;-27
2017-11-29 12:00:00;82,18;85,88;-3,7;41827;5106;0.122;5220;-114;55044;2225;0.0404;2324;-99
2017-11-29 13:00:00;82,4;84,71;-2,31;41827;3964;0.0948;4292;-328;55044;2185;0.0397;2111;74
2017-11-29 14:00:00;89,21;83,71;5,5;41827;2239;0.0535;2681;-442;55044;2076;0.0377;1939;137
2017-11-29 15:00:00;90,4;82,7;7,7;41827;681;0.0163;868;-187;55044;2011;0.0365;1874;137
2017-11-29 16:00:00;97,8;85,78;12,02;41827;21;0.0005;50;-29;55044;2198;0.0399;1892;306
2017-11-29 17:00:00;118,49;116,07;2,42;41827;0;0;0;0;55044;2325;0.0422;2031;294
2017-11-29 18:00:00;110,36;96,66;13,7;41827;0;0;0;0;55044;2279;0.0414;2205;74
2017-11-29 19:00:00;85,56;82,19;3,37;41827;0;0;0;0;55044;2388;0.0434;2313;75
2017-11-29 20:00:00;77,34;67,05;10,29;41827;0;0;0;0;55044;2295;0.0417;2349;-54
2017-11-29 21:00:00;64,27;56,91;7,36;41827;0;0;0;0;55044;2244;0.0408;2394;-150
2017-11-29 22:00:00;55,57;52,1;3,47;41827;0;0;0;0;55044;2088;0.0379;2493;-405
2017-11-29 23:00:00;47,71;44,13;3,58;41827;0;0;0;0;55044;2074;0.0377;2581;-507
2017-11-30 00:00:00;45,94;41,99;3,95;41844;0;0;0;0;55087;2026;0.0368;2210;-184
2017-11-30 01:00:00;38,2;39,69;-1,49;41844;0;0;0;0;55087;2062;0.0374;2260;-198
2017-11-30 02:00:00;36,97;42,84;-5,87;41844;0;0;0;0;55087;2218;0.0403;2327;-109
2017-11-30 03:00:00;36,1;41,74;-5,64;41844;0;0;0;0;55087;2586;0.047;2445;141
2017-11-30 04:00:00;38,47;42,85;-4,38;41844;0;0;0;0;55087;2459;0.0446;2630;-171
2017-11-30 05:00:00;42,72;44,14;-1,42;41844;0;0;0;0;55087;2668;0.0484;2744;-76
2017-11-30 06:00:00;53,99;52,61;1,38;41844;0;0;0;0;55087;2801;0.0508;2814;-13
2017-11-30 07:00:00;83,75;69,05;14,7;41844;0;0;2;-2;55087;2966;0.0538;2877;89
2017-11-30 08:00:00;88,16;76,02;12,14;41844;273;0.0065;278;-5;55087;2766;0.0502;2817;-51
2017-11-30 09:00:00;85,25;77,73;7,52;41844;1410;0.0337;1358;52;55087;2766;0.0502;2748;18
2017-11-30 10:00:00;86,79;78,74;8,05;41844;2534;0.0606;2721;-187;55087;2824;0.0513;2716;108
2017-11-30 11:00:00;86,7;80,0;6,7;41844;2904;0.0694;3511;-607;55087;2504;0.0455;2741;-237
2017-11-30 12:00:00;84,07;82,81;1,26;41844;2809;0.0672;3547;-738;55087;2390;0.0434;2777;-387
2017-11-30 13:00:00;83,34;83,35;-0,01;41844;2374;0.0567;2924;-550;55087;2392;0.0434;2751;-359
2017-11-30 14:00:00;82,81;81,55;1,26;41844;1525;0.0365;1785;-260;55087;2336;0.0424;2596;-260
2017-11-30 15:00:00;84,22;79,82;4,4;41844;474;0.0113;560;-86;55087;2587;0.0469;2523;64
2017-11-30 16:00:00;86,06;86,57;-0,51;41844;11;0.0002;35;-24;55087;3067;0.0557;2503;564
2017-11-30 17:00:00;100,12;95,31;4,81;41844;0;0;0;0;55087;3414;0.062;2671;743
2017-11-30 18:00:00;95,1;80,11;14,99;41844;0;0;0;0;55087;3449;0.0626;2961;488
2017-11-30 19:00:00;87,24;71,64;15,6;41844;0;0;0;0;55087;3250;0.059;3158;92
2017-11-30 20:00:00;68,5;63,59;4,91;41844;0;0;0;0;55087;3126;0.0567;3256;-130
2017-11-30 21:00:00;51,96;50,87;1,09;41844;0;0;0;0;55087;2832;0.0514;3387;-555
2017-11-30 22:00:00;38,45;40,85;-2,4;41844;0;0;0;0;55087;2829;0.0514;3559;-730
2017-11-30 23:00:00;36,67;38,8;-2,13;41844;0;0;0;0;55087;2898;0.0526;3709;-811
2017-01-12 00:00:00;35,82;34,6;1,22;41847;0;0;0;0;55143;3199;0.058;3736;-537
2017-01-12 01:00:00;38,59;35,38;3,21;41847;0;0;0;0;55143;3170;0.0575;3820;-650
2017-01-12 02:00:00;37,18;35,16;2,02;41847;0;0;0;0;55143;3000;0.0544;3921;-921
2017-01-12 03:00:00;37,0;35,07;1,93;41847;0;0;0;0;55143;2911;0.0528;4054;-1143
2017-01-12 04:00:00;37,42;36,93;0,49;41847;0;0;0;0;55143;2876;0.0522;4201;-1325
2017-01-12 05:00:00;36,14;36,82;-0,68;41847;0;0;0;0;55143;2808;0.0509;4341;-1533
2017-01-12 06:00:00;55,97;55,29;0,68;41847;0;0;0;0;55143;2506;0.0454;4496;-1990
2017-01-12 07:00:00;81,69;77,94;3,75;41847;1;0;4;-3;55143;2414;0.0438;4600;-2186
2017-01-12 08:00:00;75,01;73,42;1,59;41847;412;0.0099;475;-63;55143;2471;0.0448;4531;-2060
2017-01-12 09:00:00;72,89;72,02;0,87;41847;1674;0.04;2301;-627;55143;2374;0.0431;4389;-2015
2017-01-12 10:00:00;70,38;69,88;0,5;41847;3048;0.0728;4255;-1207;55143;2029;0.0368;4070;-2041
2017-01-12 11:00:00;74,87;75,14;-0,27;41847;4150;0.0992;5406;-1256;55143;1963;0.0356;3613;-1650
2017-01-12 12:00:00;74,91;74,27;0,64;41847;3957;0.0946;5439;-1482;55143;1630;0.0296;3181;-1551
2017-01-12 13:00:00;73,18;72,79;0,39;41847;3260;0.0779;4506;-1246;55143;1579;0.0286;2859;-1280
2017-01-12 14:00:00;72,5;69,94;2,56;41847;2068;0.0494;2847;-779;55143;1911;0.0346;2725;-814
2017-01-12 15:00:00;74,42;66,69;7,73;41847;676;0.0161;947;-271;55143;2104;0.0382;2735;-631
2017-01-12 16:00:00;76,6;66,13;10,47;41847;20;0.0005;44;-24;55143;2300;0.0418;2768;-468
2017-01-12 17:00:00;85,69;73,64;12,05;41847;0;0;0;0;55143;2298;0.0417;2788;-490
2017-01-12 18:00:00;82,57;62,59;19,98;41847;0;0;0;0;55143;2297;0.0416;2770;-473
2017-01-12 19:00:00;77,38;58,47;18,91;41847;0;0;0;0;55143;1961;0.0356;2627;-666
2017-01-12 20:00:00;61,95;54,23;7,72;41847;0;0;0;0;55143;1802;0.0327;2372;-570
2017-01-12 21:00:00;52,93;44,18;8,75;41847;0;0;0;0;55143;1662;0.0302;2162;-500
2017-01-12 22:00:00;41,58;38,37;3,21;41847;0;0;0;0;55143;1584;0.0287;2031;-447
2017-01-12 23:00:00;37,94;37,24;0,7;41847;0;0;0;0;55143;1408;0.0255;2007;-599
2017-02-12 00:00:00;39,9;36,98;2,92;41847;0;0;0;0;55181;1265;0.0229;1527;-262
2017-02-12 01:00:00;39,02;35,52;3,5;41847;0;0;0;0;55181;1262;0.0229;1604;-342
2017-02-12 02:00:00;37,89;36,45;1,44;41847;0;0;0;0;55181;1296;0.0235;1679;-383
2017-02-12 03:00:00;37,82;36,07;1,75;41847;0;0;0;0;55181;1424;0.0258;1834;-410
2017-02-12 04:00:00;34,7;35,69;-0,99;41847;0;0;0;0;55181;1528;0.0276;2132;-604
2017-02-12 05:00:00;36,75;35,97;0,78;41847;0;0;0;0;55181;1697;0.0308;2526;-829
2017-02-12 06:00:00;34,07;36,85;-2,78;41847;0;0;0;0;55181;2100;0.0381;2927;-827
2017-02-12 07:00:00;37,01;41,17;-4,16;41847;0;0;5;-5;55181;2433;0.0441;3325;-892
2017-02-12 08:00:00;46,17;48,83;-2,66;41847;352;0.0084;642;-290;55181;2911;0.0528;3724;-813
2017-02-12 09:00:00;46,1;51,16;-5,06;41847;1627;0.0389;2808;-1181;55181;3267;0.0592;4193;-926
2017-02-12 10:00:00;42,33;52,36;-10,03;41847;2896;0.0692;5268;-2372;55181;3808;0.069;4635;-827
2017-02-12 11:00:00;44,02;54,36;-10,34;41847;3522;0.0842;6807;-3285;55181;4551;0.0825;5077;-526
2017-02-12 12:00:00;40,0;52,9;-12,9;41847;3451;0.0825;6964;-3513;55181;5042;0.0914;5548;-506
2017-02-12 13:00:00;37,28;51,55;-14,27;41847;2731;0.0653;5807;-3076;55181;5780;0.1048;6067;-287
2017-02-12 14:00:00;38,21;51,09;-12,88;41847;1492;0.0356;3687;-2195;55181;6102;0.1106;6576;-474
2017-02-12 15:00:00;46,13;51,73;-5,6;41847;382;0.0091;1246;-864;55181;6402;0.116;7150;-748
2017-02-12 16:00:00;47,96;52,78;-4,82;41847;6;0.0002;64;-58;55181;6725;0.1219;7763;-1038
2017-02-12 17:00:00;47,95;55,14;-7,19;41847;0;0;0;0;55181;7248;0.1314;8473;-1225
2017-02-12 18:00:00;42,99;53,21;-10,22;41847;0;0;0;0;55181;7766;0.1407;9168;-1402
2017-02-12 19:00:00;39,37;45,37;-6,0;41847;0;0;0;0;55181;8316;0.1507;9693;-1377
2017-02-12 20:00:00;36,79;39,52;-2,73;41847;0;0;0;0;55181;8890;0.1611;10054;-1164
2017-02-12 21:00:00;38,52;37,84;0,68;41847;0;0;0;0;55181;8945;0.1621;10415;-1470
2017-02-12 22:00:00;39,92;41,36;-1,44;41847;0;0;0;0;55181;8952;0.1623;10751;-1799
2017-02-12 23:00:00;35,68;39,62;-3,94;41847;0;0;0;0;55181;9540;0.1729;11052;-1512
2017-03-12 00:00:00;33,17;35,13;-1,96;41847;0;0;0;0;55201;10289;0.1864;11180;-891
2017-03-12 01:00:00;31,93;31,91;0,02;41847;0;0;0;0;55201;10740;0.1946;11597;-857
2017-03-12 02:00:00;30,43;29,65;0,78;41847;0;0;0;0;55201;11067;0.2005;11948;-881
2017-03-12 03:00:00;28,3;27,42;0,88;41847;0;0;0;0;55201;11598;0.2101;12360;-762
2017-03-12 04:00:00;30,44;30,67;-0,23;41847;0;0;0;0;55201;12436;0.2253;12739;-303
2017-03-12 05:00:00;29,87;28,39;1,48;41847;0;0;0;0;55201;13500;0.2446;12971;529
2017-03-12 06:00:00;29,81;24,35;5,46;41847;0;0;0;0;55201;14360;0.2602;13228;1132
2017-03-12 07:00:00;27,72;22,31;5,41;41847;1;0;2;-1;55201;14118;0.2558;13604;514
2017-03-12 08:00:00;29,95;27,65;2,3;41847;280;0.0067;592;-312;55201;14338;0.2598;14048;290
2017-03-12 09:00:00;33,08;34,19;-1,11;41847;1311;0.0314;2263;-952;55201;14780;0.2678;14516;264
2017-03-12 10:00:00;34,85;37,2;-2,35;41847;2290;0.0547;3800;-1510;55201;15347;0.278;14834;513
2017-03-12 11:00:00;36,91;38,28;-1,37;41847;2790;0.0666;4618;-1828;55201;16094;0.2915;15064;1030
2017-03-12 12:00:00;37,0;34,46;2,54;41847;2677;0.064;4534;-1857;55201;17190;0.3114;15353;1837
2017-03-12 13:00:00;32,92;29,12;3,8;41847;1932;0.0462;3653;-1721;55201;17667;0.32;15626;2041
2017-03-12 14:00:00;34,06;28,63;5,43;41847;946;0.0226;2217;-1271;55201;17588;0.3186;15870;1718
2017-03-12 15:00:00;34,29;29,75;4,54;41847;182;0.0044;675;-493;55201;17692;0.3205;16162;1530
2017-03-12 16:00:00;36,97;28,75;8,22;41847;2;0;26;-24;55201;17826;0.323;16535;1291
2017-03-12 17:00:00;39,36;32,66;6,7;41847;0;0;0;0;55201;17893;0.3242;16938;955
2017-03-12 18:00:00;39,0;33,86;5,14;41847;0;0;0;0;55201;17977;0.3256;17352;625
2017-03-12 19:00:00;37,06;31,64;5,42;41847;0;0;0;0;55201;18270;0.331;17657;613
2017-03-12 20:00:00;36,03;31,17;4,86;41847;0;0;0;0;55201;18642;0.3377;17960;682
2017-03-12 21:00:00;33,95;30,17;3,78;41847;0;0;0;0;55201;19044;0.345;18323;721
2017-03-12 22:00:00;33,98;30,25;3,73;41847;0;0;0;0;55201;19458;0.3525;18750;708
2017-03-12 23:00:00;28,25;28,99;-0,74;41847;0;0;0;0;55201;19657;0.3561;19274;383
2017-04-12 00:00:00;12,05;19,41;-7,36;41849;0;0;0;0;55234;20208;0.3658;20270;-62
2017-04-12 01:00:00;17,69;23,92;-6,23;41849;0;0;0;0;55234;20261;0.3668;20673;-412
2017-04-12 02:00:00;15,31;19,62;-4,31;41849;0;0;0;0;55234;20521;0.3715;21093;-572
2017-04-12 03:00:00;12,75;22,52;-9,77;41849;0;0;0;0;55234;21082;0.3817;21614;-532
2017-04-12 04:00:00;17,18;28,43;-11,25;41849;0;0;0;0;55234;21616;0.3914;22085;-469
2017-04-12 05:00:00;25,05;32,74;-7,69;41849;0;0;0;0;55234;22067;0.3995;22507;-440
2017-04-12 06:00:00;33,19;40,62;-7,43;41849;0;0;0;0;55234;21854;0.3957;22762;-908
2017-04-12 07:00:00;38,56;50,96;-12,4;41849;0;0;1;-1;55234;21570;0.3905;22764;-1194
2017-04-12 08:00:00;42,9;52,32;-9,42;41849;108;0.0026;184;-76;55234;21249;0.3847;22547;-1298
2017-04-12 09:00:00;38,29;50,72;-12,43;41849;749;0.0179;949;-200;55234;20435;0.37;22204;-1769
2017-04-12 10:00:00;37,06;50,03;-12,97;41849;1494;0.0357;1815;-321;55234;20074;0.3634;21895;-1821
2017-04-12 11:00:00;38,94;52,69;-13,75;41849;2114;0.0505;2379;-265;55234;19326;0.3499;21638;-2312
2017-04-12 12:00:00;36,36;51,86;-15,5;41849;2472;0.0591;2436;36;55234;18994;0.3439;21395;-2401
2017-04-12 13:00:00;39,45;53,69;-14,24;41849;2149;0.0514;1948;201;55234;18729;0.3391;20936;-2207
2017-04-12 14:00:00;43,97;55,24;-11,27;41849;1320;0.0316;1110;210;55234;17947;0.3249;20068;-2121
2017-04-12 15:00:00;46,14;56,78;-10,64;41849;336;0.008;297;39;55234;17352;0.3142;19195;-1843
2017-04-12 16:00:00;50,96;56,2;-5,24;41849;5;0.0001;13;-8;55234;17066;0.309;18430;-1364
2017-04-12 17:00:00;51,04;53,65;-2,61;41849;0;0;0;0;55234;17323;0.3136;17874;-551
2017-04-12 18:00:00;48,85;52,33;-3,48;41849;0;0;0;0;55234;17996;0.3258;17390;606
2017-04-12 19:00:00;45,6;48,49;-2,89;41849;0;0;0;0;55234;18629;0.3373;16923;1706
2017-04-12 20:00:00;42,38;42,12;0,26;41849;0;0;0;0;55234;19560;0.3541;16480;3080
2017-04-12 21:00:00;39,83;34,47;5,36;41849;0;0;0;0;55234;20354;0.3685;16239;4115
2017-04-12 22:00:00;33,53;28,57;4,96;41849;0;0;0;0;55234;21543;0.39;16415;5128
2017-04-12 23:00:00;30,03;26,08;3,95;41849;0;0;0;0;55234;21936;0.3972;16988;4948
2017-05-12 00:00:00;28,69;22,25;6,44;41859;0;0;0;0;55263;22314;0.4038;19100;3214
2017-05-12 01:00:00;28,01;23,66;4,35;41859;0;0;0;0;55263;22289;0.4034;19718;2571
2017-05-12 02:00:00;26,88;24,02;2,86;41859;0;0;0;0;55263;22343;0.4043;20088;2255
2017-05-12 03:00:00;27,93;24,84;3,09;41859;0;0;0;0;55263;22357;0.4046;20456;1901
2017-05-12 04:00:00;28,23;26,96;1,27;41859;0;0;0;0;55263;22847;0.4134;20776;2071
2017-05-12 05:00:00;30,73;27,63;3,1;41859;0;0;0;0;55263;23205;0.4199;21014;2191
2017-05-12 06:00:00;35,39;32,41;2,98;41859;0;0;0;0;55263;23611;0.4272;21301;2310
2017-05-12 07:00:00;39,69;35,95;3,74;41859;0;0;1;-1;55263;24438;0.4422;21620;2818
2017-05-12 08:00:00;40,05;37,91;2,14;41859;155;0.0037;156;-1;55263;24919;0.4509;21956;2963
2017-05-12 09:00:00;40,36;36,05;4,31;41859;890;0.0212;746;144;55263;24792;0.4486;22496;2296
2017-05-12 10:00:00;47,59;38,5;9,09;41859;1804;0.0431;1548;256;55263;24606;0.4452;23056;1550
2017-05-12 11:00:00;46,78;38,33;8,45;41859;2270;0.0542;2149;121;55263;25118;0.4545;23573;1545
2017-05-12 12:00:00;44,07;37,7;6,37;41859;2435;0.0582;2222;213;55263;25423;0.4601;24006;1417
2017-05-12 13:00:00;42,45;36,77;5,68;41859;1947;0.0465;1829;118;55263;25748;0.4659;24200;1548
2017-05-12 14:00:00;39,97;36,36;3,61;41859;1130;0.027;1125;5;55263;25975;0.47;24275;1700
2017-05-12 15:00:00;39,05;37,45;1,6;41859;315;0.0076;383;-68;55263;26629;0.4819;24235;2394
2017-05-12 16:00:00;39,05;34,17;4,88;41859;7;0.0002;22;-15;55263;27210;0.4924;24404;2806
2017-05-12 17:00:00;43,96;37,5;6,46;41859;0;0;0;0;55263;27378;0.4954;24801;2577
2017-05-12 18:00:00;40,04;40,47;-0,43;41859;0;0;0;0;55263;27535;0.4982;25245;2290
2017-05-12 19:00:00;46,04;41,74;4,3;41859;0;0;0;0;55263;27676;0.5008;25599;2077
2017-05-12 20:00:00;35,35;35,14;0,21;41859;0;0;0;0;55263;28068;0.5079;25915;2153
2017-05-12 21:00:00;30,03;27,13;2,9;41859;0;0;0;0;55263;27744;0.502;26249;1495
2017-05-12 22:00:00;28,06;24,92;3,14;41859;0;0;0;0;55263;27140;0.4911;26584;556
2017-05-12 23:00:00;13,45;20,33;-6,88;41859;0;0;0;0;55263;27182;0.4919;26879;303
2017-06-12 00:00:00;14,34;17,56;-3,22;41861;0;0;0;0;55290;27255;0.493;27789;-534
2017-06-12 01:00:00;12,34;16,45;-4,11;41861;0;0;0;0;55290;27388;0.4954;28062;-674
2017-06-12 02:00:00;9,71;15,09;-5,38;41861;0;0;0;0;55290;27310;0.4939;28269;-959
2017-06-12 03:00:00;12,7;14,89;-2,19;41861;0;0;0;0;55290;27294;0.4937;28394;-1100
2017-06-12 04:00:00;14,04;19,09;-5,05;41861;0;0;0;0;55290;27776;0.5024;28442;-666
2017-06-12 05:00:00;13,27;19,54;-6,27;41861;0;0;0;0;55290;28036;0.5071;28448;-412
2017-06-12 06:00:00;29,57;32,83;-3,26;41861;0;0;0;0;55290;28656;0.5183;28521;135
2017-06-12 07:00:00;38,24;40,28;-2,04;41861;0;0;1;-1;55290;28458;0.5147;28572;-114
2017-06-12 08:00:00;37,59;41,71;-4,12;41861;96;0.0023;217;-121;55290;28130;0.5088;28491;-361
2017-06-12 09:00:00;39,13;41,94;-2,81;41861;564;0.0135;1021;-457;55290;27716;0.5013;28515;-799
2017-06-12 10:00:00;38,22;46,41;-8,19;41861;1210;0.0289;2024;-814;55290;27618;0.4995;28595;-977
2017-06-12 11:00:00;34,6;45,15;-10,55;41861;1610;0.0384;2758;-1148;55290;27676;0.5006;28648;-972
2017-06-12 12:00:00;34,59;45,75;-11,16;41861;1665;0.0398;2893;-1228;55290;27288;0.4935;28542;-1254
2017-06-12 13:00:00;36,48;46,9;-10,42;41861;1411;0.0337;2456;-1045;55290;26886;0.4863;28143;-1257
2017-06-12 14:00:00;39,81;49,04;-9,23;41861;828;0.0198;1549;-721;55290;26341;0.4764;27492;-1151
2017-06-12 15:00:00;39,0;46,17;-7,17;41861;228;0.0054;520;-292;55290;25816;0.4669;26557;-741
2017-06-12 16:00:00;40,9;47,97;-7,07;41861;6;0.0002;25;-19;55290;25151;0.4549;25688;-537
2017-06-12 17:00:00;45,69;52,74;-7,05;41861;0;0;0;0;55290;25081;0.4536;25155;-74
2017-06-12 18:00:00;41,96;48,73;-6,77;41861;0;0;0;0;55290;24967;0.4516;24876;91
2017-06-12 19:00:00;39,95;45,51;-5,56;41861;0;0;0;0;55290;24233;0.4383;24656;-423
2017-06-12 20:00:00;39,01;42,17;-3,16;41861;0;0;0;0;55290;24010;0.4343;24520;-510
2017-06-12 21:00:00;38,98;39,5;-0,52;41861;0;0;0;0;55290;24259;0.4388;24482;-223
2017-06-12 22:00:00;31,97;37,16;-5,19;41861;0;0;0;0;55290;23816;0.4308;24465;-649
2017-06-12 23:00:00;27,95;32,21;-4,26;41861;0;0;0;0;55290;24166;0.4371;24501;-335
2017-07-12 00:00:00;30,47;32,14;-1,67;41863;0;0;0;0;55317;24429;0.4416;24373;56
2017-07-12 01:00:00;29,43;32,81;-3,38;41863;0;0;0;0;55317;24478;0.4425;24498;-20
2017-07-12 02:00:00;26,57;26,87;-0,3;41863;0;0;0;0;55317;24456;0.4421;24549;-93
2017-07-12 03:00:00;27,36;24,05;3,31;41863;0;0;0;0;55317;24616;0.445;24665;-49
2017-07-12 04:00:00;30,01;28,22;1,79;41863;0;0;0;0;55317;25245;0.4564;24986;259
2017-07-12 05:00:00;32,07;30,06;2,01;41863;0;0;0;0;55317;25658;0.4638;25594;64
2017-07-12 06:00:00;44,72;41,46;3,26;41863;0;0;0;0;55317;26614;0.4811;26325;289
2017-07-12 07:00:00;51,98;46,46;5,52;41863;0;0;2;-2;55317;27726;0.5012;27122;604
2017-07-12 08:00:00;48,53;43,57;4,96;41863;494;0.0118;675;-181;55317;28583;0.5167;27910;673
2017-07-12 09:00:00;43,85;41,9;1,95;41863;2958;0.0707;3390;-432;55317;29300;0.5297;28653;647
2017-07-12 10:00:00;38,55;35,69;2,86;41863;6119;0.1462;6551;-432;55317;30311;0.5479;29235;1076
2017-07-12 11:00:00;33,1;30,85;2,25;41863;8748;0.209;8653;95;55317;30964;0.5598;29723;1241
2017-07-12 12:00:00;30,04;27,37;2,67;41863;9650;0.2306;8955;695;55317;31390;0.5674;30237;1153
2017-07-12 13:00:00;31,06;24,97;6,09;41863;8304;0.1984;7505;799;55317;32210;0.5822;31015;1195
2017-07-12 14:00:00;32,06;23,51;8,55;41863;5138;0.1228;4735;403;55317;32806;0.5931;32185;621
2017-07-12 15:00:00;37,23;27,67;9,56;41863;1556;0.0372;1531;25;55317;34237;0.6189;33651;586
2017-07-12 16:00:00;38,53;33,74;4,79;41863;27;0.0006;54;-27;55317;35512;0.642;35040;472
2017-07-12 17:00:00;39,73;34,22;5,51;41863;0;0;0;0;55317;37150;0.6716;36028;1122
2017-07-12 18:00:00;37,49;33,77;3,72;41863;0;0;0;0;55317;37872;0.6846;36555;1317
2017-07-12 19:00:00;32,07;30,41;1,66;41863;0;0;0;0;55317;37516;0.6782;36464;1052
2017-07-12 20:00:00;28,06;23,68;4,38;41863;0;0;0;0;55317;36592;0.6615;35718;874
2017-07-12 21:00:00;27,5;19,64;7,86;41863;0;0;0;0;55317;34830;0.6296;34746;84
2017-07-12 22:00:00;26,42;17,04;9,38;41863;0;0;0;0;55317;32563;0.5887;33612;-1049
2017-07-12 23:00:00;22,61;17,14;5,47;41863;0;0;0;0;55317;31675;0.5726;32189;-514
2017-08-12 00:00:00;13,45;10,59;2,86;41865;0;0;0;0;55364;31421;0.5676;29905;1516
2017-08-12 01:00:00;12,2;10,63;1,57;41865;0;0;0;0;55364;30288;0.5471;28694;1594
2017-08-12 02:00:00;10,5;10,13;0,37;41865;0;0;0;0;55364;28780;0.5198;27613;1167
2017-08-12 03:00:00;18,93;11,8;7,13;41865;0;0;0;0;55364;27918;0.5042;26509;1409
2017-08-12 04:00:00;24,56;12,79;11,77;41865;0;0;0;0;55364;27581;0.4982;25719;1862
2017-08-12 05:00:00;23,05;11,27;11,78;41865;0;0;0;0;55364;26868;0.4853;25011;1857
2017-08-12 06:00:00;35,88;18,22;17,66;41865;0;0;0;0;55364;27532;0.4973;24479;3053
2017-08-12 07:00:00;37,7;23,41;14,29;41865;0;0;1;-1;55364;27007;0.4878;24352;2655
2017-08-12 08:00:00;46,04;30,27;15,77;41865;323;0.0077;303;20;55364;26563;0.4798;24522;2041
2017-08-12 09:00:00;43,93;32,43;11,5;41865;1881;0.0449;1695;186;55364;26128;0.4719;25055;1073
2017-08-12 10:00:00;37,99;30,75;7,24;41865;3425;0.0818;3360;65;55364;27243;0.4921;25969;1274
2017-08-12 11:00:00;41,51;33,24;8,27;41865;4008;0.0958;4427;-419;55364;28998;0.5237;27109;1889
2017-08-12 12:00:00;34,21;29,36;4,85;41865;4389;0.1048;4539;-150;55364;28684;0.5181;27935;749
2017-08-12 13:00:00;32,1;30,64;1,46;41865;3829;0.0914;3836;-7;55364;27739;0.501;28156;-417
2017-08-12 14:00:00;32,17;37,44;-5,27;41865;2081;0.0497;2423;-342;55364;27518;0.497;27791;-273
2017-08-12 15:00:00;37,98;37,81;0,17;41865;556;0.0133;748;-192;55364;27096;0.4895;27272;-176
2017-08-12 16:00:00;41,57;37,93;3,64;41865;12;0.0003;28;-16;55364;26492;0.4785;26905;-413
2017-08-12 17:00:00;40,73;37,46;3,27;41865;0;0;0;0;55364;27103;0.4895;26896;207
2017-08-12 18:00:00;39,96;36,44;3,52;41865;0;0;0;0;55364;26632;0.481;27137;-505
2017-08-12 19:00:00;38,57;34,86;3,71;41865;0;0;0;0;55364;26359;0.4761;27418;-1059
2017-08-12 20:00:00;32,32;34,14;-1,82;41865;0;0;0;0;55364;26076;0.471;27569;-1493
2017-08-12 21:00:00;28,0;32,43;-4,43;41865;0;0;0;0;55364;25670;0.4637;27709;-2039
2017-08-12 22:00:00;23,1;32,21;-9,11;41865;0;0;0;0;55364;25420;0.4592;27983;-2563
2017-08-12 23:00:00;9,29;18,67;-9,38;41865;0;0;0;0;55364;25964;0.469;28338;-2374
2017-09-12 00:00:00;15,03;14,88;0,15;41865;0;0;0;0;55366;27171;0.4908;27805;-634
2017-09-12 01:00:00;12,51;10,45;2,06;41865;0;0;0;0;55366;28319;0.5115;28338;-19
2017-09-12 02:00:00;10,31;7,29;3,02;41865;0;0;0;0;55366;28744;0.5191;28781;-37
2017-09-12 03:00:00;9,26;2,32;6,94;41865;0;0;0;0;55366;28874;0.5215;29130;-256
2017-09-12 04:00:00;9,12;7,42;1,7;41865;0;0;0;0;55366;28747;0.5192;29497;-750
2017-09-12 05:00:00;8,92;7,74;1,18;41865;0;0;0;0;55366;28294;0.511;29771;-1477
2017-09-12 06:00:00;10,06;9,16;0,9;41865;0;0;0;0;55366;29046;0.5246;29951;-905
2017-09-12 07:00:00;12,15;16,41;-4,26;41865;0;0;0;0;55366;30074;0.5432;29847;227
2017-09-12 08:00:00;12,41;12,69;-0,28;41865;112;0.0027;222;-110;55366;30262;0.5466;29579;683
2017-09-12 09:00:00;18,07;13,87;4,2;41865;790;0.0189;1311;-521;55366;31053;0.5609;29476;1577
2017-09-12 10:00:00;18,96;16,42;2,54;41865;1648;0.0393;2679;-1031;55366;30778;0.5559;29440;1338
2017-09-12 11:00:00;16,25;19,09;-2,84;41865;2217;0.053;3662;-1445;55366;31175;0.5631;29670;1505
2017-09-12 12:00:00;15,03;18,58;-3,55;41865;2653;0.0633;3976;-1323;55366;31052;0.5609;30087;965
2017-09-12 13:00:00;12,39;14,42;-2,03;41865;2536;0.0606;3489;-953;55366;30586;0.5524;30144;442
2017-09-12 14:00:00;12,53;14,94;-2,41;41865;1787;0.0427;2285;-498;55366;30103;0.5437;29757;346
2017-09-12 15:00:00;19,41;17,46;1,95;41865;592;0.0142;778;-186;55366;29215;0.5277;29158;57
2017-09-12 16:00:00;26,51;28,82;-2,31;41865;9;0.0002;31;-22;55366;29048;0.5247;28934;114
2017-09-12 17:00:00;31,67;34,6;-2,93;41865;0;0;0;0;55366;29241;0.5282;29064;177
2017-09-12 18:00:00;28,45;30,41;-1,96;41865;0;0;0;0;55366;29031;0.5244;29351;-320
2017-09-12 19:00:00;24,56;29,35;-4,79;41865;0;0;0;0;55366;29539;0.5335;29517;22
2017-09-12 20:00:00;15,8;13,36;2,44;41865;0;0;0;0;55366;30292;0.5471;29500;792
2017-09-12 21:00:00;13,01;7,08;5,93;41865;0;0;0;0;55366;30327;0.5478;29246;1081
2017-09-12 22:00:00;15,04;8,29;6,75;41865;0;0;0;0;55366;29352;0.5302;28925;427
2017-09-12 23:00:00;10,16;6,98;3,18;41865;0;0;0;0;55366;29662;0.5358;28500;1162
2017-10-12 00:00:00;14,31;-1,37;15,68;41865;0;0;0;0;55366;29503;0.5329;26683;2820
2017-10-12 01:00:00;10,92;-2,23;13,15;41865;0;0;0;0;55366;28904;0.5221;26250;2654
2017-10-12 02:00:00;10,17;-4,47;14,64;41865;0;0;0;0;55366;27857;0.5032;26060;1797
2017-10-12 03:00:00;12,09;0,51;11,58;41865;0;0;0;0;55366;26316;0.4754;25459;857
2017-10-12 04:00:00;15,06;4,0;11,06;41865;0;0;0;0;55366;25615;0.4627;24456;1159
2017-10-12 05:00:00;12,23;3,49;8,74;41865;0;0;0;0;55366;24265;0.4382;23172;1093
2017-10-12 06:00:00;12,28;6,19;6,09;41865;0;0;0;0;55366;23035;0.416;22051;984
2017-10-12 07:00:00;20,68;14,49;6,19;41865;0;0;1;-1;55366;21989;0.3972;21289;700
2017-10-12 08:00:00;27,85;27,7;0,15;41865;444;0.0106;383;61;55366;21230;0.3834;21023;207
2017-10-12 09:00:00;28,56;29,09;-0,53;41865;1724;0.0412;1783;-59;55366;20820;0.376;21005;-185
2017-10-12 10:00:00;29,15;28,78;0,37;41865;2472;0.059;3039;-567;55366;21124;0.3815;21218;-94
2017-10-12 11:00:00;29,57;32,16;-2,59;41865;2219;0.053;3505;-1286;55366;21153;0.382;21435;-282
2017-10-12 12:00:00;29,26;33,82;-4,56;41865;1616;0.0386;3091;-1475;55366;21024;0.3797;21813;-789
2017-10-12 13:00:00;28,24;37,58;-9,34;41865;962;0.023;1966;-1004;55366;21878;0.3952;22780;-902
2017-10-12 14:00:00;25,07;34,28;-9,21;41865;401;0.0096;908;-507;55366;23906;0.4318;24768;-862
2017-10-12 15:00:00;9,12;28,47;-19,35;41865;80;0.0019;214;-134;55366;26526;0.4791;27133;-607
2017-10-12 16:00:00;9,19;27,79;-18,6;41865;4;0.0001;8;-4;55366;28423;0.5134;29039;-616
2017-10-12 17:00:00;17,42;33,51;-16,09;41865;0;0;0;0;55366;29556;0.5338;30267;-711
2017-10-12 18:00:00;15,02;33,07;-18,05;41865;0;0;0;0;55366;30697;0.5544;30982;-285
2017-10-12 19:00:00;12,05;26,96;-14,91;41865;0;0;0;0;55366;31528;0.5694;31301;227
2017-10-12 20:00:00;12,27;21,44;-9,17;41865;0;0;0;0;55366;31354;0.5663;31077;277
2017-10-12 21:00:00;12,16;20,35;-8,19;41865;0;0;0;0;55366;30650;0.5536;30735;-85
2017-10-12 22:00:00;14,81;19,91;-5,1;41865;0;0;0;0;55366;29141;0.5263;30197;-1056
2017-10-12 23:00:00;12,13;17,74;-5,61;41865;0;0;0;0;55366;28640;0.5173;29121;-481
2017-11-12 00:00:00;15,03;22,2;-7,17;41876;0;0;0;0;55411;27313;0.4929;27893;-580
2017-11-12 01:00:00;10,87;21,55;-10,68;41876;0;0;0;0;55411;25767;0.465;26540;-773
2017-11-12 02:00:00;12,59;20,87;-8,28;41876;0;0;0;0;55411;22802;0.4115;24011;-1209
2017-11-12 03:00:00;11,75;20,81;-9,06;41876;0;0;0;0;55411;20248;0.3654;20933;-685
2017-11-12 04:00:00;12,78;19,79;-7,01;41876;0;0;0;0;55411;17066;0.308;17757;-691
2017-11-12 05:00:00;23,22;29,67;-6,45;41876;0;0;0;0;55411;13727;0.2477;15006;-1279
2017-11-12 06:00:00;47,95;48,32;-0,37;41876;0;0;0;0;55411;11205;0.2022;12152;-947
2017-11-12 07:00:00;62,0;60,83;1,17;41876;0;0;0;0;55411;11001;0.1986;10037;964
2017-11-12 08:00:00;63,01;56,73;6,28;41876;88;0.0021;145;-57;55411;10739;0.1938;9041;1698
2017-11-12 09:00:00;60,2;52,13;8,07;41876;556;0.0133;829;-273;55411;10202;0.1841;8488;1714
2017-11-12 10:00:00;62,93;49,21;13,72;41876;1010;0.0241;1604;-594;55411;10204;0.1842;8196;2008
2017-11-12 11:00:00;61,95;50,14;11,81;41876;1106;0.0264;1990;-884;55411;10689;0.1929;8145;2544
2017-11-12 12:00:00;64,98;54,56;10,42;41876;1132;0.027;1935;-803;55411;11428;0.2062;8442;2986
2017-11-12 13:00:00;58,23;48,53;9,7;41876;925;0.0221;1533;-608;55411;12599;0.2274;9024;3575
2017-11-12 14:00:00;53,84;46,07;7,77;41876;628;0.015;907;-279;55411;14636;0.2641;10181;4455
2017-11-12 15:00:00;51,91;42,6;9,31;41876;218;0.0052;267;-49;55411;16143;0.2913;11886;4257
2017-11-12 16:00:00;53,38;43,08;10,3;41876;6;0.0002;11;-5;55411;18386;0.3318;13914;4472
2017-11-12 17:00:00;51,87;44,72;7,15;41876;0;0;0;0;55411;19547;0.3528;16039;3508
2017-11-12 18:00:00;47,4;45,0;2,4;41876;0;0;0;0;55411;20056;0.3619;17719;2337
2017-11-12 19:00:00;39,68;40,05;-0,37;41876;0;0;0;0;55411;22072;0.3984;18859;3213
2017-11-12 20:00:00;40,7;38,78;1,92;41876;0;0;0;0;55411;23314;0.4208;19400;3914
2017-11-12 21:00:00;34,43;29,57;4,86;41876;0;0;0;0;55411;23345;0.4213;19681;3664
2017-11-12 22:00:00;31,95;30,29;1,66;41876;0;0;0;0;55411;22812;0.4117;19895;2917
2017-11-12 23:00:00;27,35;24,1;3,25;41876;0;0;0;0;55411;23053;0.416;20032;3021
2017-12-12 00:00:00;24,52;16,9;7,62;41879;0;0;0;0;55437;24068;0.4342;23340;728
2017-12-12 01:00:00;22,21;12,2;10,01;41879;0;0;0;0;55437;24866;0.4485;23942;924
2017-12-12 02:00:00;14,58;5,67;8,91;41879;0;0;0;0;55437;26016;0.4693;24725;1291
2017-12-12 03:00:00;12,31;6,74;5,57;41879;0;0;0;0;55437;26621;0.4802;25729;892
2017-12-12 04:00:00;14,2;7,56;6,64;41879;0;0;0;0;55437;27062;0.4881;26647;415
2017-12-12 05:00:00;26,14;21,67;4,47;41879;0;0;0;0;55437;27916;0.5035;27503;413
2017-12-12 06:00:00;30,89;31,56;-0,67;41879;0;0;0;0;55437;29562;0.5332;28304;1258
2017-12-12 07:00:00;32,32;33,37;-1,05;41879;0;0;0;0;55437;30591;0.5518;28628;1963
2017-12-12 08:00:00;35,19;35,6;-0,41;41879;134;0.0032;148;-14;55437;30085;0.5427;28434;1651
2017-12-12 09:00:00;34,7;36,55;-1,85;41879;936;0.0223;886;50;55437;29760;0.5369;28129;1631
2017-12-12 10:00:00;34,75;35,66;-0,91;41879;2000;0.0478;1800;200;55437;28988;0.5229;27547;1441
2017-12-12 11:00:00;35,75;38,6;-2,85;41879;2717;0.0649;2413;304;55437;28106;0.507;26648;1458
2017-12-12 12:00:00;36,92;38,09;-1,17;41879;3025;0.0722;2575;450;55437;26186;0.4724;25517;669
2017-12-12 13:00:00;39,9;39,84;0,06;41879;2492;0.0595;2240;252;55437;24063;0.434;24120;-57
2017-12-12 14:00:00;43,16;42,49;0,67;41879;1446;0.0345;1426;20;55437;22996;0.4148;22516;480
2017-12-12 15:00:00;45,0;42,89;2,11;41879;486;0.0116;452;34;55437;22950;0.414;20784;2166
2017-12-12 16:00:00;46,09;40,59;5,5;41879;14;0.0003;22;-8;55437;22639;0.4084;19375;3264
2017-12-12 17:00:00;50,95;39,13;11,82;41879;0;0;0;0;55437;22699;0.4095;18573;4126
2017-12-12 18:00:00;46,95;37,01;9,94;41879;0;0;0;0;55437;22202;0.4005;17949;4253
2017-12-12 19:00:00;46,08;35,61;10,47;41879;0;0;0;0;55437;21012;0.379;17543;3469
2017-12-12 20:00:00;46,1;35,53;10,57;41879;0;0;0;0;55437;19860;0.3582;17325;2535
2017-12-12 21:00:00;40,95;30,48;10,47;41879;0;0;0;0;55437;18764;0.3385;17294;1470
2017-12-12 22:00:00;36,74;29,36;7,38;41879;0;0;0;0;55437;18157;0.3275;17569;588
2017-12-12 23:00:00;27,96;24,68;3,28;41879;0;0;0;0;55437;19149;0.3454;17956;1193
2017-12-13 00:00:00;22,55;28,19;-5,64;41880;0;0;0;0;55471;19851;0.3578;22390;-2539
2017-12-13 01:00:00;20,0;33,06;-13,06;41880;0;0;0;0;55471;20238;0.3648;22951;-2713
2017-12-13 02:00:00;15,96;29,49;-13,53;41880;0;0;0;0;55471;20756;0.3742;23721;-2965
2017-12-13 03:00:00;12,74;25,3;-12,56;41880;0;0;0;0;55471;21375;0.3853;24477;-3102
2017-12-13 04:00:00;14,2;25,1;-10,9;41880;0;0;0;0;55471;22381;0.4035;25313;-2932
2017-12-13 05:00:00;18,02;28,9;-10,88;41880;0;0;0;0;55471;23519;0.424;26255;-2736
2017-12-13 06:00:00;32,93;46,28;-13,35;41880;0;0;0;0;55471;25824;0.4656;27480;-1656
2017-12-13 07:00:00;34,19;43,76;-9,57;41880;0;0;1;-1;55471;27948;0.5038;29125;-1177
2017-12-13 08:00:00;38,27;42,7;-4,43;41880;578;0.0138;528;50;55471;28976;0.5224;30451;-1475
2017-12-13 09:00:00;34,45;39,01;-4,56;41880;3255;0.0777;2751;504;55471;29991;0.5407;31421;-1430
2017-12-13 10:00:00;30,97;35,29;-4,32;41880;6246;0.1492;4976;1270;55471;30402;0.5481;31897;-1495
2017-12-13 11:00:00;29,83;31,05;-1,22;41880;8327;0.1988;6147;2180;55471;31098;0.5606;32363;-1265
2017-12-13 12:00:00;29,7;29,28;0,42;41880;8436;0.2014;5878;2558;55471;32476;0.5854;32788;-312
2017-12-13 13:00:00;29,98;27,44;2,54;41880;6343;0.1514;4455;1888;55471;32661;0.5888;32860;-199
2017-12-13 14:00:00;32,44;29,87;2,57;41880;3066;0.0732;2485;581;55471;32610;0.5879;32512;98
2017-12-13 15:00:00;32,91;34,24;-1,33;41880;622;0.0148;692;-70;55471;32646;0.5886;32292;354
2017-12-13 16:00:00;34,49;34,8;-0,31;41880;7;0.0002;28;-21;55471;33372;0.6016;32201;1171
2017-12-13 17:00:00;34,46;37,4;-2,94;41880;0;0;0;0;55471;33778;0.609;32435;1343
2017-12-13 18:00:00;33,94;35,21;-1,27;41880;0;0;0;0;55471;34210;0.6167;32558;1652
2017-12-13 19:00:00;32,75;32,71;0,04;41880;0;0;0;0;55471;34636;0.6244;32686;1950
2017-12-13 20:00:00;29,1;31,36;-2,26;41880;0;0;0;0;55471;34374;0.6197;33043;1331
2017-12-13 21:00:00;22,62;23,02;-0,4;41880;0;0;0;0;55471;34784;0.6271;33347;1437
2017-12-13 22:00:00;20,05;21,72;-1,67;41880;0;0;0;0;55471;34279;0.618;33306;973
2017-12-13 23:00:00;8,45;10,8;-2,35;41880;0;0;0;0;55471;34662;0.6248;32972;1690
2017-12-14 00:00:00;8,84;3,26;5,58;41890;0;0;0;0;55507;34544;0.6223;33107;1437
2017-12-14 01:00:00;8,8;4,27;4,53;41890;0;0;0;0;55507;34306;0.618;32648;1658
2017-12-14 02:00:00;8,84;3,41;5,43;41890;0;0;0;0;55507;34300;0.6179;32153;2147
2017-12-14 03:00:00;9,01;-9,18;18,19;41890;0;0;0;0;55507;34624;0.6238;32295;2329
2017-12-14 04:00:00;10,79;3,4;7,39;41890;0;0;0;0;55507;33648;0.6062;32348;1300
2017-12-14 05:00:00;14,44;15,86;-1,42;41890;0;0;0;0;55507;32432;0.5843;32179;253
2017-12-14 06:00:00;32,63;33,49;-0,86;41890;0;0;0;0;55507;32063;0.5777;31991;72
2017-12-14 07:00:00;45,94;51,22;-5,28;41890;0;0;0;0;55507;31402;0.5658;32058;-656
2017-12-14 08:00:00;42,14;46,95;-4,81;41890;185;0.0044;278;-93;55507;31247;0.5629;32389;-1142
2017-12-14 09:00:00;33,84;43,36;-9,52;41890;1406;0.0335;1663;-257;55507;31469;0.5669;32908;-1439
2017-12-14 10:00:00;32,06;40,67;-8,61;41890;3293;0.0786;3321;-28;55507;32312;0.5821;33788;-1476
2017-12-14 11:00:00;31,82;36,58;-4,76;41890;4457;0.1064;4325;132;55507;32763;0.5903;34184;-1421
2017-12-14 12:00:00;31,54;33,81;-2,27;41890;4884;0.1166;4304;580;55507;32948;0.5936;34134;-1186
2017-12-14 13:00:00;31,46;35,02;-3,56;41890;3909;0.0933;3407;502;55507;31873;0.5742;33285;-1412
2017-12-14 14:00:00;32,53;35,89;-3,36;41890;2222;0.053;1989;233;55507;30199;0.544;31712;-1513
2017-12-14 15:00:00;36,43;39,67;-3,24;41890;662;0.0158;596;66;55507;28419;0.512;29927;-1508
2017-12-14 16:00:00;38,43;43,06;-4,63;41890;12;0.0003;26;-14;55507;27418;0.494;28088;-670
2017-12-14 17:00:00;49,94;49,02;0,92;41890;0;0;0;0;55507;26058;0.4694;26085;-27
2017-12-14 18:00:00;51,55;50,25;1,3;41890;0;0;0;0;55507;23573;0.4247;24179;-606
2017-12-14 19:00:00;48,06;49,6;-1,54;41890;0;0;0;0;55507;21696;0.3909;22327;-631
2017-12-14 20:00:00;41,9;46,79;-4,89;41890;0;0;0;0;55507;20284;0.3654;20567;-283
2017-12-14 21:00:00;39,31;41,14;-1,83;41890;0;0;0;0;55507;18120;0.3264;18820;-700
2017-12-14 22:00:00;34,94;39,28;-4,34;41890;0;0;0;0;55507;16598;0.299;17366;-768
2017-12-14 23:00:00;28,96;33,56;-4,6;41890;0;0;0;0;55507;15012;0.2704;16091;-1079
2017-12-15 00:00:00;32,01;35,6;-3,59;41899;0;0;0;0;55538;13674;0.2462;14232;-558
2017-12-15 01:00:00;30,93;37,62;-6,69;41899;0;0;0;0;55538;12214;0.2199;13372;-1158
2017-12-15 02:00:00;29,0;36,12;-7,12;41899;0;0;0;0;55538;11368;0.2047;12911;-1543
2017-12-15 03:00:00;28,97;34,34;-5,37;41899;0;0;0;0;55538;10860;0.1956;12535;-1675
2017-12-15 04:00:00;29,57;34,97;-5,4;41899;0;0;0;0;55538;10624;0.1913;11997;-1373
2017-12-15 05:00:00;33,17;38,89;-5,72;41899;0;0;0;0;55538;9808;0.1766;11322;-1514
2017-12-15 06:00:00;46,95;48,8;-1,85;41899;0;0;0;0;55538;9660;0.174;10870;-1210
2017-12-15 07:00:00;57,17;60,95;-3,78;41899;0;0;0;0;55538;9354;0.1684;10480;-1126
2017-12-15 08:00:00;54,31;62,61;-8,3;41899;172;0.0041;339;-167;55538;9155;0.1648;10105;-950
2017-12-15 09:00:00;53,93;67,51;-13,58;41899;1559;0.0372;1912;-353;55538;8487;0.1528;9823;-1336
2017-12-15 10:00:00;52,09;65,09;-13,0;41899;3488;0.0832;3724;-236;55538;7981;0.1437;9592;-1611
2017-12-15 11:00:00;52,51;63,23;-10,72;41899;4788;0.1143;4893;-105;55538;7845;0.1412;9406;-1561
2017-12-15 12:00:00;48,49;54,36;-5,87;41899;4986;0.119;5080;-94;55538;7798;0.1404;9222;-1424
2017-12-15 13:00:00;47,92;52,85;-4,93;41899;3724;0.0889;4240;-516;55538;7312;0.1317;8840;-1528
2017-12-15 14:00:00;48,93;56,67;-7,74;41899;2182;0.0521;2600;-418;55538;6345;0.1143;8148;-1803
2017-12-15 15:00:00;52,94;63,33;-10,39;41899;730;0.0174;794;-64;55538;5556;0.1;7595;-2039
2017-12-15 16:00:00;60,92;66,25;-5,33;41899;24;0.0006;31;-7;55538;4905;0.0883;7454;-2549
2017-12-15 17:00:00;74,54;76,02;-1,48;41899;0;0;0;0;55538;4591;0.0826;7753;-3162
2017-12-15 18:00:00;59,32;71,0;-11,68;41899;0;0;0;0;55538;4028;0.0725;8309;-4281
2017-12-15 19:00:00;53,91;71,03;-17,12;41899;0;0;0;0;55538;4038;0.0727;8937;-4899
2017-12-15 20:00:00;50,13;65,99;-15,86;41899;0;0;0;0;55538;4344;0.0782;9502;-5158
2017-12-15 21:00:00;42,23;49,8;-7,57;41899;0;0;0;0;55538;4604;0.0829;10132;-5528
2017-12-15 22:00:00;37,04;47,05;-10,01;41899;0;0;0;0;55538;4973;0.0895;10731;-5758
2017-12-15 23:00:00;33,23;40,95;-7,72;41899;0;0;0;0;55538;4926;0.0887;11312;-6386
2017-12-16 00:00:00;35,07;34,96;0,11;41900;0;0;0;0;55540;5642;0.1016;6191;-549
2017-12-16 01:00:00;33,08;32,54;0,54;41900;0;0;0;0;55540;5837;0.1051;6769;-932
2017-12-16 02:00:00;32,96;32,44;0,52;41900;0;0;0;0;55540;6935;0.1248;7321;-386
2017-12-16 03:00:00;31,96;32,12;-0,16;41900;0;0;0;0;55540;6884;0.124;7919;-1035
2017-12-16 04:00:00;32,0;33,46;-1,46;41900;0;0;0;0;55540;7575;0.1364;8551;-976
2017-12-16 05:00:00;31,76;34,17;-2,41;41900;0;0;0;0;55540;8263;0.1488;9147;-884
2017-12-16 06:00:00;31,58;33,86;-2,28;41900;0;0;0;0;55540;9204;0.1657;9845;-641
2017-12-16 07:00:00;31,39;35,59;-4,2;41900;0;0;0;0;55540;9322;0.1678;10337;-1015
2017-12-16 08:00:00;34,01;38,06;-4,05;41900;134;0.0032;142;-8;55540;10014;0.1803;10727;-713
2017-12-16 09:00:00;41,56;40,63;0,93;41900;1092;0.026;990;102;55540;9774;0.176;11279;-1505
2017-12-16 10:00:00;44,34;41,48;2,86;41900;2467;0.0588;2192;275;55540;9906;0.1784;11624;-1718
2017-12-16 11:00:00;44,03;43,95;0,08;41900;3356;0.0801;3042;314;55540;9854;0.1774;11963;-2109
2017-12-16 12:00:00;41,69;43,61;-1,92;41900;3662;0.0874;3255;407;55540;10716;0.193;12417;-1701
2017-12-16 13:00:00;38,1;39,19;-1,09;41900;2985;0.0712;2820;165;55540;11034;0.1987;12948;-1914
2017-12-16 14:00:00;36,48;38,94;-2,46;41900;1692;0.0404;1809;-117;55540;12251;0.2206;13415;-1164
2017-12-16 15:00:00;40,0;43,41;-3,41;41900;501;0.012;563;-62;55540;12636;0.2275;13828;-1192
2017-12-16 16:00:00;46,17;45,27;0,9;41900;15;0.0004;27;-12;55540;14050;0.253;14230;-180
2017-12-16 17:00:00;48,93;43,35;5,58;41900;0;0;0;0;55540;14674;0.2642;14666;8
2017-12-16 18:00:00;46,9;42,37;4,53;41900;0;0;0;0;55540;15708;0.2828;15104;604
2017-12-16 19:00:00;42,0;37,37;4,63;41900;0;0;0;0;55540;15729;0.2832;15450;279
2017-12-16 20:00:00;39,0;35,18;3,82;41900;0;0;0;0;55540;15400;0.2773;15554;-154
2017-12-16 21:00:00;33,62;31,7;1,92;41900;0;0;0;0;55540;15754;0.2837;15498;256
2017-12-16 22:00:00;33,01;32,54;0,47;41900;0;0;0;0;55540;15292;0.2754;15389;-97
2017-12-16 23:00:00;29,02;29,12;-0,1;41900;0;0;0;0;55540;15352;0.2764;15207;145
2017-12-17 00:00:00;28,9;26,05;2,85;41903;0;0;0;0;55546;15227;0.2741;14542;685
2017-12-17 01:00:00;28,2;21,43;6,77;41903;0;0;0;0;55546;14993;0.2699;14175;818
2017-12-17 02:00:00;28,2;19,48;8,72;41903;0;0;0;0;55546;14319;0.2578;13649;670
2017-12-17 03:00:00;27,94;16,2;11,74;41903;0;0;0;0;55546;14120;0.2542;13033;1087
2017-12-17 04:00:00;28,21;16,85;11,36;41903;0;0;0;0;55546;13729;0.2472;12431;1298
2017-12-17 05:00:00;28,38;13,14;15,24;41903;0;0;0;0;55546;12746;0.2294;11705;1041
2017-12-17 06:00:00;28,58;15,9;12,68;41903;0;0;0;0;55546;11498;0.207;10983;515
2017-12-17 07:00:00;29,4;21,38;8,02;41903;0;0;0;0;55546;10192;0.1835;10186;6
2017-12-17 08:00:00;31,38;32,29;-0,91;41903;60;0.0014;115;-55;55546;8932;0.1608;9265;-333
2017-12-17 09:00:00;34,78;36,99;-2,21;41903;767;0.0183;959;-192;55546;7680;0.1383;8428;-748
2017-12-17 10:00:00;38,12;41,99;-3,87;41903;1962;0.0468;2426;-464;55546;6560;0.1181;7704;-1144
2017-12-17 11:00:00;43,64;46,25;-2,61;41903;2737;0.0653;3450;-713;55546;5820;0.1048;7262;-1442
2017-12-17 12:00:00;41,57;47,13;-5,56;41903;2912;0.0695;3725;-813;55546;5424;0.0976;6945;-1521
2017-12-17 13:00:00;40,02;43,63;-3,61;41903;2470;0.059;3246;-776;55546;5145;0.0926;6861;-1716
2017-12-17 14:00:00;39,08;44,84;-5,76;41903;1350;0.0322;2056;-706;55546;5268;0.0948;7082;-1814
2017-12-17 15:00:00;41,5;45,33;-3,83;41903;354;0.0084;607;-253;55546;5922;0.1066;7652;-1730
2017-12-17 16:00:00;45,74;49,73;-3,99;41903;8;0.0002;25;-17;55546;7406;0.1333;8781;-1375
2017-12-17 17:00:00;46,96;52,73;-5,77;41903;0;0;0;0;55546;9757;0.1756;10270;-513
2017-12-17 18:00:00;45,91;50,86;-4,95;41903;0;0;0;0;55546;11128;0.2004;11705;-577
2017-12-17 19:00:00;42,91;47,28;-4,37;41903;0;0;0;0;55546;11836;0.2131;13089;-1253
2017-12-17 20:00:00;36,42;45,75;-9,33;41903;0;0;0;0;55546;12224;0.2201;14426;-2202
2017-12-17 21:00:00;32,92;41,43;-8,51;41903;0;0;0;0;55546;13012;0.2342;15798;-2786
2017-12-17 22:00:00;30,66;40,74;-10,08;41903;0;0;0;0;55546;13644;0.2456;17016;-3372
2017-12-17 23:00:00;28,59;35,62;-7,03;41903;0;0;0;0;55546;14326;0.2579;18060;-3734
2017-12-18 00:00:00;30,43;33,95;-3,52;41908;0;0;0;0;55563;15045;0.2708;14905;140
2017-12-18 01:00:00;29,9;32,69;-2,79;41908;0;0;0;0;55563;15014;0.2702;15186;-172
2017-12-18 02:00:00;28,15;31,93;-3,78;41908;0;0;0;0;55563;14892;0.268;15034;-142
2017-12-18 03:00:00;27,39;28,42;-1,03;41908;0;0;0;0;55563;14102;0.2538;14910;-808
2017-12-18 04:00:00;28,71;30,79;-2,08;41908;0;0;0;0;55563;12478;0.2246;14107;-1629
2017-12-18 05:00:00;33,73;34,11;-0,38;41908;0;0;0;0;55563;10420;0.1876;12402;-1982
2017-12-18 06:00:00;46,2;50,21;-4,01;41908;0;0;0;0;55563;8620;0.1552;11044;-2424
2017-12-18 07:00:00;63,95;72,22;-8,27;41908;0;0;0;0;55563;7106;0.1279;9982;-2876
2017-12-18 08:00:00;64,42;71,41;-6,99;41908;116;0.0028;174;-58;55563;6070;0.1092;9063;-2993
2017-12-18 09:00:00;64,08;71,66;-7,58;41908;1055;0.0252;1177;-122;55563;4912;0.0884;8216;-3304
2017-12-18 10:00:00;64,28;71,19;-6,91;41908;2465;0.0588;2380;85;55563;3550;0.0639;7430;-3880
2017-12-18 11:00:00;69,65;73,49;-3,84;41908;3472;0.0829;3143;329;55563;2137;0.0385;6759;-4622
2017-12-18 12:00:00;68,23;74,6;-6,37;41908;3616;0.0863;3286;330;55563;1596;0.0287;6220;-4624
2017-12-18 13:00:00;69,97;75,87;-5,9;41908;2974;0.071;2770;204;55563;1660;0.0298;5908;-4248
2017-12-18 14:00:00;69,49;77,56;-8,07;41908;1783;0.0426;1695;88;55563;1601;0.0288;5822;-4221
2017-12-18 15:00:00;71,32;79,49;-8,17;41908;413;0.0098;475;-62;55563;1681;0.0302;5933;-4252
2017-12-18 16:00:00;73,5;80,69;-7,19;41908;3;0;19;-16;55563;1828;0.0329;6095;-4267
2017-12-18 17:00:00;79,72;87,46;-7,74;41908;0;0;0;0;55563;2146;0.0386;6355;-4209
2017-12-18 18:00:00;75,84;82,29;-6,45;41908;0;0;0;0;55563;2564;0.0461;6579;-4015
2017-12-18 19:00:00;68,87;77,33;-8,46;41908;0;0;0;0;55563;2740;0.0493;6727;-3987
2017-12-18 20:00:00;63,31;69,01;-5,7;41908;0;0;0;0;55563;3340;0.0601;6696;-3356
2017-12-18 21:00:00;56,58;59,11;-2,53;41908;0;0;0;0;55563;3974;0.0715;6613;-2639
2017-12-18 22:00:00;45,03;47,27;-2,24;41908;0;0;0;0;55563;4280;0.077;6586;-2306
2017-12-18 23:00:00;37,29;37,76;-0,47;41908;0;0;0;0;55563;4247;0.0764;6566;-2319
2017-12-19 00:00:00;44,34;40,3;4,04;41925;0;0;0;0;55605;3885;0.0698;4738;-853
2017-12-19 01:00:00;38,07;38,37;-0,3;41925;0;0;0;0;55605;3787;0.0681;4824;-1037
2017-12-19 02:00:00;37,59;37,45;0,14;41925;0;0;0;0;55605;3539;0.0636;4747;-1208
2017-12-19 03:00:00;36,5;36,71;-0,21;41925;0;0;0;0;55605;3521;0.0633;4734;-1213
2017-12-19 04:00:00;38,89;39,74;-0,85;41925;0;0;0;0;55605;3775;0.0679;4661;-886
2017-12-19 05:00:00;41,01;43,85;-2,84;41925;0;0;0;0;55605;4040;0.0726;4554;-514
2017-12-19 06:00:00;53,67;51,88;1,79;41925;0;0;0;0;55605;4464;0.0803;4518;-54
2017-12-19 07:00:00;68,17;66,88;1,29;41925;0;0;0;0;55605;4830;0.0869;4497;333
2017-12-19 08:00:00;76,91;69,17;7,74;41925;69;0.0016;121;-52;55605;5258;0.0946;4450;808
2017-12-19 09:00:00;77,06;68,93;8,13;41925;606;0.0145;721;-115;55605;5224;0.094;4499;725
2017-12-19 10:00:00;75,3;66,41;8,89;41925;1322;0.0316;1524;-202;55605;4888;0.0879;4422;466
2017-12-19 11:00:00;74,0;65,79;8,21;41925;1802;0.043;2086;-284;55605;4505;0.081;4298;207
2017-12-19 12:00:00;70,85;67,0;3,85;41925;2004;0.0478;2129;-125;55605;4387;0.0789;4312;75
2017-12-19 13:00:00;70,57;66,13;4,44;41925;1729;0.0412;1720;9;55605;4716;0.0848;4402;314
2017-12-19 14:00:00;70,2;64,42;5,78;41925;969;0.0231;1005;-36;55605;4747;0.0854;4555;192
2017-12-19 15:00:00;70,32;62,17;8,15;41925;286;0.0068;298;-12;55605;4558;0.082;4752;-194
2017-12-19 16:00:00;75,82;71,07;4,75;41925;6;0.0002;17;-11;55605;4420;0.0795;4842;-422
2017-12-19 17:00:00;78,28;72,07;6,21;41925;0;0;0;0;55605;4336;0.078;4804;-468
2017-12-19 18:00:00;75,16;71,27;3,89;41925;0;0;0;0;55605;4256;0.0765;4735;-479
2017-12-19 19:00:00;75,06;72,77;2,29;41925;0;0;0;0;55605;3901;0.0702;4727;-826
2017-12-19 20:00:00;66,29;66,3;-0,01;41925;0;0;0;0;55605;3558;0.064;4650;-1092
2017-12-19 21:00:00;52,01;54,75;-2,74;41925;0;0;0;0;55605;3623;0.0652;4541;-918
2017-12-19 22:00:00;48,86;50,61;-1,75;41925;0;0;0;0;55605;3424;0.0616;4383;-959
2017-12-19 23:00:00;41,18;43,38;-2,2;41925;0;0;0;0;55605;2916;0.0524;4131;-1215
2017-12-20 00:00:00;44,47;48,42;-3,95;41932;0;0;0;0;55669;2425;0.0436;2963;-538
2017-12-20 01:00:00;40,1;42,37;-2,27;41932;0;0;0;0;55669;1906;0.0342;2661;-755
2017-12-20 02:00:00;37,83;38,73;-0,9;41932;0;0;0;0;55669;1556;0.0279;2439;-883
2017-12-20 03:00:00;37,27;41,33;-4,06;41932;0;0;0;0;55669;1402;0.0252;2283;-881
2017-12-20 04:00:00;40,85;42,14;-1,29;41932;0;0;0;0;55669;1453;0.0261;2164;-711
2017-12-20 05:00:00;45,79;45,76;0,03;41932;0;0;0;0;55669;1570;0.0282;1995;-425
2017-12-20 06:00:00;57,35;51,01;6,34;41932;0;0;0;0;55669;1589;0.0286;1811;-222
2017-12-20 07:00:00;75,98;72,11;3,87;41932;0;0;0;0;55669;1331;0.0239;1721;-390
2017-12-20 08:00:00;76,7;68,92;7,78;41932;56;0.0014;89;-33;55669;1398;0.0252;1739;-341
2017-12-20 09:00:00;76,69;67,15;9,54;41932;526;0.0125;571;-45;55669;1408;0.0253;1854;-446
2017-12-20 10:00:00;76,61;64,5;12,11;41932;1283;0.0306;1200;83;55669;1572;0.0282;1976;-404
2017-12-20 11:00:00;76,56;63,27;13,29;41932;1892;0.0451;1660;232;55669;1873;0.0336;2166;-293
2017-12-20 12:00:00;76,35;61,43;14,92;41932;2005;0.0479;1809;196;55669;2081;0.0374;2456;-375
2017-12-20 13:00:00;76,03;60,5;15,53;41932;1703;0.0406;1585;118;55669;2593;0.0466;2793;-200
2017-12-20 14:00:00;74,89;60,89;14,0;41932;1041;0.0248;1008;33;55669;3229;0.058;3075;154
2017-12-20 15:00:00;72,05;60,33;11,72;41932;289;0.0069;320;-31;55669;3763;0.0676;3462;301
2017-12-20 16:00:00;76,06;64,28;11,78;41932;4;0.0001;14;-10;55669;4332;0.0778;3944;388
2017-12-20 17:00:00;79,3;67,4;11,9;41932;0;0;0;0;55669;4931;0.0886;4493;438
2017-12-20 18:00:00;77,26;60,43;16,83;41932;0;0;0;0;55669;5684;0.1021;5033;651
2017-12-20 19:00:00;75,96;57,75;18,21;41932;0;0;0;0;55669;6197;0.1113;5612;585
2017-12-20 20:00:00;64,16;51,79;12,37;41932;0;0;0;0;55669;6838;0.1228;6217;621
2017-12-20 21:00:00;46,03;41,41;4,62;41932;0;0;0;0;55669;7642;0.1372;6868;774
2017-12-20 22:00:00;42,01;42,13;-0,12;41932;0;0;0;0;55669;8379;0.1505;7456;923
2017-12-20 23:00:00;37,63;39,81;-2,18;41932;0;0;0;0;55669;8845;0.1589;7955;890
2017-12-21 00:00:00;33,09;36,02;-2,93;41935;0;0;0;0;55704;9308;0.1671;9894;-586
2017-12-21 01:00:00;35,26;34,91;0,35;41935;0;0;0;0;55704;10096;0.1812;10381;-285
2017-12-21 02:00:00;31,88;31,33;0,55;41935;0;0;0;0;55704;10918;0.196;10610;308
2017-12-21 03:00:00;33,04;29,76;3,28;41935;0;0;0;0;55704;10857;0.1949;10776;81
2017-12-21 04:00:00;33,6;32,27;1,33;41935;0;0;0;0;55704;10785;0.1936;10947;-162
2017-12-21 05:00:00;35,05;30,64;4,41;41935;0;0;0;0;55704;11082;0.199;11092;-10
2017-12-21 06:00:00;35,19;31,45;3,74;41935;0;0;0;0;55704;10945;0.1965;11117;-172
2017-12-21 07:00:00;45,94;42,63;3,31;41935;0;0;0;0;55704;10671;0.1916;11063;-392
2017-12-21 08:00:00;49,9;46,23;3,67;41935;42;0.001;52;-10;55704;10832;0.1944;11004;-172
2017-12-21 09:00:00;50,0;45,76;4,24;41935;409;0.0097;410;-1;55704;11075;0.1988;11018;57
2017-12-21 10:00:00;51,03;45,59;5,44;41935;1037;0.0247;938;99;55704;11277;0.2024;11044;233
2017-12-21 11:00:00;54,48;44,94;9,54;41935;1644;0.0392;1313;331;55704;11562;0.2076;11141;421
2017-12-21 12:00:00;55,96;43,39;12,57;41935;1842;0.0439;1402;440;55704;11501;0.2065;11248;253
2017-12-21 13:00:00;49,99;42,29;7,7;41935;1406;0.0335;1184;222;55704;11207;0.2012;11200;7
2017-12-21 14:00:00;46,15;40,67;5,48;41935;749;0.0178;712;37;55704;11047;0.1983;10899;148
2017-12-21 15:00:00;46,86;40,53;6,33;41935;183;0.0044;201;-18;55704;10467;0.1879;10586;-119
2017-12-21 16:00:00;51,93;43,42;8,51;41935;1;0;9;-8;55704;10319;0.1853;10313;6
2017-12-21 17:00:00;50,95;45,71;5,24;41935;0;0;0;0;55704;10737;0.1927;10094;643
2017-12-21 18:00:00;51,03;44,76;6,27;41935;0;0;0;0;55704;10794;0.1938;10022;772
2017-12-21 19:00:00;46,02;40,63;5,39;41935;0;0;0;0;55704;10647;0.1911;10013;634
2017-12-21 20:00:00;35,83;37,75;-1,92;41935;0;0;0;0;55704;10340;0.1856;10099;241
2017-12-21 21:00:00;36,26;37,2;-0,94;41935;0;0;0;0;55704;10301;0.1849;10321;-20
2017-12-21 22:00:00;38,72;36,66;2,06;41935;0;0;0;0;55704;10280;0.1846;10602;-322
2017-12-21 23:00:00;34,84;32,72;2,12;41935;0;0;0;0;55704;10483;0.1882;10854;-371
2017-12-22 00:00:00;27,76;28,74;-0,98;41941;0;0;0;0;55736;10816;0.1941;10921;-105
2017-12-22 01:00:00;26,45;25,29;1,16;41941;0;0;0;0;55736;10335;0.1854;11132;-797
2017-12-22 02:00:00;26,2;27,41;-1,21;41941;0;0;0;0;55736;10030;0.18;10958;-928
2017-12-22 03:00:00;26,36;26,6;-0,24;41941;0;0;0;0;55736;9855;0.1768;10504;-649
2017-12-22 04:00:00;27,59;20,9;6,69;41941;0;0;0;0;55736;9666;0.1734;9913;-247
2017-12-22 05:00:00;31,93;27,29;4,64;41941;0;0;0;0;55736;9062;0.1626;9199;-137
2017-12-22 06:00:00;38,61;35,29;3,32;41941;0;0;0;0;55736;8120;0.1457;8482;-362
2017-12-22 07:00:00;47,52;48,99;-1,47;41941;0;0;0;0;55736;7482;0.1342;7944;-462
2017-12-22 08:00:00;48,0;49,36;-1,36;41941;63;0.0015;73;-10;55736;7265;0.1304;7591;-326
2017-12-22 09:00:00;50,0;51,19;-1,19;41941;632;0.0151;559;73;55736;7240;0.1299;7546;-306
2017-12-22 10:00:00;48,99;49,93;-0,94;41941;1392;0.0332;1286;106;55736;6963;0.1249;7720;-757
2017-12-22 11:00:00;46,55;47,32;-0,77;41941;2020;0.0482;1822;198;55736;7211;0.1294;8147;-936
2017-12-22 12:00:00;47,86;44,1;3,76;41941;2232;0.0532;2004;228;55736;7676;0.1377;8773;-1097
2017-12-22 13:00:00;46,96;40,41;6,55;41941;2008;0.0479;1782;226;55736;7857;0.141;9445;-1588
2017-12-22 14:00:00;39,0;37,42;1,58;41941;1326;0.0316;1149;177;55736;8237;0.1478;9904;-1667
2017-12-22 15:00:00;39,37;38,29;1,08;41941;388;0.0092;339;49;55736;8861;0.159;10319;-1458
2017-12-22 16:00:00;46,06;39,57;6,49;41941;4;0.0001;14;-10;55736;9141;0.164;10635;-1494
2017-12-22 17:00:00;47,34;40,86;6,48;41941;0;0;0;0;55736;9766;0.1752;10780;-1014
2017-12-22 18:00:00;41,5;38,86;2,64;41941;0;0;0;0;55736;10081;0.1808;10781;-700
2017-12-22 19:00:00;40,66;37,46;3,2;41941;0;0;0;0;55736;10097;0.1812;10654;-557
2017-12-22 20:00:00;42,91;37,97;4,94;41941;0;0;0;0;55736;10641;0.1909;10528;113
2017-12-22 21:00:00;42,06;32,42;9,64;41941;0;0;0;0;55736;11593;0.208;10558;1035
2017-12-22 22:00:00;37,4;30,37;7,03;41941;0;0;0;0;55736;12730;0.2284;10871;1859
2017-12-22 23:00:00;30,62;20,97;9,65;41941;0;0;0;0;55736;13884;0.2491;11594;2290
2017-12-23 00:00:00;26,33;11,71;14,62;41942;0;0;0;0;55736;14980;0.2688;14739;241
2017-12-23 01:00:00;17,72;9,74;7,98;41942;0;0;0;0;55736;16342;0.2932;15941;401
2017-12-23 02:00:00;11,8;6,9;4,9;41942;0;0;0;0;55736;18333;0.3289;17300;1033
2017-12-23 03:00:00;11,3;3,75;7,55;41942;0;0;0;0;55736;20679;0.371;18755;1924
2017-12-23 04:00:00;12,4;-1,74;14,14;41942;0;0;0;0;55736;22786;0.4088;20361;2425
2017-12-23 05:00:00;8,4;-4,77;13,17;41942;0;0;0;0;55736;25109;0.4505;21889;3220
2017-12-23 06:00:00;9,71;-17,38;27,09;41942;0;0;0;0;55736;27126;0.4867;23473;3653
2017-12-23 07:00:00;10,71;-9,5;20,21;41942;0;0;0;0;55736;28505;0.5114;24898;3607
2017-12-23 08:00:00;14,78;0,73;14,05;41942;60;0.0014;78;-18;55736;29748;0.5337;26035;3713
2017-12-23 09:00:00;18,79;4,21;14,58;41942;556;0.0132;513;43;55736;31043;0.5569;27117;3926
2017-12-23 10:00:00;20,08;6,33;13,75;41942;1167;0.0278;1134;33;55736;32383;0.581;28205;4178
2017-12-23 11:00:00;14,74;6,19;8,55;41942;1722;0.041;1611;111;55736;33766;0.6058;29222;4544
2017-12-23 12:00:00;14,77;5,14;9,63;41942;1979;0.0472;1776;203;55736;34353;0.6164;30192;4161
2017-12-23 13:00:00;10,87;2,41;8,46;41942;1654;0.0394;1565;89;55736;34897;0.6261;30938;3959
2017-12-23 14:00:00;5,65;2,78;2,87;41942;986;0.0235;1015;-29;55736;35383;0.6348;31375;4008
2017-12-23 15:00:00;10,04;7,06;2,98;41942;320;0.0076;362;-42;55736;35813;0.6426;31699;4114
2017-12-23 16:00:00;12,91;11,77;1,14;41942;6;0.0002;19;-13;55736;35957;0.6452;32033;3924
2017-12-23 17:00:00;22,01;16,28;5,73;41942;0;0;0;0;55736;35944;0.6449;32453;3491
2017-12-23 18:00:00;18,08;15,41;2,67;41942;0;0;0;0;55736;36057;0.6469;32877;3180
2017-12-23 19:00:00;10,84;8,72;2,12;41942;0;0;0;0;55736;36555;0.6558;33216;3339
2017-12-23 20:00:00;0,4;0,99;-0,59;41942;0;0;0;0;55736;36598;0.6566;33357;3241
2017-12-23 21:00:00;-0,03;1,88;-1,91;41942;0;0;0;0;55736;36364;0.6524;33451;2913
2017-12-23 22:00:00;-0,09;2,84;-2,93;41942;0;0;0;0;55736;35296;0.6333;33418;1878
2017-12-23 23:00:00;-12,12;-2,19;-9,93;41942;0;0;0;0;55736;34852;0.6253;33324;1528
2017-12-24 00:00:00;-40,84;-31,17;-9,67;41942;0;0;0;0;55736;34185;0.6133;34106;79
2017-12-24 01:00:00;-43,18;-44,17;0,99;41942;0;0;0;0;55736;34233;0.6142;33731;502
2017-12-24 02:00:00;-55,99;-56,26;0,27;41942;0;0;0;0;55736;32836;0.5892;33393;-557
2017-12-24 03:00:00;-49,99;-63,37;13,38;41942;0;0;0;0;55736;32017;0.5744;32836;-819
2017-12-24 04:00:00;-40,14;-61,86;21,72;41942;0;0;0;0;55736;32160;0.577;32203;-43
2017-12-24 05:00:00;-36,05;-53,67;17,62;41942;0;0;0;0;55736;32360;0.5806;31566;794
2017-12-24 06:00:00;-42,93;-53,63;10,7;41942;0;0;0;0;55736;32266;0.5789;30960;1306
2017-12-24 07:00:00;-9,94;-37,91;27,97;41942;0;0;0;0;55736;32849;0.5894;30621;2228
2017-12-24 08:00:00;2,13;-23,7;25,83;41942;74;0.0017;90;-16;55736;34816;0.6247;30545;4271
2017-12-24 09:00:00;5,07;-12,42;17,49;41942;555;0.0132;588;-33;55736;35461;0.6362;30614;4847
2017-12-24 10:00:00;5,03;-6,39;11,42;41942;1336;0.0319;1261;75;55736;35632;0.6393;31012;4620
2017-12-24 11:00:00;6,82;-5,44;12,26;41942;1963;0.0468;1749;214;55736;36044;0.6467;31732;4312
2017-12-24 12:00:00;2,17;-7,05;9,22;41942;2158;0.0514;1905;253;55736;36101;0.6477;32391;3710
2017-12-24 13:00:00;2,93;-7,38;10,31;41942;2006;0.0478;1689;317;55736;35638;0.6394;32745;2893
2017-12-24 14:00:00;0,1;-1,53;1,63;41942;1363;0.0325;1135;228;55736;35207;0.6317;32713;2494
2017-12-24 15:00:00;1,09;1,42;-0,33;41942;482;0.0115;428;54;55736;34866;0.6256;32493;2373
2017-12-24 16:00:00;6,75;3,84;2,91;41942;12;0.0003;27;-15;55736;34576;0.6204;32263;2313
2017-12-24 17:00:00;11,08;8,41;2,67;41942;0;0;0;0;55736;34159;0.6129;32114;2045
2017-12-24 18:00:00;2,85;1,7;1,15;41942;0;0;0;0;55736;34348;0.6163;32046;2302
2017-12-24 19:00:00;1,8;1,62;0,18;41942;0;0;0;0;55736;34446;0.618;31931;2515
2017-12-24 20:00:00;-4,94;-18,61;13,67;41942;0;0;0;0;55736;33593;0.6027;31609;1984
2017-12-24 21:00:00;-6,74;-28,47;21,73;41942;0;0;0;0;55736;33542;0.6018;31081;2461
2017-12-24 22:00:00;0,08;-24,2;24,28;41942;0;0;0;0;55736;32766;0.5879;30424;2342
2017-12-24 23:00:00;0,06;-22,69;22,75;41942;0;0;0;0;55736;31931;0.5729;29706;2225
2017-12-25 00:00:00;-4,98;-7,31;2,33;41942;0;0;0;0;55736;30575;0.5486;29666;909
2017-12-25 01:00:00;-32,58;-10,19;-22,39;41942;0;0;0;0;55736;29603;0.5311;28751;852
2017-12-25 02:00:00;-19,79;-7,51;-12,28;41942;0;0;0;0;55736;28385;0.5093;28197;188
2017-12-25 03:00:00;-11,9;-4,36;-7,54;41942;0;0;0;0;55736;27445;0.4924;27675;-230
2017-12-25 04:00:00;-4,96;-0,34;-4,62;41942;0;0;0;0;55736;27132;0.4868;27208;-76
2017-12-25 05:00:00;-4,83;-0,25;-4,58;41942;0;0;0;0;55736;26604;0.4773;26656;-52
2017-12-25 06:00:00;-61,41;-24,43;-36,98;41942;0;0;0;0;55736;26195;0.47;26110;85
2017-12-25 07:00:00;-4,97;4,66;-9,63;41942;0;0;0;0;55736;26451;0.4746;25717;734
2017-12-25 08:00:00;0,07;8,56;-8,49;41942;91;0.0022;166;-75;55736;26820;0.4812;25360;1460
2017-12-25 09:00:00;9,94;16,77;-6,83;41942;707;0.0169;1082;-375;55736;26339;0.4726;25072;1267
2017-12-25 10:00:00;19,9;19,76;0,14;41942;1842;0.0439;2356;-514;55736;26184;0.4698;24765;1419
2017-12-25 11:00:00;22,01;22,65;-0,64;41942;2807;0.0669;3401;-594;55736;25742;0.4618;24409;1333
2017-12-25 12:00:00;18,35;20,19;-1,84;41942;3378;0.0806;3887;-509;55736;25224;0.4526;23884;1340
2017-12-25 13:00:00;15,99;13,02;2,97;41942;3392;0.0809;3617;-225;55736;24174;0.4337;23123;1051
2017-12-25 14:00:00;12,97;11,44;1,53;41942;2554;0.0609;2590;-36;55736;22899;0.4108;22139;760
2017-12-25 15:00:00;17,97;14,5;3,47;41942;969;0.0231;1041;-72;55736;21926;0.3934;21112;814
2017-12-25 16:00:00;17,99;16,09;1,9;41942;25;0.0006;52;-27;55736;20988;0.3766;20532;456
2017-12-25 17:00:00;26,45;25,64;0,81;41942;0;0;0;0;55736;20680;0.371;20524;156
2017-12-25 18:00:00;27,41;27,08;0,33;41942;0;0;0;0;55736;21086;0.3783;20712;374
2017-12-25 19:00:00;27,59;27,68;-0,09;41942;0;0;0;0;55736;21240;0.3811;20911;329
2017-12-25 20:00:00;25,64;27,11;-1,47;41942;0;0;0;0;55736;21711;0.3896;21108;603
2017-12-25 21:00:00;22,09;24,22;-2,13;41942;0;0;0;0;55736;22586;0.4052;21336;1250
2017-12-25 22:00:00;22,17;23,32;-1,15;41942;0;0;0;0;55736;22028;0.3952;21522;506
2017-12-25 23:00:00;22,0;21,81;0,19;41942;0;0;0;0;55736;22730;0.4078;21748;982
2017-12-26 00:00:00;5,06;18,36;-13,3;41942;0;0;0;0;55739;23638;0.4241;23376;262
2017-12-26 01:00:00;5,06;9,11;-4,05;41942;0;0;0;0;55739;24538;0.4402;24130;408
2017-12-26 02:00:00;-1,44;5,09;-6,53;41942;0;0;0;0;55739;25104;0.4504;25447;-343
2017-12-26 03:00:00;-6,94;9,17;-16,11;41942;0;0;0;0;55739;26546;0.4762;26885;-339
2017-12-26 04:00:00;-9,65;6,48;-16,13;41942;0;0;0;0;55739;27623;0.4956;28501;-878
2017-12-26 05:00:00;-9,89;7,77;-17,66;41942;0;0;0;0;55739;28746;0.5157;30037;-1291
2017-12-26 06:00:00;-11,88;7,06;-18,94;41942;0;0;0;0;55739;30768;0.552;31525;-757
2017-12-26 07:00:00;-3,24;11,98;-15,22;41942;0;0;0;0;55739;32525;0.5835;33102;-577
2017-12-26 08:00:00;-9,78;10,0;-19,78;41942;259;0.0062;395;-136;55739;33819;0.6068;34365;-546
2017-12-26 09:00:00;0,0;9,37;-9,37;41942;2244;0.0535;2604;-360;55739;35037;0.6286;35183;-146
2017-12-26 10:00:00;-24,33;3,75;-28,08;41942;4822;0.115;5086;-264;55739;35084;0.6294;35769;-685
2017-12-26 11:00:00;-31,69;0,75;-32,44;41942;6502;0.155;6531;-29;55739;34997;0.6279;36241;-1244
2017-12-26 12:00:00;-52,82;-3,76;-49,06;41942;7046;0.168;6652;394;55739;34807;0.6245;36453;-1646
2017-12-26 13:00:00;-53,42;-5,08;-48,34;41942;5734;0.1367;5561;173;55739;34642;0.6215;35883;-1241
2017-12-26 14:00:00;-18,0;0,24;-18,24;41942;3254;0.0776;3597;-343;55739;33944;0.609;34535;-591
2017-12-26 15:00:00;-0,48;11,03;-11,51;41942;1033;0.0246;1222;-189;55739;32749;0.5875;32804;-55
2017-12-26 16:00:00;5,49;15,42;-9,93;41942;29;0.0007;47;-18;55739;32578;0.5844;31250;1328
2017-12-26 17:00:00;10,66;15,93;-5,27;41942;0;0;0;0;55739;31158;0.559;30244;914
2017-12-26 18:00:00;13,35;19,89;-6,54;41942;0;0;0;0;55739;30155;0.541;29310;845
2017-12-26 19:00:00;11,19;15,96;-4,77;41942;0;0;0;0;55739;29471;0.5287;28295;1176
2017-12-26 20:00:00;19,0;19,4;-0,4;41942;0;0;0;0;55739;28084;0.5038;27013;1071
2017-12-26 21:00:00;18,06;12,52;5,54;41942;0;0;0;0;55739;26502;0.4754;25609;893
2017-12-26 22:00:00;22,02;16,59;5,43;41942;0;0;0;0;55739;24117;0.4326;24137;-20
2017-12-26 23:00:00;13,46;13,97;-0,51;41942;0;0;0;0;55739;22802;0.4091;22648;154
2017-12-27 00:00:00;25,37;15,57;9,8;41943;0;0;0;0;55749;21657;0.3885;20507;1150
2017-12-27 01:00:00;15,09;2,13;12,96;41943;0;0;0;0;55749;20750;0.3722;19395;1355
2017-12-27 02:00:00;13,93;2,12;11,81;41943;0;0;0;0;55749;19458;0.349;19013;445
2017-12-27 03:00:00;13,48;9,78;3,7;41943;0;0;0;0;55749;20008;0.3589;19161;847
2017-12-27 04:00:00;12,74;8,3;4,44;41943;0;0;0;0;55749;21128;0.379;19738;1390
2017-12-27 05:00:00;13,29;2,2;11,09;41943;0;0;0;0;55749;21838;0.3917;20577;1261
2017-12-27 06:00:00;20,03;12,39;7,64;41943;0;0;0;0;55749;23561;0.4226;21482;2079
2017-12-27 07:00:00;28,62;26,04;2,58;41943;0;0;0;0;55749;24658;0.4423;22120;2538
2017-12-27 08:00:00;32,0;26,44;5,56;41943;106;0.0025;225;-119;55749;24441;0.4384;22181;2260
2017-12-27 09:00:00;34,91;27,69;7,22;41943;1051;0.025;1406;-355;55749;23553;0.4225;21663;1890
2017-12-27 10:00:00;35,3;34,34;0,96;41943;2526;0.0602;2767;-241;55749;22301;0.4;20358;1943
2017-12-27 11:00:00;42,46;37,37;5,09;41943;3518;0.0839;3545;-27;55749;19927;0.3574;18396;1531
2017-12-27 12:00:00;46,11;39,97;6,14;41943;4040;0.0964;3472;568;55749;16605;0.2978;16254;351
2017-12-27 13:00:00;46,01;42,05;3,96;41943;3131;0.0747;2802;329;55749;13561;0.2432;14330;-769
2017-12-27 14:00:00;46,4;44,8;1,6;41943;1649;0.0393;1696;-47;55749;11344;0.2035;12634;-1290
2017-12-27 15:00:00;46,48;49,81;-3,33;41943;491;0.0117;540;-49;55749;10004;0.1794;11476;-1472
2017-12-27 16:00:00;50,9;54,9;-4,0;41943;18;0.0004;22;-4;55749;9367;0.168;10909;-1542
2017-12-27 17:00:00;56,09;55,1;0,99;41943;0;0;0;0;55749;9715;0.1743;10867;-1152
2017-12-27 18:00:00;57,57;55,15;2,42;41943;0;0;0;0;55749;10298;0.1847;10960;-662
2017-12-27 19:00:00;51,33;47,19;4,14;41943;0;0;0;0;55749;10782;0.1934;11143;-361
2017-12-27 20:00:00;42,4;41,35;1,05;41943;0;0;0;0;55749;10888;0.1953;11450;-562
2017-12-27 21:00:00;40,0;39,02;0,98;41943;0;0;0;0;55749;11013;0.1976;11943;-930
2017-12-27 22:00:00;42,24;39,21;3,03;41943;0;0;0;0;55749;11938;0.2141;12368;-430
2017-12-27 23:00:00;31,27;28,48;2,79;41943;0;0;0;0;55749;13199;0.2368;12863;336
2017-12-28 00:00:00;28,87;16,99;11,88;41946;0;0;0;0;55775;14170;0.254;9504;4666
2017-12-28 01:00:00;28,12;11,17;16,95;41946;0;0;0;0;55775;13695;0.2455;10185;3510
2017-12-28 02:00:00;27,2;19,04;8,16;41946;0;0;0;0;55775;13987;0.2508;10878;3109
2017-12-28 03:00:00;26,0;18,71;7,29;41946;0;0;0;0;55775;15174;0.2721;11559;3615
2017-12-28 04:00:00;26,33;8,53;17,8;41946;0;0;0;0;55775;15063;0.27;12236;2827
2017-12-28 05:00:00;28,89;12,76;16,13;41946;0;0;0;0;55775;15662;0.2808;12819;2843
2017-12-28 06:00:00;30,74;12,58;18,16;41946;0;0;0;0;55775;16372;0.2936;13603;2769
2017-12-28 07:00:00;35,98;19,26;16,72;41946;0;0;0;0;55775;17308;0.3103;14248;3060
2017-12-28 08:00:00;38,43;27,69;10,74;41946;44;0.001;57;-13;55775;18265;0.3275;14869;3396
2017-12-28 09:00:00;39,93;30,66;9,27;41946;604;0.0144;546;58;55775;18926;0.3393;15564;3362
2017-12-28 10:00:00;40,12;31,71;8,41;41946;1773;0.0422;1426;347;55775;19113;0.3427;16469;2644
2017-12-28 11:00:00;39,97;31,06;8,91;41946;2922;0.0696;2185;737;55775;19475;0.3492;17615;1860
2017-12-28 12:00:00;40,16;30,61;9,55;41946;3387;0.0808;2537;850;55775;20331;0.3645;18794;1537
2017-12-28 13:00:00;39,24;29,66;9,58;41946;2943;0.0702;2370;573;55775;21642;0.388;19351;2291
2017-12-28 14:00:00;36,42;26,13;10,29;41946;1827;0.0436;1654;173;55775;22435;0.4022;19395;3040
2017-12-28 15:00:00;40,03;25,03;15,0;41946;632;0.0151;601;31;55775;22512;0.4036;19376;3136
2017-12-28 16:00:00;42,98;28,52;14,46;41946;30;0.0007;32;-2;55775;23235;0.4166;19695;3540
2017-12-28 17:00:00;43,01;28,58;14,43;41946;0;0;0;0;55775;24478;0.4388;20549;3929
2017-12-28 18:00:00;42,16;27,19;14,97;41946;0;0;0;0;55775;25859;0.4636;21582;4277
2017-12-28 19:00:00;34,93;14,68;20,25;41946;0;0;0;0;55775;26896;0.4822;22613;4283
2017-12-28 20:00:00;25,06;4,92;20,14;41946;0;0;0;0;55775;27278;0.4891;23316;3962
2017-12-28 21:00:00;19,99;1,56;18,43;41946;0;0;0;0;55775;27824;0.4989;23735;4089
2017-12-28 22:00:00;19,22;-1,61;20,83;41946;0;0;0;0;55775;26994;0.484;23915;3079
2017-12-28 23:00:00;5,86;-3,72;9,58;41946;0;0;0;0;55775;26810;0.4806;23990;2820
2017-12-29 00:00:00;9,73;-4,65;14,38;41950;0;0;0;0;55784;27090;0.4856;25105;1985
2017-12-29 01:00:00;0,72;-4,08;4,8;41950;0;0;0;0;55784;27523;0.4934;25063;2460
2017-12-29 02:00:00;-0,93;-9,26;8,33;41950;0;0;0;0;55784;27413;0.4914;25140;2273
2017-12-29 03:00:00;1,07;-7,2;8,27;41950;0;0;0;0;55784;26580;0.4765;25145;1435
2017-12-29 04:00:00;1,0;1,03;-0,03;41950;0;0;0;0;55784;25754;0.4617;24885;869
2017-12-29 05:00:00;2,91;7,89;-4,98;41950;0;0;0;0;55784;24488;0.439;24329;159
2017-12-29 06:00:00;3,6;8,2;-4,6;41950;0;0;0;0;55784;24285;0.4353;23718;567
2017-12-29 07:00:00;15,97;11,78;4,19;41950;0;0;0;0;55784;24767;0.444;23039;1728
2017-12-29 08:00:00;29,69;19,56;10,13;41950;122;0.0029;231;-109;55784;24151;0.433;22422;1729
2017-12-29 09:00:00;30,2;20,8;9,4;41950;1422;0.0339;1892;-470;55784;23148;0.415;21941;1207
2017-12-29 10:00:00;29,83;22,42;7,41;41950;3919;0.0934;4266;-347;55784;21913;0.3929;21711;202
2017-12-29 11:00:00;29,47;24,27;5,2;41950;6210;0.148;5993;217;55784;21661;0.3883;21700;-39
2017-12-29 12:00:00;29,2;21,95;7,25;41950;7386;0.1761;6468;918;55784;21684;0.3887;21438;246
2017-12-29 13:00:00;29,45;18,75;10,7;41950;6210;0.148;5570;640;55784;21719;0.3893;20729;990
2017-12-29 14:00:00;30,02;19,59;10,43;41950;3642;0.0868;3632;10;55784;21802;0.3909;19847;1955
2017-12-29 15:00:00;31,0;21,92;9,08;41950;934;0.0222;1306;-372;55784;21620;0.3876;19384;2236
2017-12-29 16:00:00;32,98;26,98;6,0;41950;9;0.0002;58;-49;55784;23178;0.4155;19881;3297
2017-12-29 17:00:00;34,95;25,9;9,05;41950;0;0;0;0;55784;25484;0.4568;21096;4388
2017-12-29 18:00:00;32,79;23,71;9,08;41950;0;0;0;0;55784;26450;0.4742;22638;3812
2017-12-29 19:00:00;30,23;23,87;6,36;41950;0;0;0;0;55784;26377;0.4728;23678;2699
2017-12-29 20:00:00;28,49;25,79;2,7;41950;0;0;0;0;55784;25622;0.4593;23952;1670
2017-12-29 21:00:00;26,51;23,92;2,59;41950;0;0;0;0;55784;25374;0.4549;23723;1651
2017-12-29 22:00:00;26,9;20,47;6,43;41950;0;0;0;0;55784;24630;0.4415;23138;1492
2017-12-29 23:00:00;15,06;15,33;-0,27;41950;0;0;0;0;55784;24578;0.4406;22445;2133
2017-12-30 00:00:00;16,4;11,32;5,08;41951;0;0;0;0;55790;24076;0.4315;21844;2232
2017-12-30 01:00:00;13,33;9,8;3,53;41951;0;0;0;0;55790;24151;0.4329;21533;2618
2017-12-30 02:00:00;13,25;9,28;3,97;41951;0;0;0;0;55790;23988;0.43;21457;2531
2017-12-30 03:00:00;12,04;7,98;4,06;41951;0;0;0;0;55790;22740;0.4076;21169;1571
2017-12-30 04:00:00;11,45;12,99;-1,54;41951;0;0;0;0;55790;22351;0.4006;20980;1371
2017-12-30 05:00:00;8,49;10,28;-1,79;41951;0;0;0;0;55790;23024;0.4127;20952;2072
2017-12-30 06:00:00;9,83;6,29;3,54;41951;0;0;0;0;55790;24732;0.4433;20958;3774
2017-12-30 07:00:00;12,07;4,04;8,03;41951;0;0;0;0;55790;25275;0.453;21173;4102
2017-12-30 08:00:00;13,41;7,79;5,62;41951;65;0.0016;58;7;55790;26341;0.4721;21712;4629
2017-12-30 09:00:00;16,09;4,95;11,14;41951;518;0.0124;418;100;55790;27034;0.4846;22355;4679
2017-12-30 10:00:00;18,8;0,28;18,52;41951;1109;0.0264;895;214;55790;27484;0.4926;23139;4345
2017-12-30 11:00:00;17,03;3,42;13,61;41951;1532;0.0365;1161;371;55790;28279;0.5069;24108;4171
2017-12-30 12:00:00;17,67;1,21;16,46;41951;1606;0.0383;1144;462;55790;28896;0.5179;25059;3837
2017-12-30 13:00:00;15,51;0,92;14,59;41951;1313;0.0313;947;366;55790;29928;0.5365;25922;4006
2017-12-30 14:00:00;17,61;0,41;17,2;41951;929;0.0221;626;303;55790;30832;0.5527;27216;3616
2017-12-30 15:00:00;13,22;2,13;11,09;41951;378;0.009;220;158;55790;32218;0.5775;29033;3185
2017-12-30 16:00:00;14,02;5,17;8,85;41951;17;0.0004;16;1;55790;33924;0.6081;30460;3464
2017-12-30 17:00:00;16,78;7,34;9,44;41951;0;0;0;0;55790;35728;0.6404;31849;3879
2017-12-30 18:00:00;16,01;5,11;10,9;41951;0;0;0;0;55790;37216;0.6671;33334;3882
2017-12-30 19:00:00;16,18;2,32;13,86;41951;0;0;0;0;55790;37901;0.6793;34124;3777
2017-12-30 20:00:00;11,13;2,58;8,55;41951;0;0;0;0;55790;38128;0.6834;34490;3638
2017-12-30 21:00:00;4,62;-0,38;5,0;41951;0;0;0;0;55790;38086;0.6826;34545;3541
2017-12-30 22:00:00;4,71;0,02;4,69;41951;0;0;0;0;55790;36243;0.6497;34215;2028
2017-12-30 23:00:00;-0,27;-0,13;-0,14;41951;0;0;0;0;55790;34444;0.6174;33561;883
2017-12-31 00:00:00;-2,04;2,61;-4,65;41951;0;0;0;0;55790;32304;0.579;33428;-1124
2017-12-31 01:00:00;-4,99;7,06;-12,05;41951;0;0;0;0;55790;30419;0.5452;31523;-1104
2017-12-31 02:00:00;-0,59;12,64;-13,23;41951;0;0;0;0;55790;27533;0.4935;29867;-2334
2017-12-31 03:00:00;-3,71;10,91;-14,62;41951;0;0;0;0;55790;23920;0.4288;27775;-3855
2017-12-31 04:00:00;0,08;10,75;-10,67;41951;0;0;0;0;55790;21531;0.3859;25681;-4150
2017-12-31 05:00:00;1,16;10,66;-9,5;41951;0;0;0;0;55790;21962;0.3936;24343;-2381
2017-12-31 06:00:00;-0,86;9,84;-10,7;41951;0;0;0;0;55790;22920;0.4108;24009;-1089
2017-12-31 07:00:00;4,09;5,53;-1,44;41951;0;0;0;0;55790;23844;0.4274;24489;-645
2017-12-31 08:00:00;4,17;5,76;-1,59;41951;125;0.003;143;-18;55790;25477;0.4566;25906;-429
2017-12-31 09:00:00;4,21;6,11;-1,9;41951;1190;0.0284;877;313;55790;27999;0.5019;28099;-100
2017-12-31 10:00:00;9,05;1,92;7,13;41951;2846;0.0678;1916;930;55790;30902;0.5539;30346;556
2017-12-31 11:00:00;9,2;-1,99;11,19;41951;3963;0.0945;2681;1282;55790;33568;0.6017;32489;1079
2017-12-31 12:00:00;4,45;-5,93;10,38;41951;4034;0.0962;3007;1027;55790;35903;0.6436;34310;1593
2017-12-31 13:00:00;2,04;-7,07;9,11;41951;3698;0.0881;2866;832;55790;36623;0.6564;35233;1390
2017-12-31 14:00:00;0,06;-3,93;3,99;41951;2780;0.0662;2127;653;55790;37017;0.6635;35334;1683
2017-12-31 15:00:00;0,36;-5,19;5,55;41951;1264;0.0302;911;353;55790;36322;0.651;34895;1427
2017-12-31 16:00:00;1,46;-1,34;2,8;41951;80;0.0019;66;14;55790;35752;0.6408;34142;1610
2017-12-31 17:00:00;6,14;8,16;-2,02;41951;0;0;0;0;55790;34478;0.618;33343;1135
2017-12-31 18:00:00;9,96;11,64;-1,68;41951;0;0;0;0;55790;32045;0.5744;32241;-196
2017-12-31 19:00:00;7,92;20,64;-12,72;41951;0;0;0;0;55790;30688;0.55;31401;-713
2017-12-31 20:00:00;4,06;10,63;-6,57;41951;0;0;0;0;55790;29758;0.5334;30872;-1114
2017-12-31 21:00:00;5,3;3,86;1,44;41951;0;0;0;0;55790;29988;0.5375;30561;-573
2017-12-31 22:00:00;1,86;5,37;-3,51;41951;0;0;0;0;55790;30355;0.5441;30490;-135
2017-12-31 23:00:00;-0,92;3,65;-4,57;41951;0;0;0;0;55790;30594;0.5484;30492;102
